"Survey Date","Hospital Region","Hospital Region Code","Facility Type","Facility Filter","All Beds","Inpatient Beds","Inpatient Beds Used","Inpatient Beds Available","ICU Beds","ICU Beds Used","ICU Beds Available","Vents","Vents Used","Vents Available","Pos COVID","PUI Pending","Pos COVID PUI Pending","All Beds (Imputed)","Inpatient Beds (Imputed)","Inpatient Beds Used (Imputed)","Inpatient Beds Available (Imputed)","ICU Beds (Imputed)","ICU Beds Used (Imputed)","ICU Beds Available (Imputed)","Vents (Imputed)","Vents Used (Imputed)","Vents Available (Imputed)","Pos COVID (Imputed)","PUI Pending (Imputed)","Pos COVID PUI Pending (Imputed)"
04/02/2020,Anchorage,7,GACH,1,868,724,393,331,83,46,37,126,15,111,,,,868,724,393,331,83,46,37,126,15,111,,,
04/02/2020,Anchorage,7,LTACH,0,56,30,20,10,11,3,8,24,0,24,,,,56,30,20,10,11,3,8,24,0,24,,,
04/02/2020,Anchorage,7,Psych,0,244,214,141,73,0,0,0,0,0,0,,,,244,214,141,73,0,0,0,0,0,0,,,
04/02/2020,Gulf Coast,4,CAH,1,112,106,23,83,4,0,4,16,2,14,,,,112,106,23,83,4,0,4,16,2,14,,,
04/02/2020,Gulf Coast,4,GACH,1,49,43,17,26,6,1,5,7,1,6,,,,49,43,17,26,6,1,5,7,1,6,,,
04/02/2020,Interior,6,GACH,1,94,81,38,43,13,3,10,15,0,15,,,,94,81,38,43,13,3,10,15,0,15,,,
04/02/2020,Matanuska-Susitna,3,GACH,1,192,125,51,74,14,7,7,14,2,12,,,,192,125,51,74,14,7,7,14,2,12,,,
04/02/2020,Northern,2,CAH,1,47,43,21,22,0,0,0,15,0,15,,,,47,43,21,22,0,0,0,15,0,15,,,
04/02/2020,Southeast,5,CAH,1,79,75,26,49,12,0,12,25,0,25,,,,79,75,26,49,12,0,12,25,0,25,,,
04/02/2020,Southeast,5,GACH,1,81,56,18,38,9,0,9,15,0,15,,,,81,56,18,38,9,0,9,15,0,15,,,
04/02/2020,Southwest,1,CAH,1,26,12,1,11,0,0,0,2,0,2,,,,26,12,1,11,0,0,0,2,0,2,,,
04/02/2020,Southwest,1,GACH,1,62,45,10,35,8,0,8,4,0,4,,,,62,45,10,35,8,0,8,4,0,4,,,
04/03/2020,Anchorage,7,GACH,1,909,724,452,272,92,55,37,127,13,114,,,,909,724,452,272,92,55,37,127,13,114,,,
04/03/2020,Anchorage,7,LTACH,0,56,30,22,8,11,3,8,24,0,24,,,,56,30,22,8,11,3,8,24,0,24,,,
04/03/2020,Anchorage,7,Psych,0,116,86,47,39,0,0,0,0,0,0,,,,116,86,47,39,0,0,0,0,0,0,,,
04/03/2020,Gulf Coast,4,CAH,1,118,106,22,84,4,0,4,16,0,16,,,,118,106,22,84,4,0,4,16,0,16,,,
04/03/2020,Gulf Coast,4,GACH,1,49,43,18,25,6,1,5,7,1,6,,,,49,43,18,25,6,1,5,7,1,6,,,
04/03/2020,Interior,6,GACH,1,94,81,38,43,13,3,10,15,0,15,,,,94,81,38,43,13,3,10,15,0,15,,,
04/03/2020,Matanuska-Susitna,3,GACH,1,192,125,48,77,14,7,7,14,4,10,,,,192,125,48,77,14,7,7,14,4,10,,,
04/03/2020,Northern,2,CAH,1,47,43,25,18,0,0,0,15,0,15,,,,47,43,25,18,0,0,0,15,0,15,,,
04/03/2020,Southeast,5,CAH,1,79,75,26,49,12,0,12,25,0,25,,,,79,75,26,49,12,0,12,25,0,25,,,
04/03/2020,Southeast,5,GACH,1,81,56,13,43,9,2,7,15,0,15,,,,81,56,13,43,9,2,7,15,0,15,,,
04/03/2020,Southwest,1,CAH,1,26,12,1,11,0,0,0,2,0,2,,,,26,12,1,11,0,0,0,2,0,2,,,
04/03/2020,Southwest,1,GACH,1,62,45,11,34,8,0,8,4,0,4,,,,62,45,11,34,8,0,8,4,0,4,,,
04/04/2020,Anchorage,7,GACH,1,909,724,454,270,92,56,36,125,8,117,,,,909,724,454,270,92,56,36,125,8,117,,,
04/04/2020,Anchorage,7,LTACH,0,56,30,22,8,11,3,8,24,0,24,,,,56,30,22,8,11,3,8,24,0,24,,,
04/04/2020,Anchorage,7,Psych,0,116,86,47,39,0,0,0,0,0,0,,,,116,86,47,39,0,0,0,0,0,0,,,
04/04/2020,Gulf Coast,4,CAH,1,131,109,16,93,4,0,4,16,0,16,,,,131,109,16,93,4,0,4,16,0,16,,,
04/04/2020,Gulf Coast,4,GACH,1,49,43,21,22,6,2,4,7,1,6,,,,49,43,21,22,6,2,4,7,1,6,,,
04/04/2020,Interior,6,GACH,1,94,81,43,38,13,3,10,15,0,15,,,,94,81,43,38,13,3,10,15,0,15,,,
04/04/2020,Matanuska-Susitna,3,GACH,1,192,125,48,77,14,7,7,14,4,10,,,,192,125,48,77,14,7,7,14,4,10,,,
04/04/2020,Northern,2,CAH,1,94,43,23,20,0,0,0,15,1,14,,,,94,43,23,20,0,0,0,15,1,14,,,
04/04/2020,Southeast,5,CAH,1,79,75,27,48,12,0,12,25,0,25,,,,79,75,27,48,12,0,12,25,0,25,,,
04/04/2020,Southeast,5,GACH,1,57,46,15,31,9,3,6,15,0,15,,,,57,46,15,31,9,3,6,15,0,15,,,
04/04/2020,Southwest,1,CAH,1,26,12,2,10,0,0,0,2,0,2,,,,26,12,2,10,0,0,0,2,0,2,,,
04/04/2020,Southwest,1,GACH,1,62,45,10,35,8,0,8,4,0,4,,,,62,45,10,35,8,0,8,4,0,4,,,
04/05/2020,Anchorage,7,GACH,1,909,724,452,272,92,59,33,133,17,116,,,,909,724,452,272,92,59,33,133,17,116,,,
04/05/2020,Anchorage,7,LTACH,0,56,30,22,8,11,3,8,24,0,24,,,,56,30,22,8,11,3,8,24,0,24,,,
04/05/2020,Anchorage,7,Psych,0,116,86,47,39,0,0,0,0,0,0,,,,116,86,47,39,0,0,0,0,0,0,,,
04/05/2020,Gulf Coast,4,CAH,1,140,109,15,94,4,0,4,16,0,16,,,,140,109,15,94,4,0,4,16,0,16,,,
04/05/2020,Gulf Coast,4,GACH,1,49,43,27,16,6,5,1,7,1,6,,,,49,43,27,16,6,5,1,7,1,6,,,
04/05/2020,Interior,6,GACH,1,94,81,43,38,13,3,10,15,0,15,,,,94,81,43,38,13,3,10,15,0,15,,,
04/05/2020,Matanuska-Susitna,3,GACH,1,192,125,48,77,14,7,7,14,4,10,,,,192,125,48,77,14,7,7,14,4,10,,,
04/05/2020,Northern,2,CAH,1,135,43,23,20,0,0,0,15,1,14,,,,135,43,23,20,0,0,0,15,1,14,,,
04/05/2020,Southeast,5,CAH,1,79,75,28,47,12,0,12,25,0,25,,,,79,75,28,47,12,0,12,25,0,25,,,
04/05/2020,Southeast,5,GACH,1,57,46,9,37,9,3,6,15,0,15,,,,57,46,9,37,9,3,6,15,0,15,,,
04/05/2020,Southwest,1,CAH,1,26,12,3,9,0,0,0,2,0,2,,,,26,12,3,9,0,0,0,2,0,2,,,
04/05/2020,Southwest,1,GACH,1,62,45,10,35,8,0,8,4,0,4,,,,62,45,10,35,8,0,8,4,0,4,,,
04/06/2020,Anchorage,7,GACH,1,909,724,415,309,92,53,39,135,18,117,,,,909,724,415,309,92,53,39,135,18,117,,,
04/06/2020,Anchorage,7,LTACH,0,56,30,24,6,11,3,8,24,0,24,,,,56,30,24,6,11,3,8,24,0,24,,,
04/06/2020,Anchorage,7,Psych,0,116,86,49,37,0,0,0,0,0,0,,,,116,86,49,37,0,0,0,0,0,0,,,
04/06/2020,Gulf Coast,4,CAH,1,130,109,13,96,4,0,4,17,0,17,,,,130,109,13,96,4,0,4,17,0,17,,,
04/06/2020,Gulf Coast,4,GACH,1,49,43,29,14,6,5,1,7,0,7,,,,49,43,29,14,6,5,1,7,0,7,,,
04/06/2020,Interior,6,GACH,1,94,81,42,39,13,2,11,15,0,15,,,,94,81,42,39,13,2,11,15,0,15,,,
04/06/2020,Matanuska-Susitna,3,GACH,1,192,125,50,75,14,9,5,14,4,10,,,,192,125,50,75,14,9,5,14,4,10,,,
04/06/2020,Northern,2,CAH,1,79,43,16,27,0,0,0,15,0,15,,,,79,43,16,27,0,0,0,15,0,15,,,
04/06/2020,Southeast,5,CAH,1,79,75,32,43,12,2,10,25,0,25,,,,79,75,32,43,12,2,10,25,0,25,,,
04/06/2020,Southeast,5,GACH,1,81,56,13,43,9,1,8,15,0,15,,,,81,56,13,43,9,1,8,15,0,15,,,
04/06/2020,Southwest,1,CAH,1,26,12,1,11,0,0,0,2,0,2,,,,26,12,1,11,0,0,0,2,0,2,,,
04/06/2020,Southwest,1,GACH,1,62,45,10,35,8,0,8,4,0,4,,,,62,45,10,35,8,0,8,4,0,4,,,
04/07/2020,Anchorage,7,GACH,1,909,724,405,319,92,55,37,138,22,116,,,,909,724,405,319,92,55,37,138,22,116,,,
04/07/2020,Anchorage,7,LTACH,0,56,30,22,8,11,3,8,24,0,24,,,,56,30,22,8,11,3,8,24,0,24,,,
04/07/2020,Anchorage,7,Psych,0,116,86,50,36,0,0,0,0,0,0,,,,116,86,50,36,0,0,0,0,0,0,,,
04/07/2020,Gulf Coast,4,CAH,1,130,109,11,98,4,1,3,17,0,17,,,,130,109,11,98,4,1,3,17,0,17,,,
04/07/2020,Gulf Coast,4,GACH,1,49,43,30,13,6,5,1,7,0,7,,,,49,43,30,13,6,5,1,7,0,7,,,
04/07/2020,Interior,6,GACH,1,94,81,41,40,13,1,12,15,1,14,,,,94,81,41,40,13,1,12,15,1,14,,,
04/07/2020,Matanuska-Susitna,3,GACH,1,192,125,50,75,14,6,8,14,5,9,,,,192,125,50,75,14,6,8,14,5,9,,,
04/07/2020,Northern,2,CAH,1,120,43,21,22,0,0,0,15,0,15,,,,120,43,21,22,0,0,0,15,0,15,,,
04/07/2020,Southeast,5,CAH,1,79,75,36,39,12,2,10,25,0,25,,,,79,75,36,39,12,2,10,25,0,25,,,
04/07/2020,Southeast,5,GACH,1,81,56,12,44,9,3,6,15,0,15,,,,81,56,12,44,9,3,6,15,0,15,,,
04/07/2020,Southwest,1,CAH,1,26,12,1,11,0,0,0,2,0,2,,,,26,12,1,11,0,0,0,2,0,2,,,
04/07/2020,Southwest,1,GACH,1,62,45,13,32,8,0,8,4,0,4,,,,62,45,13,32,8,0,8,4,0,4,,,
04/08/2020,Anchorage,7,GACH,1,378,724,183,140,36,19,17,167,12,155,,,,909,724,410,314,92,54,38,167,12,155,,,
04/08/2020,Anchorage,7,LTACH,0,56,30,22,8,11,3,8,24,0,24,,,,56,30,22,8,11,3,8,24,0,24,,,
04/08/2020,Anchorage,7,Psych,0,116,86,58,28,0,0,0,0,0,0,,,,116,86,58,28,0,0,0,0,0,0,,,
04/08/2020,Gulf Coast,4,CAH,1,130,109,14,95,4,0,4,17,0,17,,,,130,109,14,95,4,0,4,17,0,17,,,
04/08/2020,Gulf Coast,4,GACH,1,49,43,29,14,6,5,1,10,0,10,,,,49,43,29,14,6,5,1,10,0,10,,,
04/08/2020,Interior,6,GACH,1,94,81,37,44,13,5,8,15,0,15,,,,94,81,37,44,13,5,8,15,0,15,,,
04/08/2020,Matanuska-Susitna,3,GACH,1,192,125,49,76,14,7,7,14,2,12,,,,192,125,49,76,14,7,7,14,2,12,,,
04/08/2020,Northern,2,CAH,1,120,78,14,64,8,0,8,24,0,24,,,,120,78,14,64,8,0,8,24,0,24,,,
04/08/2020,Southeast,5,CAH,1,79,75,30,45,12,3,9,25,0,25,,,,79,75,30,45,12,3,9,25,0,25,,,
04/08/2020,Southeast,5,GACH,1,81,56,20,36,9,3,6,15,0,15,,,,81,56,20,36,9,3,6,15,0,15,,,
04/08/2020,Southwest,1,CAH,1,26,12,0,12,0,0,0,2,0,2,,,,26,12,0,12,0,0,0,2,0,2,,,
04/08/2020,Southwest,1,GACH,1,62,45,14,31,8,0,8,4,0,4,,,,62,45,14,31,8,0,8,4,0,4,,,
04/09/2020,Anchorage,7,GACH,1,909,724,411,313,92,51,41,138,18,120,,,,909,724,411,313,92,51,41,138,18,120,,,
04/09/2020,Anchorage,7,LTACH,0,56,30,26,4,11,3,8,24,0,24,,,,56,30,26,4,11,3,8,24,0,24,,,
04/09/2020,Anchorage,7,Psych,0,116,86,56,30,0,0,0,0,0,0,,,,116,86,56,30,0,0,0,0,0,0,,,
04/09/2020,Gulf Coast,4,CAH,1,130,109,15,94,4,1,3,17,0,17,,,,130,109,15,94,4,1,3,17,0,17,,,
04/09/2020,Gulf Coast,4,GACH,1,49,43,35,8,6,4,2,10,0,10,,,,49,43,35,8,6,4,2,10,0,10,,,
04/09/2020,Interior,6,GACH,1,94,81,44,37,13,4,9,15,0,15,,,,94,81,44,37,13,4,9,15,0,15,,,
04/09/2020,Matanuska-Susitna,3,GACH,1,192,125,52,73,14,7,7,14,4,10,,,,192,125,52,73,14,7,7,14,4,10,,,
04/09/2020,Northern,2,CAH,1,135,95,15,80,8,0,8,24,0,24,,,,135,95,15,80,8,0,8,24,0,24,,,
04/09/2020,Southeast,5,CAH,1,79,75,28,47,12,1,11,25,0,25,,,,79,75,28,47,12,1,11,25,0,25,,,
04/09/2020,Southeast,5,GACH,1,81,56,16,40,9,5,4,15,0,15,,,,81,56,16,40,9,5,4,15,0,15,,,
04/09/2020,Southwest,1,CAH,1,26,12,1,11,0,0,0,2,0,2,,,,26,12,1,11,0,0,0,2,0,2,,,
04/09/2020,Southwest,1,GACH,1,62,45,14,31,8,0,8,4,0,4,,,,62,45,14,31,8,0,8,4,0,4,,,
04/10/2020,Anchorage,7,GACH,1,909,724,413,311,92,54,38,134,26,108,,,,909,724,413,311,92,54,38,134,26,108,,,
04/10/2020,Anchorage,7,LTACH,0,56,30,28,2,11,3,8,24,0,24,,,,56,30,28,2,11,3,8,24,0,24,,,
04/10/2020,Anchorage,7,Psych,0,116,86,57,29,0,0,0,0,0,0,,,,116,86,57,29,0,0,0,0,0,0,,,
04/10/2020,Gulf Coast,4,CAH,1,130,109,20,89,4,1,3,17,0,17,,,,130,109,20,89,4,1,3,17,0,17,,,
04/10/2020,Gulf Coast,4,GACH,1,49,43,29,14,6,4,2,10,0,10,,,,49,43,29,14,6,4,2,10,0,10,,,
04/10/2020,Interior,6,GACH,1,94,81,38,43,13,5,8,15,0,15,,,,94,81,38,43,13,5,8,15,0,15,,,
04/10/2020,Matanuska-Susitna,3,GACH,1,192,125,47,78,14,8,6,14,3,11,,,,192,125,47,78,14,8,6,14,3,11,,,
04/10/2020,Northern,2,CAH,1,135,95,13,82,8,0,8,24,0,24,,,,135,95,13,82,8,0,8,24,0,24,,,
04/10/2020,Southeast,5,CAH,1,79,75,28,47,12,2,10,25,0,25,,,,79,75,28,47,12,2,10,25,0,25,,,
04/10/2020,Southeast,5,GACH,1,81,56,22,34,9,4,5,15,0,15,,,,81,56,22,34,9,4,5,15,0,15,,,
04/10/2020,Southwest,1,CAH,1,26,12,3,9,0,0,0,2,0,2,,,,26,12,3,9,0,0,0,2,0,2,,,
04/10/2020,Southwest,1,GACH,1,62,45,13,32,8,0,8,4,0,4,,,,62,45,13,32,8,0,8,4,0,4,,,
04/11/2020,Anchorage,7,GACH,1,909,724,422,302,92,58,34,134,26,108,,,,909,724,422,302,92,58,34,134,26,108,,,
04/11/2020,Anchorage,7,LTACH,0,56,30,28,2,11,3,8,24,0,24,,,,56,30,28,2,11,3,8,24,0,24,,,
04/11/2020,Anchorage,7,Psych,0,116,86,58,28,0,0,0,0,0,0,,,,116,86,58,28,0,0,0,0,0,0,,,
04/11/2020,Gulf Coast,4,CAH,1,140,107,20,87,4,0,4,16,0,16,,,,140,107,20,87,4,0,4,16,0,16,,,
04/11/2020,Gulf Coast,4,GACH,1,49,43,25,18,6,2,4,9,0,9,,,,49,43,25,18,6,2,4,9,0,9,,,
04/11/2020,Interior,6,GACH,1,94,81,35,46,13,8,5,15,0,15,,,,94,81,35,46,13,8,5,15,0,15,,,
04/11/2020,Matanuska-Susitna,3,GACH,1,192,125,51,74,14,6,8,14,2,12,,,,192,125,51,74,14,6,8,14,2,12,,,
04/11/2020,Northern,2,CAH,1,135,95,15,80,8,0,8,24,0,24,,,,135,95,15,80,8,0,8,24,0,24,,,
04/11/2020,Southeast,5,CAH,1,79,75,35,40,12,2,10,25,0,25,,,,79,75,35,40,12,2,10,25,0,25,,,
04/11/2020,Southeast,5,GACH,1,57,46,18,28,9,5,4,15,0,15,,,,57,46,18,28,9,5,4,15,0,15,,,
04/11/2020,Southwest,1,CAH,1,26,12,3,9,0,0,0,2,0,2,,,,26,12,3,9,0,0,0,2,0,2,,,
04/11/2020,Southwest,1,GACH,1,62,45,8,37,8,0,8,4,0,4,,,,62,45,8,37,8,0,8,4,0,4,,,
04/12/2020,Anchorage,7,GACH,1,909,724,417,307,92,58,34,137,23,114,,,,909,724,417,307,92,58,34,137,23,114,,,
04/12/2020,Anchorage,7,LTACH,0,56,30,27,3,11,3,8,24,0,24,,,,56,30,27,3,11,3,8,24,0,24,,,
04/12/2020,Anchorage,7,Psych,0,116,86,58,28,0,0,0,0,0,0,,,,116,86,58,28,0,0,0,0,0,0,,,
04/12/2020,Gulf Coast,4,CAH,1,140,107,20,87,4,0,4,16,0,16,,,,140,107,20,87,4,0,4,16,0,16,,,
04/12/2020,Gulf Coast,4,GACH,1,49,43,25,18,6,4,2,9,0,9,,,,49,43,25,18,6,4,2,9,0,9,,,
04/12/2020,Interior,6,GACH,1,94,81,40,41,13,6,7,15,0,15,,,,94,81,40,41,13,6,7,15,0,15,,,
04/12/2020,Matanuska-Susitna,3,GACH,1,192,125,47,78,14,4,10,16,1,15,,,,192,125,47,78,14,4,10,16,1,15,,,
04/12/2020,Northern,2,CAH,1,135,95,10,85,8,0,8,24,0,24,,,,135,95,10,85,8,0,8,24,0,24,,,
04/12/2020,Southeast,5,CAH,1,79,75,36,39,12,2,10,25,0,25,,,,79,75,36,39,12,2,10,25,0,25,,,
04/12/2020,Southeast,5,GACH,1,57,46,17,29,9,4,5,15,0,15,,,,57,46,17,29,9,4,5,15,0,15,,,
04/12/2020,Southwest,1,CAH,1,26,12,2,10,0,0,0,2,0,2,,,,26,12,2,10,0,0,0,2,0,2,,,
04/12/2020,Southwest,1,GACH,1,62,45,8,37,8,0,8,4,0,4,,,,62,45,8,37,8,0,8,4,0,4,,,
04/13/2020,Anchorage,7,GACH,1,909,323,395,137,90,58,32,136,22,114,,,,909,724,395,300,90,58,32,136,22,114,,,
04/13/2020,Anchorage,7,LTACH,0,56,30,28,2,11,5,6,23,1,22,,,,56,30,28,2,11,5,6,23,1,22,,,
04/13/2020,Anchorage,7,Psych,0,116,86,61,25,0,0,0,0,0,0,,,,116,86,61,25,0,0,0,0,0,0,,,
04/13/2020,Gulf Coast,4,CAH,1,130,109,19,90,4,0,4,17,0,17,,,,130,109,19,90,4,0,4,17,0,17,,,
04/13/2020,Gulf Coast,4,GACH,1,49,43,26,17,6,2,4,9,1,8,,,,49,43,26,17,6,2,4,9,1,8,,,
04/13/2020,Interior,6,GACH,1,94,81,41,40,13,5,8,15,0,15,,,,94,81,41,40,13,5,8,15,0,15,,,
04/13/2020,Matanuska-Susitna,3,GACH,1,192,125,47,78,14,11,3,16,0,16,,,,192,125,47,78,14,11,3,16,0,16,,,
04/13/2020,Northern,2,CAH,1,135,95,9,86,8,0,8,24,0,24,,,,135,95,9,86,8,0,8,24,0,24,,,
04/13/2020,Southeast,5,CAH,1,79,75,27,48,12,3,9,25,0,25,,,,79,75,27,48,12,3,9,25,0,25,,,
04/13/2020,Southeast,5,GACH,1,81,56,18,38,9,3,6,15,0,15,,,,81,56,18,38,9,3,6,15,0,15,,,
04/13/2020,Southwest,1,CAH,1,26,12,2,10,0,0,0,2,0,2,,,,26,12,2,10,0,0,0,2,0,2,,,
04/13/2020,Southwest,1,GACH,1,62,45,4,41,8,0,8,4,0,4,,,,62,45,4,41,8,0,8,4,0,4,,,
04/14/2020,Anchorage,7,GACH,1,995,423,387,242,90,55,35,155,19,136,,,,995,824,387,405,90,55,35,155,19,136,,,
04/14/2020,Anchorage,7,LTACH,0,56,30,28,2,11,5,6,23,1,22,,,,56,30,28,2,11,5,6,23,1,22,,,
04/14/2020,Anchorage,7,Psych,0,116,86,62,24,0,0,0,0,0,0,,,,116,86,62,24,0,0,0,0,0,0,,,
04/14/2020,Gulf Coast,4,CAH,1,130,96,17,81,4,0,4,17,0,17,,,,130,109,17,92,4,0,4,17,0,17,,,
04/14/2020,Gulf Coast,4,GACH,1,49,43,24,19,6,2,4,9,2,7,,,,49,43,24,19,6,2,4,9,2,7,,,
04/14/2020,Interior,6,GACH,1,94,81,32,49,13,5,8,15,0,15,,,,94,81,32,49,13,5,8,15,0,15,,,
04/14/2020,Matanuska-Susitna,3,GACH,1,192,125,53,72,14,6,8,17,0,17,,,,192,125,53,72,14,6,8,17,0,17,,,
04/14/2020,Northern,2,CAH,1,135,95,13,82,8,0,8,24,0,24,,,,135,95,13,82,8,0,8,24,0,24,,,
04/14/2020,Southeast,5,CAH,1,79,75,28,47,12,0,12,25,0,25,,,,79,75,28,47,12,0,12,25,0,25,,,
04/14/2020,Southeast,5,GACH,1,81,56,19,37,9,1,8,15,0,15,,,,81,56,19,37,9,1,8,15,0,15,,,
04/14/2020,Southwest,1,CAH,1,26,12,3,9,0,0,0,2,0,2,,,,26,12,3,9,0,0,0,2,0,2,,,
04/14/2020,Southwest,1,GACH,1,62,45,5,40,8,0,8,4,0,4,,,,62,45,5,40,8,0,8,4,0,4,,,
04/15/2020,Anchorage,7,GACH,1,464,824,235,589,149,33,116,182,17,165,,,,995,824,235,589,149,33,116,182,17,165,,,
04/15/2020,Anchorage,7,LTACH,0,56,30,28,2,11,5,6,23,1,22,,,,56,30,28,2,11,5,6,23,1,22,,,
04/15/2020,Anchorage,7,Psych,0,116,86,55,31,0,0,0,0,0,0,,,,116,86,55,31,0,0,0,0,0,0,,,
04/15/2020,Gulf Coast,4,CAH,1,130,96,19,79,4,0,4,17,0,17,,,,130,109,19,90,4,0,4,17,0,17,,,
04/15/2020,Gulf Coast,4,GACH,1,49,43,23,20,6,2,4,9,1,8,,,,49,43,23,20,6,2,4,9,1,8,,,
04/15/2020,Interior,6,GACH,1,94,81,28,53,13,4,9,15,1,14,,,,94,81,28,53,13,4,9,15,1,14,,,
04/15/2020,Matanuska-Susitna,3,GACH,1,192,125,51,74,14,8,6,17,1,16,,,,192,125,51,74,14,8,6,17,1,16,,,
04/15/2020,Northern,2,CAH,1,135,95,20,75,8,0,8,24,0,24,,,,135,95,20,75,8,0,8,24,0,24,,,
04/15/2020,Southeast,5,CAH,1,79,75,21,54,12,0,12,25,0,25,,,,79,75,21,54,12,0,12,25,0,25,,,
04/15/2020,Southeast,5,GACH,1,81,56,19,37,9,3,6,15,0,15,,,,81,56,19,37,9,3,6,15,0,15,,,
04/15/2020,Southwest,1,CAH,1,26,12,1,11,0,0,0,2,0,2,,,,26,12,1,11,0,0,0,2,0,2,,,
04/15/2020,Southwest,1,GACH,1,62,45,4,41,8,0,8,4,0,4,,,,62,45,4,41,8,0,8,4,0,4,,,
04/16/2020,Anchorage,7,GACH,1,865,824,234,590,149,43,106,183,13,170,,,,865,824,234,590,149,43,106,183,13,170,,,
04/16/2020,Anchorage,7,LTACH,0,56,30,28,2,11,5,6,23,1,22,,,,56,30,28,2,11,5,6,23,1,22,,,
04/16/2020,Anchorage,7,Psych,0,116,86,56,30,0,0,0,0,0,0,,,,116,86,56,30,0,0,0,0,0,0,,,
04/16/2020,Gulf Coast,4,CAH,1,130,96,18,80,4,0,4,17,0,17,,,,130,109,18,91,4,0,4,17,0,17,,,
04/16/2020,Gulf Coast,4,GACH,1,49,43,23,20,6,4,2,9,1,8,,,,49,43,23,20,6,4,2,9,1,8,,,
04/16/2020,Interior,6,GACH,1,94,81,32,49,13,8,5,15,2,13,,,,94,81,32,49,13,8,5,15,2,13,,,
04/16/2020,Matanuska-Susitna,3,GACH,1,192,125,45,80,14,5,9,17,0,17,,,,192,125,45,80,14,5,9,17,0,17,,,
04/16/2020,Northern,2,CAH,1,135,95,18,77,8,0,8,24,0,24,,,,135,95,18,77,8,0,8,24,0,24,,,
04/16/2020,Southeast,5,CAH,1,79,75,22,53,12,1,11,25,0,25,,,,79,75,22,53,12,1,11,25,0,25,,,
04/16/2020,Southeast,5,GACH,1,81,56,23,33,9,7,2,15,0,15,,,,81,56,23,33,9,7,2,15,0,15,,,
04/16/2020,Southwest,1,CAH,1,26,12,3,9,0,0,0,2,0,2,,,,26,12,3,9,0,0,0,2,0,2,,,
04/16/2020,Southwest,1,GACH,1,62,45,7,38,8,0,8,4,0,4,,,,62,45,7,38,8,0,8,4,0,4,,,
04/17/2020,Anchorage,7,GACH,1,865,824,229,595,149,42,107,182,16,166,,,,865,824,229,595,149,42,107,182,16,166,,,
04/17/2020,Anchorage,7,LTACH,0,56,30,28,2,11,5,6,23,1,22,,,,56,30,28,2,11,5,6,23,1,22,,,
04/17/2020,Anchorage,7,Psych,0,116,86,60,26,0,0,0,0,0,0,,,,116,86,60,26,0,0,0,0,0,0,,,
04/17/2020,Gulf Coast,4,CAH,1,130,96,20,78,4,0,4,17,0,17,,,,130,109,20,89,4,0,4,17,0,17,,,
04/17/2020,Gulf Coast,4,GACH,1,49,43,19,24,6,2,4,9,1,8,,,,49,43,19,24,6,2,4,9,1,8,,,
04/17/2020,Interior,6,GACH,1,94,81,32,49,13,7,6,15,3,12,,,,94,81,32,49,13,7,6,15,3,12,,,
04/17/2020,Matanuska-Susitna,3,GACH,1,192,125,45,80,14,3,11,17,0,17,,,,192,125,45,80,14,3,11,17,0,17,,,
04/17/2020,Northern,2,CAH,1,135,95,16,79,8,0,8,29,0,29,,,,135,95,16,79,8,0,8,29,0,29,,,
04/17/2020,Southeast,5,CAH,1,79,75,28,47,12,2,10,25,0,25,,,,79,75,28,47,12,2,10,25,0,25,,,
04/17/2020,Southeast,5,GACH,1,81,56,22,34,9,6,3,15,0,15,,,,81,56,22,34,9,6,3,15,0,15,,,
04/17/2020,Southwest,1,CAH,1,26,12,2,10,0,0,0,2,0,2,,,,26,12,2,10,0,0,0,2,0,2,,,
04/17/2020,Southwest,1,GACH,1,62,45,9,36,8,0,8,4,0,4,,,,62,45,9,36,8,0,8,4,0,4,,,
04/18/2020,Anchorage,7,GACH,1,865,824,221,603,149,46,103,182,16,166,,,,865,824,221,603,149,46,103,182,16,166,,,
04/18/2020,Anchorage,7,LTACH,0,56,30,26,4,11,5,6,24,0,24,,,,56,30,26,4,11,5,6,24,0,24,,,
04/18/2020,Anchorage,7,Psych,0,116,86,61,25,0,0,0,0,0,0,,,,116,86,61,25,0,0,0,0,0,0,,,
04/18/2020,Gulf Coast,4,CAH,1,140,94,19,77,4,0,4,16,0,16,,,,140,107,19,88,4,0,4,16,0,16,,,
04/18/2020,Gulf Coast,4,GACH,1,49,43,22,21,6,4,2,9,1,8,,,,49,43,22,21,6,4,2,9,1,8,,,
04/18/2020,Interior,6,GACH,1,94,81,34,47,13,8,5,15,3,12,,,,94,81,34,47,13,8,5,15,3,12,,,
04/18/2020,Matanuska-Susitna,3,GACH,1,192,125,38,87,14,3,11,17,0,17,,,,192,125,38,87,14,3,11,17,0,17,,,
04/18/2020,Northern,2,CAH,1,84,52,10,42,0,0,0,16,0,16,,,,135,95,12,83,8,0,8,29,0,29,,,
04/18/2020,Southeast,5,CAH,1,67,63,22,41,12,3,9,22,0,22,,,,79,75,25,50,12,3,9,25,0,25,,,
04/18/2020,Southeast,5,GACH,1,57,46,15,31,9,3,6,15,0,15,,,,57,46,15,31,9,3,6,15,0,15,,,
04/18/2020,Southwest,1,CAH,1,26,12,0,12,0,0,0,2,0,2,,,,26,12,0,12,0,0,0,2,0,2,,,
04/18/2020,Southwest,1,GACH,1,,,,,,,,,,,,,,62,45,9,36,8,0,8,4,0,4,,,
04/19/2020,Anchorage,7,GACH,1,464,824,225,599,149,39,110,182,15,167,,,,865,824,225,599,149,39,110,182,15,167,,,
04/19/2020,Anchorage,7,LTACH,0,56,30,27,3,11,5,6,24,0,24,,,,56,30,27,3,11,5,6,24,0,24,,,
04/19/2020,Anchorage,7,Psych,0,116,86,62,24,0,0,0,0,0,0,,,,116,86,62,24,0,0,0,0,0,0,,,
04/19/2020,Gulf Coast,4,CAH,1,140,107,19,88,4,0,4,16,0,16,,,,140,107,19,88,4,0,4,16,0,16,,,
04/19/2020,Gulf Coast,4,GACH,1,49,43,19,24,6,2,4,9,1,8,,,,49,43,19,24,6,2,4,9,1,8,,,
04/19/2020,Interior,6,GACH,1,94,81,38,43,13,10,3,15,4,11,,,,94,81,38,43,13,10,3,15,4,11,,,
04/19/2020,Matanuska-Susitna,3,GACH,1,192,125,44,81,14,8,6,17,2,15,,,,192,125,44,81,14,8,6,17,2,15,,,
04/19/2020,Northern,2,CAH,1,84,52,6,46,0,0,0,16,0,16,,,,135,95,8,87,8,0,8,29,0,29,,,
04/19/2020,Southeast,5,CAH,1,79,75,33,42,12,3,9,25,0,25,,,,79,75,33,42,12,3,9,25,0,25,,,
04/19/2020,Southeast,5,GACH,1,57,46,17,29,9,3,6,15,0,15,,,,57,46,17,29,9,3,6,15,0,15,,,
04/19/2020,Southwest,1,CAH,1,26,12,1,11,0,0,0,2,0,2,,,,26,12,1,11,0,0,0,2,0,2,,,
04/19/2020,Southwest,1,GACH,1,62,45,8,37,8,0,8,4,0,4,,,,62,45,8,37,8,0,8,4,0,4,,,
04/20/2020,Anchorage,7,GACH,1,464,824,240,584,149,46,103,183,13,170,,,,865,824,240,584,149,46,103,183,13,170,,,
04/20/2020,Anchorage,7,LTACH,0,56,30,27,3,11,5,6,24,0,24,,,,56,30,27,3,11,5,6,24,0,24,,,
04/20/2020,Anchorage,7,Psych,0,116,86,63,23,0,0,0,0,0,0,,,,116,86,63,23,0,0,0,0,0,0,,,
04/20/2020,Gulf Coast,4,CAH,1,130,96,19,79,4,1,3,17,0,17,,,,130,109,19,90,4,1,3,17,0,17,,,
04/20/2020,Gulf Coast,4,GACH,1,49,43,23,20,6,4,2,9,1,8,,,,49,43,23,20,6,4,2,9,1,8,,,
04/20/2020,Interior,6,GACH,1,81,,33,,13,9,4,16,2,14,,,,81,81,33,43,13,9,4,16,2,14,,,
04/20/2020,Matanuska-Susitna,3,GACH,1,192,125,50,75,14,7,7,17,1,16,,,,192,125,50,75,14,7,7,17,1,16,,,
04/20/2020,Northern,2,CAH,1,135,95,14,81,8,0,8,29,0,29,,,,135,95,14,81,8,0,8,29,0,29,,,
04/20/2020,Southeast,5,CAH,1,79,75,29,46,12,2,10,25,0,25,,,,79,75,29,46,12,2,10,25,0,25,,,
04/20/2020,Southeast,5,GACH,1,81,56,9,47,9,2,7,15,0,15,,,,81,56,9,47,9,2,7,15,0,15,,,
04/20/2020,Southwest,1,CAH,1,26,12,2,10,0,0,0,2,0,2,,,,26,12,2,10,0,0,0,2,0,2,,,
04/20/2020,Southwest,1,GACH,1,62,45,12,33,8,0,8,4,0,4,,,,62,45,12,33,8,0,8,4,0,4,,,
04/21/2020,Anchorage,7,GACH,1,464,824,246,578,149,35,114,180,16,164,,,,865,824,246,578,149,35,114,180,16,164,,,
04/21/2020,Anchorage,7,LTACH,0,56,30,29,1,11,5,6,24,0,24,,,,56,30,29,1,11,5,6,24,0,24,,,
04/21/2020,Anchorage,7,Psych,0,116,86,55,31,0,0,0,0,0,0,,,,116,86,55,31,0,0,0,0,0,0,,,
04/21/2020,Gulf Coast,4,CAH,1,130,96,24,74,4,1,3,17,0,17,,,,130,109,24,85,4,1,3,17,0,17,,,
04/21/2020,Gulf Coast,4,GACH,1,49,43,25,18,6,2,4,9,0,9,,,,49,43,25,18,6,2,4,9,0,9,,,
04/21/2020,Interior,6,GACH,1,81,,31,,13,9,4,16,3,13,,,,81,81,31,43,13,9,4,16,3,13,,,
04/21/2020,Matanuska-Susitna,3,GACH,1,112,102,63,39,12,8,4,39,1,38,,,,112,102,63,39,12,8,4,39,1,38,,,
04/21/2020,Northern,2,CAH,1,135,95,13,82,8,0,8,29,0,29,,,,135,95,13,82,8,0,8,29,0,29,,,
04/21/2020,Southeast,5,CAH,1,81,77,19,58,12,3,9,25,0,25,,,,81,77,19,58,12,3,9,25,0,25,,,
04/21/2020,Southeast,5,GACH,1,81,56,9,47,9,1,8,15,0,15,,,,81,56,9,47,9,1,8,15,0,15,,,
04/21/2020,Southwest,1,CAH,1,26,12,3,9,0,0,0,2,0,2,,,,26,12,3,9,0,0,0,2,0,2,,,
04/21/2020,Southwest,1,GACH,1,62,45,14,31,8,0,8,4,0,4,,,,62,45,14,31,8,0,8,4,0,4,,,
04/22/2020,Anchorage,7,GACH,1,464,824,268,556,149,38,111,177,21,156,,,,865,824,268,556,149,38,111,177,21,156,,,
04/22/2020,Anchorage,7,LTACH,0,56,30,29,1,11,5,6,24,0,24,,,,56,30,29,1,11,5,6,24,0,24,,,
04/22/2020,Anchorage,7,Psych,0,116,86,66,20,0,0,0,0,0,0,,,,116,86,66,20,0,0,0,0,0,0,,,
04/22/2020,Gulf Coast,4,CAH,1,130,96,29,70,4,2,2,17,0,17,,,,130,109,29,81,4,2,2,17,0,17,,,
04/22/2020,Gulf Coast,4,GACH,1,49,,29,,6,3,3,10,0,10,,,,49,43,29,18,6,3,3,10,0,10,,,
04/22/2020,Interior,6,GACH,1,81,,39,,13,6,7,16,1,15,,,,81,81,39,43,13,6,7,16,1,15,,,
04/22/2020,Matanuska-Susitna,3,GACH,1,112,102,66,36,12,9,3,39,2,37,,,,112,102,66,36,12,9,3,39,2,37,,,
04/22/2020,Northern,2,CAH,1,135,95,14,81,8,0,8,29,0,29,,,,135,95,14,81,8,0,8,29,0,29,,,
04/22/2020,Southeast,5,CAH,1,81,65,21,46,12,4,8,25,0,25,,,,81,77,21,55,12,4,8,25,0,25,,,
04/22/2020,Southeast,5,GACH,1,81,56,13,43,9,1,8,15,1,14,,,,81,56,13,43,9,1,8,15,1,14,,,
04/22/2020,Southwest,1,CAH,1,26,12,4,8,0,0,0,2,0,2,,,,26,12,4,8,0,0,0,2,0,2,,,
04/22/2020,Southwest,1,GACH,1,62,45,12,33,8,0,8,4,0,4,,,,62,45,12,33,8,0,8,4,0,4,,,
04/23/2020,Anchorage,7,GACH,1,464,824,260,564,149,33,116,176,20,156,,,,865,824,260,564,149,33,116,176,20,156,,,
04/23/2020,Anchorage,7,LTACH,0,56,56,35,21,11,3,8,24,0,24,,,,56,56,35,21,11,3,8,24,0,24,,,
04/23/2020,Anchorage,7,Psych,0,116,86,66,20,0,0,0,0,0,0,,,,116,86,66,20,0,0,0,0,0,0,,,
04/23/2020,Gulf Coast,4,CAH,1,130,47,28,36,4,0,4,17,0,17,,,,130,109,28,83,4,0,4,17,0,17,,,
04/23/2020,Gulf Coast,4,GACH,1,49,43,26,17,6,3,3,9,1,8,,,,49,43,26,17,6,3,3,9,1,8,,,
04/23/2020,Interior,6,GACH,1,81,,45,,13,6,7,16,0,16,,,,81,81,45,43,13,6,7,16,0,16,,,
04/23/2020,Matanuska-Susitna,3,GACH,1,112,102,70,32,12,10,2,39,2,37,,,,112,102,70,32,12,10,2,39,2,37,,,
04/23/2020,Northern,2,CAH,1,135,95,13,82,8,0,8,29,0,29,,,,135,95,13,82,8,0,8,29,0,29,,,
04/23/2020,Southeast,5,CAH,1,81,77,20,57,12,3,9,25,0,25,,,,81,77,20,57,12,3,9,25,0,25,,,
04/23/2020,Southeast,5,GACH,1,81,56,17,39,9,1,8,15,0,15,,,,81,56,17,39,9,1,8,15,0,15,,,
04/23/2020,Southwest,1,CAH,1,26,12,4,8,0,0,0,2,0,2,,,,26,12,4,8,0,0,0,2,0,2,,,
04/23/2020,Southwest,1,GACH,1,62,45,13,32,8,0,8,4,0,4,,,,62,45,13,32,8,0,8,4,0,4,,,
04/24/2020,Anchorage,7,GACH,1,464,824,276,548,149,45,104,178,19,159,,,,865,824,276,548,149,45,104,178,19,159,,,
04/24/2020,Anchorage,7,LTACH,0,51,,30,,11,6,5,24,0,24,,,,51,56,30,21,11,6,5,24,0,24,,,
04/24/2020,Anchorage,7,Psych,0,116,86,66,20,0,0,0,0,0,0,,,,116,86,66,20,0,0,0,0,0,0,,,
04/24/2020,Gulf Coast,4,CAH,1,130,47,29,37,5,0,5,17,0,17,,,,130,109,29,84,5,0,5,17,0,17,,,
04/24/2020,Gulf Coast,4,GACH,1,49,43,26,17,6,4,2,9,1,8,,,,49,43,26,17,6,4,2,9,1,8,,,
04/24/2020,Interior,6,GACH,1,81,,45,,13,9,4,16,0,16,,,,81,81,45,43,13,9,4,16,0,16,,,
04/24/2020,Matanuska-Susitna,3,GACH,1,112,102,69,33,12,9,3,39,1,38,,,,112,102,69,33,12,9,3,39,1,38,,,
04/24/2020,Northern,2,CAH,1,84,52,10,42,0,0,0,19,0,19,,,,84,95,10,84,0,0,0,19,0,19,,,
04/24/2020,Southeast,5,CAH,1,81,77,18,59,12,3,9,25,0,25,,,,81,77,18,59,12,3,9,25,0,25,,,
04/24/2020,Southeast,5,GACH,1,98,56,20,36,9,3,6,15,0,15,,,,98,56,20,36,9,3,6,15,0,15,,,
04/24/2020,Southwest,1,CAH,1,26,12,3,9,0,0,0,2,0,2,,,,26,12,3,9,0,0,0,2,0,2,,,
04/24/2020,Southwest,1,GACH,1,62,45,14,31,8,0,8,4,0,4,,,,62,45,14,31,8,0,8,4,0,4,,,
04/25/2020,Anchorage,7,GACH,1,464,824,267,557,149,41,108,180,16,164,,,,865,824,267,557,149,41,108,180,16,164,,,
04/25/2020,Anchorage,7,LTACH,0,51,,30,,11,6,5,24,0,24,,,,51,56,30,21,11,6,5,24,0,24,,,
04/25/2020,Anchorage,7,Psych,0,116,86,66,20,0,0,0,0,0,0,,,,116,86,66,20,0,0,0,0,0,0,,,
04/25/2020,Gulf Coast,4,CAH,1,140,45,21,40,4,0,4,16,0,16,,,,140,107,21,87,4,0,4,16,0,16,,,
04/25/2020,Gulf Coast,4,GACH,1,49,43,27,16,6,6,0,9,0,9,,,,49,43,27,16,6,6,0,9,0,9,,,
04/25/2020,Interior,6,GACH,1,81,,48,,13,9,4,16,0,16,,,,81,81,48,43,13,9,4,16,0,16,,,
04/25/2020,Matanuska-Susitna,3,GACH,1,192,125,63,62,14,11,3,14,0,14,,,,192,125,63,62,14,11,3,14,0,14,,,
04/25/2020,Northern,2,CAH,1,135,95,10,85,8,0,8,29,0,29,,,,135,95,10,85,8,0,8,29,0,29,,,
04/25/2020,Southeast,5,CAH,1,25,21,6,15,4,3,1,11,0,11,,,,81,77,18,59,12,3,9,25,0,25,,,
04/25/2020,Southeast,5,GACH,1,57,39,19,20,9,1,8,15,0,15,,,,57,39,19,20,9,1,8,15,0,15,,,
04/25/2020,Southwest,1,CAH,1,26,12,4,8,0,0,0,2,0,2,,,,26,12,4,8,0,0,0,2,0,2,,,
04/25/2020,Southwest,1,GACH,1,62,45,15,30,8,0,8,4,0,4,,,,62,45,15,30,8,0,8,4,0,4,,,
04/26/2020,Anchorage,7,GACH,1,865,824,321,503,149,43,106,181,16,165,,,,865,824,321,503,149,43,106,181,16,165,,,
04/26/2020,Anchorage,7,LTACH,0,56,56,30,26,11,6,5,24,0,24,,,,56,56,30,26,11,6,5,24,0,24,,,
04/26/2020,Anchorage,7,Psych,0,116,86,64,22,0,0,0,0,0,0,,,,116,86,64,22,0,0,0,0,0,0,,,
04/26/2020,Gulf Coast,4,CAH,1,140,45,21,40,4,0,4,16,0,16,,,,140,107,21,87,4,0,4,16,0,16,,,
04/26/2020,Gulf Coast,4,GACH,1,49,43,24,19,6,4,2,9,0,9,,,,49,43,24,19,6,4,2,9,0,9,,,
04/26/2020,Interior,6,GACH,1,81,,48,,13,5,8,16,0,16,,,,81,81,48,43,13,5,8,16,0,16,,,
04/26/2020,Matanuska-Susitna,3,GACH,1,192,125,66,59,14,10,4,14,0,14,,,,192,125,66,59,14,10,4,14,0,14,,,
04/26/2020,Northern,2,CAH,1,135,95,9,86,8,0,8,29,0,29,,,,135,95,9,86,8,0,8,29,0,29,,,
04/26/2020,Southeast,5,CAH,1,25,21,5,16,4,2,2,11,0,11,,,,81,77,17,60,12,2,10,25,0,25,,,
04/26/2020,Southeast,5,GACH,1,57,39,15,24,9,1,8,15,0,15,,,,57,39,15,24,9,1,8,15,0,15,,,
04/26/2020,Southwest,1,CAH,1,26,12,4,8,0,0,0,2,0,2,,,,26,12,4,8,0,0,0,2,0,2,,,
04/26/2020,Southwest,1,GACH,1,62,45,17,28,8,0,8,4,0,4,,,,62,45,17,28,8,0,8,4,0,4,,,
04/27/2020,Anchorage,7,GACH,1,865,824,378,446,149,47,102,179,19,160,,,,865,824,378,446,149,47,102,179,19,160,,,
04/27/2020,Anchorage,7,LTACH,0,51,,31,,11,6,5,24,0,24,,,,51,56,31,26,11,6,5,24,0,24,,,
04/27/2020,Anchorage,7,Psych,0,116,86,62,24,0,0,0,0,0,0,,,,116,86,62,24,0,0,0,0,0,0,,,
04/27/2020,Gulf Coast,4,CAH,1,130,47,24,38,4,0,4,17,0,17,,,,130,109,24,85,4,0,4,17,0,17,,,
04/27/2020,Gulf Coast,4,GACH,1,49,43,27,16,6,3,3,9,0,9,,,,49,43,27,16,6,3,3,9,0,9,,,
04/27/2020,Interior,6,GACH,1,81,,42,,13,8,5,16,2,14,,,,81,81,42,43,13,8,5,16,2,14,,,
04/27/2020,Matanuska-Susitna,3,GACH,1,112,102,68,34,12,10,2,39,1,38,,,,112,102,68,34,12,10,2,39,1,38,,,
04/27/2020,Northern,2,CAH,1,135,61,12,55,8,0,8,30,0,30,,,,135,95,12,85,8,0,8,30,0,30,,,
04/27/2020,Southeast,5,CAH,1,81,77,24,53,12,3,9,25,0,25,,,,81,77,24,53,12,3,9,25,0,25,,,
04/27/2020,Southeast,5,GACH,1,133,56,13,43,9,1,8,15,0,15,,,,133,56,13,43,9,1,8,15,0,15,,,
04/27/2020,Southwest,1,CAH,1,26,12,6,6,0,0,0,2,0,2,,,,26,12,6,6,0,0,0,2,0,2,,,
04/27/2020,Southwest,1,GACH,1,62,45,17,28,8,0,8,4,0,4,,,,62,45,17,28,8,0,8,4,0,4,,,
04/28/2020,Anchorage,7,GACH,1,865,824,406,418,149,51,98,179,19,160,,,,865,824,406,418,149,51,98,179,19,160,,,
04/28/2020,Anchorage,7,LTACH,0,51,,30,,11,6,5,24,0,24,,,,51,56,30,26,11,6,5,24,0,24,,,
04/28/2020,Anchorage,7,Psych,0,116,86,58,28,0,0,0,0,0,0,,,,116,86,58,28,0,0,0,0,0,0,,,
04/28/2020,Gulf Coast,4,CAH,1,130,47,25,38,5,0,5,19,0,19,,,,130,109,25,85,5,0,5,19,0,19,,,
04/28/2020,Gulf Coast,4,GACH,1,49,43,26,17,6,3,3,9,0,9,,,,49,43,26,17,6,3,3,9,0,9,,,
04/28/2020,Interior,6,GACH,1,81,,40,,13,6,7,16,1,15,,,,81,81,40,43,13,6,7,16,1,15,,,
04/28/2020,Matanuska-Susitna,3,GACH,1,112,102,64,38,12,9,3,39,1,38,,,,112,102,64,38,12,9,3,39,1,38,,,
04/28/2020,Northern,2,CAH,1,135,61,13,53,8,0,8,30,0,30,,,,135,95,13,83,8,0,8,30,0,30,,,
04/28/2020,Southeast,5,CAH,1,81,77,20,57,12,4,8,25,0,25,,,,81,77,20,57,12,4,8,25,0,25,,,
04/28/2020,Southeast,5,GACH,1,133,56,13,43,9,3,6,15,0,15,,,,133,56,13,43,9,3,6,15,0,15,,,
04/28/2020,Southwest,1,CAH,1,26,12,7,5,0,0,0,2,0,2,,,,26,12,7,5,0,0,0,2,0,2,,,
04/28/2020,Southwest,1,GACH,1,62,45,18,27,8,0,8,4,0,4,,,,62,45,18,27,8,0,8,4,0,4,,,
04/29/2020,Anchorage,7,GACH,1,865,824,390,434,149,50,99,181,17,164,,,,865,824,390,434,149,50,99,181,17,164,,,
04/29/2020,Anchorage,7,LTACH,0,51,,29,,11,4,7,24,0,24,,,,51,56,29,26,11,4,7,24,0,24,,,
04/29/2020,Anchorage,7,Psych,0,116,86,54,32,0,0,0,0,0,0,,,,116,86,54,32,0,0,0,0,0,0,,,
04/29/2020,Gulf Coast,4,CAH,1,130,47,24,39,5,0,5,19,0,19,,,,130,109,24,86,5,0,5,19,0,19,,,
04/29/2020,Gulf Coast,4,GACH,1,49,43,28,15,6,4,2,9,0,9,,,,49,43,28,15,6,4,2,9,0,9,,,
04/29/2020,Interior,6,GACH,1,81,,44,,13,9,4,16,1,15,,,,81,81,44,43,13,9,4,16,1,15,,,
04/29/2020,Matanuska-Susitna,3,GACH,1,112,102,53,49,12,6,6,39,1,38,,,,112,102,53,49,12,6,6,39,1,38,,,
04/29/2020,Northern,2,CAH,1,135,95,9,86,8,0,8,30,0,30,,,,135,95,9,86,8,0,8,30,0,30,,,
04/29/2020,Southeast,5,CAH,1,81,77,22,55,12,4,8,25,0,25,,,,81,77,22,55,12,4,8,25,0,25,,,
04/29/2020,Southeast,5,GACH,1,98,56,14,42,9,3,6,15,0,15,,,,98,56,14,42,9,3,6,15,0,15,,,
04/29/2020,Southwest,1,CAH,1,26,12,4,8,0,0,0,2,0,2,,,,26,12,4,8,0,0,0,2,0,2,,,
04/29/2020,Southwest,1,GACH,1,62,45,18,27,8,0,8,4,0,4,,,,62,45,18,27,8,0,8,4,0,4,,,
04/30/2020,Anchorage,7,GACH,1,865,824,265,559,149,38,111,179,17,162,,,,865,824,265,559,149,38,111,179,17,162,,,
04/30/2020,Anchorage,7,LTACH,0,51,,31,,11,5,6,24,0,24,,,,51,56,31,26,11,5,6,24,0,24,,,
04/30/2020,Anchorage,7,Psych,0,116,86,55,31,0,0,0,0,0,0,,,,116,86,55,31,0,0,0,0,0,0,,,
04/30/2020,Gulf Coast,4,CAH,1,130,47,22,15,5,0,3,19,0,19,,,,130,109,23,86,5,0,5,19,0,19,,,
04/30/2020,Gulf Coast,4,GACH,1,49,43,33,10,6,4,2,9,0,9,,,,49,43,33,10,6,4,2,9,0,9,,,
04/30/2020,Interior,6,GACH,1,81,,42,,13,5,8,16,0,16,,,,81,81,42,43,13,5,8,16,0,16,,,
04/30/2020,Matanuska-Susitna,3,GACH,1,112,102,54,48,12,7,5,39,1,38,,,,112,102,54,48,12,7,5,39,1,38,,,
04/30/2020,Northern,2,CAH,1,135,95,9,86,8,0,8,30,0,30,,,,135,95,9,86,8,0,8,30,0,30,,,
04/30/2020,Southeast,5,CAH,1,81,77,28,49,12,2,10,25,0,25,,,,81,77,28,49,12,2,10,25,0,25,,,
04/30/2020,Southeast,5,GACH,1,98,56,16,40,9,3,6,15,0,15,,,,98,56,16,40,9,3,6,15,0,15,,,
04/30/2020,Southwest,1,CAH,1,26,12,3,9,0,0,0,2,0,2,,,,26,12,3,9,0,0,0,2,0,2,,,
04/30/2020,Southwest,1,GACH,1,62,45,15,30,8,0,8,4,0,4,,,,62,45,15,30,8,0,8,4,0,4,,,
05/01/2020,Anchorage,7,GACH,1,865,824,404,420,149,55,94,178,18,160,,,,865,824,404,420,149,55,94,178,18,160,,,
05/01/2020,Anchorage,7,LTACH,0,51,,31,,11,5,6,24,0,24,,,,51,56,31,26,11,5,6,24,0,24,,,
05/01/2020,Anchorage,7,Psych,0,116,86,53,33,0,0,0,0,0,0,,,,116,86,53,33,0,0,0,0,0,0,,,
05/01/2020,Gulf Coast,4,CAH,1,130,60,23,46,5,0,5,19,0,19,,,,130,109,23,82,5,0,5,19,0,19,,,
05/01/2020,Gulf Coast,4,GACH,1,49,43,31,12,6,5,1,9,0,9,,,,49,43,31,12,6,5,1,9,0,9,,,
05/01/2020,Interior,6,GACH,1,81,,36,,13,6,7,16,0,16,,,,81,81,36,43,13,6,7,16,0,16,,,
05/01/2020,Matanuska-Susitna,3,GACH,1,112,102,49,53,12,5,7,39,1,38,,,,112,102,49,53,12,5,7,39,1,38,,,
05/01/2020,Northern,2,CAH,1,135,95,12,83,8,0,8,30,0,30,,,,135,95,12,83,8,0,8,30,0,30,,,
05/01/2020,Southeast,5,CAH,1,81,77,25,52,12,0,12,25,0,25,,,,81,77,25,52,12,0,12,25,0,25,,,
05/01/2020,Southeast,5,GACH,1,98,56,16,40,9,2,7,15,0,15,,,,98,56,16,40,9,2,7,15,0,15,,,
05/01/2020,Southwest,1,CAH,1,26,12,4,8,0,0,0,2,0,2,,,,26,12,4,8,0,0,0,2,0,2,,,
05/01/2020,Southwest,1,GACH,1,62,45,10,35,8,0,8,4,0,4,,,,62,45,10,35,8,0,8,4,0,4,,,
05/02/2020,Anchorage,7,GACH,1,865,824,384,440,149,47,102,178,19,159,,,,865,824,384,440,149,47,102,178,19,159,,,
05/02/2020,Anchorage,7,LTACH,0,56,56,31,25,11,5,6,24,0,24,,,,56,56,31,25,11,5,6,24,0,24,,,
05/02/2020,Anchorage,7,Psych,0,116,86,50,36,0,0,0,0,0,0,,,,116,86,50,36,0,0,0,0,0,0,,,
05/02/2020,Gulf Coast,4,CAH,1,140,58,15,51,4,0,4,18,0,18,,,,140,107,15,87,4,0,4,18,0,18,,,
05/02/2020,Gulf Coast,4,GACH,1,49,43,28,15,6,4,2,9,0,9,,,,49,43,28,15,6,4,2,9,0,9,,,
05/02/2020,Interior,6,GACH,1,81,,39,,13,5,8,16,0,16,,,,81,81,39,43,13,5,8,16,0,16,,,
05/02/2020,Matanuska-Susitna,3,GACH,1,112,102,52,50,12,6,6,39,1,38,,,,112,102,52,50,12,6,6,39,1,38,,,
05/02/2020,Northern,2,CAH,1,135,95,16,79,8,0,8,30,0,30,,,,135,95,16,79,8,0,8,30,0,30,,,
05/02/2020,Southeast,5,CAH,1,81,77,25,52,12,2,10,25,0,25,,,,81,77,25,52,12,2,10,25,0,25,,,
05/02/2020,Southeast,5,GACH,1,133,133,16,117,9,3,6,15,0,15,,,,133,133,16,117,9,3,6,15,0,15,,,
05/02/2020,Southwest,1,CAH,1,26,12,7,5,0,0,0,2,0,2,,,,26,12,7,5,0,0,0,2,0,2,,,
05/02/2020,Southwest,1,GACH,1,62,45,8,37,8,0,8,4,0,4,,,,62,45,8,37,8,0,8,4,0,4,,,
05/03/2020,Anchorage,7,GACH,1,865,824,280,544,149,30,119,179,17,162,,,,865,824,280,544,149,30,119,179,17,162,,,
05/03/2020,Anchorage,7,LTACH,0,56,56,32,24,11,6,5,24,0,24,,,,56,56,32,24,11,6,5,24,0,24,,,
05/03/2020,Anchorage,7,Psych,0,116,86,50,36,0,0,0,0,0,0,,,,116,86,50,36,0,0,0,0,0,0,,,
05/03/2020,Gulf Coast,4,CAH,1,140,58,17,51,4,0,4,18,0,18,,,,140,107,17,87,4,0,4,18,0,18,,,
05/03/2020,Gulf Coast,4,GACH,1,49,43,29,14,6,4,2,9,0,9,,,,49,43,29,14,6,4,2,9,0,9,,,
05/03/2020,Interior,6,GACH,1,81,,39,,13,4,9,16,1,15,,,,81,81,39,43,13,4,9,16,1,15,,,
05/03/2020,Matanuska-Susitna,3,GACH,1,112,102,46,56,12,7,5,39,1,38,,,,112,102,46,56,12,7,5,39,1,38,,,
05/03/2020,Northern,2,CAH,1,135,95,15,80,8,0,8,30,0,30,,,,135,95,15,80,8,0,8,30,0,30,,,
05/03/2020,Southeast,5,CAH,1,81,77,24,53,12,2,10,25,0,25,,,,81,77,24,53,12,2,10,25,0,25,,,
05/03/2020,Southeast,5,GACH,1,133,133,20,113,9,1,8,15,0,15,,,,133,133,20,113,9,1,8,15,0,15,,,
05/03/2020,Southwest,1,CAH,1,26,12,5,7,0,0,0,2,0,2,,,,26,12,5,7,0,0,0,2,0,2,,,
05/03/2020,Southwest,1,GACH,1,,,,,,,,,,,,,,62,45,8,37,8,0,8,4,0,4,,,
05/04/2020,Anchorage,7,GACH,1,865,824,293,531,149,37,112,179,18,161,,,,865,824,293,531,149,37,112,179,18,161,,,
05/04/2020,Anchorage,7,LTACH,0,51,,32,,11,6,5,24,0,24,,,,51,56,32,24,11,6,5,24,0,24,,,
05/04/2020,Anchorage,7,Psych,0,116,86,49,37,0,0,0,0,0,0,,,,116,86,49,37,0,0,0,0,0,0,,,
05/04/2020,Gulf Coast,4,CAH,1,130,60,21,49,4,1,3,19,0,19,,,,130,109,21,85,4,1,3,19,0,19,,,
05/04/2020,Gulf Coast,4,GACH,1,49,43,32,11,6,4,2,9,0,9,,,,49,43,32,11,6,4,2,9,0,9,,,
05/04/2020,Interior,6,GACH,1,81,,33,,13,3,10,16,0,16,,,,81,81,33,43,13,3,10,16,0,16,,,
05/04/2020,Matanuska-Susitna,3,GACH,1,112,102,54,48,12,9,3,39,2,37,,,,112,102,54,48,12,9,3,39,2,37,,,
05/04/2020,Northern,2,CAH,1,135,95,17,78,8,0,8,30,0,30,,,,135,95,17,78,8,0,8,30,0,30,,,
05/04/2020,Southeast,5,CAH,1,81,77,23,54,12,0,12,25,0,25,,,,81,77,23,54,12,0,12,25,0,25,,,
05/04/2020,Southeast,5,GACH,1,133,56,21,35,9,4,5,15,0,15,,,,133,56,21,35,9,4,5,15,0,15,,,
05/04/2020,Southwest,1,CAH,1,26,12,4,8,0,0,0,2,0,2,,,,26,12,4,8,0,0,0,2,0,2,,,
05/04/2020,Southwest,1,GACH,1,62,45,11,34,8,0,8,4,0,4,,,,62,45,11,34,8,0,8,4,0,4,,,
05/05/2020,Anchorage,7,GACH,1,865,824,311,513,149,40,109,178,20,158,,,,865,824,311,513,149,40,109,178,20,158,,,
05/05/2020,Anchorage,7,LTACH,0,51,,32,,11,6,5,24,0,24,,,,51,56,32,24,11,6,5,24,0,24,,,
05/05/2020,Anchorage,7,Psych,0,116,86,51,35,0,0,0,0,0,0,,,,116,86,51,35,0,0,0,0,0,0,,,
05/05/2020,Gulf Coast,4,CAH,1,130,60,22,49,4,0,4,19,0,19,,,,130,109,22,85,4,0,4,19,0,19,,,
05/05/2020,Gulf Coast,4,GACH,1,49,43,42,1,6,5,1,9,1,8,,,,49,43,42,1,6,5,1,9,1,8,,,
05/05/2020,Interior,6,GACH,1,81,,33,,13,5,8,16,0,16,,,,81,81,33,43,13,5,8,16,0,16,,,
05/05/2020,Matanuska-Susitna,3,GACH,1,192,125,69,56,14,7,7,15,2,13,,,,192,125,69,56,14,7,7,15,2,13,,,
05/05/2020,Northern,2,CAH,1,135,95,15,80,8,0,8,30,0,30,,,,135,95,15,80,8,0,8,30,0,30,,,
05/05/2020,Southeast,5,CAH,1,68,44,21,29,13,0,13,31,0,31,,,,68,77,21,54,13,0,13,31,0,31,,,
05/05/2020,Southeast,5,GACH,1,133,56,19,37,9,2,7,15,0,15,,,,133,56,19,37,9,2,7,15,0,15,,,
05/05/2020,Southwest,1,CAH,1,26,12,3,9,0,0,0,2,0,2,,,,26,12,3,9,0,0,0,2,0,2,,,
05/05/2020,Southwest,1,GACH,1,62,45,11,34,8,0,8,4,0,4,,,,62,45,11,34,8,0,8,4,0,4,,,
05/06/2020,Anchorage,7,GACH,1,865,824,325,499,149,45,104,179,18,78,,,,865,824,325,499,149,45,104,179,18,161,,,
05/06/2020,Anchorage,7,LTACH,0,51,,31,,11,6,5,24,0,24,,,,51,56,31,24,11,6,5,24,0,24,,,
05/06/2020,Anchorage,7,Psych,0,116,86,52,34,0,0,0,0,0,0,,,,116,86,52,34,0,0,0,0,0,0,,,
05/06/2020,Gulf Coast,4,CAH,1,130,60,23,48,4,0,4,19,0,19,,,,130,109,23,84,4,0,4,19,0,19,,,
05/06/2020,Gulf Coast,4,GACH,1,49,43,38,5,6,4,2,9,1,8,,,,49,43,38,5,6,4,2,9,1,8,,,
05/06/2020,Interior,6,GACH,1,81,,37,,13,5,8,16,0,16,,,,81,81,37,43,13,5,8,16,0,16,,,
05/06/2020,Matanuska-Susitna,3,GACH,1,112,102,82,20,12,7,5,39,2,37,,,,112,102,82,20,12,7,5,39,2,37,,,
05/06/2020,Northern,2,CAH,1,135,95,18,77,8,0,8,30,0,30,,,,135,95,18,77,8,0,8,30,0,30,,,
05/06/2020,Southeast,5,CAH,1,68,44,21,29,13,0,13,31,0,31,,,,68,77,21,54,13,0,13,31,0,31,,,
05/06/2020,Southeast,5,GACH,1,133,56,19,37,9,1,8,15,0,15,,,,133,56,19,37,9,1,8,15,0,15,,,
05/06/2020,Southwest,1,CAH,1,26,12,5,7,0,0,0,2,0,2,,,,26,12,5,7,0,0,0,2,0,2,,,
05/06/2020,Southwest,1,GACH,1,62,45,8,37,8,0,8,4,0,4,,,,62,45,8,37,8,0,8,4,0,4,,,
05/07/2020,Anchorage,7,GACH,1,865,824,344,480,149,38,111,179,18,161,,,,865,824,344,480,149,38,111,179,18,161,,,
05/07/2020,Anchorage,7,LTACH,0,51,,31,,11,6,5,24,0,24,,,,51,56,31,24,11,6,5,24,0,24,,,
05/07/2020,Anchorage,7,Psych,0,116,86,50,36,0,0,0,0,0,0,,,,116,86,50,36,0,0,0,0,0,0,,,
05/07/2020,Gulf Coast,4,CAH,1,130,58,26,45,4,0,4,19,0,19,,,,130,107,26,81,4,0,4,19,0,19,,,
05/07/2020,Gulf Coast,4,GACH,1,49,43,32,11,6,4,2,9,0,9,,,,49,43,32,11,6,4,2,9,0,9,,,
05/07/2020,Interior,6,GACH,1,81,,42,,13,3,10,16,1,15,,,,81,81,42,43,13,3,10,16,1,15,,,
05/07/2020,Matanuska-Susitna,3,GACH,1,112,102,80,22,12,9,3,39,2,37,,,,112,102,80,22,12,9,3,39,2,37,,,
05/07/2020,Northern,2,CAH,1,135,61,19,45,8,0,8,30,0,30,,,,135,95,19,73,8,0,8,30,0,30,,,
05/07/2020,Southeast,5,CAH,1,71,44,19,32,13,2,11,31,0,31,,,,71,77,19,57,13,2,11,31,0,31,,,
05/07/2020,Southeast,5,GACH,1,133,56,14,42,9,1,8,15,0,15,,,,133,56,14,42,9,1,8,15,0,15,,,
05/07/2020,Southwest,1,CAH,1,26,12,5,7,0,0,0,2,0,2,,,,26,12,5,7,0,0,0,2,0,2,,,
05/07/2020,Southwest,1,GACH,1,62,45,7,38,8,0,8,4,0,4,,,,62,45,7,38,8,0,8,4,0,4,,,
05/08/2020,Anchorage,7,GACH,1,865,824,328,496,149,32,117,179,17,162,,,,865,824,328,496,149,32,117,179,17,162,,,
05/08/2020,Anchorage,7,LTACH,0,51,,31,,11,6,5,24,0,24,,,,51,56,31,24,11,6,5,24,0,24,,,
05/08/2020,Anchorage,7,Psych,0,116,86,54,32,0,0,0,0,0,0,,,,116,86,54,32,0,0,0,0,0,0,,,
05/08/2020,Gulf Coast,4,CAH,1,130,58,23,47,4,1,3,19,0,19,,,,130,107,23,83,4,1,3,19,0,19,,,
05/08/2020,Gulf Coast,4,GACH,1,49,43,34,9,6,3,3,9,0,9,,,,49,43,34,9,6,3,3,9,0,9,,,
05/08/2020,Interior,6,GACH,1,81,,49,,13,2,11,16,0,16,,,,81,81,49,43,13,2,11,16,0,16,,,
05/08/2020,Matanuska-Susitna,3,GACH,1,112,102,84,18,12,11,1,39,2,37,,,,112,102,84,18,12,11,1,39,2,37,,,
05/08/2020,Northern,2,CAH,1,135,95,25,70,8,0,8,30,0,30,,,,135,95,25,70,8,0,8,30,0,30,,,
05/08/2020,Southeast,5,CAH,1,74,44,23,31,13,3,10,31,0,31,,,,74,77,23,56,13,3,10,31,0,31,,,
05/08/2020,Southeast,5,GACH,1,133,56,14,42,9,3,6,15,1,14,,,,133,56,14,42,9,3,6,15,1,14,,,
05/08/2020,Southwest,1,CAH,1,26,12,2,10,0,0,0,2,0,2,,,,26,12,2,10,0,0,0,2,0,2,,,
05/08/2020,Southwest,1,GACH,1,62,45,11,34,8,0,8,4,0,4,,,,62,45,11,34,8,0,8,4,0,4,,,
05/09/2020,Anchorage,7,GACH,1,865,824,450,374,149,91,58,263,20,160,,,,865,824,450,374,149,91,58,263,20,243,,,
05/09/2020,Anchorage,7,LTACH,0,51,,31,,11,6,5,24,0,24,,,,51,56,31,24,11,6,5,24,0,24,,,
05/09/2020,Anchorage,7,Psych,0,80,50,34,16,0,0,0,0,0,0,,,,116,86,53,33,0,0,0,0,0,0,,,
05/09/2020,Gulf Coast,4,CAH,1,73,13,14,10,2,2,0,5,0,5,,,,130,107,22,83,4,3,1,19,0,19,,,
05/09/2020,Gulf Coast,4,GACH,1,49,43,36,7,6,4,2,9,0,9,,,,49,43,36,7,6,4,2,9,0,9,,,
05/09/2020,Interior,6,GACH,1,81,,56,,13,1,12,16,0,16,,,,81,81,56,43,13,1,12,16,0,16,,,
05/09/2020,Matanuska-Susitna,3,GACH,1,112,102,73,29,12,12,0,39,3,36,,,,112,102,73,29,12,12,0,39,3,36,,,
05/09/2020,Northern,2,CAH,1,84,52,23,29,0,0,0,17,0,17,,,,135,95,28,67,8,0,8,30,0,30,,,
05/09/2020,Southeast,5,CAH,1,81,77,27,50,12,2,10,25,0,25,,,,81,77,27,50,12,2,10,25,0,25,,,
05/09/2020,Southeast,5,GACH,1,133,133,18,115,9,9,0,15,0,15,,,,133,133,18,115,9,9,0,15,0,15,,,
05/09/2020,Southwest,1,CAH,1,26,12,1,11,0,0,0,2,0,2,,,,26,12,1,11,0,0,0,2,0,2,,,
05/09/2020,Southwest,1,GACH,1,,,,,,,,,,,,,,62,45,11,34,8,0,8,4,0,4,,,
05/10/2020,Anchorage,7,GACH,1,921,824,449,375,149,82,67,176,20,73,,,,921,824,449,375,149,82,67,176,20,156,,,
05/10/2020,Anchorage,7,LTACH,0,51,,31,,11,6,5,24,0,24,,,,51,56,31,24,11,6,5,24,0,24,,,
05/10/2020,Anchorage,7,Psych,0,80,50,34,16,0,0,0,0,0,0,,,,116,86,53,33,0,0,0,0,0,0,,,
05/10/2020,Gulf Coast,4,CAH,1,73,13,13,11,2,1,1,5,0,5,,,,130,107,21,84,4,2,2,19,0,19,,,
05/10/2020,Gulf Coast,4,GACH,1,49,43,32,11,6,3,3,9,0,9,,,,49,43,32,11,6,3,3,9,0,9,,,
05/10/2020,Interior,6,GACH,1,81,,57,,13,3,10,16,0,16,,,,81,81,57,43,13,3,10,16,0,16,,,
05/10/2020,Matanuska-Susitna,3,GACH,1,112,102,75,27,12,11,1,39,2,37,,,,112,102,75,27,12,11,1,39,2,37,,,
05/10/2020,Northern,2,CAH,1,84,52,19,33,0,0,0,17,0,17,,,,135,95,24,71,8,0,8,30,0,30,,,
05/10/2020,Southeast,5,CAH,1,81,77,25,52,12,2,10,25,0,25,,,,81,77,25,52,12,2,10,25,0,25,,,
05/10/2020,Southeast,5,GACH,1,133,133,22,111,9,4,5,15,1,14,,,,133,133,22,111,9,4,5,15,1,14,,,
05/10/2020,Southwest,1,CAH,1,26,12,2,10,0,0,0,2,0,2,,,,26,12,2,10,0,0,0,2,0,2,,,
05/10/2020,Southwest,1,GACH,1,,,,,,,,,,,,,,62,45,11,34,8,0,8,4,0,4,,,
05/11/2020,Anchorage,7,GACH,1,921,824,479,345,149,84,65,174,22,69,,,,921,824,479,345,149,84,65,174,22,152,,,
05/11/2020,Anchorage,7,LTACH,0,51,31,31,0,11,6,5,24,0,24,,,,51,31,31,0,11,6,5,24,0,24,,,
05/11/2020,Anchorage,7,Psych,0,116,86,50,36,0,0,0,0,0,0,,,,116,86,50,36,0,0,0,0,0,0,,,
05/11/2020,Gulf Coast,4,CAH,1,118,109,25,84,4,1,3,19,0,19,,,,118,109,25,84,4,1,3,19,0,19,,,
05/11/2020,Gulf Coast,4,GACH,1,49,43,31,12,6,3,3,9,0,9,,,,49,43,31,12,6,3,3,9,0,9,,,
05/11/2020,Interior,6,GACH,1,94,81,46,35,13,5,8,16,0,16,,,,94,81,46,35,13,5,8,16,0,16,,,
05/11/2020,Matanuska-Susitna,3,GACH,1,112,102,73,29,12,11,1,39,3,36,,,,112,102,73,29,12,11,1,39,3,36,,,
05/11/2020,Northern,2,CAH,1,84,25,17,8,0,0,0,20,0,20,,,,84,25,17,8,0,0,0,20,0,20,,,
05/11/2020,Southeast,5,CAH,1,70,65,28,37,12,3,9,31,0,31,,,,70,65,28,37,12,3,9,31,0,31,,,
05/11/2020,Southeast,5,GACH,1,133,56,22,34,9,6,3,15,0,15,,,,133,56,22,34,9,6,3,15,0,15,,,
05/11/2020,Southwest,1,CAH,1,26,12,3,9,0,0,0,2,0,2,,,,26,12,3,9,0,0,0,2,0,2,,,
05/11/2020,Southwest,1,GACH,1,62,45,19,26,8,0,8,4,0,4,,,,62,45,19,26,8,0,8,4,0,4,,,
05/12/2020,Anchorage,7,GACH,1,921,824,477,347,149,95,54,183,18,165,,,,921,824,477,347,149,95,54,183,18,165,,,
05/12/2020,Anchorage,7,LTACH,0,51,30,30,0,11,6,5,24,0,24,,,,51,30,30,0,11,6,5,24,0,24,,,
05/12/2020,Anchorage,7,Psych,0,116,86,60,26,0,0,0,0,0,0,,,,116,86,60,26,0,0,0,0,0,0,,,
05/12/2020,Gulf Coast,4,CAH,1,130,109,19,90,4,0,4,20,0,20,,,,130,109,19,90,4,0,4,20,0,20,,,
05/12/2020,Gulf Coast,4,GACH,1,146,146,36,110,6,4,2,9,0,9,,,,146,146,36,110,6,4,2,9,0,9,,,
05/12/2020,Interior,6,GACH,1,94,81,51,30,13,4,9,16,1,15,,,,94,81,51,30,13,4,9,16,1,15,,,
05/12/2020,Matanuska-Susitna,3,GACH,1,,,,,,,,,,,,,,112,102,73,29,12,11,1,39,3,36,,,
05/12/2020,Northern,2,CAH,1,135,95,24,71,8,0,8,30,0,30,,,,135,95,24,71,8,0,8,30,0,30,,,
05/12/2020,Southeast,5,CAH,1,74,74,26,48,13,2,11,31,0,31,,,,74,74,26,48,13,2,11,31,0,31,,,
05/12/2020,Southeast,5,GACH,1,133,56,25,31,9,7,2,15,0,15,,,,133,56,25,31,9,7,2,15,0,15,,,
05/12/2020,Southwest,1,CAH,1,26,12,6,6,0,0,0,2,0,2,,,,26,12,6,6,0,0,0,2,0,2,,,
05/12/2020,Southwest,1,GACH,1,,,,,,,,,,,,,,62,45,19,26,8,0,8,4,0,4,,,
05/13/2020,Anchorage,7,GACH,1,921,824,475,349,149,97,52,180,21,159,,,,921,824,475,349,149,97,52,180,21,159,,,
05/13/2020,Anchorage,7,LTACH,0,51,28,28,0,11,4,7,24,0,24,,,,51,28,28,0,11,4,7,24,0,24,,,
05/13/2020,Anchorage,7,Psych,0,116,86,57,29,0,0,0,0,0,0,,,,116,86,57,29,0,0,0,0,0,0,,,
05/13/2020,Gulf Coast,4,CAH,1,130,109,20,89,4,2,2,20,0,20,,,,130,109,20,89,4,2,2,20,0,20,,,
05/13/2020,Gulf Coast,4,GACH,1,49,43,31,12,6,1,5,9,0,9,,,,49,43,31,12,6,1,5,9,0,9,,,
05/13/2020,Interior,6,GACH,1,94,81,52,29,13,6,7,16,0,16,,,,94,81,52,29,13,6,7,16,0,16,,,
05/13/2020,Matanuska-Susitna,3,GACH,1,112,102,94,8,12,10,2,39,1,38,,,,112,102,94,8,12,10,2,39,1,38,,,
05/13/2020,Northern,2,CAH,1,135,95,22,73,8,0,8,30,0,30,,,,135,95,22,73,8,0,8,30,0,30,,,
05/13/2020,Southeast,5,CAH,1,75,75,23,52,13,2,11,31,0,31,,,,75,75,23,52,13,2,11,31,0,31,,,
05/13/2020,Southeast,5,GACH,1,133,56,27,29,9,7,2,15,0,15,,,,133,56,27,29,9,7,2,15,0,15,,,
05/13/2020,Southwest,1,CAH,1,26,12,2,10,0,0,0,2,0,2,,,,26,12,2,10,0,0,0,2,0,2,,,
05/13/2020,Southwest,1,GACH,1,0,0,0,0,0,0,0,0,0,0,,,,0,0,0,0,0,0,0,0,0,0,,,
05/14/2020,Anchorage,7,GACH,1,921,824,490,334,149,93,56,177,24,153,,,,921,824,490,334,149,93,56,177,24,153,,,
05/14/2020,Anchorage,7,LTACH,0,51,29,29,0,11,5,6,24,0,24,,,,51,29,29,0,11,5,6,24,0,24,,,
05/14/2020,Anchorage,7,Psych,0,116,86,61,25,0,0,0,0,0,0,,,,116,86,61,25,0,0,0,0,0,0,,,
05/14/2020,Gulf Coast,4,CAH,1,130,109,28,81,4,2,2,20,0,20,,,,130,109,28,81,4,2,2,20,0,20,,,
05/14/2020,Gulf Coast,4,GACH,1,49,43,32,11,6,2,4,9,0,9,,,,49,43,32,11,6,2,4,9,0,9,,,
05/14/2020,Interior,6,GACH,1,94,81,62,19,13,6,7,16,1,15,,,,94,81,62,19,13,6,7,16,1,15,,,
05/14/2020,Matanuska-Susitna,3,GACH,1,112,102,88,14,12,12,0,39,4,35,,,,112,102,88,14,12,12,0,39,4,35,,,
05/14/2020,Northern,2,CAH,1,135,95,19,76,8,0,8,30,0,30,,,,135,95,19,76,8,0,8,30,0,30,,,
05/14/2020,Southeast,5,CAH,1,65,65,30,35,13,2,11,31,0,31,,,,65,65,30,35,13,2,11,31,0,31,,,
05/14/2020,Southeast,5,GACH,1,133,56,21,35,9,0,9,15,0,15,,,,133,56,21,35,9,0,9,15,0,15,,,
05/14/2020,Southwest,1,CAH,1,26,12,2,10,0,0,0,2,0,2,,,,26,12,2,10,0,0,0,2,0,2,,,
05/14/2020,Southwest,1,GACH,1,62,45,6,39,8,0,8,4,0,4,,,,62,45,6,39,8,0,8,4,0,4,,,
05/15/2020,Anchorage,7,GACH,1,921,824,473,351,149,94,55,175,26,149,,,,921,824,473,351,149,94,55,175,26,149,,,
05/15/2020,Anchorage,7,LTACH,0,51,29,29,0,11,5,6,24,0,24,,,,51,29,29,0,11,5,6,24,0,24,,,
05/15/2020,Anchorage,7,Psych,0,116,86,59,27,0,0,0,0,0,0,,,,116,86,59,27,0,0,0,0,0,0,,,
05/15/2020,Gulf Coast,4,CAH,1,130,109,22,87,4,0,4,20,0,20,,,,130,109,22,87,4,0,4,20,0,20,,,
05/15/2020,Gulf Coast,4,GACH,1,146,146,38,108,6,4,2,9,0,9,,,,146,146,38,108,6,4,2,9,0,9,,,
05/15/2020,Interior,6,GACH,1,94,81,65,16,13,6,7,16,2,14,,,,94,81,65,16,13,6,7,16,2,14,,,
05/15/2020,Matanuska-Susitna,3,GACH,1,,,,,,,,,,,,,,112,102,88,14,12,12,0,39,4,35,,,
05/15/2020,Northern,2,CAH,1,135,95,15,80,8,0,8,30,0,30,,,,135,95,15,80,8,0,8,30,0,30,,,
05/15/2020,Southeast,5,CAH,1,65,65,26,39,13,2,11,31,0,31,,,,65,65,26,39,13,2,11,31,0,31,,,
05/15/2020,Southeast,5,GACH,1,133,56,20,36,9,4,5,15,0,15,,,,133,56,20,36,9,4,5,15,0,15,,,
05/15/2020,Southwest,1,CAH,1,26,12,1,11,0,0,0,2,0,2,,,,26,12,1,11,0,0,0,2,0,2,,,
05/15/2020,Southwest,1,GACH,1,62,45,10,35,8,0,8,4,0,4,,,,62,45,10,35,8,0,8,4,0,4,,,
05/16/2020,Anchorage,7,GACH,1,921,824,477,347,149,94,55,178,23,155,,,,921,824,477,347,149,94,55,178,23,155,,,
05/16/2020,Anchorage,7,LTACH,0,51,29,29,0,11,5,6,24,0,24,,,,51,29,29,0,11,5,6,24,0,24,,,
05/16/2020,Anchorage,7,Psych,0,,,,,,,,,,,,,,116,86,59,27,0,0,0,0,0,0,,,
05/16/2020,Gulf Coast,4,CAH,1,73,64,9,55,2,0,2,6,0,6,,,,130,109,23,86,4,0,4,20,0,20,,,
05/16/2020,Gulf Coast,4,GACH,1,49,43,34,9,6,2,4,9,2,7,,,,49,43,34,9,6,2,4,9,2,7,,,
05/16/2020,Interior,6,GACH,1,94,81,63,18,13,5,8,16,2,14,,,,94,81,63,18,13,5,8,16,2,14,,,
05/16/2020,Matanuska-Susitna,3,GACH,1,112,102,77,25,12,11,1,39,3,36,,,,112,102,77,25,12,11,1,39,3,36,,,
05/16/2020,Northern,2,CAH,1,84,52,10,42,0,0,0,17,0,17,,,,135,95,13,82,8,0,8,30,0,30,,,
05/16/2020,Southeast,5,CAH,1,56,56,18,38,8,0,8,14,0,14,,,,65,65,26,39,13,2,11,31,0,31,,,
05/16/2020,Southeast,5,GACH,1,133,56,19,37,9,4,5,15,0,15,,,,133,56,19,37,9,4,5,15,0,15,,,
05/16/2020,Southwest,1,CAH,1,26,12,3,9,0,0,0,2,0,2,,,,26,12,3,9,0,0,0,2,0,2,,,
05/16/2020,Southwest,1,GACH,1,62,45,14,31,8,0,8,4,0,4,,,,62,45,14,31,8,0,8,4,0,4,,,
05/17/2020,Anchorage,7,GACH,1,921,824,473,351,149,107,42,176,30,146,,,,921,824,473,351,149,107,42,176,30,146,,,
05/17/2020,Anchorage,7,LTACH,0,51,29,29,0,11,5,6,24,0,24,,,,51,29,29,0,11,5,6,24,0,24,,,
05/17/2020,Anchorage,7,Psych,0,,,,,,,,,,,,,,116,86,59,27,0,0,0,0,0,0,,,
05/17/2020,Gulf Coast,4,CAH,1,73,64,9,55,2,0,2,6,0,6,,,,130,109,23,86,4,0,4,20,0,20,,,
05/17/2020,Gulf Coast,4,GACH,1,49,43,35,8,6,2,4,9,2,7,,,,49,43,35,8,6,2,4,9,2,7,,,
05/17/2020,Interior,6,GACH,1,94,81,53,28,13,3,10,16,2,14,,,,94,81,53,28,13,3,10,16,2,14,,,
05/17/2020,Matanuska-Susitna,3,GACH,1,,,,,,,,,,,,,,112,102,77,25,12,11,1,39,3,36,,,
05/17/2020,Northern,2,CAH,1,84,52,11,41,0,0,0,17,0,17,,,,135,95,14,81,8,0,8,30,0,30,,,
05/17/2020,Southeast,5,CAH,1,81,77,24,53,12,0,12,25,0,25,,,,81,77,24,53,12,0,12,25,0,25,,,
05/17/2020,Southeast,5,GACH,1,133,56,19,37,9,3,6,15,0,15,,,,133,56,19,37,9,3,6,15,0,15,,,
05/17/2020,Southwest,1,CAH,1,26,12,5,7,0,0,0,2,0,2,,,,26,12,5,7,0,0,0,2,0,2,,,
05/17/2020,Southwest,1,GACH,1,,,,,,,,,,,,,,62,45,14,31,8,0,8,4,0,4,,,
05/18/2020,Anchorage,7,GACH,1,995,824,442,382,92,66,26,150,24,126,,,,995,824,442,382,92,66,26,150,24,126,,,
05/18/2020,Anchorage,7,LTACH,0,51,33,33,0,11,7,4,24,0,24,,,,51,33,33,0,11,7,4,24,0,24,,,
05/18/2020,Anchorage,7,Psych,0,116,86,57,29,0,0,0,0,0,0,,,,116,86,57,29,0,0,0,0,0,0,,,
05/18/2020,Gulf Coast,4,CAH,1,130,109,17,92,4,0,4,20,0,20,,,,130,109,17,92,4,0,4,20,0,20,,,
05/18/2020,Gulf Coast,4,GACH,1,49,43,34,9,6,2,4,9,2,7,,,,49,43,34,9,6,2,4,9,2,7,,,
05/18/2020,Interior,6,GACH,1,94,81,45,36,13,2,11,16,2,14,,,,94,81,45,36,13,2,11,16,2,14,,,
05/18/2020,Matanuska-Susitna,3,GACH,1,112,102,77,25,12,12,0,39,1,38,,,,112,102,77,25,12,12,0,39,1,38,,,
05/18/2020,Northern,2,CAH,1,135,95,12,83,8,0,8,30,0,30,,,,135,95,12,83,8,0,8,30,0,30,,,
05/18/2020,Southeast,5,CAH,1,65,65,24,41,13,0,13,31,0,31,,,,65,65,24,41,13,0,13,31,0,31,,,
05/18/2020,Southeast,5,GACH,1,133,56,17,39,9,4,5,15,0,15,,,,133,56,17,39,9,4,5,15,0,15,,,
05/18/2020,Southwest,1,CAH,1,26,12,5,7,0,0,0,2,0,2,,,,26,12,5,7,0,0,0,2,0,2,,,
05/18/2020,Southwest,1,GACH,1,62,45,17,28,8,0,8,4,0,4,,,,62,45,17,28,8,0,8,4,0,4,,,
05/19/2020,Anchorage,7,GACH,1,995,824,438,386,92,31,61,145,27,118,,,,995,824,438,386,92,31,61,145,27,118,,,
05/19/2020,Anchorage,7,LTACH,0,51,35,35,0,11,8,3,24,0,24,,,,51,35,35,0,11,8,3,24,0,24,,,
05/19/2020,Anchorage,7,Psych,0,116,86,61,25,0,0,0,0,0,0,,,,116,86,61,25,0,0,0,0,0,0,,,
05/19/2020,Gulf Coast,4,CAH,1,130,109,21,88,4,0,4,20,0,20,,,,130,109,21,88,4,0,4,20,0,20,,,
05/19/2020,Gulf Coast,4,GACH,1,49,43,36,7,6,4,2,9,1,8,,,,49,43,36,7,6,4,2,9,1,8,,,
05/19/2020,Interior,6,GACH,1,94,81,46,35,13,10,3,16,3,13,,,,94,81,46,35,13,10,3,16,3,13,,,
05/19/2020,Matanuska-Susitna,3,GACH,1,112,102,89,13,12,11,1,39,2,37,,,,112,102,89,13,12,11,1,39,2,37,,,
05/19/2020,Northern,2,CAH,1,135,95,18,77,8,0,8,30,0,30,,,,135,95,18,77,8,0,8,30,0,30,,,
05/19/2020,Southeast,5,CAH,1,65,65,23,42,13,1,12,31,0,31,,,,65,65,23,42,13,1,12,31,0,31,,,
05/19/2020,Southeast,5,GACH,1,133,56,28,28,9,6,3,15,0,15,,,,133,56,28,28,9,6,3,15,0,15,,,
05/19/2020,Southwest,1,CAH,1,26,12,4,8,0,0,0,2,0,2,,,,26,12,4,8,0,0,0,2,0,2,,,
05/19/2020,Southwest,1,GACH,1,62,45,14,31,8,0,8,4,0,4,,,,62,45,14,31,8,0,8,4,0,4,,,
05/20/2020,Anchorage,7,GACH,1,921,824,546,278,149,132,17,176,27,149,,,,921,824,546,278,149,132,17,176,27,149,,,
05/20/2020,Anchorage,7,LTACH,0,51,51,35,16,11,8,3,24,0,24,,,,51,51,35,16,11,8,3,24,0,24,,,
05/20/2020,Anchorage,7,Psych,0,116,86,57,29,0,0,0,0,0,0,,,,116,86,57,29,0,0,0,0,0,0,,,
05/20/2020,Gulf Coast,4,CAH,1,130,97,21,76,4,0,4,20,0,20,,,,130,97,21,76,4,0,4,20,0,20,,,
05/20/2020,Gulf Coast,4,GACH,1,49,43,35,8,6,4,2,9,0,9,,,,49,43,35,8,6,4,2,9,0,9,,,
05/20/2020,Interior,6,GACH,1,94,81,48,33,13,10,3,16,1,15,,,,94,81,48,33,13,10,3,16,1,15,,,
05/20/2020,Matanuska-Susitna,3,GACH,1,,,,,,,,,,,,,,112,102,89,13,12,11,1,39,2,37,,,
05/20/2020,Northern,2,CAH,1,135,95,17,78,8,0,8,30,0,30,,,,135,95,17,78,8,0,8,30,0,30,,,
05/20/2020,Southeast,5,CAH,1,65,65,26,39,13,0,13,31,0,31,,,,65,65,26,39,13,0,13,31,0,31,,,
05/20/2020,Southeast,5,GACH,1,133,56,29,27,9,5,4,15,0,15,,,,133,56,29,27,9,5,4,15,0,15,,,
05/20/2020,Southwest,1,CAH,1,26,12,4,8,0,0,0,2,0,2,,,,26,12,4,8,0,0,0,2,0,2,,,
05/20/2020,Southwest,1,GACH,1,62,45,16,29,8,0,8,4,0,4,,,,62,45,16,29,8,0,8,4,0,4,,,
05/21/2020,Anchorage,7,GACH,1,921,824,541,283,149,127,22,176,27,149,,,,921,824,541,283,149,127,22,176,27,149,,,
05/21/2020,Anchorage,7,LTACH,0,51,51,35,16,11,7,4,24,0,24,,,,51,51,35,16,11,7,4,24,0,24,,,
05/21/2020,Anchorage,7,Psych,0,116,86,58,28,0,0,0,0,0,0,,,,116,86,58,28,0,0,0,0,0,0,,,
05/21/2020,Gulf Coast,4,CAH,1,130,98,16,57,4,0,2,20,0,20,,,,130,98,21,77,4,0,4,20,0,20,,,
05/21/2020,Gulf Coast,4,GACH,1,146,146,41,105,6,4,2,9,0,9,,,,146,146,41,105,6,4,2,9,0,9,,,
05/21/2020,Interior,6,GACH,1,94,81,40,41,13,10,3,16,2,14,,,,94,81,40,41,13,10,3,16,2,14,,,
05/21/2020,Matanuska-Susitna,3,GACH,1,,,,,,,,,,,,,,112,102,89,13,12,11,1,39,2,37,,,
05/21/2020,Northern,2,CAH,1,135,95,22,73,8,0,8,30,0,30,,,,135,95,22,73,8,0,8,30,0,30,,,
05/21/2020,Southeast,5,CAH,1,65,65,28,37,13,0,13,31,0,31,,,,65,65,28,37,13,0,13,31,0,31,,,
05/21/2020,Southeast,5,GACH,1,133,56,21,35,9,5,4,15,0,15,,,,133,56,21,35,9,5,4,15,0,15,,,
05/21/2020,Southwest,1,CAH,1,26,12,4,8,0,0,0,2,0,2,,,,26,12,4,8,0,0,0,2,0,2,,,
05/21/2020,Southwest,1,GACH,1,62,45,10,35,8,0,8,4,0,4,,,,62,45,10,35,8,0,8,4,0,4,,,
05/22/2020,Anchorage,7,GACH,1,921,824,541,283,149,127,22,180,26,154,,,,921,824,541,283,149,127,22,180,26,154,,,
05/22/2020,Anchorage,7,LTACH,0,51,51,35,16,11,7,4,24,0,24,,,,51,51,35,16,11,7,4,24,0,24,,,
05/22/2020,Anchorage,7,Psych,0,116,86,60,26,0,0,0,0,0,0,,,,116,86,60,26,0,0,0,0,0,0,,,
05/22/2020,Gulf Coast,4,CAH,1,130,97,18,79,4,1,3,20,0,20,,,,130,97,18,79,4,1,3,20,0,20,,,
05/22/2020,Gulf Coast,4,GACH,1,49,43,37,6,6,0,6,9,0,9,,,,49,43,37,6,6,0,6,9,0,9,,,
05/22/2020,Interior,6,GACH,1,94,81,41,40,13,10,3,16,2,14,,,,94,81,41,40,13,10,3,16,2,14,,,
05/22/2020,Matanuska-Susitna,3,GACH,1,112,102,86,16,12,11,1,39,2,37,,,,112,102,86,16,12,11,1,39,2,37,,,
05/22/2020,Northern,2,CAH,1,135,64,16,48,8,0,8,30,0,30,,,,135,64,16,48,8,0,8,30,0,30,,,
05/22/2020,Southeast,5,CAH,1,81,77,28,49,12,0,12,25,0,25,,,,81,77,28,49,12,0,12,25,0,25,,,
05/22/2020,Southeast,5,GACH,1,133,56,32,24,9,5,4,15,0,15,,,,133,56,32,24,9,5,4,15,0,15,,,
05/22/2020,Southwest,1,CAH,1,26,12,6,6,0,0,0,2,0,2,,,,26,12,6,6,0,0,0,2,0,2,,,
05/22/2020,Southwest,1,GACH,1,62,45,15,30,8,0,8,4,0,4,,,,62,45,15,30,8,0,8,4,0,4,,,
05/23/2020,Anchorage,7,GACH,1,921,824,529,295,149,128,21,182,25,157,,,,921,824,529,295,149,128,21,182,25,157,,,
05/23/2020,Anchorage,7,LTACH,0,56,45,35,10,11,7,4,24,0,24,,,,56,45,35,10,11,7,4,24,0,24,,,
05/23/2020,Anchorage,7,Psych,0,,,,,,,,,,,,,,116,86,60,26,0,0,0,0,0,0,,,
05/23/2020,Gulf Coast,4,CAH,1,115,84,17,67,2,0,2,18,0,18,,,,130,95,18,77,2,0,2,22,0,22,,,
05/23/2020,Gulf Coast,4,GACH,1,49,43,33,10,6,1,5,9,0,9,,,,49,43,33,10,6,1,5,9,0,9,,,
05/23/2020,Interior,6,GACH,1,94,81,36,45,13,7,6,16,3,13,,,,94,81,36,45,13,7,6,16,3,13,,,
05/23/2020,Matanuska-Susitna,3,GACH,1,192,125,70,55,14,9,5,15,1,14,,,,192,125,70,55,14,9,5,15,1,14,,,
05/23/2020,Northern,2,CAH,1,84,52,16,36,0,0,0,17,0,17,,,,135,95,20,75,8,0,8,30,0,30,,,
05/23/2020,Southeast,5,CAH,1,56,56,17,39,8,0,8,14,0,14,,,,81,77,26,51,12,0,12,25,0,25,,,
05/23/2020,Southeast,5,GACH,1,133,56,30,26,9,2,7,15,0,15,,,,133,56,30,26,9,2,7,15,0,15,,,
05/23/2020,Southwest,1,CAH,1,26,12,4,8,0,0,0,2,0,2,,,,26,12,4,8,0,0,0,2,0,2,,,
05/23/2020,Southwest,1,GACH,1,62,45,16,29,8,0,8,4,0,4,,,,62,45,16,29,8,0,8,4,0,4,,,
05/24/2020,Anchorage,7,GACH,1,921,824,521,303,149,123,26,182,24,158,,,,921,824,521,303,149,123,26,182,24,158,,,
05/24/2020,Anchorage,7,LTACH,0,56,45,35,10,11,7,4,24,0,24,,,,56,45,35,10,11,7,4,24,0,24,,,
05/24/2020,Anchorage,7,Psych,0,,,,,,,,,,,,,,116,86,60,26,0,0,0,0,0,0,,,
05/24/2020,Gulf Coast,4,CAH,1,130,107,16,91,2,0,2,22,0,22,,,,130,107,16,91,2,0,2,22,0,22,,,
05/24/2020,Gulf Coast,4,GACH,1,49,43,33,10,6,2,4,9,0,9,,,,49,43,33,10,6,2,4,9,0,9,,,
05/24/2020,Interior,6,GACH,1,94,81,56,25,13,5,8,16,2,14,,,,94,81,56,25,13,5,8,16,2,14,,,
05/24/2020,Matanuska-Susitna,3,GACH,1,112,102,70,32,12,8,4,39,1,38,,,,112,102,70,32,12,8,4,39,1,38,,,
05/24/2020,Northern,2,CAH,1,135,95,20,75,8,0,8,30,0,30,,,,135,95,20,75,8,0,8,30,0,30,,,
05/24/2020,Southeast,5,CAH,1,56,56,16,40,8,0,8,14,0,14,,,,81,77,25,52,12,0,12,25,0,25,,,
05/24/2020,Southeast,5,GACH,1,133,56,26,30,9,2,7,15,0,15,,,,133,56,26,30,9,2,7,15,0,15,,,
05/24/2020,Southwest,1,CAH,1,26,12,3,9,0,0,0,2,0,2,,,,26,12,3,9,0,0,0,2,0,2,,,
05/24/2020,Southwest,1,GACH,1,62,45,18,27,8,0,8,4,0,4,,,,62,45,18,27,8,0,8,4,0,4,,,
05/25/2020,Anchorage,7,GACH,1,921,824,507,317,149,120,29,183,24,159,,,,921,824,507,317,149,120,29,183,24,159,,,
05/25/2020,Anchorage,7,LTACH,0,56,45,35,10,11,7,4,24,0,24,,,,56,45,35,10,11,7,4,24,0,24,,,
05/25/2020,Anchorage,7,Psych,0,,,,,,,,,,,,,,116,86,60,26,0,0,0,0,0,0,,,
05/25/2020,Gulf Coast,4,CAH,1,130,95,21,74,2,0,2,22,0,22,,,,130,95,21,74,2,0,2,22,0,22,,,
05/25/2020,Gulf Coast,4,GACH,1,49,43,34,9,6,5,1,9,1,8,,,,49,43,34,9,6,5,1,9,1,8,,,
05/25/2020,Interior,6,GACH,1,94,81,57,24,13,7,6,16,3,13,,,,94,81,57,24,13,7,6,16,3,13,,,
05/25/2020,Matanuska-Susitna,3,GACH,1,192,125,68,57,14,10,4,15,1,14,,,,192,125,68,57,14,10,4,15,1,14,,,
05/25/2020,Northern,2,CAH,1,135,95,17,78,8,0,8,30,0,30,,,,135,95,17,78,8,0,8,30,0,30,,,
05/25/2020,Southeast,5,CAH,1,81,77,19,58,12,1,11,25,0,25,,,,81,77,19,58,12,1,11,25,0,25,,,
05/25/2020,Southeast,5,GACH,1,133,56,23,33,9,2,7,15,0,15,,,,133,56,23,33,9,2,7,15,0,15,,,
05/25/2020,Southwest,1,CAH,1,26,12,2,10,0,0,0,2,0,2,,,,26,12,2,10,0,0,0,2,0,2,,,
05/25/2020,Southwest,1,GACH,1,62,45,18,27,8,0,8,4,0,4,,,,62,45,18,27,8,0,8,4,0,4,,,
05/26/2020,Anchorage,7,GACH,1,921,824,525,299,149,113,36,179,27,152,,,,921,824,525,299,149,113,36,179,27,152,,,
05/26/2020,Anchorage,7,LTACH,0,51,51,35,16,11,7,4,24,0,24,,,,51,51,35,16,11,7,4,24,0,24,,,
05/26/2020,Anchorage,7,Psych,0,36,36,18,18,0,0,0,0,0,0,,,,116,86,63,23,0,0,0,0,0,0,,,
05/26/2020,Gulf Coast,4,CAH,1,130,97,19,78,4,0,4,20,0,20,,,,130,97,19,78,4,0,4,20,0,20,,,
05/26/2020,Gulf Coast,4,GACH,1,49,43,33,10,6,3,3,9,1,8,,,,49,43,33,10,6,3,3,9,1,8,,,
05/26/2020,Interior,6,GACH,1,94,81,55,26,13,3,10,16,0,16,,,,94,81,55,26,13,3,10,16,0,16,,,
05/26/2020,Matanuska-Susitna,3,GACH,1,112,102,81,21,12,7,5,39,1,38,,,,112,102,81,21,12,7,5,39,1,38,,,
05/26/2020,Northern,2,CAH,1,135,95,17,78,8,0,8,30,0,30,,,,135,95,17,78,8,0,8,30,0,30,,,
05/26/2020,Southeast,5,CAH,1,71,71,21,50,13,2,11,31,0,31,,,,71,71,21,50,13,2,11,31,0,31,,,
05/26/2020,Southeast,5,GACH,1,133,56,20,36,9,1,8,15,0,15,,,,133,56,20,36,9,1,8,15,0,15,,,
05/26/2020,Southwest,1,CAH,1,26,12,2,10,0,0,0,2,0,2,,,,26,12,2,10,0,0,0,2,0,2,,,
05/26/2020,Southwest,1,GACH,1,62,45,21,24,8,0,8,4,0,4,,,,62,45,21,24,8,0,8,4,0,4,,,
05/27/2020,Anchorage,7,GACH,1,921,824,547,277,149,116,33,182,24,158,,,,921,824,547,277,149,116,33,182,24,158,,,
05/27/2020,Anchorage,7,LTACH,0,51,51,34,17,11,6,5,24,0,24,,,,51,51,34,17,11,6,5,24,0,24,,,
05/27/2020,Anchorage,7,Psych,0,116,86,69,17,0,0,0,0,0,0,,,,116,86,69,17,0,0,0,0,0,0,,,
05/27/2020,Gulf Coast,4,CAH,1,130,97,17,80,4,1,3,20,0,20,,,,130,97,17,80,4,1,3,20,0,20,,,
05/27/2020,Gulf Coast,4,GACH,1,49,43,31,12,6,5,1,9,1,8,,,,49,43,31,12,6,5,1,9,1,8,,,
05/27/2020,Interior,6,GACH,1,94,81,54,27,13,8,5,16,1,15,,,,94,81,54,27,13,8,5,16,1,15,,,
05/27/2020,Matanuska-Susitna,3,GACH,1,112,102,85,17,12,6,6,39,1,38,,,,112,102,85,17,12,6,6,39,1,38,,,
05/27/2020,Northern,2,CAH,1,101,61,13,48,8,0,8,24,0,24,,,,135,95,18,77,8,0,8,30,0,30,,,
05/27/2020,Southeast,5,CAH,1,71,71,23,48,13,2,11,31,0,31,,,,71,71,23,48,13,2,11,31,0,31,,,
05/27/2020,Southeast,5,GACH,1,133,56,27,29,9,3,6,15,0,15,,,,133,56,27,29,9,3,6,15,0,15,,,
05/27/2020,Southwest,1,CAH,1,26,12,0,12,0,0,0,2,0,2,,,,26,12,0,12,0,0,0,2,0,2,,,
05/27/2020,Southwest,1,GACH,1,62,45,22,23,8,0,8,4,0,4,,,,62,45,22,23,8,0,8,4,0,4,,,
05/28/2020,Anchorage,7,GACH,1,921,824,549,275,149,114,35,183,19,164,,,,921,824,549,275,149,114,35,183,19,164,,,
05/28/2020,Anchorage,7,LTACH,0,51,51,36,15,11,7,4,24,1,23,,,,51,51,36,15,11,7,4,24,1,23,,,
05/28/2020,Anchorage,7,Psych,0,,,,,,,,,,,,,,116,86,69,17,0,0,0,0,0,0,,,
05/28/2020,Gulf Coast,4,CAH,1,98,77,17,60,4,1,3,12,0,12,,,,130,97,18,79,4,1,3,20,0,20,,,
05/28/2020,Gulf Coast,4,GACH,1,,,,,,,,,,,,,,49,43,31,12,6,5,1,9,1,8,,,
05/28/2020,Interior,6,GACH,1,94,81,55,26,13,6,7,16,0,16,,,,94,81,55,26,13,6,7,16,0,16,,,
05/28/2020,Matanuska-Susitna,3,GACH,1,112,102,87,15,12,7,5,39,0,39,,,,112,102,87,15,12,7,5,39,0,39,,,
05/28/2020,Northern,2,CAH,1,50,18,10,8,0,0,0,11,0,11,,,,135,95,19,76,8,0,8,30,0,30,,,
05/28/2020,Southeast,5,CAH,1,27,27,8,19,5,2,3,20,0,20,,,,71,71,23,48,13,2,11,31,0,31,,,
05/28/2020,Southeast,5,GACH,1,133,56,27,29,9,3,6,15,0,15,,,,133,56,27,29,9,3,6,15,0,15,,,
05/28/2020,Southwest,1,CAH,1,,,,,,,,,,,,,,26,12,0,12,0,0,0,2,0,2,,,
05/28/2020,Southwest,1,GACH,1,0,0,0,0,0,0,0,0,0,0,,,,0,0,0,0,0,0,0,0,0,0,,,
05/29/2020,Anchorage,7,GACH,1,921,824,543,281,149,115,34,179,28,151,,,,921,824,543,281,149,115,34,179,28,151,,,
05/29/2020,Anchorage,7,LTACH,0,51,51,36,15,11,7,4,24,1,23,,,,51,51,36,15,11,7,4,24,1,23,,,
05/29/2020,Anchorage,7,Psych,0,116,86,67,19,0,0,0,0,0,0,,,,116,86,67,19,0,0,0,0,0,0,,,
05/29/2020,Gulf Coast,4,CAH,1,115,86,22,64,4,2,2,16,0,16,,,,130,97,22,75,4,2,2,20,0,20,,,
05/29/2020,Gulf Coast,4,GACH,1,49,43,32,11,6,5,1,9,1,8,,,,49,43,32,11,6,5,1,9,1,8,,,
05/29/2020,Interior,6,GACH,1,94,81,54,27,13,3,10,16,0,16,,,,94,81,54,27,13,3,10,16,0,16,,,
05/29/2020,Matanuska-Susitna,3,GACH,1,112,102,88,14,12,7,5,39,1,38,,,,112,102,88,14,12,7,5,39,1,38,,,
05/29/2020,Northern,2,CAH,1,135,95,19,76,8,0,8,34,0,34,,,,135,95,19,76,8,0,8,34,0,34,,,
05/29/2020,Southeast,5,CAH,1,71,71,25,46,13,2,11,31,0,31,,,,71,71,25,46,13,2,11,31,0,31,,,
05/29/2020,Southeast,5,GACH,1,133,56,24,32,9,4,5,15,0,15,,,,133,56,24,32,9,4,5,15,0,15,,,
05/29/2020,Southwest,1,CAH,1,26,12,3,9,0,0,0,2,0,2,,,,26,12,3,9,0,0,0,2,0,2,,,
05/29/2020,Southwest,1,GACH,1,0,0,0,0,0,0,0,0,0,0,,,,0,0,0,0,0,0,0,0,0,0,,,
05/30/2020,Anchorage,7,GACH,1,921,824,523,301,149,111,38,182,25,157,,,,921,824,523,301,149,111,38,182,25,157,,,
05/30/2020,Anchorage,7,LTACH,0,56,45,36,9,11,7,4,24,0,24,,,,56,45,36,9,11,7,4,24,0,24,,,
05/30/2020,Anchorage,7,Psych,0,,,,,,,,,,,,,,116,86,67,19,0,0,0,0,0,0,,,
05/30/2020,Gulf Coast,4,CAH,1,130,95,22,73,2,0,2,22,0,22,,,,130,95,22,73,2,0,2,22,0,22,,,
05/30/2020,Gulf Coast,4,GACH,1,49,43,31,12,6,5,1,9,1,8,,,,49,43,31,12,6,5,1,9,1,8,,,
05/30/2020,Interior,6,GACH,1,94,81,48,33,13,7,6,16,0,16,,,,94,81,48,33,13,7,6,16,0,16,,,
05/30/2020,Matanuska-Susitna,3,GACH,1,112,102,77,25,12,7,5,39,1,38,,,,112,102,77,25,12,7,5,39,1,38,,,
05/30/2020,Northern,2,CAH,1,135,95,17,78,8,0,8,34,0,34,,,,135,95,17,78,8,0,8,34,0,34,,,
05/30/2020,Southeast,5,CAH,1,56,56,20,36,8,0,8,14,0,14,,,,71,71,28,43,13,2,11,31,0,31,,,
05/30/2020,Southeast,5,GACH,1,133,56,21,35,9,3,6,15,0,15,,,,133,56,21,35,9,3,6,15,0,15,,,
05/30/2020,Southwest,1,CAH,1,26,12,1,11,0,0,0,2,0,2,,,,26,12,1,11,0,0,0,2,0,2,,,
05/30/2020,Southwest,1,GACH,1,,,,,,,,,,,,,,0,0,0,0,0,0,0,0,0,0,,,
05/31/2020,Anchorage,7,GACH,1,921,824,515,309,149,106,43,184,23,161,,,,921,824,515,309,149,106,43,184,23,161,,,
05/31/2020,Anchorage,7,LTACH,0,56,45,36,9,11,6,5,24,0,24,,,,56,45,36,9,11,6,5,24,0,24,,,
05/31/2020,Anchorage,7,Psych,0,,,,,,,,,,,,,,116,86,67,19,0,0,0,0,0,0,,,
05/31/2020,Gulf Coast,4,CAH,1,117,94,16,78,2,1,1,21,0,21,,,,130,95,17,78,2,1,1,22,0,22,,,
05/31/2020,Gulf Coast,4,GACH,1,49,43,32,11,6,3,3,9,0,9,,,,49,43,32,11,6,3,3,9,0,9,,,
05/31/2020,Interior,6,GACH,1,94,81,45,36,13,6,7,16,0,16,,,,94,81,45,36,13,6,7,16,0,16,,,
05/31/2020,Matanuska-Susitna,3,GACH,1,112,102,66,36,12,6,6,39,3,36,,,,112,102,66,36,12,6,6,39,3,36,,,
05/31/2020,Northern,2,CAH,1,135,95,18,77,8,0,8,34,0,34,,,,135,95,18,77,8,0,8,34,0,34,,,
05/31/2020,Southeast,5,CAH,1,81,77,25,52,12,0,12,25,0,25,,,,81,77,25,52,12,0,12,25,0,25,,,
05/31/2020,Southeast,5,GACH,1,133,56,24,32,9,4,5,15,0,15,,,,133,56,24,32,9,4,5,15,0,15,,,
05/31/2020,Southwest,1,CAH,1,26,12,2,10,0,0,0,2,0,2,,,,26,12,2,10,0,0,0,2,0,2,,,
05/31/2020,Southwest,1,GACH,1,,,,,,,,,,,,,,0,0,0,0,0,0,0,0,0,0,,,
06/01/2020,Anchorage,7,GACH,1,921,824,487,337,149,117,32,184,24,160,,,,921,824,487,337,149,117,32,184,24,160,,,
06/01/2020,Anchorage,7,LTACH,0,56,45,36,9,11,5,6,24,0,24,,,,56,45,36,9,11,5,6,24,0,24,,,
06/01/2020,Anchorage,7,Psych,0,116,86,65,21,0,0,0,0,0,0,,,,116,86,65,21,0,0,0,0,0,0,,,
06/01/2020,Gulf Coast,4,CAH,1,147,108,45,63,4,0,4,20,0,20,,,,147,108,45,63,4,0,4,20,0,20,,,
06/01/2020,Gulf Coast,4,GACH,1,146,146,33,113,6,3,3,9,0,9,,,,146,146,33,113,6,3,3,9,0,9,,,
06/01/2020,Interior,6,GACH,1,94,81,50,31,13,8,5,16,0,16,,,,94,81,50,31,13,8,5,16,0,16,,,
06/01/2020,Matanuska-Susitna,3,GACH,1,112,102,62,40,12,7,5,39,1,38,,,,112,102,62,40,12,7,5,39,1,38,,,
06/01/2020,Northern,2,CAH,1,101,61,12,49,8,0,8,34,0,34,,,,101,61,12,49,8,0,8,34,0,34,,,
06/01/2020,Southeast,5,CAH,1,71,71,21,50,13,1,12,31,0,31,,,,71,71,21,50,13,1,12,31,0,31,,,
06/01/2020,Southeast,5,GACH,1,133,56,21,35,9,2,7,15,0,15,,,,133,56,21,35,9,2,7,15,0,15,,,
06/01/2020,Southwest,1,CAH,1,26,12,2,10,0,0,0,2,0,2,,,,26,12,2,10,0,0,0,2,0,2,,,
06/01/2020,Southwest,1,GACH,1,62,45,13,32,8,0,8,4,0,4,,,,62,45,13,32,8,0,8,4,0,4,,,
06/02/2020,Anchorage,7,GACH,1,921,824,546,278,149,116,33,182,25,157,,,,921,824,546,278,149,116,33,182,25,157,,,
06/02/2020,Anchorage,7,LTACH,0,51,51,34,17,11,5,6,24,0,24,,,,51,51,34,17,11,5,6,24,0,24,,,
06/02/2020,Anchorage,7,Psych,0,116,86,65,21,0,0,0,0,0,0,,,,116,86,65,21,0,0,0,0,0,0,,,
06/02/2020,Gulf Coast,4,CAH,1,118,97,18,79,4,0,4,20,0,20,,,,118,97,18,79,4,0,4,20,0,20,,,
06/02/2020,Gulf Coast,4,GACH,1,146,146,31,115,9,3,6,9,0,9,,,,146,146,31,115,9,3,6,9,0,9,,,
06/02/2020,Interior,6,GACH,1,94,81,53,28,13,10,3,16,0,16,,,,94,81,53,28,13,10,3,16,0,16,,,
06/02/2020,Matanuska-Susitna,3,GACH,1,112,102,82,20,12,11,1,39,3,36,,,,112,102,82,20,12,11,1,39,3,36,,,
06/02/2020,Northern,2,CAH,1,135,95,22,73,8,0,8,34,0,34,,,,135,95,22,73,8,0,8,34,0,34,,,
06/02/2020,Southeast,5,CAH,1,70,64,20,44,13,1,12,31,0,31,,,,70,64,20,44,13,1,12,31,0,31,,,
06/02/2020,Southeast,5,GACH,1,133,56,20,36,9,5,4,15,0,15,,,,133,56,20,36,9,5,4,15,0,15,,,
06/02/2020,Southwest,1,CAH,1,12,12,2,10,0,0,0,0,0,0,,,,12,12,2,10,0,0,0,0,0,0,,,
06/02/2020,Southwest,1,GACH,1,62,45,11,34,8,0,8,4,0,4,,,,62,45,11,34,8,0,8,4,0,4,,,
06/03/2020,Anchorage,7,GACH,1,921,824,542,282,149,111,38,182,22,160,,,,921,824,542,282,149,111,38,182,22,160,,,
06/03/2020,Anchorage,7,LTACH,0,51,51,34,17,11,6,5,24,0,24,,,,51,51,34,17,11,6,5,24,0,24,,,
06/03/2020,Anchorage,7,Psych,0,116,86,68,18,0,0,0,0,0,0,,,,116,86,68,18,0,0,0,0,0,0,,,
06/03/2020,Gulf Coast,4,CAH,1,130,97,25,72,4,1,3,20,0,20,,,,130,97,25,72,4,1,3,20,0,20,,,
06/03/2020,Gulf Coast,4,GACH,1,146,146,35,111,9,3,6,9,0,9,,,,146,146,35,111,9,3,6,9,0,9,,,
06/03/2020,Interior,6,GACH,1,94,81,47,34,13,7,6,16,0,16,,,,94,81,47,34,13,7,6,16,0,16,,,
06/03/2020,Matanuska-Susitna,3,GACH,1,112,102,83,19,12,11,1,39,1,38,,,,112,102,83,19,12,11,1,39,1,38,,,
06/03/2020,Northern,2,CAH,1,84,52,20,32,0,0,0,17,0,17,,,,135,95,20,75,8,0,8,34,0,34,,,
06/03/2020,Southeast,5,CAH,1,71,71,22,49,13,1,12,31,0,31,,,,71,71,22,49,13,1,12,31,0,31,,,
06/03/2020,Southeast,5,GACH,1,133,56,23,33,9,3,6,15,0,15,,,,133,56,23,33,9,3,6,15,0,15,,,
06/03/2020,Southwest,1,CAH,1,26,12,3,9,0,0,0,2,0,2,,,,26,12,3,9,0,0,0,2,0,2,,,
06/03/2020,Southwest,1,GACH,1,62,45,14,31,8,0,8,4,0,4,,,,62,45,14,31,8,0,8,4,0,4,,,
06/04/2020,Anchorage,7,GACH,1,921,824,563,261,149,106,43,185,21,164,,,,921,824,563,261,149,106,43,185,21,164,,,
06/04/2020,Anchorage,7,LTACH,0,51,51,35,16,11,6,5,24,0,24,,,,51,51,35,16,11,6,5,24,0,24,,,
06/04/2020,Anchorage,7,Psych,0,116,86,71,15,0,0,0,0,0,0,,,,116,86,71,15,0,0,0,0,0,0,,,
06/04/2020,Gulf Coast,4,CAH,1,130,109,20,89,4,0,4,20,0,20,,,,130,109,20,89,4,0,4,20,0,20,,,
06/04/2020,Gulf Coast,4,GACH,1,146,146,36,110,9,2,7,9,1,8,,,,146,146,36,110,9,2,7,9,1,8,,,
06/04/2020,Interior,6,GACH,1,94,81,42,39,13,7,6,16,1,15,,,,94,81,42,39,13,7,6,16,1,15,,,
06/04/2020,Matanuska-Susitna,3,GACH,1,,,,,,,,,,,,,,112,102,83,19,12,11,1,39,1,38,,,
06/04/2020,Northern,2,CAH,1,135,95,18,77,8,0,8,34,0,34,,,,135,95,18,77,8,0,8,34,0,34,,,
06/04/2020,Southeast,5,CAH,1,71,71,26,45,13,1,12,31,0,31,,,,71,71,26,45,13,1,12,31,0,31,,,
06/04/2020,Southeast,5,GACH,1,133,56,15,41,9,1,8,15,0,15,,,,133,56,15,41,9,1,8,15,0,15,,,
06/04/2020,Southwest,1,CAH,1,26,12,2,10,0,0,0,2,0,2,,,,26,12,2,10,0,0,0,2,0,2,,,
06/04/2020,Southwest,1,GACH,1,62,45,13,32,8,0,8,4,0,4,,,,62,45,13,32,8,0,8,4,0,4,,,
06/05/2020,Anchorage,7,GACH,1,931,834,528,306,159,109,50,186,17,169,,,,931,834,528,306,159,109,50,186,17,169,,,
06/05/2020,Anchorage,7,LTACH,0,51,51,35,16,11,6,5,24,1,23,,,,51,51,35,16,11,6,5,24,1,23,,,
06/05/2020,Anchorage,7,Psych,0,116,86,71,15,0,0,0,0,0,0,,,,116,86,71,15,0,0,0,0,0,0,,,
06/05/2020,Gulf Coast,4,CAH,1,130,97,20,77,4,0,4,20,0,20,,,,130,97,20,77,4,0,4,20,0,20,,,
06/05/2020,Gulf Coast,4,GACH,1,146,146,35,111,9,2,7,9,1,8,,,,146,146,35,111,9,2,7,9,1,8,,,
06/05/2020,Interior,6,GACH,1,94,81,39,42,13,10,3,16,0,16,,,,94,81,39,42,13,10,3,16,0,16,,,
06/05/2020,Matanuska-Susitna,3,GACH,1,112,102,77,25,12,11,1,39,1,38,,,,112,102,77,25,12,11,1,39,1,38,,,
06/05/2020,Northern,2,CAH,1,135,95,18,77,8,0,8,34,6,28,,,,135,95,18,77,8,0,8,34,6,28,,,
06/05/2020,Southeast,5,CAH,1,71,71,31,40,13,2,11,31,1,30,,,,71,71,31,40,13,2,11,31,1,30,,,
06/05/2020,Southeast,5,GACH,1,133,56,26,30,9,2,7,15,1,14,,,,133,56,26,30,9,2,7,15,1,14,,,
06/05/2020,Southwest,1,CAH,1,26,12,2,10,0,0,0,2,0,2,,,,26,12,2,10,0,0,0,2,0,2,,,
06/05/2020,Southwest,1,GACH,1,62,45,14,31,8,0,8,4,0,4,,,,62,45,14,31,8,0,8,4,0,4,,,
06/06/2020,Anchorage,7,GACH,1,931,834,514,320,159,105,54,187,16,171,,,,931,834,514,320,159,105,54,187,16,171,,,
06/06/2020,Anchorage,7,LTACH,0,56,45,34,11,11,6,5,24,1,23,,,,56,45,34,11,11,6,5,24,1,23,,,
06/06/2020,Anchorage,7,Psych,0,,,,,,,,,,,,,,116,86,71,15,0,0,0,0,0,0,,,
06/06/2020,Gulf Coast,4,CAH,1,130,107,15,92,2,0,2,22,0,22,,,,130,107,15,92,2,0,2,22,0,22,,,
06/06/2020,Gulf Coast,4,GACH,1,146,52,36,16,9,4,5,9,0,9,,,,146,52,36,16,9,4,5,9,0,9,,,
06/06/2020,Interior,6,GACH,1,94,81,39,42,13,9,4,16,0,16,,,,94,81,39,42,13,9,4,16,0,16,,,
06/06/2020,Matanuska-Susitna,3,GACH,1,,,,,,,,,,,,,,112,102,77,25,12,11,1,39,1,38,,,
06/06/2020,Northern,2,CAH,1,101,61,13,48,8,0,8,28,0,28,,,,135,95,19,76,8,0,8,34,6,28,,,
06/06/2020,Southeast,5,CAH,1,71,71,32,39,13,2,11,31,1,30,,,,71,71,32,39,13,2,11,31,1,30,,,
06/06/2020,Southeast,5,GACH,1,133,56,24,32,9,2,7,15,1,14,,,,133,56,24,32,9,2,7,15,1,14,,,
06/06/2020,Southwest,1,CAH,1,,,,,,,,,,,,,,26,12,2,10,0,0,0,2,0,2,,,
06/06/2020,Southwest,1,GACH,1,62,45,13,32,8,0,8,4,0,4,,,,62,45,13,32,8,0,8,4,0,4,,,
06/07/2020,Anchorage,7,GACH,1,931,834,505,329,159,111,48,187,22,165,,,,931,834,505,329,159,111,48,187,22,165,,,
06/07/2020,Anchorage,7,LTACH,0,56,45,33,12,11,6,5,24,1,23,,,,56,45,33,12,11,6,5,24,1,23,,,
06/07/2020,Anchorage,7,Psych,0,,,,,,,,,,,,,,116,86,71,15,0,0,0,0,0,0,,,
06/07/2020,Gulf Coast,4,CAH,1,130,107,22,85,2,1,1,22,0,22,,,,130,107,22,85,2,1,1,22,0,22,,,
06/07/2020,Gulf Coast,4,GACH,1,146,52,31,21,9,2,7,9,0,9,,,,146,52,31,21,9,2,7,9,0,9,,,
06/07/2020,Interior,6,GACH,1,94,81,39,42,13,6,7,16,0,16,,,,94,81,39,42,13,6,7,16,0,16,,,
06/07/2020,Matanuska-Susitna,3,GACH,1,112,102,81,21,12,12,0,39,2,37,,,,112,102,81,21,12,12,0,39,2,37,,,
06/07/2020,Northern,2,CAH,1,101,61,14,47,8,0,8,28,0,28,,,,135,95,20,75,8,0,8,34,6,28,,,
06/07/2020,Southeast,5,CAH,1,71,71,30,41,13,2,11,31,1,30,,,,71,71,30,41,13,2,11,31,1,30,,,
06/07/2020,Southeast,5,GACH,1,133,56,25,31,9,4,5,15,1,14,,,,133,56,25,31,9,4,5,15,1,14,,,
06/07/2020,Southwest,1,CAH,1,,,,,,,,,,,,,,26,12,2,10,0,0,0,2,0,2,,,
06/07/2020,Southwest,1,GACH,1,62,45,11,34,8,0,8,4,0,4,,,,62,45,11,34,8,0,8,4,0,4,,,
06/08/2020,Anchorage,7,GACH,1,931,834,514,320,159,112,47,190,15,175,,,,931,834,514,320,159,112,47,190,15,175,,,
06/08/2020,Anchorage,7,LTACH,0,51,51,34,17,11,6,5,24,1,23,,,,51,51,34,17,11,6,5,24,1,23,,,
06/08/2020,Anchorage,7,Psych,0,36,36,20,16,0,0,0,0,0,0,,,,116,86,69,17,0,0,0,0,0,0,,,
06/08/2020,Gulf Coast,4,CAH,1,130,98,22,76,4,0,4,20,0,20,,,,130,98,22,76,4,0,4,20,0,20,,,
06/08/2020,Gulf Coast,4,GACH,1,146,146,28,118,9,2,7,9,1,8,,,,146,146,28,118,9,2,7,9,1,8,,,
06/08/2020,Interior,6,GACH,1,94,81,37,44,13,6,7,16,0,16,,,,94,81,37,44,13,6,7,16,0,16,,,
06/08/2020,Matanuska-Susitna,3,GACH,1,,,,,,,,,,,,,,112,102,81,21,12,12,0,39,2,37,,,
06/08/2020,Northern,2,CAH,1,135,95,19,76,8,0,8,34,0,34,,,,135,95,19,76,8,0,8,34,0,34,,,
06/08/2020,Southeast,5,CAH,1,71,71,26,45,13,0,13,31,1,30,,,,71,71,26,45,13,0,13,31,1,30,,,
06/08/2020,Southeast,5,GACH,1,133,56,28,28,9,4,5,15,0,15,,,,133,56,28,28,9,4,5,15,0,15,,,
06/08/2020,Southwest,1,CAH,1,,,,,,,,,,,,,,26,12,2,10,0,0,0,2,0,2,,,
06/08/2020,Southwest,1,GACH,1,62,45,14,31,8,0,8,4,0,4,,,,62,45,14,31,8,0,8,4,0,4,,,
06/09/2020,Anchorage,7,GACH,1,931,834,514,320,159,108,51,188,19,169,,,,931,834,514,320,159,108,51,188,19,169,,,
06/09/2020,Anchorage,7,LTACH,0,51,51,37,14,11,6,5,24,1,23,,,,51,51,37,14,11,6,5,24,1,23,,,
06/09/2020,Anchorage,7,Psych,0,116,86,65,21,0,0,0,0,0,0,,,,116,86,65,21,0,0,0,0,0,0,,,
06/09/2020,Gulf Coast,4,CAH,1,130,98,23,75,4,1,3,20,0,20,,,,130,98,23,75,4,1,3,20,0,20,,,
06/09/2020,Gulf Coast,4,GACH,1,120,120,32,88,9,2,7,9,1,8,,,,120,120,32,88,9,2,7,9,1,8,,,
06/09/2020,Interior,6,GACH,1,94,81,39,42,13,6,7,16,0,16,,,,94,81,39,42,13,6,7,16,0,16,,,
06/09/2020,Matanuska-Susitna,3,GACH,1,112,102,88,14,14,13,1,39,3,36,,,,112,102,88,14,14,13,1,39,3,36,,,
06/09/2020,Northern,2,CAH,1,84,21,18,3,0,0,0,17,0,17,,,,135,64,20,44,8,0,8,34,0,34,,,
06/09/2020,Southeast,5,CAH,1,71,71,30,41,13,0,13,31,0,31,,,,71,71,30,41,13,0,13,31,0,31,,,
06/09/2020,Southeast,5,GACH,1,133,56,35,21,9,4,5,15,0,15,,,,133,56,35,21,9,4,5,15,0,15,,,
06/09/2020,Southwest,1,CAH,1,,,,,,,,,,,,,,26,12,2,10,0,0,0,2,0,2,,,
06/09/2020,Southwest,1,GACH,1,60,34,11,23,8,0,8,4,0,4,,,,60,34,11,23,8,0,8,4,0,4,,,
06/10/2020,Anchorage,7,GACH,1,931,834,513,321,159,107,52,193,23,170,,,,931,834,513,321,159,107,52,193,23,170,,,
06/10/2020,Anchorage,7,LTACH,0,51,51,39,12,11,6,5,24,1,23,,,,51,51,39,12,11,6,5,24,1,23,,,
06/10/2020,Anchorage,7,Psych,0,116,86,64,22,0,0,0,0,0,0,,,,116,86,64,22,0,0,0,0,0,0,,,
06/10/2020,Gulf Coast,4,CAH,1,130,97,25,72,4,0,4,20,0,20,,,,130,97,25,72,4,0,4,20,0,20,,,
06/10/2020,Gulf Coast,4,GACH,1,120,120,30,90,9,2,7,9,1,8,,,,120,120,30,90,9,2,7,9,1,8,,,
06/10/2020,Interior,6,GACH,1,94,81,61,20,13,4,9,16,1,15,,,,94,81,61,20,13,4,9,16,1,15,,,
06/10/2020,Matanuska-Susitna,3,GACH,1,112,102,86,16,14,14,0,39,3,36,,,,112,102,86,16,14,14,0,39,3,36,,,
06/10/2020,Northern,2,CAH,1,135,95,20,75,8,0,8,34,0,34,,,,135,95,20,75,8,0,8,34,0,34,,,
06/10/2020,Southeast,5,CAH,1,71,71,24,47,13,0,13,31,0,31,,,,71,71,24,47,13,0,13,31,0,31,,,
06/10/2020,Southeast,5,GACH,1,133,56,33,23,9,3,6,15,0,15,,,,133,56,33,23,9,3,6,15,0,15,,,
06/10/2020,Southwest,1,CAH,1,,,,,,,,,,,,,,26,12,2,10,0,0,0,2,0,2,,,
06/10/2020,Southwest,1,GACH,1,62,45,12,33,8,0,8,4,0,4,,,,62,45,12,33,8,0,8,4,0,4,,,
06/11/2020,Anchorage,7,GACH,1,931,834,545,289,159,116,43,185,19,166,,,,931,834,545,289,159,116,43,185,19,166,,,
06/11/2020,Anchorage,7,LTACH,0,51,51,39,12,11,6,5,24,1,23,,,,51,51,39,12,11,6,5,24,1,23,,,
06/11/2020,Anchorage,7,Psych,0,116,86,65,21,0,0,0,0,0,0,,,,116,86,65,21,0,0,0,0,0,0,,,
06/11/2020,Gulf Coast,4,CAH,1,130,97,25,72,4,0,4,20,0,20,,,,130,97,25,72,4,0,4,20,0,20,,,
06/11/2020,Gulf Coast,4,GACH,1,120,120,42,78,9,3,6,9,1,8,,,,120,120,42,78,9,3,6,9,1,8,,,
06/11/2020,Interior,6,GACH,1,94,81,54,27,13,6,7,16,1,15,,,,94,81,54,27,13,6,7,16,1,15,,,
06/11/2020,Matanuska-Susitna,3,GACH,1,114,104,94,10,14,10,4,39,3,36,,,,114,104,94,10,14,10,4,39,3,36,,,
06/11/2020,Northern,2,CAH,1,101,61,18,43,8,0,8,28,0,28,,,,135,95,23,72,8,0,8,34,0,34,,,
06/11/2020,Southeast,5,CAH,1,71,71,34,37,13,3,10,31,0,31,,,,71,71,34,37,13,3,10,31,0,31,,,
06/11/2020,Southeast,5,GACH,1,133,56,29,27,9,5,4,15,0,15,,,,133,56,29,27,9,5,4,15,0,15,,,
06/11/2020,Southwest,1,CAH,1,12,12,2,10,0,0,0,0,0,0,,,,12,12,2,10,0,0,0,0,0,0,,,
06/11/2020,Southwest,1,GACH,1,62,45,13,32,8,0,8,4,0,4,,,,62,45,13,32,8,0,8,4,0,4,,,
06/12/2020,Anchorage,7,GACH,1,931,834,558,276,159,116,43,186,15,171,,,,931,834,558,276,159,116,43,186,15,171,,,
06/12/2020,Anchorage,7,LTACH,0,51,51,36,15,11,6,5,24,1,23,,,,51,51,36,15,11,6,5,24,1,23,,,
06/12/2020,Anchorage,7,Psych,0,116,86,62,24,0,0,0,0,0,0,,,,116,86,62,24,0,0,0,0,0,0,,,
06/12/2020,Gulf Coast,4,CAH,1,118,97,24,73,4,1,3,20,0,20,,,,118,97,24,73,4,1,3,20,0,20,,,
06/12/2020,Gulf Coast,4,GACH,1,120,120,42,78,9,5,4,9,1,8,,,,120,120,42,78,9,5,4,9,1,8,,,
06/12/2020,Interior,6,GACH,1,94,81,52,29,13,6,7,16,1,15,,,,94,81,52,29,13,6,7,16,1,15,,,
06/12/2020,Matanuska-Susitna,3,GACH,1,114,104,82,22,14,8,6,39,2,37,,,,114,104,82,22,14,8,6,39,2,37,,,
06/12/2020,Northern,2,CAH,1,135,95,17,78,8,0,8,36,0,36,,,,135,95,17,78,8,0,8,36,0,36,,,
06/12/2020,Southeast,5,CAH,1,71,71,36,35,13,0,13,31,0,31,,,,71,71,36,35,13,0,13,31,0,31,,,
06/12/2020,Southeast,5,GACH,1,133,56,23,33,9,5,4,15,0,15,,,,133,56,23,33,9,5,4,15,0,15,,,
06/12/2020,Southwest,1,CAH,1,,,,,,,,,,,,,,12,12,2,10,0,0,0,0,0,0,,,
06/12/2020,Southwest,1,GACH,1,62,45,11,34,8,0,8,4,0,4,,,,62,45,11,34,8,0,8,4,0,4,,,
06/13/2020,Anchorage,7,GACH,1,931,834,517,317,159,109,50,187,15,172,,,,931,834,517,317,159,109,50,187,15,172,,,
06/13/2020,Anchorage,7,LTACH,0,,,,,,,,,,,,,,51,51,36,15,11,6,5,24,1,23,,,
06/13/2020,Anchorage,7,Psych,0,,,,,,,,,,,,,,116,86,62,24,0,0,0,0,0,0,,,
06/13/2020,Gulf Coast,4,CAH,1,98,75,20,55,3,1,2,14,0,14,,,,118,95,22,73,3,1,2,22,0,22,,,
06/13/2020,Gulf Coast,4,GACH,1,120,120,35,85,9,3,6,9,1,8,,,,120,120,35,85,9,3,6,9,1,8,,,
06/13/2020,Interior,6,GACH,1,94,81,47,34,13,5,8,16,0,16,,,,94,81,47,34,13,5,8,16,0,16,,,
06/13/2020,Matanuska-Susitna,3,GACH,1,114,104,62,42,14,7,7,39,2,37,,,,114,104,62,42,14,7,7,39,2,37,,,
06/13/2020,Northern,2,CAH,1,101,61,14,47,8,0,8,28,0,28,,,,135,95,18,77,8,0,8,36,0,36,,,
06/13/2020,Southeast,5,CAH,1,71,71,34,37,13,0,13,31,0,31,,,,71,71,34,37,13,0,13,31,0,31,,,
06/13/2020,Southeast,5,GACH,1,133,56,21,35,9,3,6,15,0,15,,,,133,56,21,35,9,3,6,15,0,15,,,
06/13/2020,Southwest,1,CAH,1,,,,,,,,,,,,,,12,12,2,10,0,0,0,0,0,0,,,
06/13/2020,Southwest,1,GACH,1,62,45,13,32,8,0,8,4,0,4,,,,62,45,13,32,8,0,8,4,0,4,,,
06/14/2020,Anchorage,7,GACH,1,931,834,496,338,159,107,52,186,16,170,,,,931,834,496,338,159,107,52,186,16,170,,,
06/14/2020,Anchorage,7,LTACH,0,,,,,,,,,,,,,,51,51,36,15,11,6,5,24,1,23,,,
06/14/2020,Anchorage,7,Psych,0,,,,,,,,,,,,,,116,86,62,24,0,0,0,0,0,0,,,
06/14/2020,Gulf Coast,4,CAH,1,98,87,20,67,2,0,2,14,0,14,,,,118,107,22,85,2,0,2,22,0,22,,,
06/14/2020,Gulf Coast,4,GACH,1,120,120,36,84,9,4,5,9,1,8,,,,120,120,36,84,9,4,5,9,1,8,,,
06/14/2020,Interior,6,GACH,1,94,81,44,37,13,6,7,16,0,16,,,,94,81,44,37,13,6,7,16,0,16,,,
06/14/2020,Matanuska-Susitna,3,GACH,1,114,104,63,41,14,10,4,39,4,35,,,,114,104,63,41,14,10,4,39,4,35,,,
06/14/2020,Northern,2,CAH,1,50,18,12,6,0,0,0,11,0,11,,,,135,95,20,75,8,0,8,36,0,36,,,
06/14/2020,Southeast,5,CAH,1,71,71,39,32,13,0,13,31,0,31,,,,71,71,39,32,13,0,13,31,0,31,,,
06/14/2020,Southeast,5,GACH,1,133,56,24,32,9,3,6,15,0,15,,,,133,56,24,32,9,3,6,15,0,15,,,
06/14/2020,Southwest,1,CAH,1,,,,,,,,,,,,,,12,12,2,10,0,0,0,0,0,0,,,
06/14/2020,Southwest,1,GACH,1,62,45,10,35,8,0,8,4,0,4,,,,62,45,10,35,8,0,8,4,0,4,,,
06/15/2020,Anchorage,7,GACH,1,931,834,522,312,159,115,44,185,21,164,,,,931,834,522,312,159,115,44,185,21,164,,,
06/15/2020,Anchorage,7,LTACH,0,51,51,36,15,11,6,5,24,1,23,,,,51,51,36,15,11,6,5,24,1,23,,,
06/15/2020,Anchorage,7,Psych,0,116,86,61,25,0,0,0,0,0,0,,,,116,86,61,25,0,0,0,0,0,0,,,
06/15/2020,Gulf Coast,4,CAH,1,130,97,25,72,4,0,4,20,0,20,,,,130,97,25,72,4,0,4,20,0,20,,,
06/15/2020,Gulf Coast,4,GACH,1,120,120,41,79,9,4,5,9,1,8,,,,120,120,41,79,9,4,5,9,1,8,,,
06/15/2020,Interior,6,GACH,1,94,81,46,35,13,6,7,16,0,16,,,,94,81,46,35,13,6,7,16,0,16,,,
06/15/2020,Matanuska-Susitna,3,GACH,1,114,104,69,35,14,10,4,39,4,35,,,,114,104,69,35,14,10,4,39,4,35,,,
06/15/2020,Northern,2,CAH,1,84,52,20,32,0,0,0,19,0,19,,,,135,95,24,71,8,0,8,36,0,36,,,
06/15/2020,Southeast,5,CAH,1,71,71,27,44,13,1,12,31,0,31,,,,71,71,27,44,13,1,12,31,0,31,,,
06/15/2020,Southeast,5,GACH,1,133,56,25,31,9,3,6,15,0,15,,,,133,56,25,31,9,3,6,15,0,15,,,
06/15/2020,Southwest,1,CAH,1,,,,,,,,,,,,,,12,12,2,10,0,0,0,0,0,0,,,
06/15/2020,Southwest,1,GACH,1,62,45,16,29,8,0,8,4,0,4,,,,62,45,16,29,8,0,8,4,0,4,,,
06/16/2020,Anchorage,7,GACH,1,931,834,535,299,159,119,40,185,25,160,,,,931,834,535,299,159,119,40,185,25,160,,,
06/16/2020,Anchorage,7,LTACH,0,51,51,34,17,11,6,5,24,0,24,,,,51,51,34,17,11,6,5,24,0,24,,,
06/16/2020,Anchorage,7,Psych,0,116,86,62,24,0,0,0,0,0,0,,,,116,86,62,24,0,0,0,0,0,0,,,
06/16/2020,Gulf Coast,4,CAH,1,130,97,25,72,4,0,4,20,0,20,,,,130,97,25,72,4,0,4,20,0,20,,,
06/16/2020,Gulf Coast,4,GACH,1,120,120,36,84,9,4,5,9,1,8,,,,120,120,36,84,9,4,5,9,1,8,,,
06/16/2020,Interior,6,GACH,1,94,81,52,29,13,7,6,16,0,16,,,,94,81,52,29,13,7,6,16,0,16,,,
06/16/2020,Matanuska-Susitna,3,GACH,1,114,104,73,31,14,10,4,39,4,35,,,,114,104,73,31,14,10,4,39,4,35,,,
06/16/2020,Northern,2,CAH,1,135,66,21,45,8,0,8,34,0,34,,,,135,66,21,45,8,0,8,34,0,34,,,
06/16/2020,Southeast,5,CAH,1,70,70,27,43,13,0,13,31,0,31,,,,70,70,27,43,13,0,13,31,0,31,,,
06/16/2020,Southeast,5,GACH,1,133,56,23,33,9,7,2,15,0,15,,,,133,56,23,33,9,7,2,15,0,15,,,
06/16/2020,Southwest,1,CAH,1,26,12,2,10,0,0,0,2,0,2,,,,26,12,2,10,0,0,0,2,0,2,,,
06/16/2020,Southwest,1,GACH,1,62,45,17,28,8,0,8,4,0,4,,,,62,45,17,28,8,0,8,4,0,4,,,
06/17/2020,Anchorage,7,GACH,1,931,834,538,296,159,107,52,185,22,163,,,,931,834,538,296,159,107,52,185,22,163,,,
06/17/2020,Anchorage,7,LTACH,0,51,51,32,19,11,6,5,24,1,23,,,,51,51,32,19,11,6,5,24,1,23,,,
06/17/2020,Anchorage,7,Psych,0,116,86,60,26,0,0,0,0,0,0,,,,116,86,60,26,0,0,0,0,0,0,,,
06/17/2020,Gulf Coast,4,CAH,1,130,99,26,73,4,0,4,20,0,20,,,,130,99,26,73,4,0,4,20,0,20,,,
06/17/2020,Gulf Coast,4,GACH,1,120,120,39,81,9,4,5,9,1,8,,,,120,120,39,81,9,4,5,9,1,8,,,
06/17/2020,Interior,6,GACH,1,94,81,51,30,13,8,5,16,0,16,,,,94,81,51,30,13,8,5,16,0,16,,,
06/17/2020,Matanuska-Susitna,3,GACH,1,114,104,75,29,14,13,1,39,4,35,,,,114,104,75,29,14,13,1,39,4,35,,,
06/17/2020,Northern,2,CAH,1,135,95,27,68,8,0,8,36,0,36,,,,135,95,27,68,8,0,8,36,0,36,,,
06/17/2020,Southeast,5,CAH,1,71,71,31,40,13,0,13,31,0,31,,,,71,71,31,40,13,0,13,31,0,31,,,
06/17/2020,Southeast,5,GACH,1,133,56,19,37,9,3,6,15,0,15,,,,133,56,19,37,9,3,6,15,0,15,,,
06/17/2020,Southwest,1,CAH,1,26,12,3,9,0,0,0,2,0,2,,,,26,12,3,9,0,0,0,2,0,2,,,
06/17/2020,Southwest,1,GACH,1,62,45,18,27,8,0,8,4,0,4,,,,62,45,18,27,8,0,8,4,0,4,,,
06/18/2020,Anchorage,7,GACH,1,931,834,541,293,159,99,60,183,26,157,,,,931,834,541,293,159,99,60,183,26,157,,,
06/18/2020,Anchorage,7,LTACH,0,51,51,29,22,11,7,4,24,1,23,,,,51,51,29,22,11,7,4,24,1,23,,,
06/18/2020,Anchorage,7,Psych,0,116,86,60,26,0,0,0,0,0,0,,,,116,86,60,26,0,0,0,0,0,0,,,
06/18/2020,Gulf Coast,4,CAH,1,130,100,26,74,4,0,4,20,0,20,,,,130,100,26,74,4,0,4,20,0,20,,,
06/18/2020,Gulf Coast,4,GACH,1,120,120,47,73,9,7,2,9,1,8,,,,120,120,47,73,9,7,2,9,1,8,,,
06/18/2020,Interior,6,GACH,1,94,81,53,28,13,11,2,16,1,15,,,,94,81,53,28,13,11,2,16,1,15,,,
06/18/2020,Matanuska-Susitna,3,GACH,1,114,104,72,32,14,14,0,39,3,36,,,,114,104,72,32,14,14,0,39,3,36,,,
06/18/2020,Northern,2,CAH,1,135,95,25,70,8,0,8,36,0,36,,,,135,95,25,70,8,0,8,36,0,36,,,
06/18/2020,Southeast,5,CAH,1,81,77,33,44,12,1,11,25,1,24,,,,81,77,33,44,12,1,11,25,1,24,,,
06/18/2020,Southeast,5,GACH,1,133,56,26,30,9,3,6,15,0,15,,,,133,56,26,30,9,3,6,15,0,15,,,
06/18/2020,Southwest,1,CAH,1,26,12,3,9,0,0,0,2,0,2,,,,26,12,3,9,0,0,0,2,0,2,,,
06/18/2020,Southwest,1,GACH,1,62,45,14,31,8,0,8,4,0,4,,,,62,45,14,31,8,0,8,4,0,4,,,
06/19/2020,Anchorage,7,GACH,1,931,834,541,293,159,101,58,181,28,153,,,,931,834,541,293,159,101,58,181,28,153,,,
06/19/2020,Anchorage,7,LTACH,0,51,51,29,22,11,7,4,24,1,23,,,,51,51,29,22,11,7,4,24,1,23,,,
06/19/2020,Anchorage,7,Psych,0,116,86,59,27,0,0,0,0,0,0,,,,116,86,59,27,0,0,0,0,0,0,,,
06/19/2020,Gulf Coast,4,CAH,1,130,109,26,83,4,0,4,20,0,20,,,,130,109,26,83,4,0,4,20,0,20,,,
06/19/2020,Gulf Coast,4,GACH,1,120,120,39,81,9,5,4,9,1,8,,,,120,120,39,81,9,5,4,9,1,8,,,
06/19/2020,Interior,6,GACH,1,94,81,51,30,13,6,7,16,0,16,,,,94,81,51,30,13,6,7,16,0,16,,,
06/19/2020,Matanuska-Susitna,3,GACH,1,114,104,80,24,14,12,2,39,1,38,,,,114,104,80,24,14,12,2,39,1,38,,,
06/19/2020,Northern,2,CAH,1,135,95,28,67,8,0,8,36,13,23,,,,135,95,28,67,8,0,8,36,13,23,,,
06/19/2020,Southeast,5,CAH,1,69,69,34,35,13,2,11,28,1,27,,,,81,81,36,45,13,2,11,31,1,30,,,
06/19/2020,Southeast,5,GACH,1,133,56,27,29,9,6,3,15,0,15,,,,133,56,27,29,9,6,3,15,0,15,,,
06/19/2020,Southwest,1,CAH,1,26,12,2,10,0,0,0,2,0,2,,,,26,12,2,10,0,0,0,2,0,2,,,
06/19/2020,Southwest,1,GACH,1,62,45,16,29,8,0,8,4,0,4,,,,62,45,16,29,8,0,8,4,0,4,,,
06/20/2020,Anchorage,7,GACH,1,931,834,518,316,159,103,56,183,26,157,,,,931,834,518,316,159,103,56,183,26,157,,,
06/20/2020,Anchorage,7,LTACH,0,56,45,29,16,11,7,4,24,1,23,,,,56,45,29,16,11,7,4,24,1,23,,,
06/20/2020,Anchorage,7,Psych,0,,,,,,,,,,,,,,116,86,59,27,0,0,0,0,0,0,,,
06/20/2020,Gulf Coast,4,CAH,1,130,109,24,85,2,0,2,20,0,20,,,,130,109,24,85,2,0,2,20,0,20,,,
06/20/2020,Gulf Coast,4,GACH,1,120,120,35,85,9,5,4,9,1,8,,,,120,120,35,85,9,5,4,9,1,8,,,
06/20/2020,Interior,6,GACH,1,94,81,46,35,13,8,5,16,0,16,,,,94,81,46,35,13,8,5,16,0,16,,,
06/20/2020,Matanuska-Susitna,3,GACH,1,114,104,84,20,14,10,4,39,2,37,,,,114,104,84,20,14,10,4,39,2,37,,,
06/20/2020,Northern,2,CAH,1,135,95,25,70,8,0,8,36,0,36,,,,135,95,25,70,8,0,8,36,0,36,,,
06/20/2020,Southeast,5,CAH,1,81,77,26,51,12,3,9,25,0,25,,,,81,77,26,51,12,3,9,25,0,25,,,
06/20/2020,Southeast,5,GACH,1,133,56,23,33,9,4,5,15,0,15,,,,133,56,23,33,9,4,5,15,0,15,,,
06/20/2020,Southwest,1,CAH,1,26,12,1,11,0,0,0,2,0,2,,,,26,12,1,11,0,0,0,2,0,2,,,
06/20/2020,Southwest,1,GACH,1,62,45,19,26,8,0,8,4,0,4,,,,62,45,19,26,8,0,8,4,0,4,,,
06/21/2020,Anchorage,7,GACH,1,931,834,499,335,159,101,58,181,30,151,,,,931,834,499,335,159,101,58,181,30,151,,,
06/21/2020,Anchorage,7,LTACH,0,51,51,30,21,11,6,5,24,0,24,,,,51,51,30,21,11,6,5,24,0,24,,,
06/21/2020,Anchorage,7,Psych,0,,,,,,,,,,,,,,116,86,59,27,0,0,0,0,0,0,,,
06/21/2020,Gulf Coast,4,CAH,1,130,95,21,74,2,1,1,22,0,22,,,,130,95,21,74,2,1,1,22,0,22,,,
06/21/2020,Gulf Coast,4,GACH,1,120,120,36,84,9,7,2,9,1,8,,,,120,120,36,84,9,7,2,9,1,8,,,
06/21/2020,Interior,6,GACH,1,94,81,43,38,13,9,4,16,0,16,,,,94,81,43,38,13,9,4,16,0,16,,,
06/21/2020,Matanuska-Susitna,3,GACH,1,114,104,69,35,14,9,5,39,2,37,,,,114,104,69,35,14,9,5,39,2,37,,,
06/21/2020,Northern,2,CAH,1,135,95,25,70,8,0,8,36,0,36,,,,135,95,25,70,8,0,8,36,0,36,,,
06/21/2020,Southeast,5,CAH,1,81,81,29,52,13,1,12,31,1,30,,,,81,81,29,52,13,1,12,31,1,30,,,
06/21/2020,Southeast,5,GACH,1,133,56,24,32,9,5,4,15,0,15,,,,133,56,24,32,9,5,4,15,0,15,,,
06/21/2020,Southwest,1,CAH,1,,,,,,,,,,,,,,26,12,1,11,0,0,0,2,0,2,,,
06/21/2020,Southwest,1,GACH,1,62,45,15,30,8,0,8,4,0,4,,,,62,45,15,30,8,0,8,4,0,4,,,
06/22/2020,Anchorage,7,GACH,1,931,834,519,315,159,106,53,180,25,155,,,,931,834,519,315,159,106,53,180,25,155,,,
06/22/2020,Anchorage,7,LTACH,0,51,51,29,22,11,6,5,24,0,24,,,,51,51,29,22,11,6,5,24,0,24,,,
06/22/2020,Anchorage,7,Psych,0,116,86,62,24,0,0,0,0,0,0,,,,116,86,62,24,0,0,0,0,0,0,,,
06/22/2020,Gulf Coast,4,CAH,1,130,98,21,77,4,0,4,20,0,20,,,,130,98,21,77,4,0,4,20,0,20,,,
06/22/2020,Gulf Coast,4,GACH,1,120,120,35,85,9,6,3,9,1,8,,,,120,120,35,85,9,6,3,9,1,8,,,
06/22/2020,Interior,6,GACH,1,94,81,45,36,13,7,6,16,0,16,,,,94,81,45,36,13,7,6,16,0,16,,,
06/22/2020,Matanuska-Susitna,3,GACH,1,114,104,72,32,14,5,9,24,1,23,,,,114,104,72,32,14,5,9,24,1,23,,,
06/22/2020,Northern,2,CAH,1,135,95,24,71,8,0,8,36,0,36,,,,135,95,24,71,8,0,8,36,0,36,,,
06/22/2020,Southeast,5,CAH,1,81,81,26,55,13,3,10,31,1,30,,,,81,81,26,55,13,3,10,31,1,30,,,
06/22/2020,Southeast,5,GACH,1,133,56,29,27,9,2,7,15,0,15,,,,133,56,29,27,9,2,7,15,0,15,,,
06/22/2020,Southwest,1,CAH,1,26,12,3,9,0,0,0,2,0,2,,,,26,12,3,9,0,0,0,2,0,2,,,
06/22/2020,Southwest,1,GACH,1,62,45,14,31,8,0,8,4,0,4,,,,62,45,14,31,8,0,8,4,0,4,,,
06/23/2020,Anchorage,7,GACH,1,931,834,550,284,159,110,49,182,24,158,,,,931,834,550,284,159,110,49,182,24,158,,,
06/23/2020,Anchorage,7,LTACH,0,51,51,29,22,11,6,5,24,0,24,,,,51,51,29,22,11,6,5,24,0,24,,,
06/23/2020,Anchorage,7,Psych,0,116,86,61,25,0,0,0,0,0,0,,,,116,86,61,25,0,0,0,0,0,0,,,
06/23/2020,Gulf Coast,4,CAH,1,130,97,16,81,4,1,3,20,0,20,,,,130,97,16,81,4,1,3,20,0,20,,,
06/23/2020,Gulf Coast,4,GACH,1,120,120,45,75,9,6,3,9,1,8,,,,120,120,45,75,9,6,3,9,1,8,,,
06/23/2020,Interior,6,GACH,1,94,81,58,23,13,4,9,16,0,16,,,,94,81,58,23,13,4,9,16,0,16,,,
06/23/2020,Matanuska-Susitna,3,GACH,1,192,125,70,55,14,6,8,14,2,12,,,,192,125,70,55,14,6,8,14,2,12,,,
06/23/2020,Northern,2,CAH,1,135,95,21,74,8,0,8,36,0,36,,,,135,95,21,74,8,0,8,36,0,36,,,
06/23/2020,Southeast,5,CAH,1,80,80,32,48,13,3,10,31,1,30,,,,80,80,32,48,13,3,10,31,1,30,,,
06/23/2020,Southeast,5,GACH,1,133,56,21,35,9,2,7,15,0,15,,,,133,56,21,35,9,2,7,15,0,15,,,
06/23/2020,Southwest,1,CAH,1,26,12,4,8,0,0,0,2,0,2,,,,26,12,4,8,0,0,0,2,0,2,,,
06/23/2020,Southwest,1,GACH,1,62,45,17,28,8,0,8,4,0,4,,,,62,45,17,28,8,0,8,4,0,4,,,
06/24/2020,Anchorage,7,GACH,1,931,834,541,293,159,108,51,184,25,159,,,,931,834,541,293,159,108,51,184,25,159,,,
06/24/2020,Anchorage,7,LTACH,0,51,51,32,19,11,6,5,24,0,24,,,,51,51,32,19,11,6,5,24,0,24,,,
06/24/2020,Anchorage,7,Psych,0,116,86,64,22,0,0,0,0,0,0,,,,116,86,64,22,0,0,0,0,0,0,,,
06/24/2020,Gulf Coast,4,CAH,1,130,97,18,79,4,1,3,20,0,20,,,,130,97,18,79,4,1,3,20,0,20,,,
06/24/2020,Gulf Coast,4,GACH,1,120,120,43,77,9,7,2,9,1,8,,,,120,120,43,77,9,7,2,9,1,8,,,
06/24/2020,Interior,6,GACH,1,94,81,52,29,13,7,6,16,0,16,,,,94,81,52,29,13,7,6,16,0,16,,,
06/24/2020,Matanuska-Susitna,3,GACH,1,192,125,71,54,14,8,6,11,2,9,,,,192,125,71,54,14,8,6,11,2,9,,,
06/24/2020,Northern,2,CAH,1,135,95,20,75,8,0,8,36,0,36,,,,135,95,20,75,8,0,8,36,0,36,,,
06/24/2020,Southeast,5,CAH,1,81,81,46,35,13,5,8,31,0,31,,,,81,81,46,35,13,5,8,31,0,31,,,
06/24/2020,Southeast,5,GACH,1,133,56,29,27,9,6,3,15,0,15,,,,133,56,29,27,9,6,3,15,0,15,,,
06/24/2020,Southwest,1,CAH,1,26,12,4,8,0,0,0,2,0,2,,,,26,12,4,8,0,0,0,2,0,2,,,
06/24/2020,Southwest,1,GACH,1,62,45,15,30,8,0,8,4,0,4,,,,62,45,15,30,8,0,8,4,0,4,,,
06/25/2020,Anchorage,7,GACH,1,931,834,545,289,159,104,55,183,24,159,,,,931,834,545,289,159,104,55,183,24,159,,,
06/25/2020,Anchorage,7,LTACH,0,56,45,32,13,11,5,6,24,1,23,,,,56,45,32,13,11,5,6,24,1,23,,,
06/25/2020,Anchorage,7,Psych,0,116,86,63,23,0,0,0,0,0,0,,,,116,86,63,23,0,0,0,0,0,0,,,
06/25/2020,Gulf Coast,4,CAH,1,130,97,23,74,4,1,3,20,0,20,,,,130,97,23,74,4,1,3,20,0,20,,,
06/25/2020,Gulf Coast,4,GACH,1,120,120,42,78,9,6,3,9,1,8,,,,120,120,42,78,9,6,3,9,1,8,,,
06/25/2020,Interior,6,GACH,1,94,81,54,27,13,6,7,16,0,16,,,,94,81,54,27,13,6,7,16,0,16,,,
06/25/2020,Matanuska-Susitna,3,GACH,1,114,104,66,38,14,11,3,24,2,22,,,,114,104,66,38,14,11,3,24,2,22,,,
06/25/2020,Northern,2,CAH,1,84,52,15,37,0,0,0,19,0,19,,,,135,95,17,78,8,0,8,36,0,36,,,
06/25/2020,Southeast,5,CAH,1,81,81,44,37,13,4,9,31,0,31,,,,81,81,44,37,13,4,9,31,0,31,,,
06/25/2020,Southeast,5,GACH,1,133,56,21,35,9,5,4,15,0,15,,,,133,56,21,35,9,5,4,15,0,15,,,
06/25/2020,Southwest,1,CAH,1,26,12,1,11,0,0,0,2,0,2,,,,26,12,1,11,0,0,0,2,0,2,,,
06/25/2020,Southwest,1,GACH,1,62,45,14,31,8,0,8,4,0,4,,,,62,45,14,31,8,0,8,4,0,4,,,
06/26/2020,Anchorage,7,GACH,1,931,834,544,290,159,106,53,185,24,161,,,,931,834,544,290,159,106,53,185,24,161,,,
06/26/2020,Anchorage,7,LTACH,0,51,51,34,17,11,6,5,24,2,22,,,,51,51,34,17,11,6,5,24,2,22,,,
06/26/2020,Anchorage,7,Psych,0,116,86,61,25,0,0,0,0,0,0,,,,116,86,61,25,0,0,0,0,0,0,,,
06/26/2020,Gulf Coast,4,CAH,1,130,97,25,72,4,1,3,20,0,20,,,,130,97,25,72,4,1,3,20,0,20,,,
06/26/2020,Gulf Coast,4,GACH,1,120,120,46,74,9,7,2,9,1,8,,,,120,120,46,74,9,7,2,9,1,8,,,
06/26/2020,Interior,6,GACH,1,94,81,48,33,13,4,9,16,1,15,,,,94,81,48,33,13,4,9,16,1,15,,,
06/26/2020,Matanuska-Susitna,3,GACH,1,114,104,62,42,14,10,4,24,2,22,,,,114,104,62,42,14,10,4,24,2,22,,,
06/26/2020,Northern,2,CAH,1,135,95,18,77,8,0,8,36,0,36,,,,135,95,18,77,8,0,8,36,0,36,,,
06/26/2020,Southeast,5,CAH,1,81,81,45,36,13,3,10,31,0,31,,,,81,81,45,36,13,3,10,31,0,31,,,
06/26/2020,Southeast,5,GACH,1,133,56,26,30,9,5,4,15,0,15,,,,133,56,26,30,9,5,4,15,0,15,,,
06/26/2020,Southwest,1,CAH,1,26,12,4,8,0,0,0,2,0,2,,,,26,12,4,8,0,0,0,2,0,2,,,
06/26/2020,Southwest,1,GACH,1,62,45,14,31,8,0,8,4,0,4,,,,62,45,14,31,8,0,8,4,0,4,,,
06/27/2020,Anchorage,7,GACH,1,931,834,523,311,159,98,61,181,28,153,,,,931,834,523,311,159,98,61,181,28,153,,,
06/27/2020,Anchorage,7,LTACH,0,51,51,34,17,11,6,5,24,2,22,,,,51,51,34,17,11,6,5,24,2,22,,,
06/27/2020,Anchorage,7,Psych,0,,,,,,,,,,,,,,116,86,61,25,0,0,0,0,0,0,,,
06/27/2020,Gulf Coast,4,CAH,1,130,97,24,73,3,1,2,20,0,20,,,,130,97,24,73,3,1,2,20,0,20,,,
06/27/2020,Gulf Coast,4,GACH,1,120,120,40,80,9,6,3,9,1,8,,,,120,120,40,80,9,6,3,9,1,8,,,
06/27/2020,Interior,6,GACH,1,94,81,57,24,13,8,5,16,1,15,,,,94,81,57,24,13,8,5,16,1,15,,,
06/27/2020,Matanuska-Susitna,3,GACH,1,114,104,63,41,14,10,4,24,2,22,,,,114,104,63,41,14,10,4,24,2,22,,,
06/27/2020,Northern,2,CAH,1,135,95,21,74,8,0,8,36,0,36,,,,135,95,21,74,8,0,8,36,0,36,,,
06/27/2020,Southeast,5,CAH,1,81,81,43,38,13,3,10,31,0,31,,,,81,81,43,38,13,3,10,31,0,31,,,
06/27/2020,Southeast,5,GACH,1,133,56,34,22,9,5,4,15,0,15,,,,133,56,34,22,9,5,4,15,0,15,,,
06/27/2020,Southwest,1,CAH,1,,,,,,,,,,,,,,26,12,4,8,0,0,0,2,0,2,,,
06/27/2020,Southwest,1,GACH,1,62,45,13,32,8,0,8,4,0,4,,,,62,45,13,32,8,0,8,4,0,4,,,
06/28/2020,Anchorage,7,GACH,1,931,834,515,319,159,96,63,183,25,158,,,,931,834,515,319,159,96,63,183,25,158,,,
06/28/2020,Anchorage,7,LTACH,0,51,51,34,17,11,6,5,24,2,22,,,,51,51,34,17,11,6,5,24,2,22,,,
06/28/2020,Anchorage,7,Psych,0,,,,,,,,,,,,,,116,86,61,25,0,0,0,0,0,0,,,
06/28/2020,Gulf Coast,4,CAH,1,130,95,20,75,3,2,1,22,0,22,,,,130,95,20,75,3,2,1,22,0,22,,,
06/28/2020,Gulf Coast,4,GACH,1,120,120,41,79,9,8,1,9,0,9,,,,120,120,41,79,9,8,1,9,0,9,,,
06/28/2020,Interior,6,GACH,1,94,81,54,27,13,7,6,16,1,15,,,,94,81,54,27,13,7,6,16,1,15,,,
06/28/2020,Matanuska-Susitna,3,GACH,1,114,104,68,36,14,13,1,24,0,24,,,,114,104,68,36,14,13,1,24,0,24,,,
06/28/2020,Northern,2,CAH,1,135,95,18,77,8,0,8,36,0,36,,,,135,95,18,77,8,0,8,36,0,36,,,
06/28/2020,Southeast,5,CAH,1,81,81,41,40,13,3,10,31,0,31,,,,81,81,41,40,13,3,10,31,0,31,,,
06/28/2020,Southeast,5,GACH,1,133,56,28,28,9,3,6,15,0,15,,,,133,56,28,28,9,3,6,15,0,15,,,
06/28/2020,Southwest,1,CAH,1,,,,,,,,,,,,,,26,12,4,8,0,0,0,2,0,2,,,
06/28/2020,Southwest,1,GACH,1,62,45,11,34,8,0,8,4,0,4,,,,62,45,11,34,8,0,8,4,0,4,,,
06/29/2020,Anchorage,7,GACH,1,931,834,522,312,159,100,59,185,21,164,,,,931,834,522,312,159,100,59,185,21,164,,,
06/29/2020,Anchorage,7,LTACH,0,56,45,30,15,11,6,5,24,3,21,,,,56,45,30,15,11,6,5,24,3,21,,,
06/29/2020,Anchorage,7,Psych,0,116,86,62,24,0,0,0,0,0,0,,,,116,86,62,24,0,0,0,0,0,0,,,
06/29/2020,Gulf Coast,4,CAH,1,130,98,23,75,4,1,3,20,0,20,,,,130,98,23,75,4,1,3,20,0,20,,,
06/29/2020,Gulf Coast,4,GACH,1,120,120,33,87,9,8,1,9,0,9,,,,120,120,33,87,9,8,1,9,0,9,,,
06/29/2020,Interior,6,GACH,1,94,81,36,45,13,5,8,16,1,15,,,,94,81,36,45,13,5,8,16,1,15,,,
06/29/2020,Matanuska-Susitna,3,GACH,1,114,104,67,37,14,13,1,24,0,24,,,,114,104,67,37,14,13,1,24,0,24,,,
06/29/2020,Northern,2,CAH,1,101,61,11,50,8,0,8,28,0,28,,,,135,95,17,78,8,0,8,36,0,36,,,
06/29/2020,Southeast,5,CAH,1,81,81,32,49,13,3,10,31,0,31,,,,81,81,32,49,13,3,10,31,0,31,,,
06/29/2020,Southeast,5,GACH,1,133,56,25,31,9,4,5,15,0,15,,,,133,56,25,31,9,4,5,15,0,15,,,
06/29/2020,Southwest,1,CAH,1,26,12,1,11,0,0,0,2,0,2,,,,26,12,1,11,0,0,0,2,0,2,,,
06/29/2020,Southwest,1,GACH,1,62,45,18,27,8,0,8,4,0,4,,,,62,45,18,27,8,0,8,4,0,4,,,
06/30/2020,Anchorage,7,GACH,1,931,834,530,304,159,100,59,184,20,164,,,,931,834,530,304,159,100,59,184,20,164,,,
06/30/2020,Anchorage,7,LTACH,0,51,51,30,21,11,6,5,24,3,21,,,,51,51,30,21,11,6,5,24,3,21,,,
06/30/2020,Anchorage,7,Psych,0,116,86,66,20,0,0,0,0,0,0,,,,116,86,66,20,0,0,0,0,0,0,,,
06/30/2020,Gulf Coast,4,CAH,1,130,97,24,73,4,1,3,20,0,20,,,,130,97,24,73,4,1,3,20,0,20,,,
06/30/2020,Gulf Coast,4,GACH,1,120,120,37,83,9,5,4,9,0,9,,,,120,120,37,83,9,5,4,9,0,9,,,
06/30/2020,Interior,6,GACH,1,94,81,52,29,13,4,9,16,0,16,,,,94,81,52,29,13,4,9,16,0,16,,,
06/30/2020,Matanuska-Susitna,3,GACH,1,114,104,75,29,14,7,7,24,0,24,,,,114,104,75,29,14,7,7,24,0,24,,,
06/30/2020,Northern,2,CAH,1,135,95,17,78,8,0,8,36,0,36,,,,135,95,17,78,8,0,8,36,0,36,,,
06/30/2020,Southeast,5,CAH,1,80,80,27,53,13,3,10,31,0,31,,,,80,80,27,53,13,3,10,31,0,31,,,
06/30/2020,Southeast,5,GACH,1,133,56,28,28,9,5,4,15,0,15,,,,133,56,28,28,9,5,4,15,0,15,,,
06/30/2020,Southwest,1,CAH,1,26,12,2,10,0,0,0,2,0,2,,,,26,12,2,10,0,0,0,2,0,2,,,
06/30/2020,Southwest,1,GACH,1,62,45,19,26,8,0,8,4,0,4,,,,62,45,19,26,8,0,8,4,0,4,,,
07/01/2020,Anchorage,7,GACH,1,931,834,523,311,159,103,56,185,20,165,,,,931,834,523,311,159,103,56,185,20,165,,,
07/01/2020,Anchorage,7,LTACH,0,51,51,31,20,11,6,5,24,2,22,,,,51,51,31,20,11,6,5,24,2,22,,,
07/01/2020,Anchorage,7,Psych,0,116,86,61,25,0,0,0,0,0,0,,,,116,86,61,25,0,0,0,0,0,0,,,
07/01/2020,Gulf Coast,4,CAH,1,130,97,24,73,4,1,3,20,0,20,,,,130,97,24,73,4,1,3,20,0,20,,,
07/01/2020,Gulf Coast,4,GACH,1,120,120,35,85,9,5,4,9,0,9,,,,120,120,35,85,9,5,4,9,0,9,,,
07/01/2020,Interior,6,GACH,1,94,81,56,25,13,8,5,15,0,15,,,,94,81,56,25,13,8,5,15,0,15,,,
07/01/2020,Matanuska-Susitna,3,GACH,1,114,104,65,39,14,8,6,24,0,24,,,,114,104,65,39,14,8,6,24,0,24,,,
07/01/2020,Northern,2,CAH,1,84,52,15,37,0,0,0,19,0,19,,,,135,95,18,77,8,0,8,36,0,36,,,
07/01/2020,Southeast,5,CAH,1,81,81,36,45,13,1,12,31,0,31,,,,81,81,36,45,13,1,12,31,0,31,,,
07/01/2020,Southeast,5,GACH,1,133,56,23,33,9,4,5,15,0,15,,,,133,56,23,33,9,4,5,15,0,15,,,
07/01/2020,Southwest,1,CAH,1,26,12,2,10,0,0,0,2,0,2,,,,26,12,2,10,0,0,0,2,0,2,,,
07/01/2020,Southwest,1,GACH,1,62,45,14,31,8,0,8,4,0,4,,,,62,45,14,31,8,0,8,4,0,4,,,
07/02/2020,Anchorage,7,GACH,1,931,834,541,293,159,107,52,185,21,164,,,,931,834,541,293,159,107,52,185,21,164,,,
07/02/2020,Anchorage,7,LTACH,0,51,51,31,20,11,6,5,24,3,21,,,,51,51,31,20,11,6,5,24,3,21,,,
07/02/2020,Anchorage,7,Psych,0,116,86,58,28,0,0,0,0,0,0,,,,116,86,58,28,0,0,0,0,0,0,,,
07/02/2020,Gulf Coast,4,CAH,1,130,97,17,80,4,1,3,20,0,20,,,,130,97,17,80,4,1,3,20,0,20,,,
07/02/2020,Gulf Coast,4,GACH,1,120,120,39,81,9,8,1,9,0,9,,,,120,120,39,81,9,8,1,9,0,9,,,
07/02/2020,Interior,6,GACH,1,94,81,61,20,13,6,7,16,0,16,,,,94,81,61,20,13,6,7,16,0,16,,,
07/02/2020,Matanuska-Susitna,3,GACH,1,114,104,70,34,14,7,7,24,3,21,,,,114,104,70,34,14,7,7,24,3,21,,,
07/02/2020,Northern,2,CAH,1,135,95,17,78,8,0,8,36,0,36,,,,135,95,17,78,8,0,8,36,0,36,,,
07/02/2020,Southeast,5,CAH,1,81,81,32,49,13,1,12,31,0,31,,,,81,81,32,49,13,1,12,31,0,31,,,
07/02/2020,Southeast,5,GACH,1,133,56,21,35,9,5,4,15,0,15,,,,133,56,21,35,9,5,4,15,0,15,,,
07/02/2020,Southwest,1,CAH,1,12,12,2,10,0,0,0,0,0,0,,,,12,12,2,10,0,0,0,0,0,0,,,
07/02/2020,Southwest,1,GACH,1,62,45,8,37,8,0,8,4,0,4,,,,62,45,8,37,8,0,8,4,0,4,,,
07/03/2020,Anchorage,7,GACH,1,931,834,489,345,159,104,55,185,20,165,,,,931,834,489,345,159,104,55,185,20,165,,,
07/03/2020,Anchorage,7,LTACH,0,51,51,33,18,11,6,5,24,3,21,,,,51,51,33,18,11,6,5,24,3,21,,,
07/03/2020,Anchorage,7,Psych,0,36,36,16,20,0,0,0,0,0,0,,,,116,86,60,26,0,0,0,0,0,0,,,
07/03/2020,Gulf Coast,4,CAH,1,130,95,17,78,3,1,2,22,4,18,,,,130,95,17,78,3,1,2,22,4,18,,,
07/03/2020,Gulf Coast,4,GACH,1,120,120,34,86,9,7,2,9,0,9,,,,120,120,34,86,9,7,2,9,0,9,,,
07/03/2020,Interior,6,GACH,1,94,81,51,30,13,9,4,16,0,16,,,,94,81,51,30,13,9,4,16,0,16,,,
07/03/2020,Matanuska-Susitna,3,GACH,1,114,104,68,36,14,9,5,24,4,20,,,,114,104,68,36,14,9,5,24,4,20,,,
07/03/2020,Northern,2,CAH,1,135,95,16,79,8,0,8,36,0,36,,,,135,95,16,79,8,0,8,36,0,36,,,
07/03/2020,Southeast,5,CAH,1,81,81,28,53,13,1,12,31,0,31,,,,81,81,28,53,13,1,12,31,0,31,,,
07/03/2020,Southeast,5,GACH,1,133,56,24,32,9,5,4,15,0,15,,,,133,56,24,32,9,5,4,15,0,15,,,
07/03/2020,Southwest,1,CAH,1,26,12,3,9,0,0,0,2,0,2,,,,26,12,3,9,0,0,0,2,0,2,,,
07/03/2020,Southwest,1,GACH,1,62,45,14,31,8,0,8,4,0,4,,,,62,45,14,31,8,0,8,4,0,4,,,
07/04/2020,Anchorage,7,GACH,1,931,834,497,337,159,98,61,185,19,166,,,,931,834,497,337,159,98,61,185,19,166,,,
07/04/2020,Anchorage,7,LTACH,0,51,51,31,20,11,6,5,24,3,21,,,,51,51,31,20,11,6,5,24,3,21,,,
07/04/2020,Anchorage,7,Psych,0,80,50,46,4,0,0,0,0,0,0,,,,116,86,62,24,0,0,0,0,0,0,,,
07/04/2020,Gulf Coast,4,CAH,1,118,95,17,78,3,1,2,22,0,22,,,,118,95,17,78,3,1,2,22,0,22,,,
07/04/2020,Gulf Coast,4,GACH,1,120,120,30,90,9,3,6,9,2,7,,,,120,120,30,90,9,3,6,9,2,7,,,
07/04/2020,Interior,6,GACH,1,94,81,43,38,13,5,8,16,0,16,,,,94,81,43,38,13,5,8,16,0,16,,,
07/04/2020,Matanuska-Susitna,3,GACH,1,114,104,65,39,14,10,4,24,4,20,,,,114,104,65,39,14,10,4,24,4,20,,,
07/04/2020,Northern,2,CAH,1,135,95,10,85,8,0,8,36,0,36,,,,135,95,10,85,8,0,8,36,0,36,,,
07/04/2020,Southeast,5,CAH,1,81,81,28,53,13,1,12,31,0,31,,,,81,81,28,53,13,1,12,31,0,31,,,
07/04/2020,Southeast,5,GACH,1,133,56,21,35,9,6,3,15,0,15,,,,133,56,21,35,9,6,3,15,0,15,,,
07/04/2020,Southwest,1,CAH,1,,,,,,,,,,,,,,26,12,3,9,0,0,0,2,0,2,,,
07/04/2020,Southwest,1,GACH,1,62,45,19,26,8,0,8,4,0,4,,,,62,45,19,26,8,0,8,4,0,4,,,
07/05/2020,Anchorage,7,GACH,1,931,834,537,297,159,96,63,186,16,170,,,,931,834,537,297,159,96,63,186,16,170,,,
07/05/2020,Anchorage,7,LTACH,0,51,51,31,20,11,6,5,24,3,21,,,,51,51,31,20,11,6,5,24,3,21,,,
07/05/2020,Anchorage,7,Psych,0,,,,,,,,,,,,,,116,86,62,24,0,0,0,0,0,0,,,
07/05/2020,Gulf Coast,4,CAH,1,130,96,20,76,3,1,2,22,0,22,,,,130,96,20,76,3,1,2,22,0,22,,,
07/05/2020,Gulf Coast,4,GACH,1,120,120,33,87,9,6,3,9,2,7,,,,120,120,33,87,9,6,3,9,2,7,,,
07/05/2020,Interior,6,GACH,1,94,81,41,40,13,2,11,16,0,16,,,,94,81,41,40,13,2,11,16,0,16,,,
07/05/2020,Matanuska-Susitna,3,GACH,1,,,,,,,,,,,,,,114,104,65,39,14,10,4,24,4,20,,,
07/05/2020,Northern,2,CAH,1,135,95,13,82,8,0,8,36,0,36,,,,135,95,13,82,8,0,8,36,0,36,,,
07/05/2020,Southeast,5,CAH,1,81,81,25,56,13,2,11,31,0,31,,,,81,81,25,56,13,2,11,31,0,31,,,
07/05/2020,Southeast,5,GACH,1,133,56,18,38,9,2,7,15,0,15,,,,133,56,18,38,9,2,7,15,0,15,,,
07/05/2020,Southwest,1,CAH,1,,,,,,,,,,,,,,26,12,3,9,0,0,0,2,0,2,,,
07/05/2020,Southwest,1,GACH,1,62,45,15,30,8,0,8,4,0,4,,,,62,45,15,30,8,0,8,4,0,4,,,
07/06/2020,Anchorage,7,GACH,1,931,834,504,330,159,90,69,188,14,174,,,,931,834,504,330,159,90,69,188,14,174,,,
07/06/2020,Anchorage,7,LTACH,0,51,51,31,20,11,6,5,24,3,21,,,,51,51,31,20,11,6,5,24,3,21,,,
07/06/2020,Anchorage,7,Psych,0,116,86,58,28,0,0,0,0,0,0,,,,116,86,58,28,0,0,0,0,0,0,,,
07/06/2020,Gulf Coast,4,CAH,1,118,97,18,79,4,0,4,20,0,20,,,,118,97,18,79,4,0,4,20,0,20,,,
07/06/2020,Gulf Coast,4,GACH,1,120,120,36,84,9,4,5,9,2,7,,,,120,120,36,84,9,4,5,9,2,7,,,
07/06/2020,Interior,6,GACH,1,94,81,33,48,13,3,10,16,0,16,,,,94,81,33,48,13,3,10,16,0,16,,,
07/06/2020,Matanuska-Susitna,3,GACH,1,114,104,71,33,14,9,5,24,4,20,,,,114,104,71,33,14,9,5,24,4,20,,,
07/06/2020,Northern,2,CAH,1,135,95,16,79,8,0,8,36,0,36,,,,135,95,16,79,8,0,8,36,0,36,,,
07/06/2020,Southeast,5,CAH,1,81,81,26,55,13,0,13,31,0,31,,,,81,81,26,55,13,0,13,31,0,31,,,
07/06/2020,Southeast,5,GACH,1,133,56,25,31,9,4,5,15,0,15,,,,133,56,25,31,9,4,5,15,0,15,,,
07/06/2020,Southwest,1,CAH,1,26,12,4,8,0,0,0,2,0,2,,,,26,12,4,8,0,0,0,2,0,2,,,
07/06/2020,Southwest,1,GACH,1,62,45,10,35,8,0,8,4,0,4,,,,62,45,10,35,8,0,8,4,0,4,,,
07/07/2020,Anchorage,7,GACH,1,931,834,512,322,159,95,64,185,16,169,,,,931,834,512,322,159,95,64,185,16,169,,,
07/07/2020,Anchorage,7,LTACH,0,51,51,33,18,11,7,4,24,3,21,,,,51,51,33,18,11,7,4,24,3,21,,,
07/07/2020,Anchorage,7,Psych,0,116,86,58,28,0,0,0,0,0,0,,,,116,86,58,28,0,0,0,0,0,0,,,
07/07/2020,Gulf Coast,4,CAH,1,130,95,19,76,4,1,3,22,0,22,,,,130,95,19,76,4,1,3,22,0,22,,,
07/07/2020,Gulf Coast,4,GACH,1,120,120,39,81,9,4,5,9,0,9,,,,120,120,39,81,9,4,5,9,0,9,,,
07/07/2020,Interior,6,GACH,1,94,81,46,35,13,2,11,16,0,16,,,,94,81,46,35,13,2,11,16,0,16,,,
07/07/2020,Matanuska-Susitna,3,GACH,1,114,104,80,24,14,8,6,24,3,21,,,,114,104,80,24,14,8,6,24,3,21,,,
07/07/2020,Northern,2,CAH,1,135,95,13,82,8,0,8,36,0,36,,,,135,95,13,82,8,0,8,36,0,36,,,
07/07/2020,Southeast,5,CAH,1,80,80,25,55,13,0,13,31,0,31,,,,80,80,25,55,13,0,13,31,0,31,,,
07/07/2020,Southeast,5,GACH,1,133,56,28,28,9,4,5,15,0,15,,,,133,56,28,28,9,4,5,15,0,15,,,
07/07/2020,Southwest,1,CAH,1,26,12,5,7,0,0,0,2,0,2,,,,26,12,5,7,0,0,0,2,0,2,,,
07/07/2020,Southwest,1,GACH,1,62,45,10,35,8,0,8,4,0,4,,,,62,45,10,35,8,0,8,4,0,4,,,
07/08/2020,Anchorage,7,GACH,1,1005,834,537,297,102,50,52,157,13,144,,,,1005,834,537,297,102,50,52,157,13,144,,,
07/08/2020,Anchorage,7,LTACH,0,51,51,32,19,11,7,4,24,3,21,,,,51,51,32,19,11,7,4,24,3,21,,,
07/08/2020,Anchorage,7,Psych,0,116,86,69,17,0,0,0,0,0,0,,,,116,86,69,17,0,0,0,0,0,0,,,
07/08/2020,Gulf Coast,4,CAH,1,130,95,18,77,4,1,3,22,0,22,,,,130,95,18,77,4,1,3,22,0,22,,,
07/08/2020,Gulf Coast,4,GACH,1,120,120,37,83,9,5,4,9,0,9,,,,120,120,37,83,9,5,4,9,0,9,,,
07/08/2020,Interior,6,GACH,1,94,81,49,32,13,6,7,16,0,16,,,,94,81,49,32,13,6,7,16,0,16,,,
07/08/2020,Matanuska-Susitna,3,GACH,1,114,104,72,32,14,11,3,24,3,21,,,,114,104,72,32,14,11,3,24,3,21,,,
07/08/2020,Northern,2,CAH,1,135,95,16,79,8,0,8,36,0,36,,,,135,95,16,79,8,0,8,36,0,36,,,
07/08/2020,Southeast,5,CAH,1,81,81,30,51,13,2,11,31,0,31,,,,81,81,30,51,13,2,11,31,0,31,,,
07/08/2020,Southeast,5,GACH,1,133,56,36,20,9,5,4,15,0,15,,,,133,56,36,20,9,5,4,15,0,15,,,
07/08/2020,Southwest,1,CAH,1,26,12,4,8,0,0,0,2,0,2,,,,26,12,4,8,0,0,0,2,0,2,,,
07/08/2020,Southwest,1,GACH,1,62,45,14,31,8,0,8,4,0,4,,,,62,45,14,31,8,0,8,4,0,4,,,
07/09/2020,Anchorage,7,GACH,1,1005,834,528,306,102,49,53,157,16,141,,,,1005,834,528,306,102,49,53,157,16,141,,,
07/09/2020,Anchorage,7,LTACH,0,51,51,30,21,11,6,5,24,3,21,,,,51,51,30,21,11,6,5,24,3,21,,,
07/09/2020,Anchorage,7,Psych,0,,,,,,,,,,,,,,116,86,69,17,0,0,0,0,0,0,,,
07/09/2020,Gulf Coast,4,CAH,1,130,96,23,73,4,0,4,22,0,22,,,,130,96,23,73,4,0,4,22,0,22,,,
07/09/2020,Gulf Coast,4,GACH,1,120,120,34,86,9,4,5,9,0,9,,,,120,120,34,86,9,4,5,9,0,9,,,
07/09/2020,Interior,6,GACH,1,94,81,44,37,13,5,8,16,0,16,,,,94,81,44,37,13,5,8,16,0,16,,,
07/09/2020,Matanuska-Susitna,3,GACH,1,114,104,62,42,14,7,7,24,2,22,,,,114,104,62,42,14,7,7,24,2,22,,,
07/09/2020,Northern,2,CAH,1,135,95,14,81,8,0,8,36,0,36,,,,135,95,14,81,8,0,8,36,0,36,,,
07/09/2020,Southeast,5,CAH,1,81,81,31,50,13,1,12,31,0,31,,,,81,81,31,50,13,1,12,31,0,31,,,
07/09/2020,Southeast,5,GACH,1,133,56,33,23,9,5,4,15,0,15,,,,133,56,33,23,9,5,4,15,0,15,,,
07/09/2020,Southwest,1,CAH,1,26,12,4,8,0,0,0,2,0,2,,,,26,12,4,8,0,0,0,2,0,2,,,
07/09/2020,Southwest,1,GACH,1,62,45,16,29,8,0,8,4,0,4,,,,62,45,16,29,8,0,8,4,0,4,,,
07/10/2020,Anchorage,7,GACH,1,1005,834,520,314,102,55,47,155,18,137,,,,1005,834,520,314,102,55,47,155,18,137,,,
07/10/2020,Anchorage,7,LTACH,0,51,51,30,21,11,6,5,24,3,21,,,,51,51,30,21,11,6,5,24,3,21,,,
07/10/2020,Anchorage,7,Psych,0,80,50,48,2,0,0,0,0,0,0,,,,116,86,70,16,0,0,0,0,0,0,,,
07/10/2020,Gulf Coast,4,CAH,1,130,97,21,76,4,0,4,22,0,22,,,,130,97,21,76,4,0,4,22,0,22,,,
07/10/2020,Gulf Coast,4,GACH,1,120,120,38,82,9,5,4,9,0,9,,,,120,120,38,82,9,5,4,9,0,9,,,
07/10/2020,Interior,6,GACH,1,94,81,53,28,13,5,8,16,1,15,,,,94,81,53,28,13,5,8,16,1,15,,,
07/10/2020,Matanuska-Susitna,3,GACH,1,114,104,66,38,14,12,2,24,2,22,,,,114,104,66,38,14,12,2,24,2,22,,,
07/10/2020,Northern,2,CAH,1,101,61,8,53,8,0,8,28,0,28,,,,135,95,16,79,8,0,8,36,0,36,,,
07/10/2020,Southeast,5,CAH,1,81,81,28,53,13,0,13,31,0,31,,,,81,81,28,53,13,0,13,31,0,31,,,
07/10/2020,Southeast,5,GACH,1,133,56,34,22,9,5,4,15,0,15,,,,133,56,34,22,9,5,4,15,0,15,,,
07/10/2020,Southwest,1,CAH,1,26,12,1,11,0,0,0,2,0,2,,,,26,12,1,11,0,0,0,2,0,2,,,
07/10/2020,Southwest,1,GACH,1,62,45,13,32,8,0,8,4,0,4,,,,62,45,13,32,8,0,8,4,0,4,,,
07/11/2020,Anchorage,7,GACH,1,791,661,392,269,80,37,43,105,8,97,,,,1005,834,521,313,102,53,49,155,18,137,,,
07/11/2020,Anchorage,7,LTACH,0,51,51,30,21,11,6,5,24,3,21,,,,51,51,30,21,11,6,5,24,3,21,,,
07/11/2020,Anchorage,7,Psych,0,,,,,,,,,,,,,,116,86,70,16,0,0,0,0,0,0,,,
07/11/2020,Gulf Coast,4,CAH,1,140,95,17,78,4,0,4,21,0,21,,,,140,95,17,78,4,0,4,21,0,21,,,
07/11/2020,Gulf Coast,4,GACH,1,120,120,35,85,9,5,4,9,0,9,,,,120,120,35,85,9,5,4,9,0,9,,,
07/11/2020,Interior,6,GACH,1,94,81,65,16,13,10,3,16,1,15,,,,94,81,65,16,13,10,3,16,1,15,,,
07/11/2020,Matanuska-Susitna,3,GACH,1,114,104,73,31,14,11,3,24,3,21,,,,114,104,73,31,14,11,3,24,3,21,,,
07/11/2020,Northern,2,CAH,1,135,95,18,77,8,0,8,36,0,36,,,,135,95,18,77,8,0,8,36,0,36,,,
07/11/2020,Southeast,5,CAH,1,81,81,28,53,13,0,13,31,0,31,,,,81,81,28,53,13,0,13,31,0,31,,,
07/11/2020,Southeast,5,GACH,1,133,56,32,24,9,4,5,15,0,15,,,,133,56,32,24,9,4,5,15,0,15,,,
07/11/2020,Southwest,1,CAH,1,,,,,,,,,,,,,,26,12,1,11,0,0,0,2,0,2,,,
07/11/2020,Southwest,1,GACH,1,62,45,12,33,8,0,8,4,0,4,,,,62,45,12,33,8,0,8,4,0,4,,,
07/12/2020,Anchorage,7,GACH,1,791,661,371,290,80,42,38,105,7,98,,,,1005,834,500,334,102,58,44,155,17,138,,,
07/12/2020,Anchorage,7,LTACH,0,51,51,30,21,11,6,5,24,3,21,,,,51,51,30,21,11,6,5,24,3,21,,,
07/12/2020,Anchorage,7,Psych,0,,,,,,,,,,,,,,116,86,70,16,0,0,0,0,0,0,,,
07/12/2020,Gulf Coast,4,CAH,1,140,97,14,83,4,0,4,19,0,19,,,,140,97,14,83,4,0,4,19,0,19,,,
07/12/2020,Gulf Coast,4,GACH,1,120,120,35,85,9,5,4,9,1,8,,,,120,120,35,85,9,5,4,9,1,8,,,
07/12/2020,Interior,6,GACH,1,94,81,60,21,13,4,9,16,1,15,,,,94,81,60,21,13,4,9,16,1,15,,,
07/12/2020,Matanuska-Susitna,3,GACH,1,114,104,63,41,14,8,6,24,2,22,,,,114,104,63,41,14,8,6,24,2,22,,,
07/12/2020,Northern,2,CAH,1,135,95,19,76,8,0,8,36,0,36,,,,135,95,19,76,8,0,8,36,0,36,,,
07/12/2020,Southeast,5,CAH,1,81,81,26,55,13,0,13,31,0,31,,,,81,81,26,55,13,0,13,31,0,31,,,
07/12/2020,Southeast,5,GACH,1,133,56,35,21,9,4,5,15,0,15,,,,133,56,35,21,9,4,5,15,0,15,,,
07/12/2020,Southwest,1,CAH,1,,,,,,,,,,,,,,26,12,1,11,0,0,0,2,0,2,,,
07/12/2020,Southwest,1,GACH,1,62,45,17,28,8,0,8,4,0,4,,,,62,45,17,28,8,0,8,4,0,4,,,
07/13/2020,Anchorage,7,GACH,1,791,661,359,302,80,46,34,105,7,98,,,,1005,834,488,346,102,62,40,155,17,138,,,
07/13/2020,Anchorage,7,LTACH,0,51,51,29,22,11,6,5,24,2,22,,,,51,51,29,22,11,6,5,24,2,22,,,
07/13/2020,Anchorage,7,Psych,0,116,86,62,24,0,0,0,0,0,0,,,,116,86,62,24,0,0,0,0,0,0,,,
07/13/2020,Gulf Coast,4,CAH,1,130,96,19,77,4,0,4,22,0,22,,,,130,96,19,77,4,0,4,22,0,22,,,
07/13/2020,Gulf Coast,4,GACH,1,120,120,33,87,9,4,5,9,1,8,,,,120,120,33,87,9,4,5,9,1,8,,,
07/13/2020,Interior,6,GACH,1,94,81,55,26,13,4,9,16,1,15,,,,94,81,55,26,13,4,9,16,1,15,,,
07/13/2020,Matanuska-Susitna,3,GACH,1,114,104,60,44,14,8,6,24,0,24,,,,114,104,60,44,14,8,6,24,0,24,,,
07/13/2020,Northern,2,CAH,1,135,95,14,81,8,0,8,36,0,36,,,,135,95,14,81,8,0,8,36,0,36,,,
07/13/2020,Southeast,5,CAH,1,80,80,21,59,13,2,11,31,0,31,,,,80,80,21,59,13,2,11,31,0,31,,,
07/13/2020,Southeast,5,GACH,1,133,56,33,23,9,5,4,15,0,15,,,,133,56,33,23,9,5,4,15,0,15,,,
07/13/2020,Southwest,1,CAH,1,26,12,2,10,0,0,0,2,0,2,,,,26,12,2,10,0,0,0,2,0,2,,,
07/13/2020,Southwest,1,GACH,1,62,45,20,25,8,0,8,4,0,4,,,,62,45,20,25,8,0,8,4,0,4,,,
07/14/2020,Anchorage,7,GACH,1,791,661,364,297,80,46,34,105,9,96,,,,1005,834,493,341,102,62,40,155,19,136,,,
07/14/2020,Anchorage,7,LTACH,0,51,51,28,23,11,6,5,24,2,22,,,,51,51,28,23,11,6,5,24,2,22,,,
07/14/2020,Anchorage,7,Psych,0,,,,,,,,,,,,,,116,86,62,24,0,0,0,0,0,0,,,
07/14/2020,Gulf Coast,4,CAH,1,130,96,24,72,4,0,4,22,0,22,,,,130,96,24,72,4,0,4,22,0,22,,,
07/14/2020,Gulf Coast,4,GACH,1,120,120,40,80,9,5,4,9,1,8,,,,120,120,40,80,9,5,4,9,1,8,,,
07/14/2020,Interior,6,GACH,1,94,81,60,21,13,9,4,16,1,15,,,,94,81,60,21,13,9,4,16,1,15,,,
07/14/2020,Matanuska-Susitna,3,GACH,1,114,104,75,29,14,5,9,24,1,23,,,,114,104,75,29,14,5,9,24,1,23,,,
07/14/2020,Northern,2,CAH,1,135,95,16,79,8,0,8,36,0,36,,,,135,95,16,79,8,0,8,36,0,36,,,
07/14/2020,Southeast,5,CAH,1,80,80,22,58,13,1,12,31,0,31,,,,80,80,22,58,13,1,12,31,0,31,,,
07/14/2020,Southeast,5,GACH,1,133,56,37,19,9,5,4,15,1,14,,,,133,56,37,19,9,5,4,15,1,14,,,
07/14/2020,Southwest,1,CAH,1,26,12,2,10,0,0,0,2,0,2,,,,26,12,2,10,0,0,0,2,0,2,,,
07/14/2020,Southwest,1,GACH,1,62,45,13,32,8,0,8,4,0,4,,,,62,45,13,32,8,0,8,4,0,4,,,
07/15/2020,Anchorage,7,GACH,1,995,824,550,274,111,62,49,163,27,136,,,,995,824,550,274,111,62,49,163,27,136,,,
07/15/2020,Anchorage,7,LTACH,0,51,51,30,21,11,6,5,24,3,21,,,,51,51,30,21,11,6,5,24,3,21,,,
07/15/2020,Anchorage,7,Psych,0,,,,,,,,,,,,,,116,86,62,24,0,0,0,0,0,0,,,
07/15/2020,Gulf Coast,4,CAH,1,128,95,21,74,4,0,4,21,0,21,,,,128,95,21,74,4,0,4,21,0,21,,,
07/15/2020,Gulf Coast,4,GACH,1,146,52,40,12,9,6,3,9,1,8,,,,146,52,40,12,9,6,3,9,1,8,,,
07/15/2020,Interior,6,GACH,1,94,81,63,18,13,8,5,16,1,15,,,,94,81,63,18,13,8,5,16,1,15,,,
07/15/2020,Matanuska-Susitna,3,GACH,1,,,,,14,,,,,,,,,114,104,75,29,14,5,9,24,1,23,,,
07/15/2020,Northern,2,CAH,1,103,95,15,80,8,0,8,36,0,36,,,,103,95,15,80,8,0,8,36,0,36,,,
07/15/2020,Southeast,5,CAH,1,80,80,26,54,13,1,12,31,0,31,,,,80,80,26,54,13,1,12,31,0,31,,,
07/15/2020,Southeast,5,GACH,1,133,133,31,102,9,6,3,15,0,15,,,,133,133,31,102,9,6,3,15,0,15,,,
07/15/2020,Southwest,1,CAH,1,22,22,2,20,0,0,0,,0,,,,,22,22,2,20,0,0,0,2,0,2,,,
07/15/2020,Southwest,1,GACH,1,62,45,17,28,8,0,8,4,0,4,,,,62,45,17,28,8,0,8,4,0,4,,,
07/16/2020,Anchorage,7,GACH,1,995,651,562,234,89,61,46,169,62,107,,,,995,824,562,265,111,61,50,169,62,107,,,
07/16/2020,Anchorage,7,LTACH,0,51,51,29,22,11,6,5,24,1,23,,,,51,51,29,22,11,6,5,24,1,23,,,
07/16/2020,Anchorage,7,Psych,0,,,,,,,,,,,,,,116,86,62,24,0,0,0,0,0,0,,,
07/16/2020,Gulf Coast,4,CAH,1,128,95,24,71,4,0,4,21,0,21,,,,128,95,24,71,4,0,4,21,0,21,,,
07/16/2020,Gulf Coast,4,GACH,1,120,120,36,84,9,5,4,9,1,8,,,,120,120,36,84,9,5,4,9,1,8,,,
07/16/2020,Interior,6,GACH,1,94,81,60,21,13,9,4,16,1,15,,,,94,81,60,21,13,9,4,16,1,15,,,
07/16/2020,Matanuska-Susitna,3,GACH,1,192,125,69,56,14,7,7,11,2,9,,,,192,125,69,56,14,7,7,11,2,9,,,
07/16/2020,Northern,2,CAH,1,103,95,55,40,8,8,0,36,0,36,,,,103,95,55,40,8,8,0,36,0,36,,,
07/16/2020,Southeast,5,CAH,1,80,80,32,48,13,1,12,31,0,31,,,,80,80,32,48,13,1,12,31,0,31,,,
07/16/2020,Southeast,5,GACH,1,133,133,37,96,9,8,1,15,0,15,,,,133,133,37,96,9,8,1,15,0,15,,,
07/16/2020,Southwest,1,CAH,1,22,22,2,20,0,0,0,,0,,,,,22,22,2,20,0,0,0,2,0,2,,,
07/16/2020,Southwest,1,GACH,1,62,45,16,29,8,0,8,4,0,4,,,,62,45,16,29,8,0,8,4,0,4,,,
07/17/2020,Anchorage,7,GACH,1,995,651,566,232,89,58,50,169,62,107,,,,995,824,566,263,111,58,54,169,62,107,,,
07/17/2020,Anchorage,7,LTACH,0,51,51,29,22,11,6,5,24,1,23,,,,51,51,29,22,11,6,5,24,1,23,,,
07/17/2020,Anchorage,7,Psych,0,,,,,,,,,,,,,,116,86,62,24,0,0,0,0,0,0,,,
07/17/2020,Gulf Coast,4,CAH,1,132,93,16,77,4,0,4,21,0,21,,,,132,93,16,77,4,0,4,21,0,21,,,
07/17/2020,Gulf Coast,4,GACH,1,120,120,41,79,9,6,3,9,1,8,,,,120,120,41,79,9,6,3,9,1,8,,,
07/17/2020,Interior,6,GACH,1,94,81,49,32,13,7,6,16,2,14,,,,94,81,49,32,13,7,6,16,2,14,,,
07/17/2020,Matanuska-Susitna,3,GACH,1,192,125,75,50,14,12,2,11,2,9,,,,192,125,75,50,14,12,2,11,2,9,,,
07/17/2020,Northern,2,CAH,1,103,95,14,81,8,0,8,36,0,36,,,,103,95,14,81,8,0,8,36,0,36,,,
07/17/2020,Southeast,5,CAH,1,80,80,32,48,13,1,12,31,0,31,,,,80,80,32,48,13,1,12,31,0,31,,,
07/17/2020,Southeast,5,GACH,1,133,133,40,93,9,5,4,15,0,15,,,,133,133,40,93,9,5,4,15,0,15,,,
07/17/2020,Southwest,1,CAH,1,22,22,2,20,0,0,0,,0,,,,,22,22,2,20,0,0,0,2,0,2,,,
07/17/2020,Southwest,1,GACH,1,62,45,14,31,8,0,8,4,0,4,,,,62,45,14,31,8,0,8,4,0,4,,,
07/18/2020,Anchorage,7,GACH,1,464,250,262,141,24,29,15,117,16,101,,,,995,824,572,263,111,57,56,169,29,140,,,
07/18/2020,Anchorage,7,LTACH,0,,,,,,,,,,,,,,51,51,29,22,11,6,5,24,1,23,,,
07/18/2020,Anchorage,7,Psych,0,,,,,,,,,,,,,,116,86,62,24,0,0,0,0,0,0,,,
07/18/2020,Gulf Coast,4,CAH,1,73,49,8,41,2,0,2,8,0,8,,,,132,92,15,77,4,0,4,21,0,21,,,
07/18/2020,Gulf Coast,4,GACH,1,120,120,34,86,9,5,4,9,0,9,,,,120,120,34,86,9,5,4,9,0,9,,,
07/18/2020,Interior,6,GACH,1,94,81,50,31,13,7,6,16,2,14,,,,94,81,50,31,13,7,6,16,2,14,,,
07/18/2020,Matanuska-Susitna,3,GACH,1,192,125,56,69,14,11,3,11,2,9,,,,192,125,56,69,14,11,3,11,2,9,,,
07/18/2020,Northern,2,CAH,1,103,95,15,80,8,0,8,36,0,36,,,,103,95,15,80,8,0,8,36,0,36,,,
07/18/2020,Southeast,5,CAH,1,80,80,32,48,13,2,11,31,0,31,,,,80,80,32,48,13,2,11,31,0,31,,,
07/18/2020,Southeast,5,GACH,1,133,133,36,97,9,4,5,15,0,15,,,,133,133,36,97,9,4,5,15,0,15,,,
07/18/2020,Southwest,1,CAH,1,16,12,3,9,0,0,0,2,0,2,,,,16,12,3,9,0,0,0,2,0,2,,,
07/18/2020,Southwest,1,GACH,1,62,45,14,31,8,0,8,4,0,4,,,,62,45,14,31,8,0,8,4,0,4,,,
07/19/2020,Anchorage,7,GACH,1,995,651,580,221,137,107,50,169,21,148,,,,995,824,580,252,159,107,54,169,21,148,,,
07/19/2020,Anchorage,7,LTACH,0,51,51,29,22,11,6,5,24,1,23,,,,51,51,29,22,11,6,5,24,1,23,,,
07/19/2020,Anchorage,7,Psych,0,,,,,,,,,,,,,,116,86,62,24,0,0,0,0,0,0,,,
07/19/2020,Gulf Coast,4,CAH,1,128,92,19,73,4,0,4,21,0,21,,,,128,92,19,73,4,0,4,21,0,21,,,
07/19/2020,Gulf Coast,4,GACH,1,120,120,29,91,9,4,5,9,0,9,,,,120,120,29,91,9,4,5,9,0,9,,,
07/19/2020,Interior,6,GACH,1,94,81,41,40,13,4,9,16,1,15,,,,94,81,41,40,13,4,9,16,1,15,,,
07/19/2020,Matanuska-Susitna,3,GACH,1,192,125,55,70,14,5,9,11,1,10,,,,192,125,55,70,14,5,9,11,1,10,,,
07/19/2020,Northern,2,CAH,1,103,95,14,81,8,0,8,36,0,36,,,,103,95,14,81,8,0,8,36,0,36,,,
07/19/2020,Southeast,5,CAH,1,80,80,31,49,13,2,11,31,0,31,,,,80,80,31,49,13,2,11,31,0,31,,,
07/19/2020,Southeast,5,GACH,1,133,133,34,99,9,3,6,15,0,15,,,,133,133,34,99,9,3,6,15,0,15,,,
07/19/2020,Southwest,1,CAH,1,16,12,2,10,0,0,0,2,0,2,,,,16,12,2,10,0,0,0,2,0,2,,,
07/19/2020,Southwest,1,GACH,1,62,45,12,33,8,0,8,4,0,4,,,,62,45,12,33,8,0,8,4,0,4,,,
07/20/2020,Anchorage,7,GACH,1,995,651,608,192,137,98,57,171,22,149,,,,995,824,608,223,159,98,61,171,22,149,,,
07/20/2020,Anchorage,7,LTACH,0,51,51,30,21,11,6,5,24,3,21,,,,51,51,30,21,11,6,5,24,3,21,,,
07/20/2020,Anchorage,7,Psych,0,116,86,63,23,0,0,0,0,0,0,,,,116,86,63,23,0,0,0,0,0,0,,,
07/20/2020,Gulf Coast,4,CAH,1,128,92,26,66,6,2,4,21,0,21,,,,128,92,26,66,6,2,4,21,0,21,,,
07/20/2020,Gulf Coast,4,GACH,1,120,120,24,96,9,3,6,9,0,9,,,,120,120,24,96,9,3,6,9,0,9,,,
07/20/2020,Interior,6,GACH,1,94,81,42,39,13,7,6,16,1,15,,,,94,81,42,39,13,7,6,16,1,15,,,
07/20/2020,Matanuska-Susitna,3,GACH,1,192,125,55,70,14,5,9,11,1,10,,,,192,125,55,70,14,5,9,11,1,10,,,
07/20/2020,Northern,2,CAH,1,103,95,19,76,8,0,8,36,0,36,,,,103,95,19,76,8,0,8,36,0,36,,,
07/20/2020,Southeast,5,CAH,1,80,80,24,56,13,1,12,31,0,31,,,,80,80,24,56,13,1,12,31,0,31,,,
07/20/2020,Southeast,5,GACH,1,133,133,33,100,9,5,4,15,0,15,,,,133,133,33,100,9,5,4,15,0,15,,,
07/20/2020,Southwest,1,CAH,1,22,22,1,21,0,0,0,,0,,,,,22,22,1,21,0,0,0,2,0,2,,,
07/20/2020,Southwest,1,GACH,1,62,45,12,33,8,0,8,4,0,4,,,,62,45,12,33,8,0,8,4,0,4,,,
07/21/2020,Anchorage,7,GACH,1,995,651,605,195,137,99,56,171,19,152,,,,995,824,605,226,159,99,60,171,19,152,,,
07/21/2020,Anchorage,7,LTACH,0,51,51,30,21,11,6,5,24,1,23,,,,51,51,30,21,11,6,5,24,1,23,,,
07/21/2020,Anchorage,7,Psych,0,,,,,,,,,,,,,,116,86,63,23,0,0,0,0,0,0,,,
07/21/2020,Gulf Coast,4,CAH,1,128,92,21,71,4,1,3,21,0,21,,,,128,92,21,71,4,1,3,21,0,21,,,
07/21/2020,Gulf Coast,4,GACH,1,120,120,28,92,9,4,5,9,0,9,,,,120,120,28,92,9,4,5,9,0,9,,,
07/21/2020,Interior,6,GACH,1,94,81,54,27,13,12,1,16,2,14,,,,94,81,54,27,13,12,1,16,2,14,,,
07/21/2020,Matanuska-Susitna,3,GACH,1,192,125,65,60,14,8,6,11,3,8,,,,192,125,65,60,14,8,6,11,3,8,,,
07/21/2020,Northern,2,CAH,1,103,95,16,79,8,0,8,36,0,36,,,,103,95,16,79,8,0,8,36,0,36,,,
07/21/2020,Southeast,5,CAH,1,80,80,24,56,13,1,12,31,0,31,,,,80,80,24,56,13,1,12,31,0,31,,,
07/21/2020,Southeast,5,GACH,1,133,133,33,100,9,4,5,15,0,15,,,,133,133,33,100,9,4,5,15,0,15,,,
07/21/2020,Southwest,1,CAH,1,22,22,1,21,0,0,0,,0,,,,,22,22,1,21,0,0,0,2,0,2,,,
07/21/2020,Southwest,1,GACH,1,62,45,16,29,8,0,8,4,0,4,,,,62,45,16,29,8,0,8,4,0,4,,,
07/22/2020,Anchorage,7,GACH,1,995,651,627,181,137,58,97,171,22,149,,,,995,824,627,212,159,58,101,171,22,149,,,
07/22/2020,Anchorage,7,LTACH,0,51,51,30,21,11,5,6,24,0,24,,,,51,51,30,21,11,5,6,24,0,24,,,
07/22/2020,Anchorage,7,Psych,0,,,,,,,,,,,,,,116,86,63,23,0,0,0,0,0,0,,,
07/22/2020,Gulf Coast,4,CAH,1,128,92,26,66,4,0,4,21,0,21,,,,128,92,26,66,4,0,4,21,0,21,,,
07/22/2020,Gulf Coast,4,GACH,1,120,120,29,91,9,4,5,9,0,9,,,,120,120,29,91,9,4,5,9,0,9,,,
07/22/2020,Interior,6,GACH,1,94,81,57,24,13,5,8,16,2,14,,,,94,81,57,24,13,5,8,16,2,14,,,
07/22/2020,Matanuska-Susitna,3,GACH,1,192,125,70,55,14,9,5,11,3,8,,,,192,125,70,55,14,9,5,11,3,8,,,
07/22/2020,Northern,2,CAH,1,103,95,17,78,8,0,8,36,0,36,,,,103,95,17,78,8,0,8,36,0,36,,,
07/22/2020,Southeast,5,CAH,1,80,80,21,59,13,1,12,31,0,31,,,,80,80,21,59,13,1,12,31,0,31,,,
07/22/2020,Southeast,5,GACH,1,133,133,34,99,9,3,6,15,0,15,,,,133,133,34,99,9,3,6,15,0,15,,,
07/22/2020,Southwest,1,CAH,1,22,22,2,20,0,0,0,2,0,2,,,,22,22,2,20,0,0,0,2,0,2,,,
07/22/2020,Southwest,1,GACH,1,62,45,18,27,8,0,8,4,0,4,,,,62,45,18,27,8,0,8,4,0,4,,,
07/23/2020,Anchorage,7,GACH,1,1005,661,635,183,137,64,91,171,21,150,18,2,20,1005,834,635,214,159,64,95,171,21,150,18,2,20
07/23/2020,Anchorage,7,LTACH,0,51,51,30,21,11,6,5,24,1,23,0,0,0,51,51,30,21,11,6,5,24,1,23,0,0,0
07/23/2020,Anchorage,7,Psych,0,,,,,,,,,,,,,,116,86,63,23,0,0,0,0,0,0,,,
07/23/2020,Gulf Coast,4,CAH,1,128,94,21,73,4,0,4,19,0,19,1,0,1,128,94,21,73,4,0,4,19,0,19,1,0,1
07/23/2020,Gulf Coast,4,GACH,1,120,120,29,91,9,1,8,9,0,9,0,0,0,120,120,29,91,9,1,8,9,0,9,0,0,0
07/23/2020,Interior,6,GACH,1,94,81,54,27,13,10,3,16,1,15,4,0,4,94,81,54,27,13,10,3,16,1,15,4,0,4
07/23/2020,Matanuska-Susitna,3,GACH,1,192,125,76,49,14,10,4,11,4,7,2,0,2,192,125,76,49,14,10,4,11,4,7,2,0,2
07/23/2020,Northern,2,CAH,1,103,95,17,78,8,0,8,36,0,36,0,0,0,103,95,17,78,8,0,8,36,0,36,0,0,0
07/23/2020,Southeast,5,CAH,1,80,80,19,61,13,0,13,31,0,31,0,0,0,80,80,19,61,13,0,13,31,0,31,0,0,0
07/23/2020,Southeast,5,GACH,1,133,133,31,102,9,4,5,15,0,15,1,0,1,133,133,31,102,9,4,5,15,0,15,1,0,1
07/23/2020,Southwest,1,CAH,1,22,22,2,20,0,0,0,2,0,2,0,0,0,22,22,2,20,0,0,0,2,0,2,0,0,0
07/23/2020,Southwest,1,GACH,1,62,45,15,30,8,0,8,4,0,4,0,0,0,62,45,15,30,8,0,8,4,0,4,0,0,0
07/24/2020,Anchorage,7,GACH,1,1005,661,621,192,137,62,90,171,25,146,21,1,22,1005,834,621,223,159,62,94,171,25,146,21,1,22
07/24/2020,Anchorage,7,LTACH,0,51,51,30,21,11,6,5,24,0,24,0,0,0,51,51,30,21,11,6,5,24,0,24,0,0,0
07/24/2020,Anchorage,7,Psych,0,,,,,,,,,,,,,,116,86,63,23,0,0,0,0,0,0,,,
07/24/2020,Gulf Coast,4,CAH,1,119,83,20,63,4,0,4,13,0,13,0,0,0,128,92,21,71,4,0,4,17,0,17,0,0,0
07/24/2020,Gulf Coast,4,GACH,1,120,120,38,82,9,1,8,9,0,9,0,0,0,120,120,38,82,9,1,8,9,0,9,0,0,0
07/24/2020,Interior,6,GACH,1,94,81,45,36,13,8,5,16,1,15,3,0,3,94,81,45,36,13,8,5,16,1,15,3,0,3
07/24/2020,Matanuska-Susitna,3,GACH,1,192,125,70,55,14,10,4,11,5,6,1,0,1,192,125,70,55,14,10,4,11,5,6,1,0,1
07/24/2020,Northern,2,CAH,1,103,95,18,77,8,0,8,36,0,36,0,0,0,103,95,18,77,8,0,8,36,0,36,0,0,0
07/24/2020,Southeast,5,CAH,1,80,80,25,55,13,1,12,31,0,31,0,0,0,80,80,25,55,13,1,12,31,0,31,0,0,0
07/24/2020,Southeast,5,GACH,1,133,133,34,99,9,3,6,15,0,15,1,0,1,133,133,34,99,9,3,6,15,0,15,1,0,1
07/24/2020,Southwest,1,CAH,1,22,22,1,21,0,0,0,2,0,2,0,0,0,22,22,1,21,0,0,0,2,0,2,0,0,0
07/24/2020,Southwest,1,GACH,1,62,45,12,33,8,0,8,4,0,4,0,0,0,62,45,12,33,8,0,8,4,0,4,0,0,0
07/25/2020,Anchorage,7,GACH,1,1005,834,565,269,159,99,60,171,26,145,21,1,22,1005,834,565,269,159,99,60,171,26,145,21,1,22
07/25/2020,Anchorage,7,LTACH,0,51,51,30,21,11,6,5,24,0,24,0,0,0,51,51,30,21,11,6,5,24,0,24,0,0,0
07/25/2020,Anchorage,7,Psych,0,,,,,,,,,,,,,,116,86,63,23,0,0,0,0,0,0,,,
07/25/2020,Gulf Coast,4,CAH,1,117,83,19,66,4,0,4,15,0,15,0,0,0,128,94,19,75,4,0,4,15,0,15,0,0,0
07/25/2020,Gulf Coast,4,GACH,1,120,120,33,87,9,6,3,9,0,9,0,0,0,120,120,33,87,9,6,3,9,0,9,0,0,0
07/25/2020,Interior,6,GACH,1,94,81,58,23,13,8,5,16,1,15,5,0,5,94,81,58,23,13,8,5,16,1,15,5,0,5
07/25/2020,Matanuska-Susitna,3,GACH,1,192,125,65,60,14,6,8,11,1,10,1,0,1,192,125,65,60,14,6,8,11,1,10,1,0,1
07/25/2020,Northern,2,CAH,1,103,95,23,72,8,0,8,36,17,19,2,0,2,103,95,23,72,8,0,8,36,17,19,2,0,2
07/25/2020,Southeast,5,CAH,1,80,80,24,56,13,1,12,31,0,31,2,0,2,80,80,24,56,13,1,12,31,0,31,2,0,2
07/25/2020,Southeast,5,GACH,1,133,133,28,105,9,3,6,15,0,15,1,0,1,133,133,28,105,9,3,6,15,0,15,1,0,1
07/25/2020,Southwest,1,CAH,1,16,12,1,11,0,0,0,2,0,2,0,0,0,16,12,1,11,0,0,0,2,0,2,0,0,0
07/25/2020,Southwest,1,GACH,1,62,45,16,29,8,0,8,4,0,4,0,0,0,62,45,16,29,8,0,8,4,0,4,0,0,0
07/26/2020,Anchorage,7,GACH,1,1005,834,544,290,159,98,61,202,28,174,20,2,22,1005,834,544,290,159,98,61,202,28,174,20,2,22
07/26/2020,Anchorage,7,LTACH,0,51,51,33,18,11,7,4,24,1,23,0,0,0,51,51,33,18,11,7,4,24,1,23,0,0,0
07/26/2020,Anchorage,7,Psych,0,,,,,,,,,,,,,,116,86,63,23,0,0,0,0,0,0,,,
07/26/2020,Gulf Coast,4,CAH,1,128,93,21,72,4,0,4,18,0,18,0,0,0,128,93,21,72,4,0,4,18,0,18,0,0,0
07/26/2020,Gulf Coast,4,GACH,1,120,120,37,83,9,4,5,9,0,9,0,0,0,120,120,37,83,9,4,5,9,0,9,0,0,0
07/26/2020,Interior,6,GACH,1,94,81,43,38,13,9,4,16,1,15,4,0,4,94,81,43,38,13,9,4,16,1,15,4,0,4
07/26/2020,Matanuska-Susitna,3,GACH,1,192,125,65,60,14,10,4,11,5,6,1,0,1,192,125,65,60,14,10,4,11,5,6,1,0,1
07/26/2020,Northern,2,CAH,1,103,95,23,72,8,0,8,36,0,36,2,0,2,103,95,23,72,8,0,8,36,0,36,2,0,2
07/26/2020,Southeast,5,CAH,1,80,80,26,54,13,1,12,31,0,31,2,0,2,80,80,26,54,13,1,12,31,0,31,2,0,2
07/26/2020,Southeast,5,GACH,1,133,133,28,105,9,5,4,15,0,15,1,0,1,133,133,28,105,9,5,4,15,0,15,1,0,1
07/26/2020,Southwest,1,CAH,1,16,12,1,11,0,0,0,2,0,2,0,0,0,16,12,1,11,0,0,0,2,0,2,0,0,0
07/26/2020,Southwest,1,GACH,1,62,45,16,29,8,0,8,4,0,4,0,0,0,62,45,16,29,8,0,8,4,0,4,0,0,0
07/27/2020,Anchorage,7,GACH,1,1005,433,561,189,46,51,18,202,28,174,23,5,28,1005,834,561,307,159,51,64,202,28,174,23,5,28
07/27/2020,Anchorage,7,LTACH,0,51,51,33,18,11,7,4,24,1,23,0,0,0,51,51,33,18,11,7,4,24,1,23,0,0,0
07/27/2020,Anchorage,7,Psych,0,116,86,65,21,0,0,0,0,0,0,0,0,0,116,86,65,21,0,0,0,0,0,0,0,0,0
07/27/2020,Gulf Coast,4,CAH,1,96,62,22,48,2,0,2,12,0,12,0,0,0,116,94,22,74,4,0,4,12,0,12,0,0,0
07/27/2020,Gulf Coast,4,GACH,1,120,120,36,84,9,5,4,9,0,9,0,0,0,120,120,36,84,9,5,4,9,0,9,0,0,0
07/27/2020,Interior,6,GACH,1,94,81,46,35,13,7,6,16,1,15,4,0,4,94,81,46,35,13,7,6,16,1,15,4,0,4
07/27/2020,Matanuska-Susitna,3,GACH,1,192,125,63,62,14,12,2,11,4,7,2,0,2,192,125,63,62,14,12,2,11,4,7,2,0,2
07/27/2020,Northern,2,CAH,1,103,61,19,49,8,0,8,34,0,34,2,0,2,103,95,19,75,8,0,8,34,0,34,2,0,2
07/27/2020,Southeast,5,CAH,1,80,80,23,57,13,2,11,31,0,31,2,0,2,80,80,23,57,13,2,11,31,0,31,2,0,2
07/27/2020,Southeast,5,GACH,1,133,133,25,108,9,5,4,15,0,15,1,0,1,133,133,25,108,9,5,4,15,0,15,1,0,1
07/27/2020,Southwest,1,CAH,1,22,22,0,22,0,0,0,0,0,0,0,0,0,22,22,0,22,0,0,0,0,0,0,0,0,0
07/27/2020,Southwest,1,GACH,1,62,45,16,29,8,0,8,4,0,4,0,0,0,62,45,16,29,8,0,8,4,0,4,0,0,0
07/28/2020,Anchorage,7,GACH,1,1005,433,612,167,46,64,13,202,26,176,20,1,21,1005,834,612,285,159,64,59,202,26,176,20,1,21
07/28/2020,Anchorage,7,LTACH,0,51,51,33,18,11,6,5,24,1,23,0,0,0,51,51,33,18,11,6,5,24,1,23,0,0,0
07/28/2020,Anchorage,7,Psych,0,,,,,,,,,,,,,,116,86,65,21,0,0,0,0,0,0,0,0,0
07/28/2020,Gulf Coast,4,CAH,1,96,51,27,35,2,1,1,16,0,16,0,0,0,116,94,27,70,4,1,3,16,0,16,0,0,0
07/28/2020,Gulf Coast,4,GACH,1,120,120,37,83,9,7,2,9,0,9,1,0,1,120,120,37,83,9,7,2,9,0,9,1,0,1
07/28/2020,Interior,6,GACH,1,94,81,51,30,13,4,9,16,0,16,4,0,4,94,81,51,30,13,4,9,16,0,16,4,0,4
07/28/2020,Matanuska-Susitna,3,GACH,1,192,125,79,46,14,10,4,11,4,7,1,0,1,192,125,79,46,14,10,4,11,4,7,1,0,1
07/28/2020,Northern,2,CAH,1,103,95,21,74,8,0,8,36,0,36,2,0,2,103,95,21,74,8,0,8,36,0,36,2,0,2
07/28/2020,Southeast,5,CAH,1,80,80,30,50,13,4,9,31,0,31,2,0,2,80,80,30,50,13,4,9,31,0,31,2,0,2
07/28/2020,Southeast,5,GACH,1,133,133,25,108,9,3,6,15,0,15,1,0,1,133,133,25,108,9,3,6,15,0,15,1,0,1
07/28/2020,Southwest,1,CAH,1,16,12,2,10,0,0,0,2,0,2,0,0,0,16,12,2,10,0,0,0,2,0,2,0,0,0
07/28/2020,Southwest,1,GACH,1,62,45,19,26,8,0,8,4,0,4,0,0,0,62,45,19,26,8,0,8,4,0,4,0,0,0
07/29/2020,Anchorage,7,GACH,1,1005,433,651,154,46,67,15,202,25,177,22,0,22,1005,834,651,272,159,67,61,202,25,177,22,0,22
07/29/2020,Anchorage,7,LTACH,0,51,51,34,17,11,7,4,24,1,23,0,0,0,51,51,34,17,11,7,4,24,1,23,0,0,0
07/29/2020,Anchorage,7,Psych,0,,,,,,,,,,,,,,116,86,65,21,0,0,0,0,0,0,0,0,0
07/29/2020,Gulf Coast,4,CAH,1,128,52,24,38,2,2,1,20,0,20,0,0,0,128,95,24,73,4,2,3,20,0,20,0,0,0
07/29/2020,Gulf Coast,4,GACH,1,120,120,41,79,9,5,4,9,0,9,2,0,2,120,120,41,79,9,5,4,9,0,9,2,0,2
07/29/2020,Interior,6,GACH,1,94,81,63,18,13,6,7,16,0,16,4,0,4,94,81,63,18,13,6,7,16,0,16,4,0,4
07/29/2020,Matanuska-Susitna,3,GACH,1,192,125,67,58,14,11,3,11,3,8,0,0,0,192,125,67,58,14,11,3,11,3,8,0,0,0
07/29/2020,Northern,2,CAH,1,103,95,27,68,8,0,8,36,0,36,2,0,2,103,95,27,68,8,0,8,36,0,36,2,0,2
07/29/2020,Southeast,5,CAH,1,78,70,32,38,13,1,12,31,0,31,3,0,3,78,70,32,38,13,1,12,31,0,31,3,0,3
07/29/2020,Southeast,5,GACH,1,133,133,31,102,9,4,5,15,0,15,1,0,1,133,133,31,102,9,4,5,15,0,15,1,0,1
07/29/2020,Southwest,1,CAH,1,22,22,2,20,0,0,0,2,0,2,0,0,0,22,22,2,20,0,0,0,2,0,2,0,0,0
07/29/2020,Southwest,1,GACH,1,62,45,20,25,8,0,8,4,0,4,0,0,0,62,45,20,25,8,0,8,4,0,4,0,0,0
07/30/2020,Anchorage,7,GACH,1,1005,433,627,166,46,64,16,202,29,173,17,0,17,1005,834,627,284,159,64,62,202,29,173,17,0,17
07/30/2020,Anchorage,7,LTACH,0,51,51,34,17,11,7,4,24,1,23,0,0,0,51,51,34,17,11,7,4,24,1,23,0,0,0
07/30/2020,Anchorage,7,Psych,0,,,,,,,,,,,,,,116,86,65,21,0,0,0,0,0,0,0,0,0
07/30/2020,Gulf Coast,4,CAH,1,128,61,21,47,2,0,2,20,0,20,1,0,1,128,95,21,75,4,0,4,20,0,20,1,0,1
07/30/2020,Gulf Coast,4,GACH,1,120,120,38,82,9,3,6,9,0,9,0,0,0,120,120,38,82,9,3,6,9,0,9,0,0,0
07/30/2020,Interior,6,GACH,1,94,81,62,19,13,6,7,16,0,16,2,0,2,94,81,62,19,13,6,7,16,0,16,2,0,2
07/30/2020,Matanuska-Susitna,3,GACH,1,192,125,65,60,14,10,4,11,3,8,0,0,0,192,125,65,60,14,10,4,11,3,8,0,0,0
07/30/2020,Northern,2,CAH,1,103,95,22,73,8,0,8,36,0,36,2,0,2,103,95,22,73,8,0,8,36,0,36,2,0,2
07/30/2020,Southeast,5,CAH,1,70,70,33,37,7,1,6,31,1,30,3,0,3,70,70,33,37,7,1,6,31,1,30,3,0,3
07/30/2020,Southeast,5,GACH,1,133,133,26,107,9,3,6,15,0,15,0,0,0,133,133,26,107,9,3,6,15,0,15,0,0,0
07/30/2020,Southwest,1,CAH,1,22,22,2,20,0,0,0,2,0,2,0,0,0,22,22,2,20,0,0,0,2,0,2,0,0,0
07/30/2020,Southwest,1,GACH,1,62,45,19,26,8,0,8,4,0,4,0,0,0,62,45,19,26,8,0,8,4,0,4,0,0,0
07/31/2020,Anchorage,7,GACH,1,1005,433,602,180,46,61,19,171,28,143,18,0,18,1005,834,602,298,159,61,65,171,28,143,18,0,18
07/31/2020,Anchorage,7,LTACH,0,51,51,34,17,11,7,4,4,1,3,0,0,0,51,51,34,17,11,7,4,4,1,3,0,0,0
07/31/2020,Anchorage,7,Psych,0,,,,,,,,,,,,,,116,86,65,21,0,0,0,0,0,0,0,0,0
07/31/2020,Gulf Coast,4,CAH,1,128,61,24,47,2,0,2,16,0,16,0,0,0,128,95,24,75,4,0,4,16,0,16,0,0,0
07/31/2020,Gulf Coast,4,GACH,1,120,120,38,82,9,3,6,9,0,9,0,0,0,120,120,38,82,9,3,6,9,0,9,0,0,0
07/31/2020,Interior,6,GACH,1,94,81,63,18,13,8,5,15,0,15,1,0,1,94,81,63,18,13,8,5,15,0,15,1,0,1
07/31/2020,Matanuska-Susitna,3,GACH,1,192,125,67,58,14,14,0,11,4,7,0,0,0,192,125,67,58,14,14,0,11,4,7,0,0,0
07/31/2020,Northern,2,CAH,1,103,95,19,76,8,0,8,36,8,28,0,0,0,103,95,19,76,8,0,8,36,8,28,0,0,0
07/31/2020,Southeast,5,CAH,1,70,70,28,42,7,3,4,31,0,31,3,0,3,70,70,28,42,7,3,4,31,0,31,3,0,3
07/31/2020,Southeast,5,GACH,1,133,133,27,106,9,0,9,15,0,15,0,0,0,133,133,27,106,9,0,9,15,0,15,0,0,0
07/31/2020,Southwest,1,CAH,1,22,22,3,19,0,0,0,2,0,2,0,0,0,22,22,3,19,0,0,0,2,0,2,0,0,0
07/31/2020,Southwest,1,GACH,1,62,45,18,27,8,0,8,4,0,4,0,0,0,62,45,18,27,8,0,8,4,0,4,0,0,0
08/01/2020,Anchorage,7,GACH,1,1005,433,593,177,159,103,56,171,24,147,22,0,22,1005,834,593,295,159,103,56,171,24,147,22,0,22
08/01/2020,Anchorage,7,LTACH,0,51,51,34,17,11,7,4,24,1,23,0,0,0,51,51,34,17,11,7,4,24,1,23,0,0,0
08/01/2020,Anchorage,7,Psych,0,,,,,,,,,,,,,,116,86,65,21,0,0,0,0,0,0,0,0,0
08/01/2020,Gulf Coast,4,CAH,1,124,69,25,53,2,0,2,22,0,22,0,0,0,124,92,25,72,4,0,4,22,0,22,0,0,0
08/01/2020,Gulf Coast,4,GACH,1,120,120,37,83,9,2,7,9,0,9,0,0,0,120,120,37,83,9,2,7,9,0,9,0,0,0
08/01/2020,Interior,6,GACH,1,94,81,58,23,13,8,5,16,2,14,1,0,1,94,81,58,23,13,8,5,16,2,14,1,0,1
08/01/2020,Matanuska-Susitna,3,GACH,1,192,125,57,68,14,11,3,11,2,9,0,0,0,192,125,57,68,14,11,3,11,2,9,0,0,0
08/01/2020,Northern,2,CAH,1,103,95,13,82,8,0,8,36,0,36,2,0,2,103,95,13,82,8,0,8,36,0,36,2,0,2
08/01/2020,Southeast,5,CAH,1,70,70,32,38,7,3,4,31,0,31,2,0,2,70,70,32,38,7,3,4,31,0,31,2,0,2
08/01/2020,Southeast,5,GACH,1,133,133,30,103,9,2,7,15,0,15,0,0,0,133,133,30,103,9,2,7,15,0,15,0,0,0
08/01/2020,Southwest,1,CAH,1,16,12,3,9,0,0,0,2,0,2,0,0,0,16,12,3,9,0,0,0,2,0,2,0,0,0
08/01/2020,Southwest,1,GACH,1,62,45,18,27,8,0,8,4,0,4,0,0,0,62,45,18,27,8,0,8,4,0,4,0,0,0
08/02/2020,Anchorage,7,GACH,1,1005,433,535,191,159,95,64,202,24,178,17,0,17,1005,834,535,309,159,95,64,202,24,178,17,0,17
08/02/2020,Anchorage,7,LTACH,0,51,51,34,17,11,7,4,24,1,23,0,0,0,51,51,34,17,11,7,4,24,1,23,0,0,0
08/02/2020,Anchorage,7,Psych,0,,,,,,,,,,,,,,116,86,65,21,0,0,0,0,0,0,0,0,0
08/02/2020,Gulf Coast,4,CAH,1,124,71,18,58,2,0,2,12,0,12,0,0,0,124,94,18,77,4,0,4,12,0,12,0,0,0
08/02/2020,Gulf Coast,4,GACH,1,120,120,34,86,9,2,7,9,0,9,0,0,0,120,120,34,86,9,2,7,9,0,9,0,0,0
08/02/2020,Interior,6,GACH,1,94,81,44,37,13,8,5,16,1,15,1,0,1,94,81,44,37,13,8,5,16,1,15,1,0,1
08/02/2020,Matanuska-Susitna,3,GACH,1,192,125,54,71,14,10,4,11,2,9,1,0,1,192,125,54,71,14,10,4,11,2,9,1,0,1
08/02/2020,Northern,2,CAH,1,103,95,14,81,8,0,8,36,0,36,2,0,2,103,95,14,81,8,0,8,36,0,36,2,0,2
08/02/2020,Southeast,5,CAH,1,70,70,33,37,7,4,3,31,1,30,3,0,3,70,70,33,37,7,4,3,31,1,30,3,0,3
08/02/2020,Southeast,5,GACH,1,133,133,27,106,9,2,7,15,0,15,0,0,0,133,133,27,106,9,2,7,15,0,15,0,0,0
08/02/2020,Southwest,1,CAH,1,16,12,2,10,0,0,0,2,0,2,0,0,0,16,12,2,10,0,0,0,2,0,2,0,0,0
08/02/2020,Southwest,1,GACH,1,62,45,20,25,8,0,8,4,0,4,0,0,0,62,45,20,25,8,0,8,4,0,4,0,0,0
08/03/2020,Anchorage,7,GACH,1,1005,433,568,196,159,40,119,202,30,172,18,1,19,1005,834,568,314,159,40,119,202,30,172,18,1,19
08/03/2020,Anchorage,7,LTACH,0,51,51,33,18,11,7,4,24,2,22,0,0,0,51,51,33,18,11,7,4,24,2,22,0,0,0
08/03/2020,Anchorage,7,Psych,0,116,86,58,28,0,0,0,0,0,0,0,0,0,116,86,58,28,0,0,0,0,0,0,0,0,0
08/03/2020,Gulf Coast,4,CAH,1,136,52,24,44,2,0,2,16,0,16,0,0,0,136,95,24,79,4,0,4,16,0,16,0,0,0
08/03/2020,Gulf Coast,4,GACH,1,120,120,33,87,9,5,4,9,0,9,0,0,0,120,120,33,87,9,5,4,9,0,9,0,0,0
08/03/2020,Interior,6,GACH,1,94,81,45,36,13,6,7,16,1,15,1,0,1,94,81,45,36,13,6,7,16,1,15,1,0,1
08/03/2020,Matanuska-Susitna,3,GACH,1,192,125,55,70,14,11,3,11,1,10,1,0,1,192,125,55,70,14,11,3,11,1,10,1,0,1
08/03/2020,Northern,2,CAH,1,103,95,14,81,8,0,8,36,0,36,2,0,2,103,95,14,81,8,0,8,36,0,36,2,0,2
08/03/2020,Southeast,5,CAH,1,70,70,26,44,7,3,4,31,0,31,3,0,3,70,70,26,44,7,3,4,31,0,31,3,0,3
08/03/2020,Southeast,5,GACH,1,133,133,25,108,9,1,8,15,0,15,0,0,0,133,133,25,108,9,1,8,15,0,15,0,0,0
08/03/2020,Southwest,1,CAH,1,22,22,4,18,0,0,0,2,0,2,0,0,0,22,22,4,18,0,0,0,2,0,2,0,0,0
08/03/2020,Southwest,1,GACH,1,62,45,20,25,8,0,8,4,0,4,0,0,0,62,45,20,25,8,0,8,4,0,4,0,0,0
08/04/2020,Anchorage,7,GACH,1,1005,433,528,184,159,93,66,201,28,173,18,0,18,1005,834,528,302,159,93,66,201,28,173,18,0,18
08/04/2020,Anchorage,7,LTACH,0,51,51,32,19,11,7,4,24,2,22,0,0,0,51,51,32,19,11,7,4,24,2,22,0,0,0
08/04/2020,Anchorage,7,Psych,0,,,,,,,,,,,,,,116,86,58,28,0,0,0,0,0,0,0,0,0
08/04/2020,Gulf Coast,4,CAH,1,136,51,23,41,2,0,2,12,0,12,0,0,0,136,94,23,76,4,0,4,12,0,12,0,0,0
08/04/2020,Gulf Coast,4,GACH,1,120,120,34,86,9,4,5,9,0,9,1,0,1,120,120,34,86,9,4,5,9,0,9,1,0,1
08/04/2020,Interior,6,GACH,1,94,81,50,31,13,10,3,16,0,16,3,0,3,94,81,50,31,13,10,3,16,0,16,3,0,3
08/04/2020,Matanuska-Susitna,3,GACH,1,192,125,67,58,14,7,7,11,1,10,1,0,1,192,125,67,58,14,7,7,11,1,10,1,0,1
08/04/2020,Northern,2,CAH,1,103,95,14,81,8,0,8,37,0,37,2,0,2,103,95,14,81,8,0,8,37,0,37,2,0,2
08/04/2020,Southeast,5,CAH,1,70,70,32,38,7,6,1,31,0,31,3,0,3,70,70,32,38,7,6,1,31,0,31,3,0,3
08/04/2020,Southeast,5,GACH,1,133,133,28,105,9,3,6,15,0,15,0,0,0,133,133,28,105,9,3,6,15,0,15,0,0,0
08/04/2020,Southwest,1,CAH,1,22,22,1,21,0,0,0,2,0,2,0,0,0,22,22,1,21,0,0,0,2,0,2,0,0,0
08/04/2020,Southwest,1,GACH,1,62,45,16,29,8,0,8,4,0,4,0,0,0,62,45,16,29,8,0,8,4,0,4,0,0,0
08/05/2020,Anchorage,7,GACH,1,1005,433,606,177,159,94,65,202,28,174,21,1,22,1005,834,606,295,159,94,65,202,28,174,21,1,22
08/05/2020,Anchorage,7,LTACH,0,51,,30,,11,5,6,24,1,23,0,0,0,51,51,30,19,11,5,6,24,1,23,0,0,0
08/05/2020,Anchorage,7,Psych,0,,,,,,,,,,,,,,116,86,58,28,0,0,0,0,0,0,0,0,0
08/05/2020,Gulf Coast,4,CAH,1,101,51,21,43,2,0,2,12,0,12,0,0,0,136,94,21,78,4,0,4,12,0,12,0,0,0
08/05/2020,Gulf Coast,4,GACH,1,120,120,32,88,9,3,6,9,0,9,0,0,0,120,120,32,88,9,3,6,9,0,9,0,0,0
08/05/2020,Interior,6,GACH,1,94,81,61,20,13,6,7,16,0,16,4,0,4,94,81,61,20,13,6,7,16,0,16,4,0,4
08/05/2020,Matanuska-Susitna,3,GACH,1,192,125,69,56,14,10,4,11,2,9,1,0,1,192,125,69,56,14,10,4,11,2,9,1,0,1
08/05/2020,Northern,2,CAH,1,103,95,17,78,8,0,8,37,0,37,3,0,3,103,95,17,78,8,0,8,37,0,37,3,0,3
08/05/2020,Southeast,5,CAH,1,70,70,41,29,7,4,3,31,0,31,2,0,2,70,70,41,29,7,4,3,31,0,31,2,0,2
08/05/2020,Southeast,5,GACH,1,133,133,32,101,9,7,2,15,0,15,0,0,0,133,133,32,101,9,7,2,15,0,15,0,0,0
08/05/2020,Southwest,1,CAH,1,22,22,1,21,0,0,0,2,0,2,0,0,0,22,22,1,21,0,0,0,2,0,2,0,0,0
08/05/2020,Southwest,1,GACH,1,62,45,11,34,8,0,8,4,0,4,0,0,0,62,45,11,34,8,0,8,4,0,4,0,0,0
08/06/2020,Anchorage,7,GACH,1,1005,433,624,169,159,95,64,202,29,173,19,1,20,1005,834,624,287,159,95,64,202,29,173,19,1,20
08/06/2020,Anchorage,7,LTACH,0,51,,30,,11,5,6,24,2,22,0,0,0,51,51,30,19,11,5,6,24,2,22,0,0,0
08/06/2020,Anchorage,7,Psych,0,,,,,,,,,,,,,,116,86,58,28,0,0,0,0,0,0,0,0,0
08/06/2020,Gulf Coast,4,CAH,1,124,51,17,45,2,0,2,20,0,20,0,0,0,124,94,17,80,4,0,4,20,0,20,0,0,0
08/06/2020,Gulf Coast,4,GACH,1,120,120,29,91,9,4,5,9,0,9,0,0,0,120,120,29,91,9,4,5,9,0,9,0,0,0
08/06/2020,Interior,6,GACH,1,94,81,63,18,13,10,3,16,0,16,4,0,4,94,81,63,18,13,10,3,16,0,16,4,0,4
08/06/2020,Matanuska-Susitna,3,GACH,1,192,125,60,65,14,9,5,11,2,9,1,0,1,192,125,60,65,14,9,5,11,2,9,1,0,1
08/06/2020,Northern,2,CAH,1,103,95,20,75,8,0,8,37,0,37,3,0,3,103,95,20,75,8,0,8,37,0,37,3,0,3
08/06/2020,Southeast,5,CAH,1,70,70,40,30,7,4,3,31,0,31,2,0,2,70,70,40,30,7,4,3,31,0,31,2,0,2
08/06/2020,Southeast,5,GACH,1,133,133,33,100,9,4,5,15,0,15,0,0,0,133,133,33,100,9,4,5,15,0,15,0,0,0
08/06/2020,Southwest,1,CAH,1,22,22,1,21,0,0,0,2,0,2,0,0,0,22,22,1,21,0,0,0,2,0,2,0,0,0
08/06/2020,Southwest,1,GACH,1,62,45,12,33,8,0,8,4,0,4,0,0,0,62,45,12,33,8,0,8,4,0,4,0,0,0
08/07/2020,Anchorage,7,GACH,1,1005,433,629,167,158,91,67,202,28,174,20,1,21,1005,834,629,285,158,91,67,202,28,174,20,1,21
08/07/2020,Anchorage,7,LTACH,0,51,,30,,11,6,5,24,2,22,0,0,0,51,51,30,19,11,6,5,24,2,22,0,0,0
08/07/2020,Anchorage,7,Psych,0,,,,,,,,,,,,,,116,86,58,28,0,0,0,0,0,0,0,0,0
08/07/2020,Gulf Coast,4,CAH,1,118,51,19,46,2,0,2,19,0,19,0,0,0,118,94,19,81,4,0,4,19,0,19,0,0,0
08/07/2020,Gulf Coast,4,GACH,1,120,120,30,90,9,3,6,9,0,9,1,0,1,120,120,30,90,9,3,6,9,0,9,1,0,1
08/07/2020,Interior,6,GACH,1,94,81,58,23,13,5,8,16,0,16,2,0,2,94,81,58,23,13,5,8,16,0,16,2,0,2
08/07/2020,Matanuska-Susitna,3,GACH,1,192,125,66,59,14,10,4,11,2,9,1,0,1,192,125,66,59,14,10,4,11,2,9,1,0,1
08/07/2020,Northern,2,CAH,1,135,95,21,74,8,0,8,37,0,37,3,0,3,135,95,21,74,8,0,8,37,0,37,3,0,3
08/07/2020,Southeast,5,CAH,1,70,70,43,27,7,2,5,31,0,31,0,0,0,70,70,43,27,7,2,5,31,0,31,0,0,0
08/07/2020,Southeast,5,GACH,1,133,133,28,105,9,5,4,15,15,0,1,0,1,133,133,28,105,9,5,4,15,15,0,1,0,1
08/07/2020,Southwest,1,CAH,1,22,22,0,22,0,0,0,2,0,2,0,0,0,22,22,0,22,0,0,0,2,0,2,0,0,0
08/07/2020,Southwest,1,GACH,1,62,45,10,35,8,0,8,4,0,4,0,0,0,62,45,10,35,8,0,8,4,0,4,0,0,0
08/08/2020,Anchorage,7,GACH,1,1005,834,588,246,92,55,37,170,21,149,21,0,21,1005,834,588,246,92,55,37,170,21,149,21,0,21
08/08/2020,Anchorage,7,LTACH,0,56,45,30,15,11,6,5,24,2,22,0,0,0,56,45,30,15,11,6,5,24,2,22,0,0,0
08/08/2020,Anchorage,7,Psych,0,,,,,,,,,,,,,,116,86,58,28,0,0,0,0,0,0,0,0,0
08/08/2020,Gulf Coast,4,CAH,1,140,94,21,73,4,0,4,19,0,19,0,0,0,140,94,21,73,4,0,4,19,0,19,0,0,0
08/08/2020,Gulf Coast,4,GACH,1,120,120,30,90,9,3,6,9,0,9,1,0,1,120,120,30,90,9,3,6,9,0,9,1,0,1
08/08/2020,Interior,6,GACH,1,94,81,63,18,13,6,7,16,0,16,2,0,2,94,81,63,18,13,6,7,16,0,16,2,0,2
08/08/2020,Matanuska-Susitna,3,GACH,1,192,125,70,55,14,8,6,11,1,10,0,0,0,192,125,70,55,14,8,6,11,1,10,0,0,0
08/08/2020,Northern,2,CAH,1,103,95,25,70,8,0,8,37,0,37,3,0,3,103,95,25,70,8,0,8,37,0,37,3,0,3
08/08/2020,Southeast,5,CAH,1,70,70,40,30,7,2,5,31,0,31,0,0,0,70,70,40,30,7,2,5,31,0,31,0,0,0
08/08/2020,Southeast,5,GACH,1,133,133,12,121,9,6,3,15,0,15,1,0,1,133,133,12,121,9,6,3,15,0,15,1,0,1
08/08/2020,Southwest,1,CAH,1,16,12,1,11,0,0,0,2,0,2,0,0,0,16,12,1,11,0,0,0,2,0,2,0,0,0
08/08/2020,Southwest,1,GACH,1,62,45,10,35,8,0,8,4,0,4,0,0,0,62,45,10,35,8,0,8,4,0,4,0,0,0
08/09/2020,Anchorage,7,GACH,1,1005,834,558,276,92,51,41,168,19,149,16,0,16,1005,834,558,276,92,51,41,168,19,149,16,0,16
08/09/2020,Anchorage,7,LTACH,0,56,45,30,15,11,6,5,24,2,22,0,0,0,56,45,30,15,11,6,5,24,2,22,0,0,0
08/09/2020,Anchorage,7,Psych,0,,,,,,,,,,,,,,116,86,58,28,0,0,0,0,0,0,0,0,0
08/09/2020,Gulf Coast,4,CAH,1,140,94,14,80,4,0,4,19,0,19,0,0,0,140,94,14,80,4,0,4,19,0,19,0,0,0
08/09/2020,Gulf Coast,4,GACH,1,120,120,30,90,9,3,6,9,0,9,1,0,1,120,120,30,90,9,3,6,9,0,9,1,0,1
08/09/2020,Interior,6,GACH,1,94,81,53,28,13,5,8,16,0,16,2,0,2,94,81,53,28,13,5,8,16,0,16,2,0,2
08/09/2020,Matanuska-Susitna,3,GACH,1,192,125,59,66,14,5,9,11,0,11,0,0,0,192,125,59,66,14,5,9,11,0,11,0,0,0
08/09/2020,Northern,2,CAH,1,103,95,26,69,8,0,8,37,0,37,3,0,3,103,95,26,69,8,0,8,37,0,37,3,0,3
08/09/2020,Southeast,5,CAH,1,70,70,42,28,7,2,5,31,0,31,0,0,0,70,70,42,28,7,2,5,31,0,31,0,0,0
08/09/2020,Southeast,5,GACH,1,133,133,20,113,9,6,3,15,0,15,1,1,2,133,133,20,113,9,6,3,15,0,15,1,1,2
08/09/2020,Southwest,1,CAH,1,16,12,0,12,0,0,0,2,0,2,0,0,0,16,12,0,12,0,0,0,2,0,2,0,0,0
08/09/2020,Southwest,1,GACH,1,62,45,10,35,8,0,8,4,0,4,0,0,0,62,45,10,35,8,0,8,4,0,4,0,0,0
08/10/2020,Anchorage,7,GACH,1,1005,433,589,183,158,96,62,199,23,176,22,0,22,1005,834,589,279,158,96,62,199,23,176,22,0,22
08/10/2020,Anchorage,7,LTACH,0,51,,30,,11,7,4,24,3,21,0,0,0,51,45,30,15,11,7,4,24,3,21,0,0,0
08/10/2020,Anchorage,7,Psych,0,80,50,49,1,0,0,0,0,0,0,0,0,0,116,86,66,20,0,0,0,0,0,0,0,0,0
08/10/2020,Gulf Coast,4,CAH,1,118,51,20,44,2,1,1,19,0,19,0,0,0,118,94,20,79,4,1,3,19,0,19,0,0,0
08/10/2020,Gulf Coast,4,GACH,1,120,120,30,90,9,2,7,9,0,9,1,0,1,120,120,30,90,9,2,7,9,0,9,1,0,1
08/10/2020,Interior,6,GACH,1,94,81,59,22,13,6,7,16,0,16,2,0,2,94,81,59,22,13,6,7,16,0,16,2,0,2
08/10/2020,Matanuska-Susitna,3,GACH,1,192,125,62,63,14,5,9,11,0,11,0,0,0,192,125,62,63,14,5,9,11,0,11,0,0,0
08/10/2020,Northern,2,CAH,1,103,95,20,75,8,0,8,37,0,37,3,0,3,103,95,20,75,8,0,8,37,0,37,3,0,3
08/10/2020,Southeast,5,CAH,1,70,70,37,33,7,1,6,31,0,31,0,0,0,70,70,37,33,7,1,6,31,0,31,0,0,0
08/10/2020,Southeast,5,GACH,1,133,133,23,110,9,5,4,15,0,15,1,1,2,133,133,23,110,9,5,4,15,0,15,1,1,2
08/10/2020,Southwest,1,CAH,1,22,22,0,22,0,0,0,2,0,2,0,0,0,22,22,0,22,0,0,0,2,0,2,0,0,0
08/10/2020,Southwest,1,GACH,1,62,45,12,33,8,0,8,4,0,4,0,0,0,62,45,12,33,8,0,8,4,0,4,0,0,0
08/11/2020,Anchorage,7,GACH,1,1005,433,604,172,158,102,56,199,22,177,25,1,26,1005,834,604,268,158,102,56,199,22,177,25,1,26
08/11/2020,Anchorage,7,LTACH,0,51,,30,,11,5,6,24,3,21,0,0,0,51,45,30,15,11,5,6,24,3,21,0,0,0
08/11/2020,Anchorage,7,Psych,0,,,,,,,,,,,,,,116,86,66,20,0,0,0,0,0,0,0,0,0
08/11/2020,Gulf Coast,4,CAH,1,118,51,17,40,2,0,2,19,0,19,0,0,0,118,94,17,75,4,0,4,19,0,19,0,0,0
08/11/2020,Gulf Coast,4,GACH,1,120,120,37,83,9,5,4,9,0,9,0,0,0,120,120,37,83,9,5,4,9,0,9,0,0,0
08/11/2020,Interior,6,GACH,1,94,81,57,24,13,5,8,16,0,16,1,0,1,94,81,57,24,13,5,8,16,0,16,1,0,1
08/11/2020,Matanuska-Susitna,3,GACH,1,192,125,59,66,14,6,8,11,0,11,0,0,0,192,125,59,66,14,6,8,11,0,11,0,0,0
08/11/2020,Northern,2,CAH,1,103,95,18,77,8,0,8,37,0,37,0,0,0,103,95,18,77,8,0,8,37,0,37,0,0,0
08/11/2020,Southeast,5,CAH,1,70,70,37,33,7,2,5,31,0,31,1,0,1,70,70,37,33,7,2,5,31,0,31,1,0,1
08/11/2020,Southeast,5,GACH,1,133,133,31,102,9,5,4,15,0,15,1,0,1,133,133,31,102,9,5,4,15,0,15,1,0,1
08/11/2020,Southwest,1,CAH,1,22,22,0,22,0,0,0,2,0,2,0,0,0,22,22,0,22,0,0,0,2,0,2,0,0,0
08/11/2020,Southwest,1,GACH,1,62,45,9,36,8,0,8,4,0,4,0,0,0,62,45,9,36,8,0,8,4,0,4,0,0,0
08/12/2020,Anchorage,7,GACH,1,1005,433,623,153,158,103,55,199,25,174,29,1,30,1005,834,623,249,158,103,55,199,25,174,29,1,30
08/12/2020,Anchorage,7,LTACH,0,51,,31,,11,5,6,24,3,21,0,0,0,51,45,31,15,11,5,6,24,3,21,0,0,0
08/12/2020,Anchorage,7,Psych,0,,,,,,,,,,,,,,116,86,66,20,0,0,0,0,0,0,0,0,0
08/12/2020,Gulf Coast,4,CAH,1,118,51,23,37,2,0,2,19,0,19,0,0,0,118,94,23,72,4,0,4,19,0,19,0,0,0
08/12/2020,Gulf Coast,4,GACH,1,120,120,35,85,9,2,7,9,0,9,0,0,0,120,120,35,85,9,2,7,9,0,9,0,0,0
08/12/2020,Interior,6,GACH,1,94,81,67,14,13,9,4,16,0,16,1,0,1,94,81,67,14,13,9,4,16,0,16,1,0,1
08/12/2020,Matanuska-Susitna,3,GACH,1,192,125,64,61,14,6,8,11,2,9,0,0,0,192,125,64,61,14,6,8,11,2,9,0,0,0
08/12/2020,Northern,2,CAH,1,103,95,19,76,8,0,8,37,0,37,3,0,3,103,95,19,76,8,0,8,37,0,37,3,0,3
08/12/2020,Southeast,5,CAH,1,70,70,33,37,7,2,5,31,0,31,1,0,1,70,70,33,37,7,2,5,31,0,31,1,0,1
08/12/2020,Southeast,5,GACH,1,133,133,32,101,9,4,5,15,0,15,1,0,1,133,133,32,101,9,4,5,15,0,15,1,0,1
08/12/2020,Southwest,1,CAH,1,22,22,0,22,0,0,0,2,0,2,0,0,0,22,22,0,22,0,0,0,2,0,2,0,0,0
08/12/2020,Southwest,1,GACH,1,62,45,9,36,8,0,8,4,0,4,0,0,0,62,45,9,36,8,0,8,4,0,4,0,0,0
08/13/2020,Anchorage,7,GACH,1,1005,433,595,157,158,98,60,201,21,180,25,2,27,1005,834,595,253,158,98,60,201,21,180,25,2,27
08/13/2020,Anchorage,7,LTACH,0,51,,32,,11,7,4,24,3,21,0,0,0,51,45,32,15,11,7,4,24,3,21,0,0,0
08/13/2020,Anchorage,7,Psych,0,,,,,,,,,,,,,,116,86,66,20,0,0,0,0,0,0,0,0,0
08/13/2020,Gulf Coast,4,CAH,1,118,52,18,41,2,0,2,19,0,19,0,0,0,118,95,18,76,4,0,4,19,0,19,0,0,0
08/13/2020,Gulf Coast,4,GACH,1,120,120,30,90,9,3,6,9,0,9,0,0,0,120,120,30,90,9,3,6,9,0,9,0,0,0
08/13/2020,Interior,6,GACH,1,94,81,62,19,13,7,6,16,0,16,2,0,2,94,81,62,19,13,7,6,16,0,16,2,0,2
08/13/2020,Matanuska-Susitna,3,GACH,1,192,125,59,66,14,7,7,11,4,7,0,0,0,192,125,59,66,14,7,7,11,4,7,0,0,0
08/13/2020,Northern,2,CAH,1,103,95,20,75,8,0,8,37,0,37,1,0,1,103,95,20,75,8,0,8,37,0,37,1,0,1
08/13/2020,Southeast,5,CAH,1,70,70,42,28,8,6,2,31,0,31,1,0,1,70,70,42,28,8,6,2,31,0,31,1,0,1
08/13/2020,Southeast,5,GACH,1,133,133,29,104,9,5,4,15,0,15,1,0,1,133,133,29,104,9,5,4,15,0,15,1,0,1
08/13/2020,Southwest,1,CAH,1,22,22,1,21,0,0,0,2,0,2,0,0,0,22,22,1,21,0,0,0,2,0,2,0,0,0
08/13/2020,Southwest,1,GACH,1,62,45,11,34,8,0,8,4,0,4,0,0,0,62,45,11,34,8,0,8,4,0,4,0,0,0
08/14/2020,Anchorage,7,GACH,1,1005,433,629,144,158,96,62,201,24,177,28,0,28,1005,834,629,240,158,96,62,201,24,177,28,0,28
08/14/2020,Anchorage,7,LTACH,0,51,,30,,11,6,5,24,2,22,0,0,0,51,45,30,15,11,6,5,24,2,22,0,0,0
08/14/2020,Anchorage,7,Psych,0,,,,,,,,,,,,,,116,86,66,20,0,0,0,0,0,0,0,0,0
08/14/2020,Gulf Coast,4,CAH,1,118,51,17,43,2,0,2,19,0,19,0,0,0,118,94,17,78,4,0,4,19,0,19,0,0,0
08/14/2020,Gulf Coast,4,GACH,1,120,120,27,93,9,3,6,9,0,9,0,0,0,120,120,27,93,9,3,6,9,0,9,0,0,0
08/14/2020,Interior,6,GACH,1,94,81,54,27,13,5,8,16,2,14,2,0,2,94,81,54,27,13,5,8,16,2,14,2,0,2
08/14/2020,Matanuska-Susitna,3,GACH,1,192,125,66,59,14,6,8,11,1,10,0,0,0,192,125,66,59,14,6,8,11,1,10,0,0,0
08/14/2020,Northern,2,CAH,1,103,95,18,77,8,0,8,37,0,37,1,0,1,103,95,18,77,8,0,8,37,0,37,1,0,1
08/14/2020,Southeast,5,CAH,1,70,70,41,29,8,6,2,31,0,31,1,0,1,70,70,41,29,8,6,2,31,0,31,1,0,1
08/14/2020,Southeast,5,GACH,1,133,133,28,105,9,5,4,15,0,15,1,0,1,133,133,28,105,9,5,4,15,0,15,1,0,1
08/14/2020,Southwest,1,CAH,1,22,22,1,21,0,0,0,2,0,2,0,0,0,22,22,1,21,0,0,0,2,0,2,0,0,0
08/14/2020,Southwest,1,GACH,1,62,45,11,34,8,0,8,4,0,4,0,0,0,62,45,11,34,8,0,8,4,0,4,0,0,0
08/15/2020,Anchorage,7,GACH,1,1005,433,621,153,158,101,57,201,19,182,29,0,29,1005,834,621,249,158,101,57,201,19,182,29,0,29
08/15/2020,Anchorage,7,LTACH,0,51,,30,,11,6,5,24,2,22,0,0,0,51,45,30,15,11,6,5,24,2,22,0,0,0
08/15/2020,Anchorage,7,Psych,0,,,,,,,,,,,,,,116,86,66,20,0,0,0,0,0,0,0,0,0
08/15/2020,Gulf Coast,4,CAH,1,118,51,15,45,2,0,2,19,0,19,0,0,0,118,94,15,80,4,0,4,19,0,19,0,0,0
08/15/2020,Gulf Coast,4,GACH,1,120,120,31,89,9,1,8,9,0,9,0,0,0,120,120,31,89,9,1,8,9,0,9,0,0,0
08/15/2020,Interior,6,GACH,1,94,81,50,31,13,6,7,16,4,12,2,0,2,94,81,50,31,13,6,7,16,4,12,2,0,2
08/15/2020,Matanuska-Susitna,3,GACH,1,192,125,65,60,14,7,7,11,0,11,0,0,0,192,125,65,60,14,7,7,11,0,11,0,0,0
08/15/2020,Northern,2,CAH,1,103,95,16,79,8,8,0,37,0,37,1,0,1,103,95,16,79,8,8,0,37,0,37,1,0,1
08/15/2020,Southeast,5,CAH,1,70,70,37,33,8,4,4,31,0,31,1,0,1,70,70,37,33,8,4,4,31,0,31,1,0,1
08/15/2020,Southeast,5,GACH,1,133,133,25,108,9,6,3,15,0,15,1,0,1,133,133,25,108,9,6,3,15,0,15,1,0,1
08/15/2020,Southwest,1,CAH,1,16,12,1,11,0,0,0,2,0,2,0,0,0,16,12,1,11,0,0,0,2,0,2,0,0,0
08/15/2020,Southwest,1,GACH,1,62,45,15,30,8,0,8,4,0,4,0,0,0,62,45,15,30,8,0,8,4,0,4,0,0,0
08/16/2020,Anchorage,7,GACH,1,1005,433,573,175,158,92,66,201,24,177,24,0,24,1005,834,573,271,158,92,66,201,24,177,24,0,24
08/16/2020,Anchorage,7,LTACH,0,51,,32,,11,7,4,24,2,22,0,0,0,51,45,32,15,11,7,4,24,2,22,0,0,0
08/16/2020,Anchorage,7,Psych,0,,,,,,,,,,,,,,116,86,66,20,0,0,0,0,0,0,0,0,0
08/16/2020,Gulf Coast,4,CAH,1,118,51,17,45,2,0,2,19,0,19,0,0,0,118,94,17,80,4,0,4,19,0,19,0,0,0
08/16/2020,Gulf Coast,4,GACH,1,120,120,32,88,9,2,7,9,0,9,0,0,0,120,120,32,88,9,2,7,9,0,9,0,0,0
08/16/2020,Interior,6,GACH,1,94,81,50,31,13,7,6,16,3,13,3,0,3,94,81,50,31,13,7,6,16,3,13,3,0,3
08/16/2020,Matanuska-Susitna,3,GACH,1,192,125,65,60,14,7,7,11,0,11,0,0,0,192,125,65,60,14,7,7,11,0,11,0,0,0
08/16/2020,Northern,2,CAH,1,103,95,16,79,8,0,8,37,0,37,0,0,0,103,95,16,79,8,0,8,37,0,37,0,0,0
08/16/2020,Southeast,5,CAH,1,70,70,39,31,8,4,4,31,0,31,1,0,1,70,70,39,31,8,4,4,31,0,31,1,0,1
08/16/2020,Southeast,5,GACH,1,133,133,28,105,9,5,4,15,0,15,1,0,1,133,133,28,105,9,5,4,15,0,15,1,0,1
08/16/2020,Southwest,1,CAH,1,16,12,1,11,0,0,0,2,0,2,0,0,0,16,12,1,11,0,0,0,2,0,2,0,0,0
08/16/2020,Southwest,1,GACH,1,62,45,18,27,8,0,8,4,0,4,0,0,0,62,45,18,27,8,0,8,4,0,4,0,0,0
08/17/2020,Anchorage,7,GACH,1,1005,433,593,171,158,91,67,201,24,177,30,1,31,1005,834,593,267,158,91,67,201,24,177,30,1,31
08/17/2020,Anchorage,7,LTACH,0,51,,32,,11,7,4,24,2,22,0,0,0,51,45,32,15,11,7,4,24,2,22,0,0,0
08/17/2020,Anchorage,7,Psych,0,116,86,58,28,0,0,0,0,0,0,0,0,0,116,86,58,28,0,0,0,0,0,0,0,0,0
08/17/2020,Gulf Coast,4,CAH,1,118,51,16,42,2,0,2,19,0,19,3,0,3,118,94,16,77,4,0,4,19,0,19,3,0,3
08/17/2020,Gulf Coast,4,GACH,1,120,120,29,91,9,2,7,9,0,9,0,0,0,120,120,29,91,9,2,7,9,0,9,0,0,0
08/17/2020,Interior,6,GACH,1,94,81,49,32,13,6,7,16,3,13,2,0,2,94,81,49,32,13,6,7,16,3,13,2,0,2
08/17/2020,Matanuska-Susitna,3,GACH,1,192,125,70,55,14,5,9,11,0,11,1,0,1,192,125,70,55,14,5,9,11,0,11,1,0,1
08/17/2020,Northern,2,CAH,1,135,95,20,75,8,0,8,37,0,37,2,0,2,135,95,20,75,8,0,8,37,0,37,2,0,2
08/17/2020,Southeast,5,CAH,1,70,70,35,35,8,2,6,31,0,31,0,0,0,70,70,35,35,8,2,6,31,0,31,0,0,0
08/17/2020,Southeast,5,GACH,1,133,133,30,103,9,6,3,15,0,15,1,0,1,133,133,30,103,9,6,3,15,0,15,1,0,1
08/17/2020,Southwest,1,CAH,1,22,22,1,21,0,0,0,2,0,2,0,0,0,22,22,1,21,0,0,0,2,0,2,0,0,0
08/17/2020,Southwest,1,GACH,1,62,45,14,31,8,0,8,4,0,4,0,0,0,62,45,14,31,8,0,8,4,0,4,0,0,0
08/18/2020,Anchorage,7,GACH,1,1005,433,588,163,158,80,78,201,21,180,30,1,31,1005,834,588,259,158,80,78,201,21,180,30,1,31
08/18/2020,Anchorage,7,LTACH,0,51,,32,,11,7,4,24,2,22,0,0,0,51,45,32,15,11,7,4,24,2,22,0,0,0
08/18/2020,Anchorage,7,Psych,0,,,,,,,,,,,,,,116,86,58,28,0,0,0,0,0,0,0,0,0
08/18/2020,Gulf Coast,4,CAH,1,118,51,19,43,2,1,2,19,0,19,2,0,2,118,94,19,78,4,1,4,19,0,19,2,0,2
08/18/2020,Gulf Coast,4,GACH,1,120,120,28,92,9,4,5,9,1,8,2,0,2,120,120,28,92,9,4,5,9,1,8,2,0,2
08/18/2020,Interior,6,GACH,1,94,81,45,36,13,8,5,15,2,13,2,0,2,94,81,45,36,13,8,5,15,2,13,2,0,2
08/18/2020,Matanuska-Susitna,3,GACH,1,192,125,78,47,14,9,5,11,2,9,1,0,1,192,125,78,47,14,9,5,11,2,9,1,0,1
08/18/2020,Northern,2,CAH,1,103,95,21,74,8,8,0,37,0,37,3,0,3,103,95,21,74,8,8,0,37,0,37,3,0,3
08/18/2020,Southeast,5,CAH,1,70,70,38,32,8,2,6,31,0,31,1,0,1,70,70,38,32,8,2,6,31,0,31,1,0,1
08/18/2020,Southeast,5,GACH,1,133,133,31,102,9,5,4,14,1,13,1,0,1,133,133,31,102,9,5,4,14,1,13,1,0,1
08/18/2020,Southwest,1,CAH,1,22,22,1,21,0,0,0,2,0,2,0,0,0,22,22,1,21,0,0,0,2,0,2,0,0,0
08/18/2020,Southwest,1,GACH,1,62,45,13,32,8,0,8,4,0,4,0,0,0,62,45,13,32,8,0,8,4,0,4,0,0,0
08/19/2020,Anchorage,7,GACH,1,1005,433,625,158,158,92,66,201,28,173,29,0,29,1005,834,625,254,158,92,66,201,28,173,29,0,29
08/19/2020,Anchorage,7,LTACH,0,51,,30,,11,6,5,24,2,22,0,0,0,51,45,30,15,11,6,5,24,2,22,0,0,0
08/19/2020,Anchorage,7,Psych,0,,,,,,,,,,,,,,116,86,58,28,0,0,0,0,0,0,0,0,0
08/19/2020,Gulf Coast,4,CAH,1,118,64,24,55,2,2,1,19,0,19,0,0,0,118,107,24,90,4,2,3,19,0,19,0,0,0
08/19/2020,Gulf Coast,4,GACH,1,120,120,28,92,9,4,5,9,1,8,2,0,2,120,120,28,92,9,4,5,9,1,8,2,0,2
08/19/2020,Interior,6,GACH,1,94,81,52,29,13,9,4,16,1,15,2,0,2,94,81,52,29,13,9,4,16,1,15,2,0,2
08/19/2020,Matanuska-Susitna,3,GACH,1,192,125,75,50,14,10,4,11,1,10,1,0,1,192,125,75,50,14,10,4,11,1,10,1,0,1
08/19/2020,Northern,2,CAH,1,103,95,16,79,8,0,8,37,0,37,3,0,3,103,95,16,79,8,0,8,37,0,37,3,0,3
08/19/2020,Southeast,5,CAH,1,70,70,38,32,8,3,5,31,0,31,1,0,1,70,70,38,32,8,3,5,31,0,31,1,0,1
08/19/2020,Southeast,5,GACH,1,133,133,34,99,9,5,4,14,2,12,1,0,1,133,133,34,99,9,5,4,14,2,12,1,0,1
08/19/2020,Southwest,1,CAH,1,22,22,0,22,0,0,0,2,0,2,0,0,0,22,22,0,22,0,0,0,2,0,2,0,0,0
08/19/2020,Southwest,1,GACH,1,62,45,17,28,8,0,8,4,0,4,0,0,0,62,45,17,28,8,0,8,4,0,4,0,0,0
08/20/2020,Anchorage,7,GACH,1,1005,433,610,155,158,92,66,201,32,169,25,1,26,1005,834,610,251,158,92,66,201,32,169,25,1,26
08/20/2020,Anchorage,7,LTACH,0,51,,30,,11,6,5,24,2,22,0,0,0,51,45,30,15,11,6,5,24,2,22,0,0,0
08/20/2020,Anchorage,7,Psych,0,,,,,,,,,,,,,,116,86,58,28,0,0,0,0,0,0,0,0,0
08/20/2020,Gulf Coast,4,CAH,1,118,51,19,44,2,2,1,19,0,19,2,0,2,118,94,19,79,4,2,3,19,0,19,2,0,2
08/20/2020,Gulf Coast,4,GACH,1,120,120,39,81,9,4,5,9,0,9,2,0,2,120,120,39,81,9,4,5,9,0,9,2,0,2
08/20/2020,Interior,6,GACH,1,94,81,51,30,13,6,7,16,0,16,2,0,2,94,81,51,30,13,6,7,16,0,16,2,0,2
08/20/2020,Matanuska-Susitna,3,GACH,1,192,125,64,61,14,7,7,11,0,11,1,0,1,192,125,64,61,14,7,7,11,0,11,1,0,1
08/20/2020,Northern,2,CAH,1,103,95,19,76,8,0,8,37,0,37,3,0,3,103,95,19,76,8,0,8,37,0,37,3,0,3
08/20/2020,Southeast,5,CAH,1,70,70,39,31,8,3,5,31,0,31,1,0,1,70,70,39,31,8,3,5,31,0,31,1,0,1
08/20/2020,Southeast,5,GACH,1,133,133,34,99,9,4,5,14,0,14,1,0,1,133,133,34,99,9,4,5,14,0,14,1,0,1
08/20/2020,Southwest,1,CAH,1,22,22,1,21,0,0,0,2,0,2,0,0,0,22,22,1,21,0,0,0,2,0,2,0,0,0
08/20/2020,Southwest,1,GACH,1,62,45,16,29,8,0,8,4,0,4,0,0,0,62,45,16,29,8,0,8,4,0,4,0,0,0
08/21/2020,Anchorage,7,GACH,1,1005,433,594,162,158,96,62,201,30,171,24,0,24,1005,834,594,258,158,96,62,201,30,171,24,0,24
08/21/2020,Anchorage,7,LTACH,0,51,,33,,11,8,3,24,0,24,0,0,0,51,45,33,15,11,8,3,24,0,24,0,0,0
08/21/2020,Anchorage,7,Psych,0,,,,,,,,,,,,,,116,86,58,28,0,0,0,0,0,0,0,0,0
08/21/2020,Gulf Coast,4,CAH,1,118,51,17,43,2,0,2,19,0,19,1,0,1,118,94,17,78,4,0,4,19,0,19,1,0,1
08/21/2020,Gulf Coast,4,GACH,1,146,52,32,20,9,5,4,9,1,8,2,0,2,146,52,32,20,9,5,4,9,1,8,2,0,2
08/21/2020,Interior,6,GACH,1,94,81,54,27,13,6,7,16,0,16,2,0,2,94,81,54,27,13,6,7,16,0,16,2,0,2
08/21/2020,Matanuska-Susitna,3,GACH,1,192,125,63,62,14,9,5,11,1,10,1,0,1,192,125,63,62,14,9,5,11,1,10,1,0,1
08/21/2020,Northern,2,CAH,1,103,95,16,79,8,0,8,36,0,36,3,0,3,103,95,16,79,8,0,8,36,0,36,3,0,3
08/21/2020,Southeast,5,CAH,1,70,70,31,39,8,3,5,31,0,31,1,0,1,70,70,31,39,8,3,5,31,0,31,1,0,1
08/21/2020,Southeast,5,GACH,1,133,133,32,101,9,5,4,15,0,15,1,0,1,133,133,32,101,9,5,4,15,0,15,1,0,1
08/21/2020,Southwest,1,CAH,1,22,22,1,21,0,0,0,2,0,2,0,0,0,22,22,1,21,0,0,0,2,0,2,0,0,0
08/21/2020,Southwest,1,GACH,1,62,45,17,28,8,0,8,4,0,4,0,0,0,62,45,17,28,8,0,8,4,0,4,0,0,0
08/22/2020,Anchorage,7,GACH,1,1005,433,539,177,158,97,61,201,26,175,22,0,22,1005,834,539,273,158,97,61,201,26,175,22,0,22
08/22/2020,Anchorage,7,LTACH,0,51,,33,,11,8,3,24,0,24,0,0,0,51,45,33,15,11,8,3,24,0,24,0,0,0
08/22/2020,Anchorage,7,Psych,0,,,,,,,,,,,,,,116,86,58,28,0,0,0,0,0,0,0,0,0
08/22/2020,Gulf Coast,4,CAH,1,118,64,15,58,2,0,2,19,0,19,0,0,0,118,107,15,93,4,0,4,19,0,19,0,0,0
08/22/2020,Gulf Coast,4,GACH,1,120,120,30,90,9,3,6,9,0,9,3,0,3,120,120,30,90,9,3,6,9,0,9,3,0,3
08/22/2020,Interior,6,GACH,1,94,81,63,18,13,6,7,16,0,16,1,0,1,94,81,63,18,13,6,7,16,0,16,1,0,1
08/22/2020,Matanuska-Susitna,3,GACH,1,192,125,50,75,14,8,6,11,2,9,1,0,1,192,125,50,75,14,8,6,11,2,9,1,0,1
08/22/2020,Northern,2,CAH,1,103,95,15,80,8,0,8,36,0,36,2,0,2,103,95,15,80,8,0,8,36,0,36,2,0,2
08/22/2020,Southeast,5,CAH,1,70,70,29,41,8,3,5,31,0,31,2,0,2,70,70,29,41,8,3,5,31,0,31,2,0,2
08/22/2020,Southeast,5,GACH,1,133,133,29,104,9,5,4,15,0,15,1,0,1,133,133,29,104,9,5,4,15,0,15,1,0,1
08/22/2020,Southwest,1,CAH,1,16,12,0,12,0,0,0,2,0,2,0,0,0,16,12,0,12,0,0,0,2,0,2,0,0,0
08/22/2020,Southwest,1,GACH,1,62,45,22,23,8,0,8,4,0,4,0,0,0,62,45,22,23,8,0,8,4,0,4,0,0,0
08/23/2020,Anchorage,7,GACH,1,1005,433,530,180,158,96,62,201,28,173,25,0,25,1005,834,530,276,158,96,62,201,28,173,25,0,25
08/23/2020,Anchorage,7,LTACH,0,51,,33,,11,8,3,24,0,24,0,0,0,51,45,33,15,11,8,3,24,0,24,0,0,0
08/23/2020,Anchorage,7,Psych,0,,,,,,,,,,,,,,116,86,58,28,0,0,0,0,0,0,0,0,0
08/23/2020,Gulf Coast,4,CAH,1,118,64,12,59,2,0,2,19,0,19,0,0,0,118,107,12,94,4,0,4,19,0,19,0,0,0
08/23/2020,Gulf Coast,4,GACH,1,120,120,27,93,9,6,3,9,1,8,2,0,2,120,120,27,93,9,6,3,9,1,8,2,0,2
08/23/2020,Interior,6,GACH,1,94,81,48,33,13,5,8,16,0,16,1,0,1,94,81,48,33,13,5,8,16,0,16,1,0,1
08/23/2020,Matanuska-Susitna,3,GACH,1,192,125,47,78,14,9,5,11,2,9,1,0,1,192,125,47,78,14,9,5,11,2,9,1,0,1
08/23/2020,Northern,2,CAH,1,103,95,16,79,8,0,8,36,0,36,2,0,2,103,95,16,79,8,0,8,36,0,36,2,0,2
08/23/2020,Southeast,5,CAH,1,70,70,32,38,8,3,5,31,0,31,2,0,2,70,70,32,38,8,3,5,31,0,31,2,0,2
08/23/2020,Southeast,5,GACH,1,133,133,22,111,9,5,4,15,0,15,1,0,1,133,133,22,111,9,5,4,15,0,15,1,0,1
08/23/2020,Southwest,1,CAH,1,16,12,1,11,0,0,0,2,0,2,0,0,0,16,12,1,11,0,0,0,2,0,2,0,0,0
08/23/2020,Southwest,1,GACH,1,62,45,18,27,8,0,8,4,0,4,0,0,0,62,45,18,27,8,0,8,4,0,4,0,0,0
08/24/2020,Anchorage,7,GACH,1,1005,433,552,184,158,94,64,201,28,173,25,0,25,1005,834,552,280,158,94,64,201,28,173,25,0,25
08/24/2020,Anchorage,7,LTACH,0,51,,32,,11,6,5,24,0,24,0,0,0,51,45,32,15,11,6,5,24,0,24,0,0,0
08/24/2020,Anchorage,7,Psych,0,80,50,48,2,0,0,0,0,0,0,0,0,0,116,86,56,30,0,0,0,0,0,0,0,0,0
08/24/2020,Gulf Coast,4,CAH,1,118,51,14,46,2,2,1,19,0,19,0,0,0,118,94,14,81,4,2,3,19,0,19,0,0,0
08/24/2020,Gulf Coast,4,GACH,1,120,120,28,92,9,5,4,9,1,8,1,0,1,120,120,28,92,9,5,4,9,1,8,1,0,1
08/24/2020,Interior,6,GACH,1,94,81,48,33,13,3,10,16,0,16,1,0,1,94,81,48,33,13,3,10,16,0,16,1,0,1
08/24/2020,Matanuska-Susitna,3,GACH,1,192,125,60,65,14,11,3,11,3,8,2,0,2,192,125,60,65,14,11,3,11,3,8,2,0,2
08/24/2020,Northern,2,CAH,1,135,95,18,77,8,0,8,36,0,36,2,0,2,135,95,18,77,8,0,8,36,0,36,2,0,2
08/24/2020,Southeast,5,CAH,1,70,70,29,41,8,2,6,31,0,31,2,0,2,70,70,29,41,8,2,6,31,0,31,2,0,2
08/24/2020,Southeast,5,GACH,1,133,133,25,108,9,3,6,15,1,14,1,0,1,133,133,25,108,9,3,6,15,1,14,1,0,1
08/24/2020,Southwest,1,CAH,1,22,22,1,21,0,0,0,2,0,2,0,0,0,22,22,1,21,0,0,0,2,0,2,0,0,0
08/24/2020,Southwest,1,GACH,1,62,45,15,30,8,0,8,4,0,4,0,0,0,62,45,15,30,8,0,8,4,0,4,0,0,0
08/25/2020,Anchorage,7,GACH,1,1005,433,578,168,158,95,63,201,29,172,22,0,22,1005,834,578,264,158,95,63,201,29,172,22,0,22
08/25/2020,Anchorage,7,LTACH,0,51,,31,,11,6,5,24,0,24,0,0,0,51,45,31,15,11,6,5,24,0,24,0,0,0
08/25/2020,Anchorage,7,Psych,0,,,,,,,,,,,,,,116,86,56,30,0,0,0,0,0,0,0,0,0
08/25/2020,Gulf Coast,4,CAH,1,117,52,18,44,2,1,2,19,0,19,0,0,0,117,95,18,79,4,1,4,19,0,19,0,0,0
08/25/2020,Gulf Coast,4,GACH,1,120,120,35,85,9,7,2,9,1,8,2,0,2,120,120,35,85,9,7,2,9,1,8,2,0,2
08/25/2020,Interior,6,GACH,1,94,81,50,31,13,12,1,16,0,16,1,0,1,94,81,50,31,13,12,1,16,0,16,1,0,1
08/25/2020,Matanuska-Susitna,3,GACH,1,192,125,74,51,14,12,2,11,5,6,2,0,2,192,125,74,51,14,12,2,11,5,6,2,0,2
08/25/2020,Northern,2,CAH,1,103,95,14,81,8,0,8,36,0,36,2,0,2,103,95,14,81,8,0,8,36,0,36,2,0,2
08/25/2020,Southeast,5,CAH,1,70,70,29,41,8,1,7,31,0,31,2,0,2,70,70,29,41,8,1,7,31,0,31,2,0,2
08/25/2020,Southeast,5,GACH,1,133,133,23,110,9,6,3,15,0,15,0,0,0,133,133,23,110,9,6,3,15,0,15,0,0,0
08/25/2020,Southwest,1,CAH,1,22,22,1,21,0,0,0,2,0,2,0,0,0,22,22,1,21,0,0,0,2,0,2,0,0,0
08/25/2020,Southwest,1,GACH,1,62,45,11,34,8,0,8,4,0,4,0,0,0,62,45,11,34,8,0,8,4,0,4,0,0,0
08/26/2020,Anchorage,7,GACH,1,1005,433,582,172,158,92,66,201,32,169,24,0,24,1005,834,582,268,158,92,66,201,32,169,24,0,24
08/26/2020,Anchorage,7,LTACH,0,51,,32,,11,6,5,24,0,24,0,0,0,51,45,32,15,11,6,5,24,0,24,0,0,0
08/26/2020,Anchorage,7,Psych,0,,,,,,,,,,,,,,116,86,56,30,0,0,0,0,0,0,0,0,0
08/26/2020,Gulf Coast,4,CAH,1,118,64,16,59,2,2,1,19,0,19,0,0,0,118,107,16,94,4,2,3,19,0,19,0,0,0
08/26/2020,Gulf Coast,4,GACH,1,120,120,36,84,9,5,4,9,0,9,1,0,1,120,120,36,84,9,5,4,9,0,9,1,0,1
08/26/2020,Interior,6,GACH,1,94,81,61,20,13,10,3,16,0,16,2,0,2,94,81,61,20,13,10,3,16,0,16,2,0,2
08/26/2020,Matanuska-Susitna,3,GACH,1,192,125,84,41,14,13,1,11,5,6,3,0,3,192,125,84,41,14,13,1,11,5,6,3,0,3
08/26/2020,Northern,2,CAH,1,103,95,18,77,8,0,8,36,0,36,2,0,2,103,95,18,77,8,0,8,36,0,36,2,0,2
08/26/2020,Southeast,5,CAH,1,70,70,30,40,8,0,8,31,0,31,1,0,1,70,70,30,40,8,0,8,31,0,31,1,0,1
08/26/2020,Southeast,5,GACH,1,133,133,30,103,9,6,3,15,0,15,0,0,0,133,133,30,103,9,6,3,15,0,15,0,0,0
08/26/2020,Southwest,1,CAH,1,22,22,2,20,0,0,0,2,0,2,0,0,0,22,22,2,20,0,0,0,2,0,2,0,0,0
08/26/2020,Southwest,1,GACH,1,62,45,16,29,8,0,8,4,0,4,0,0,0,62,45,16,29,8,0,8,4,0,4,0,0,0
08/27/2020,Anchorage,7,GACH,1,1005,433,577,177,158,93,65,201,32,169,23,0,23,1005,834,577,273,158,93,65,201,32,169,23,0,23
08/27/2020,Anchorage,7,LTACH,0,51,,31,,11,5,6,24,0,24,0,0,0,51,45,31,15,11,5,6,24,0,24,0,0,0
08/27/2020,Anchorage,7,Psych,0,,,,,,,,,,,,,,116,86,56,30,0,0,0,0,0,0,0,0,0
08/27/2020,Gulf Coast,4,CAH,1,117,52,15,45,2,3,0,19,0,19,0,0,0,117,95,15,80,4,3,2,19,0,19,0,0,0
08/27/2020,Gulf Coast,4,GACH,1,120,120,34,86,9,5,4,9,1,8,0,0,0,120,120,34,86,9,5,4,9,1,8,0,0,0
08/27/2020,Interior,6,GACH,1,94,81,63,18,13,10,3,16,1,15,1,0,1,94,81,63,18,13,10,3,16,1,15,1,0,1
08/27/2020,Matanuska-Susitna,3,GACH,1,192,125,76,49,14,11,3,11,6,5,3,0,3,192,125,76,49,14,11,3,11,6,5,3,0,3
08/27/2020,Northern,2,CAH,1,103,95,22,73,8,0,8,36,0,36,2,0,2,103,95,22,73,8,0,8,36,0,36,2,0,2
08/27/2020,Southeast,5,CAH,1,70,66,25,41,6,1,5,25,1,24,1,0,1,70,66,25,41,6,1,5,25,1,24,1,0,1
08/27/2020,Southeast,5,GACH,1,133,133,32,101,9,6,3,15,0,15,0,0,0,133,133,32,101,9,6,3,15,0,15,0,0,0
08/27/2020,Southwest,1,CAH,1,22,22,2,20,0,0,0,2,0,2,0,0,0,22,22,2,20,0,0,0,2,0,2,0,0,0
08/27/2020,Southwest,1,GACH,1,62,45,11,34,8,0,8,4,0,4,0,0,0,62,45,11,34,8,0,8,4,0,4,0,0,0
08/28/2020,Anchorage,7,GACH,1,1005,433,584,179,158,95,63,201,30,171,29,0,29,1005,834,584,275,158,95,63,201,30,171,29,0,29
08/28/2020,Anchorage,7,LTACH,0,51,,35,,11,5,6,24,0,24,0,0,0,51,45,35,15,11,5,6,24,0,24,0,0,0
08/28/2020,Anchorage,7,Psych,0,,,,,,,,,,,,,,116,86,56,30,0,0,0,0,0,0,0,0,0
08/28/2020,Gulf Coast,4,CAH,1,118,51,19,43,2,1,2,19,0,19,0,0,0,118,94,19,78,4,1,4,19,0,19,0,0,0
08/28/2020,Gulf Coast,4,GACH,1,120,120,34,86,9,5,4,9,1,8,0,0,0,120,120,34,86,9,5,4,9,1,8,0,0,0
08/28/2020,Interior,6,GACH,1,94,81,59,22,13,6,7,16,0,16,1,0,1,94,81,59,22,13,6,7,16,0,16,1,0,1
08/28/2020,Matanuska-Susitna,3,GACH,1,192,125,71,54,14,13,1,11,3,8,3,0,3,192,125,71,54,14,13,1,11,3,8,3,0,3
08/28/2020,Northern,2,CAH,1,103,95,19,76,8,0,8,36,0,36,2,0,2,103,95,19,76,8,0,8,36,0,36,2,0,2
08/28/2020,Southeast,5,CAH,1,58,58,26,32,8,1,7,28,0,28,2,0,2,70,70,29,41,8,1,7,31,0,31,2,0,2
08/28/2020,Southeast,5,GACH,1,133,133,28,105,9,1,8,15,0,15,0,0,0,133,133,28,105,9,1,8,15,0,15,0,0,0
08/28/2020,Southwest,1,CAH,1,22,22,1,21,0,0,0,2,0,2,0,0,0,22,22,1,21,0,0,0,2,0,2,0,0,0
08/28/2020,Southwest,1,GACH,1,62,45,13,32,8,0,8,4,0,4,0,0,0,62,45,13,32,8,0,8,4,0,4,0,0,0
08/29/2020,Anchorage,7,GACH,1,1005,433,542,178,158,91,67,203,31,172,28,0,28,1005,834,542,274,158,91,67,203,31,172,28,0,28
08/29/2020,Anchorage,7,LTACH,0,51,,35,,11,5,6,24,0,24,0,0,0,51,45,35,15,11,5,6,24,0,24,0,0,0
08/29/2020,Anchorage,7,Psych,0,,,,,,,,,,,,,,116,86,56,30,0,0,0,0,0,0,0,0,0
08/29/2020,Gulf Coast,4,CAH,1,118,51,18,42,2,1,2,19,0,19,0,0,0,118,94,18,77,4,1,4,19,0,19,0,0,0
08/29/2020,Gulf Coast,4,GACH,1,120,120,35,85,9,5,4,9,0,9,0,0,0,120,120,35,85,9,5,4,9,0,9,0,0,0
08/29/2020,Interior,6,GACH,1,94,81,49,32,13,7,6,16,0,16,1,0,1,94,81,49,32,13,7,6,16,0,16,1,0,1
08/29/2020,Matanuska-Susitna,3,GACH,1,192,125,65,60,14,13,1,11,2,9,2,0,2,192,125,65,60,14,13,1,11,2,9,2,0,2
08/29/2020,Northern,2,CAH,1,103,95,17,78,8,0,8,36,0,36,0,0,0,103,95,17,78,8,0,8,36,0,36,0,0,0
08/29/2020,Southeast,5,CAH,1,70,70,26,44,8,2,6,31,0,31,2,0,2,70,70,26,44,8,2,6,31,0,31,2,0,2
08/29/2020,Southeast,5,GACH,1,133,133,31,102,9,3,6,15,0,15,0,0,0,133,133,31,102,9,3,6,15,0,15,0,0,0
08/29/2020,Southwest,1,CAH,1,22,22,1,21,0,0,0,2,0,2,0,0,0,22,22,1,21,0,0,0,2,0,2,0,0,0
08/29/2020,Southwest,1,GACH,1,62,45,21,24,8,0,8,4,0,4,0,0,0,62,45,21,24,8,0,8,4,0,4,0,0,0
08/30/2020,Anchorage,7,GACH,1,1005,433,511,196,158,89,69,203,32,171,27,0,27,1005,834,511,292,158,89,69,203,32,171,27,0,27
08/30/2020,Anchorage,7,LTACH,0,51,,33,,11,6,5,24,2,22,0,0,0,51,45,33,15,11,6,5,24,2,22,0,0,0
08/30/2020,Anchorage,7,Psych,0,,,,,,,,,,,,,,116,86,56,30,0,0,0,0,0,0,0,0,0
08/30/2020,Gulf Coast,4,CAH,1,118,51,17,42,2,1,2,19,0,19,0,0,0,118,94,17,77,4,1,4,19,0,19,0,0,0
08/30/2020,Gulf Coast,4,GACH,1,120,120,34,86,9,5,4,9,0,9,0,0,0,120,120,34,86,9,5,4,9,0,9,0,0,0
08/30/2020,Interior,6,GACH,1,94,81,47,34,13,5,8,16,0,16,2,0,2,94,81,47,34,13,5,8,16,0,16,2,0,2
08/30/2020,Matanuska-Susitna,3,GACH,1,192,125,52,73,14,7,7,11,4,7,1,0,1,192,125,52,73,14,7,7,11,4,7,1,0,1
08/30/2020,Northern,2,CAH,1,103,95,20,75,8,0,8,36,0,36,1,0,1,103,95,20,75,8,0,8,36,0,36,1,0,1
08/30/2020,Southeast,5,CAH,1,70,70,24,46,8,2,6,31,0,31,2,0,2,70,70,24,46,8,2,6,31,0,31,2,0,2
08/30/2020,Southeast,5,GACH,1,133,133,31,102,9,1,8,15,0,15,0,0,0,133,133,31,102,9,1,8,15,0,15,0,0,0
08/30/2020,Southwest,1,CAH,1,16,12,1,11,0,0,0,2,0,2,0,0,0,16,12,1,11,0,0,0,2,0,2,0,0,0
08/30/2020,Southwest,1,GACH,1,62,45,21,24,8,0,8,4,0,4,0,0,0,62,45,21,24,8,0,8,4,0,4,0,0,0
08/31/2020,Anchorage,7,GACH,1,1005,433,543,193,158,87,71,203,30,173,30,0,30,1005,834,543,289,158,87,71,203,30,173,30,0,30
08/31/2020,Anchorage,7,LTACH,0,51,,33,,11,6,5,24,2,22,0,0,0,51,45,33,15,11,6,5,24,2,22,0,0,0
08/31/2020,Anchorage,7,Psych,0,80,50,45,5,0,0,0,0,0,0,0,0,0,116,86,53,33,0,0,0,0,0,0,0,0,0
08/31/2020,Gulf Coast,4,CAH,1,118,52,20,40,2,0,2,19,0,19,0,0,0,118,95,20,75,4,0,4,19,0,19,0,0,0
08/31/2020,Gulf Coast,4,GACH,1,120,120,33,87,9,5,4,9,0,9,0,0,0,120,120,33,87,9,5,4,9,0,9,0,0,0
08/31/2020,Interior,6,GACH,1,94,81,47,34,13,8,5,16,1,15,2,0,2,94,81,47,34,13,8,5,16,1,15,2,0,2
08/31/2020,Matanuska-Susitna,3,GACH,1,192,125,63,62,14,4,10,11,2,9,3,0,3,192,125,63,62,14,4,10,11,2,9,3,0,3
08/31/2020,Northern,2,CAH,1,135,95,21,74,8,0,8,36,0,36,1,0,1,135,95,21,74,8,0,8,36,0,36,1,0,1
08/31/2020,Southeast,5,CAH,1,70,70,33,37,8,3,5,31,0,31,0,0,0,70,70,33,37,8,3,5,31,0,31,0,0,0
08/31/2020,Southeast,5,GACH,1,133,133,23,110,9,1,8,15,1,14,0,0,0,133,133,23,110,9,1,8,15,1,14,0,0,0
08/31/2020,Southwest,1,CAH,1,22,22,3,19,0,0,0,2,0,2,0,0,0,22,22,3,19,0,0,0,2,0,2,0,0,0
08/31/2020,Southwest,1,GACH,1,62,45,21,24,8,0,8,4,0,4,0,0,0,62,45,21,24,8,0,8,4,0,4,0,0,0
09/01/2020,Anchorage,7,GACH,1,1005,433,566,188,158,75,83,203,29,174,31,0,31,1005,834,566,284,158,75,83,203,29,174,31,0,31
09/01/2020,Anchorage,7,LTACH,0,51,,35,,11,6,5,24,2,22,0,0,0,51,45,35,15,11,6,5,24,2,22,0,0,0
09/01/2020,Anchorage,7,Psych,0,,,,,,,,,,,,,,116,86,53,33,0,0,0,0,0,0,0,0,0
09/01/2020,Gulf Coast,4,CAH,1,118,52,20,42,2,0,2,19,0,19,0,0,0,118,95,20,77,4,0,4,19,0,19,0,0,0
09/01/2020,Gulf Coast,4,GACH,1,120,120,40,80,9,5,4,9,0,9,0,0,0,120,120,40,80,9,5,4,9,0,9,0,0,0
09/01/2020,Interior,6,GACH,1,94,81,56,25,13,6,7,16,1,15,3,0,3,94,81,56,25,13,6,7,16,1,15,3,0,3
09/01/2020,Matanuska-Susitna,3,GACH,1,192,125,82,43,14,10,4,11,2,9,4,0,4,192,125,82,43,14,10,4,11,2,9,4,0,4
09/01/2020,Northern,2,CAH,1,103,95,18,77,8,1,7,36,0,36,1,0,1,103,95,18,77,8,1,7,36,0,36,1,0,1
09/01/2020,Southeast,5,CAH,1,70,70,34,36,8,4,4,31,0,31,0,0,0,70,70,34,36,8,4,4,31,0,31,0,0,0
09/01/2020,Southeast,5,GACH,1,133,133,26,107,9,0,9,15,0,15,1,0,1,133,133,26,107,9,0,9,15,0,15,1,0,1
09/01/2020,Southwest,1,CAH,1,22,22,1,21,0,0,0,2,0,2,0,0,0,22,22,1,21,0,0,0,2,0,2,0,0,0
09/01/2020,Southwest,1,GACH,1,62,45,16,29,8,0,8,4,0,4,0,0,0,62,45,16,29,8,0,8,4,0,4,0,0,0
09/02/2020,Anchorage,7,GACH,1,1005,433,585,171,158,88,70,203,22,181,27,0,27,1005,834,585,267,158,88,70,203,22,181,27,0,27
09/02/2020,Anchorage,7,LTACH,0,51,,36,,11,7,4,24,1,23,0,0,0,51,45,36,15,11,7,4,24,1,23,0,0,0
09/02/2020,Anchorage,7,Psych,0,,,,,,,,,,,,,,116,86,53,33,0,0,0,0,0,0,0,0,0
09/02/2020,Gulf Coast,4,CAH,1,118,52,17,43,2,0,2,19,0,19,0,0,0,118,95,17,78,4,0,4,19,0,19,0,0,0
09/02/2020,Gulf Coast,4,GACH,1,120,120,36,84,9,3,6,9,0,9,0,0,0,120,120,36,84,9,3,6,9,0,9,0,0,0
09/02/2020,Interior,6,GACH,1,94,81,54,27,13,4,9,16,0,16,3,0,3,94,81,54,27,13,4,9,16,0,16,3,0,3
09/02/2020,Matanuska-Susitna,3,GACH,1,192,125,69,56,14,11,3,11,1,10,3,0,3,192,125,69,56,14,11,3,11,1,10,3,0,3
09/02/2020,Northern,2,CAH,1,103,95,18,77,8,0,8,36,0,36,0,0,0,103,95,18,77,8,0,8,36,0,36,0,0,0
09/02/2020,Southeast,5,CAH,1,70,70,39,31,8,2,6,31,0,31,1,0,1,70,70,39,31,8,2,6,31,0,31,1,0,1
09/02/2020,Southeast,5,GACH,1,133,133,22,111,9,0,9,15,0,15,1,0,1,133,133,22,111,9,0,9,15,0,15,1,0,1
09/02/2020,Southwest,1,CAH,1,22,22,1,21,0,0,0,2,0,2,0,0,0,22,22,1,21,0,0,0,2,0,2,0,0,0
09/02/2020,Southwest,1,GACH,1,62,45,17,28,8,0,8,4,0,4,0,0,0,62,45,17,28,8,0,8,4,0,4,0,0,0
09/03/2020,Anchorage,7,GACH,1,950,362,602,93,158,86,72,203,20,183,26,0,26,950,763,602,189,158,86,72,203,20,183,26,0,26
09/03/2020,Anchorage,7,LTACH,0,51,,35,,11,7,4,24,1,23,0,0,0,51,45,35,15,11,7,4,24,1,23,0,0,0
09/03/2020,Anchorage,7,Psych,0,,,,,,,,,,,,,,116,86,53,33,0,0,0,0,0,0,0,0,0
09/03/2020,Gulf Coast,4,CAH,1,118,52,14,44,2,0,2,19,0,19,0,0,0,118,95,14,79,4,0,4,19,0,19,0,0,0
09/03/2020,Gulf Coast,4,GACH,1,120,120,37,83,9,3,6,9,1,8,0,0,0,120,120,37,83,9,3,6,9,1,8,0,0,0
09/03/2020,Interior,6,GACH,1,94,81,54,27,13,7,6,16,0,16,2,0,2,94,81,54,27,13,7,6,16,0,16,2,0,2
09/03/2020,Matanuska-Susitna,3,GACH,1,192,125,60,65,14,5,9,11,1,10,2,0,2,192,125,60,65,14,5,9,11,1,10,2,0,2
09/03/2020,Northern,2,CAH,1,103,95,18,77,8,0,8,36,0,36,0,0,0,103,95,18,77,8,0,8,36,0,36,0,0,0
09/03/2020,Southeast,5,CAH,1,58,58,35,23,8,2,6,28,0,28,3,0,3,70,70,36,34,8,2,6,31,0,31,3,0,3
09/03/2020,Southeast,5,GACH,1,133,133,33,100,9,7,2,15,0,15,3,0,3,133,133,33,100,9,7,2,15,0,15,3,0,3
09/03/2020,Southwest,1,CAH,1,22,22,3,19,0,0,0,2,0,2,0,0,0,22,22,3,19,0,0,0,2,0,2,0,0,0
09/03/2020,Southwest,1,GACH,1,62,45,17,28,8,0,8,4,0,4,0,0,0,62,45,17,28,8,0,8,4,0,4,0,0,0
09/04/2020,Anchorage,7,GACH,1,950,362,591,99,158,87,71,203,20,183,20,0,20,950,763,591,195,158,87,71,203,20,183,20,0,20
09/04/2020,Anchorage,7,LTACH,0,51,,34,,11,7,4,24,1,23,0,0,0,51,45,34,15,11,7,4,24,1,23,0,0,0
09/04/2020,Anchorage,7,Psych,0,,,,,,,,,,,,,,116,86,53,33,0,0,0,0,0,0,0,0,0
09/04/2020,Gulf Coast,4,CAH,1,118,52,12,47,2,0,2,19,0,19,0,0,0,118,95,12,82,4,0,4,19,0,19,0,0,0
09/04/2020,Gulf Coast,4,GACH,1,120,120,36,84,9,3,6,9,1,8,0,0,0,120,120,36,84,9,3,6,9,1,8,0,0,0
09/04/2020,Interior,6,GACH,1,94,81,53,28,13,12,1,16,0,16,1,0,1,94,81,53,28,13,12,1,16,0,16,1,0,1
09/04/2020,Matanuska-Susitna,3,GACH,1,192,125,66,59,14,5,9,11,0,11,1,0,1,192,125,66,59,14,5,9,11,0,11,1,0,1
09/04/2020,Northern,2,CAH,1,135,61,18,50,8,0,8,36,0,36,0,0,0,135,95,18,77,8,0,8,36,0,36,0,0,0
09/04/2020,Southeast,5,CAH,1,70,70,35,35,8,2,6,32,0,32,2,0,2,70,70,35,35,8,2,6,32,0,32,2,0,2
09/04/2020,Southeast,5,GACH,1,133,133,32,101,9,5,4,15,0,15,3,0,3,133,133,32,101,9,5,4,15,0,15,3,0,3
09/04/2020,Southwest,1,CAH,1,22,22,1,21,0,0,0,2,0,2,0,0,0,22,22,1,21,0,0,0,2,0,2,0,0,0
09/04/2020,Southwest,1,GACH,1,62,45,13,32,8,0,8,4,0,4,0,0,0,62,45,13,32,8,0,8,4,0,4,0,0,0
09/05/2020,Anchorage,7,GACH,1,950,362,538,107,158,82,76,199,18,181,28,0,28,950,763,538,203,158,82,76,199,18,181,28,0,28
09/05/2020,Anchorage,7,LTACH,0,51,,34,,11,7,4,24,1,23,0,0,0,51,45,34,15,11,7,4,24,1,23,0,0,0
09/05/2020,Anchorage,7,Psych,0,,,,,,,,,,,,,,116,86,53,33,0,0,0,0,0,0,0,0,0
09/05/2020,Gulf Coast,4,CAH,1,118,52,14,46,2,1,2,19,0,19,0,0,0,118,95,14,81,4,1,4,19,0,19,0,0,0
09/05/2020,Gulf Coast,4,GACH,1,120,120,29,91,9,5,4,9,1,8,0,0,0,120,120,29,91,9,5,4,9,1,8,0,0,0
09/05/2020,Interior,6,GACH,1,94,81,50,31,13,9,4,16,2,14,2,0,2,94,81,50,31,13,9,4,16,2,14,2,0,2
09/05/2020,Matanuska-Susitna,3,GACH,1,192,125,63,62,14,10,4,11,2,9,1,0,1,192,125,63,62,14,10,4,11,2,9,1,0,1
09/05/2020,Northern,2,CAH,1,103,61,17,49,8,0,8,36,0,36,1,0,1,103,95,17,76,8,0,8,36,0,36,1,0,1
09/05/2020,Southeast,5,CAH,1,70,70,39,31,8,2,6,32,0,32,2,0,2,70,70,39,31,8,2,6,32,0,32,2,0,2
09/05/2020,Southeast,5,GACH,1,133,133,30,103,9,6,3,15,0,15,4,0,4,133,133,30,103,9,6,3,15,0,15,4,0,4
09/05/2020,Southwest,1,CAH,1,16,12,1,11,0,0,0,2,0,2,0,0,0,16,12,1,11,0,0,0,2,0,2,0,0,0
09/05/2020,Southwest,1,GACH,1,62,45,10,35,8,0,8,4,0,4,0,0,0,62,45,10,35,8,0,8,4,0,4,0,0,0
09/06/2020,Anchorage,7,GACH,1,950,362,525,117,158,87,71,199,19,180,23,0,23,950,763,525,213,158,87,71,199,19,180,23,0,23
09/06/2020,Anchorage,7,LTACH,0,51,,33,,11,7,4,24,2,22,0,0,0,51,45,33,15,11,7,4,24,2,22,0,0,0
09/06/2020,Anchorage,7,Psych,0,,,,,,,,,,,,,,116,86,53,33,0,0,0,0,0,0,0,0,0
09/06/2020,Gulf Coast,4,CAH,1,118,53,18,46,2,1,1,19,0,19,0,0,0,118,96,18,81,4,1,3,19,0,19,0,0,0
09/06/2020,Gulf Coast,4,GACH,1,120,120,30,90,9,2,7,9,0,9,0,0,0,120,120,30,90,9,2,7,9,0,9,0,0,0
09/06/2020,Interior,6,GACH,1,94,81,52,29,13,8,5,16,2,14,2,0,2,94,81,52,29,13,8,5,16,2,14,2,0,2
09/06/2020,Matanuska-Susitna,3,GACH,1,192,125,65,60,14,10,4,11,4,7,1,0,1,192,125,65,60,14,10,4,11,4,7,1,0,1
09/06/2020,Northern,2,CAH,1,103,61,16,49,8,0,8,36,0,36,0,0,0,103,95,16,76,8,0,8,36,0,36,0,0,0
09/06/2020,Southeast,5,CAH,1,70,70,37,33,8,2,6,32,0,32,2,0,2,70,70,37,33,8,2,6,32,0,32,2,0,2
09/06/2020,Southeast,5,GACH,1,133,133,28,105,9,2,7,15,0,15,3,0,3,133,133,28,105,9,2,7,15,0,15,3,0,3
09/06/2020,Southwest,1,CAH,1,16,12,2,10,0,0,0,2,0,2,0,0,0,16,12,2,10,0,0,0,2,0,2,0,0,0
09/06/2020,Southwest,1,GACH,1,62,45,11,34,8,0,8,4,0,4,0,0,0,62,45,11,34,8,0,8,4,0,4,0,0,0
09/07/2020,Anchorage,7,GACH,1,950,362,514,128,158,79,79,199,19,180,24,0,24,950,763,514,224,158,79,79,199,19,180,24,0,24
09/07/2020,Anchorage,7,LTACH,0,51,,33,,11,7,4,24,2,22,0,0,0,51,45,33,15,11,7,4,24,2,22,0,0,0
09/07/2020,Anchorage,7,Psych,0,,,,,,,,,,,,,,116,86,53,33,0,0,0,0,0,0,0,0,0
09/07/2020,Gulf Coast,4,CAH,1,118,53,14,46,2,0,2,19,0,19,0,0,0,118,96,14,81,4,0,4,19,0,19,0,0,0
09/07/2020,Gulf Coast,4,GACH,1,120,120,25,95,9,1,8,9,0,9,0,0,0,120,120,25,95,9,1,8,9,0,9,0,0,0
09/07/2020,Interior,6,GACH,1,94,81,58,23,13,9,4,16,1,15,2,0,2,94,81,58,23,13,9,4,16,1,15,2,0,2
09/07/2020,Matanuska-Susitna,3,GACH,1,192,125,77,48,14,12,2,11,3,8,2,0,2,192,125,77,48,14,12,2,11,3,8,2,0,2
09/07/2020,Northern,2,CAH,1,103,61,17,49,8,0,8,36,0,36,0,0,0,103,95,17,76,8,0,8,36,0,36,0,0,0
09/07/2020,Southeast,5,CAH,1,70,70,37,33,8,2,6,32,0,32,2,0,2,70,70,37,33,8,2,6,32,0,32,2,0,2
09/07/2020,Southeast,5,GACH,1,133,133,30,103,9,3,6,15,1,14,3,0,3,133,133,30,103,9,3,6,15,1,14,3,0,3
09/07/2020,Southwest,1,CAH,1,16,12,0,12,0,0,0,2,0,2,0,0,0,16,12,0,12,0,0,0,2,0,2,0,0,0
09/07/2020,Southwest,1,GACH,1,62,45,11,34,8,0,8,4,0,4,0,0,0,62,45,11,34,8,0,8,4,0,4,0,0,0
09/08/2020,Anchorage,7,GACH,1,950,362,550,129,158,87,71,199,23,176,24,1,25,950,763,550,225,158,87,71,199,23,176,24,1,25
09/08/2020,Anchorage,7,LTACH,0,51,,33,,11,7,4,24,2,22,0,0,0,51,45,33,15,11,7,4,24,2,22,0,0,0
09/08/2020,Anchorage,7,Psych,0,,,,,,,,,,,,,,116,86,53,33,0,0,0,0,0,0,0,0,0
09/08/2020,Gulf Coast,4,CAH,1,118,53,19,45,2,1,2,19,0,19,0,0,0,118,96,19,80,4,1,4,19,0,19,0,0,0
09/08/2020,Gulf Coast,4,GACH,1,120,120,31,89,9,4,5,9,0,9,0,0,0,120,120,31,89,9,4,5,9,0,9,0,0,0
09/08/2020,Interior,6,GACH,1,94,81,49,32,13,7,6,16,1,15,1,0,1,94,81,49,32,13,7,6,16,1,15,1,0,1
09/08/2020,Matanuska-Susitna,3,GACH,1,192,125,75,50,14,11,3,11,5,6,2,0,2,192,125,75,50,14,11,3,11,5,6,2,0,2
09/08/2020,Northern,2,CAH,1,103,61,18,47,8,0,8,36,0,36,0,0,0,103,95,18,74,8,0,8,36,0,36,0,0,0
09/08/2020,Southeast,5,CAH,1,70,70,34,36,8,2,6,32,0,32,2,0,2,70,70,34,36,8,2,6,32,0,32,2,0,2
09/08/2020,Southeast,5,GACH,1,133,133,29,104,9,4,5,15,0,15,3,0,3,133,133,29,104,9,4,5,15,0,15,3,0,3
09/08/2020,Southwest,1,CAH,1,22,22,1,21,0,0,0,2,0,2,0,0,0,22,22,1,21,0,0,0,2,0,2,0,0,0
09/08/2020,Southwest,1,GACH,1,62,45,11,34,8,0,8,4,0,4,0,0,0,62,45,11,34,8,0,8,4,0,4,0,0,0
09/09/2020,Anchorage,7,GACH,1,950,362,588,105,158,92,66,199,25,174,24,0,24,950,763,588,201,158,92,66,199,25,174,24,0,24
09/09/2020,Anchorage,7,LTACH,0,51,,33,,11,7,4,24,2,22,0,0,0,51,45,33,15,11,7,4,24,2,22,0,0,0
09/09/2020,Anchorage,7,Psych,0,,,,,,,,,,,,,,116,86,53,33,0,0,0,0,0,0,0,0,0
09/09/2020,Gulf Coast,4,CAH,1,118,53,18,45,2,1,2,19,0,19,0,0,0,118,96,18,80,4,1,4,19,0,19,0,0,0
09/09/2020,Gulf Coast,4,GACH,1,120,120,33,87,9,3,6,9,0,9,0,0,0,120,120,33,87,9,3,6,9,0,9,0,0,0
09/09/2020,Interior,6,GACH,1,94,81,45,36,13,13,0,16,1,15,1,0,1,94,81,45,36,13,13,0,16,1,15,1,0,1
09/09/2020,Matanuska-Susitna,3,GACH,1,192,125,91,34,14,9,5,11,4,7,2,0,2,192,125,91,34,14,9,5,11,4,7,2,0,2
09/09/2020,Northern,2,CAH,1,103,61,23,43,8,0,8,36,0,36,1,0,1,103,95,23,70,8,0,8,36,0,36,1,0,1
09/09/2020,Southeast,5,CAH,1,70,70,32,38,8,3,5,32,0,32,2,0,2,70,70,32,38,8,3,5,32,0,32,2,0,2
09/09/2020,Southeast,5,GACH,1,133,133,30,103,9,3,6,15,0,15,3,0,3,133,133,30,103,9,3,6,15,0,15,3,0,3
09/09/2020,Southwest,1,CAH,1,22,22,1,21,0,0,0,2,0,2,0,0,0,22,22,1,21,0,0,0,2,0,2,0,0,0
09/09/2020,Southwest,1,GACH,1,62,45,16,29,8,0,8,4,0,4,0,0,0,62,45,16,29,8,0,8,4,0,4,0,0,0
09/10/2020,Anchorage,7,GACH,1,950,362,609,92,158,90,68,199,28,171,22,0,22,950,763,609,188,158,90,68,199,28,171,22,0,22
09/10/2020,Anchorage,7,LTACH,0,51,,33,,11,7,4,24,2,22,0,0,0,51,45,33,15,11,7,4,24,2,22,0,0,0
09/10/2020,Anchorage,7,Psych,0,,,,,,,,,,,,,,116,86,53,33,0,0,0,0,0,0,0,0,0
09/10/2020,Gulf Coast,4,CAH,1,118,53,16,45,2,0,2,19,0,19,0,0,0,118,96,16,80,4,0,4,19,0,19,0,0,0
09/10/2020,Gulf Coast,4,GACH,1,120,120,31,89,9,4,5,9,0,9,1,0,1,120,120,31,89,9,4,5,9,0,9,1,0,1
09/10/2020,Interior,6,GACH,1,94,81,46,35,13,11,2,16,4,12,1,0,1,94,81,46,35,13,11,2,16,4,12,1,0,1
09/10/2020,Matanuska-Susitna,3,GACH,1,192,125,95,30,14,10,4,11,3,8,2,0,2,192,125,95,30,14,10,4,11,3,8,2,0,2
09/10/2020,Northern,2,CAH,1,103,61,23,45,8,0,8,36,17,19,1,0,1,103,95,23,72,8,0,8,36,17,19,1,0,1
09/10/2020,Southeast,5,CAH,1,70,70,37,33,8,0,8,32,0,32,2,0,2,70,70,37,33,8,0,8,32,0,32,2,0,2
09/10/2020,Southeast,5,GACH,1,161,133,31,102,9,3,6,20,0,20,4,0,4,161,133,31,102,9,3,6,20,0,20,4,0,4
09/10/2020,Southwest,1,CAH,1,22,22,2,20,0,0,0,2,0,2,0,0,0,22,22,2,20,0,0,0,2,0,2,0,0,0
09/10/2020,Southwest,1,GACH,1,62,45,14,31,8,0,8,4,0,4,0,0,0,62,45,14,31,8,0,8,4,0,4,0,0,0
09/11/2020,Anchorage,7,GACH,1,950,362,616,100,158,82,76,199,27,172,19,0,19,950,763,616,196,158,82,76,199,27,172,19,0,19
09/11/2020,Anchorage,7,LTACH,0,51,,33,,11,7,4,24,2,22,0,0,0,51,45,33,15,11,7,4,24,2,22,0,0,0
09/11/2020,Anchorage,7,Psych,0,,,,,,,,,,,,,,116,86,53,33,0,0,0,0,0,0,0,0,0
09/11/2020,Gulf Coast,4,CAH,1,118,52,14,46,2,0,2,19,0,19,0,0,0,118,95,14,81,4,0,4,19,0,19,0,0,0
09/11/2020,Gulf Coast,4,GACH,1,120,120,26,94,9,2,7,9,0,9,0,0,0,120,120,26,94,9,2,7,9,0,9,0,0,0
09/11/2020,Interior,6,GACH,1,94,81,48,33,13,7,6,16,4,12,1,0,1,94,81,48,33,13,7,6,16,4,12,1,0,1
09/11/2020,Matanuska-Susitna,3,GACH,1,192,125,85,40,14,7,7,11,2,9,2,0,2,192,125,85,40,14,7,7,11,2,9,2,0,2
09/11/2020,Northern,2,CAH,1,103,61,11,53,8,0,8,36,0,36,0,0,0,103,95,11,80,8,0,8,36,0,36,0,0,0
09/11/2020,Southeast,5,CAH,1,70,70,38,32,8,0,8,32,0,32,2,0,2,70,70,38,32,8,0,8,32,0,32,2,0,2
09/11/2020,Southeast,5,GACH,1,161,133,39,94,9,6,3,20,0,20,3,0,3,161,133,39,94,9,6,3,20,0,20,3,0,3
09/11/2020,Southwest,1,CAH,1,22,22,0,22,0,0,0,2,0,2,0,0,0,22,22,0,22,0,0,0,2,0,2,0,0,0
09/11/2020,Southwest,1,GACH,1,62,45,14,31,8,0,8,4,0,4,0,0,0,62,45,14,31,8,0,8,4,0,4,0,0,0
09/12/2020,Anchorage,7,GACH,1,954,362,586,86,158,91,67,199,26,173,21,1,22,954,763,586,182,158,91,67,199,26,173,21,1,22
09/12/2020,Anchorage,7,LTACH,0,51,,33,,11,7,4,24,2,22,0,0,0,51,45,33,15,11,7,4,24,2,22,0,0,0
09/12/2020,Anchorage,7,Psych,0,,,,,,,,,,,,,,116,86,53,33,0,0,0,0,0,0,0,0,0
09/12/2020,Gulf Coast,4,CAH,1,118,64,14,56,2,1,2,19,0,19,0,0,0,118,107,14,91,4,1,4,19,0,19,0,0,0
09/12/2020,Gulf Coast,4,GACH,1,120,120,28,92,9,4,5,9,0,9,0,0,0,120,120,28,92,9,4,5,9,0,9,0,0,0
09/12/2020,Interior,6,GACH,1,94,81,61,20,13,8,5,16,1,15,0,0,0,94,81,61,20,13,8,5,16,1,15,0,0,0
09/12/2020,Matanuska-Susitna,3,GACH,1,192,125,73,52,14,0,14,11,1,10,2,0,2,192,125,73,52,14,0,14,11,1,10,2,0,2
09/12/2020,Northern,2,CAH,1,103,61,14,51,8,0,8,36,0,36,0,0,0,103,95,14,78,8,0,8,36,0,36,0,0,0
09/12/2020,Southeast,5,CAH,1,70,70,38,32,8,0,8,32,0,32,2,0,2,70,70,38,32,8,0,8,32,0,32,2,0,2
09/12/2020,Southeast,5,GACH,1,161,133,38,95,9,6,3,20,0,20,3,0,3,161,133,38,95,9,6,3,20,0,20,3,0,3
09/12/2020,Southwest,1,CAH,1,16,12,1,11,0,0,0,2,0,2,0,0,0,16,12,1,11,0,0,0,2,0,2,0,0,0
09/12/2020,Southwest,1,GACH,1,62,45,14,31,8,0,8,4,0,4,0,0,0,62,45,14,31,8,0,8,4,0,4,0,0,0
09/13/2020,Anchorage,7,GACH,1,954,362,577,98,158,87,71,199,26,173,24,0,24,954,763,577,194,158,87,71,199,26,173,24,0,24
09/13/2020,Anchorage,7,LTACH,0,51,,32,,11,6,5,24,2,22,0,0,0,51,45,32,15,11,6,5,24,2,22,0,0,0
09/13/2020,Anchorage,7,Psych,0,,,,,,,,,,,,,,116,86,53,33,0,0,0,0,0,0,0,0,0
09/13/2020,Gulf Coast,4,CAH,1,118,52,15,45,2,1,2,19,0,19,0,1,1,118,95,15,80,4,1,4,19,0,19,0,1,1
09/13/2020,Gulf Coast,4,GACH,1,120,120,29,91,9,2,7,9,0,9,0,0,0,120,120,29,91,9,2,7,9,0,9,0,0,0
09/13/2020,Interior,6,GACH,1,94,81,60,21,13,8,5,16,2,14,0,0,0,94,81,60,21,13,8,5,16,2,14,0,0,0
09/13/2020,Matanuska-Susitna,3,GACH,1,192,125,68,57,14,7,7,11,0,11,1,0,1,192,125,68,57,14,7,7,11,0,11,1,0,1
09/13/2020,Northern,2,CAH,1,103,61,16,50,8,0,8,36,0,36,0,0,0,103,95,16,77,8,0,8,36,0,36,0,0,0
09/13/2020,Southeast,5,CAH,1,70,70,33,37,8,0,8,32,0,32,2,0,2,70,70,33,37,8,0,8,32,0,32,2,0,2
09/13/2020,Southeast,5,GACH,1,133,133,31,102,9,5,4,15,0,15,3,0,3,133,133,31,102,9,5,4,15,0,15,3,0,3
09/13/2020,Southwest,1,CAH,1,16,12,2,10,0,0,0,2,0,2,0,0,0,16,12,2,10,0,0,0,2,0,2,0,0,0
09/13/2020,Southwest,1,GACH,1,62,45,13,32,8,0,8,4,0,4,0,0,0,62,45,13,32,8,0,8,4,0,4,0,0,0
09/14/2020,Anchorage,7,GACH,1,954,362,599,109,158,88,70,199,28,171,30,2,32,954,763,599,205,158,88,70,199,28,171,30,2,32
09/14/2020,Anchorage,7,LTACH,0,51,,32,,11,6,5,24,2,22,0,0,0,51,45,32,15,11,6,5,24,2,22,0,0,0
09/14/2020,Anchorage,7,Psych,0,,,,,,,,,,,,,,116,86,53,33,0,0,0,0,0,0,0,0,0
09/14/2020,Gulf Coast,4,CAH,1,118,52,18,43,2,1,2,19,0,19,0,0,0,118,95,18,78,4,1,4,19,0,19,0,0,0
09/14/2020,Gulf Coast,4,GACH,1,120,120,31,89,9,6,3,9,1,8,0,0,0,120,120,31,89,9,6,3,9,1,8,0,0,0
09/14/2020,Interior,6,GACH,1,94,81,47,34,13,8,5,16,3,13,0,0,0,94,81,47,34,13,8,5,16,3,13,0,0,0
09/14/2020,Matanuska-Susitna,3,GACH,1,192,125,69,56,14,11,3,11,0,11,2,0,2,192,125,69,56,14,11,3,11,0,11,2,0,2
09/14/2020,Northern,2,CAH,1,105,29,16,18,0,0,0,36,0,36,0,0,0,105,63,16,45,0,0,0,36,0,36,0,0,0
09/14/2020,Southeast,5,CAH,1,70,70,33,37,8,0,8,32,0,32,2,0,2,70,70,33,37,8,0,8,32,0,32,2,0,2
09/14/2020,Southeast,5,GACH,1,161,133,32,101,9,6,3,20,0,20,3,0,3,161,133,32,101,9,6,3,20,0,20,3,0,3
09/14/2020,Southwest,1,CAH,1,22,22,0,22,0,0,0,2,0,2,0,0,0,22,22,0,22,0,0,0,2,0,2,0,0,0
09/14/2020,Southwest,1,GACH,1,62,45,13,32,8,0,8,4,0,4,0,0,0,62,45,13,32,8,0,8,4,0,4,0,0,0
09/15/2020,Anchorage,7,GACH,1,954,362,625,103,158,96,62,201,31,170,27,2,29,954,763,625,199,158,96,62,201,31,170,27,2,29
09/15/2020,Anchorage,7,LTACH,0,51,,31,,11,5,6,24,3,21,0,0,0,51,45,31,15,11,5,6,24,3,21,0,0,0
09/15/2020,Anchorage,7,Psych,0,,,,,,,,,,,,,,116,86,53,33,0,0,0,0,0,0,0,0,0
09/15/2020,Gulf Coast,4,CAH,1,118,52,19,44,2,0,2,19,0,19,0,0,0,118,95,19,79,4,0,4,19,0,19,0,0,0
09/15/2020,Gulf Coast,4,GACH,1,120,120,39,81,9,4,5,9,0,9,0,0,0,120,120,39,81,9,4,5,9,0,9,0,0,0
09/15/2020,Interior,6,GACH,1,94,81,58,23,13,9,4,16,2,14,1,0,1,94,81,58,23,13,9,4,16,2,14,1,0,1
09/15/2020,Matanuska-Susitna,3,GACH,1,192,125,74,51,14,8,6,11,0,11,1,0,1,192,125,74,51,14,8,6,11,0,11,1,0,1
09/15/2020,Northern,2,CAH,1,105,29,15,19,0,0,0,36,0,36,1,0,1,105,63,15,46,0,0,0,36,0,36,1,0,1
09/15/2020,Southeast,5,CAH,1,53,53,16,37,6,0,6,28,0,28,0,0,0,53,53,16,37,6,0,6,28,0,28,0,0,0
09/15/2020,Southeast,5,GACH,1,161,133,32,101,9,3,6,20,0,20,3,0,3,161,133,32,101,9,3,6,20,0,20,3,0,3
09/15/2020,Southwest,1,CAH,1,22,22,1,21,0,0,0,2,0,2,0,0,0,22,22,1,21,0,0,0,2,0,2,0,0,0
09/15/2020,Southwest,1,GACH,1,62,45,15,30,8,0,8,4,0,4,0,0,0,62,45,15,30,8,0,8,4,0,4,0,0,0
09/16/2020,Anchorage,7,GACH,1,954,362,626,95,158,97,61,201,39,162,22,1,23,954,763,626,191,158,97,61,201,39,162,22,1,23
09/16/2020,Anchorage,7,LTACH,0,51,,30,,11,5,6,24,3,21,0,0,0,51,45,30,15,11,5,6,24,3,21,0,0,0
09/16/2020,Anchorage,7,Psych,0,,,,,,,,,,,,,,116,86,53,33,0,0,0,0,0,0,0,0,0
09/16/2020,Gulf Coast,4,CAH,1,118,51,31,37,2,1,2,19,0,19,0,0,0,118,94,31,72,4,1,4,19,0,19,0,0,0
09/16/2020,Gulf Coast,4,GACH,1,120,120,37,83,9,3,6,9,0,9,0,0,0,120,120,37,83,9,3,6,9,0,9,0,0,0
09/16/2020,Interior,6,GACH,1,94,81,66,15,13,10,3,16,1,15,1,0,1,94,81,66,15,13,10,3,16,1,15,1,0,1
09/16/2020,Matanuska-Susitna,3,GACH,1,192,125,88,37,14,9,5,11,11,0,1,0,1,192,125,88,37,14,9,5,11,11,0,1,0,1
09/16/2020,Northern,2,CAH,1,105,29,11,21,0,0,0,36,0,36,2,0,2,105,63,11,48,0,0,0,36,0,36,2,0,2
09/16/2020,Southeast,5,CAH,1,70,70,32,38,8,0,8,32,0,32,1,0,1,70,70,32,38,8,0,8,32,0,32,1,0,1
09/16/2020,Southeast,5,GACH,1,161,133,38,95,9,4,5,20,2,18,3,0,3,161,133,38,95,9,4,5,20,2,18,3,0,3
09/16/2020,Southwest,1,CAH,1,22,22,2,20,0,0,0,2,0,2,0,0,0,22,22,2,20,0,0,0,2,0,2,0,0,0
09/16/2020,Southwest,1,GACH,1,62,45,16,29,8,0,8,4,0,4,0,0,0,62,45,16,29,8,0,8,4,0,4,0,0,0
09/17/2020,Anchorage,7,GACH,1,954,362,664,91,158,97,61,199,41,158,20,1,21,954,763,664,187,158,97,61,199,41,158,20,1,21
09/17/2020,Anchorage,7,LTACH,0,51,,29,,11,5,6,24,3,21,0,0,0,51,45,29,15,11,5,6,24,3,21,0,0,0
09/17/2020,Anchorage,7,Psych,0,,,,,,,,,,,,,,116,86,53,33,0,0,0,0,0,0,0,0,0
09/17/2020,Gulf Coast,4,CAH,1,118,51,26,38,2,1,1,19,0,19,0,0,0,118,94,26,73,4,1,3,19,0,19,0,0,0
09/17/2020,Gulf Coast,4,GACH,1,120,120,38,82,9,2,7,9,0,9,1,0,1,120,120,38,82,9,2,7,9,0,9,1,0,1
09/17/2020,Interior,6,GACH,1,94,81,58,23,13,7,6,16,2,14,0,0,0,94,81,58,23,13,7,6,16,2,14,0,0,0
09/17/2020,Matanuska-Susitna,3,GACH,1,192,125,86,39,14,9,5,11,1,10,0,0,0,192,125,86,39,14,9,5,11,1,10,0,0,0
09/17/2020,Northern,2,CAH,1,105,29,12,20,0,0,0,36,0,36,0,0,0,105,63,12,47,0,0,0,36,0,36,0,0,0
09/17/2020,Southeast,5,CAH,1,70,70,30,40,8,2,6,32,0,32,1,0,1,70,70,30,40,8,2,6,32,0,32,1,0,1
09/17/2020,Southeast,5,GACH,1,161,133,35,98,9,4,5,20,0,20,3,0,3,161,133,35,98,9,4,5,20,0,20,3,0,3
09/17/2020,Southwest,1,CAH,1,22,22,2,20,0,0,0,2,0,2,0,0,0,22,22,2,20,0,0,0,2,0,2,0,0,0
09/17/2020,Southwest,1,GACH,1,62,45,16,29,8,0,8,4,0,4,0,0,0,62,45,16,29,8,0,8,4,0,4,0,0,0
09/18/2020,Anchorage,7,GACH,1,954,362,662,84,158,97,61,199,46,153,26,1,27,954,763,662,180,158,97,61,199,46,153,26,1,27
09/18/2020,Anchorage,7,LTACH,0,51,,26,,11,4,7,24,3,21,0,0,0,51,45,26,15,11,4,7,24,3,21,0,0,0
09/18/2020,Anchorage,7,Psych,0,,,,,,,,,,,,,,116,86,53,33,0,0,0,0,0,0,0,0,0
09/18/2020,Gulf Coast,4,CAH,1,112,51,21,41,2,2,1,19,0,19,0,0,0,112,94,21,76,4,2,3,19,0,19,0,0,0
09/18/2020,Gulf Coast,4,GACH,1,120,120,35,85,9,2,7,9,0,9,1,0,1,120,120,35,85,9,2,7,9,0,9,1,0,1
09/18/2020,Interior,6,GACH,1,94,81,57,24,13,10,3,16,2,14,1,0,1,94,81,57,24,13,10,3,16,2,14,1,0,1
09/18/2020,Matanuska-Susitna,3,GACH,1,192,125,87,38,14,8,6,11,1,10,0,0,0,192,125,87,38,14,8,6,11,1,10,0,0,0
09/18/2020,Northern,2,CAH,1,105,29,19,16,0,0,0,36,0,36,0,0,0,105,63,19,43,0,0,0,36,0,36,0,0,0
09/18/2020,Southeast,5,CAH,1,70,70,29,41,8,1,7,32,0,32,1,0,1,70,70,29,41,8,1,7,32,0,32,1,0,1
09/18/2020,Southeast,5,GACH,1,161,133,32,101,9,3,6,20,0,20,3,0,3,161,133,32,101,9,3,6,20,0,20,3,0,3
09/18/2020,Southwest,1,CAH,1,22,12,2,10,0,0,0,2,0,2,0,0,0,22,12,2,10,0,0,0,2,0,2,0,0,0
09/18/2020,Southwest,1,GACH,1,62,45,14,31,8,0,8,4,0,4,0,0,0,62,45,14,31,8,0,8,4,0,4,0,0,0
09/19/2020,Anchorage,7,GACH,1,954,362,623,85,158,96,62,197,40,157,26,0,26,954,763,623,181,158,96,62,197,40,157,26,0,26
09/19/2020,Anchorage,7,LTACH,0,51,,26,,11,4,7,24,3,21,0,0,0,51,45,26,15,11,4,7,24,3,21,0,0,0
09/19/2020,Anchorage,7,Psych,0,,,,,,,,,,,,,,116,86,53,33,0,0,0,0,0,0,0,0,0
09/19/2020,Gulf Coast,4,CAH,1,112,52,23,38,2,0,2,19,0,19,0,0,0,112,95,23,73,4,0,4,19,0,19,0,0,0
09/19/2020,Gulf Coast,4,GACH,1,120,52,35,17,9,3,6,9,0,9,2,0,2,120,52,35,17,9,3,6,9,0,9,2,0,2
09/19/2020,Interior,6,GACH,1,94,81,61,20,13,8,5,16,2,14,1,0,1,94,81,61,20,13,8,5,16,2,14,1,0,1
09/19/2020,Matanuska-Susitna,3,GACH,1,192,125,86,39,14,5,9,11,1,10,0,0,0,192,125,86,39,14,5,9,11,1,10,0,0,0
09/19/2020,Northern,2,CAH,1,137,29,14,22,0,0,0,36,0,36,0,0,0,137,63,14,49,0,0,0,36,0,36,0,0,0
09/19/2020,Southeast,5,CAH,1,70,70,26,44,8,1,7,32,0,32,2,0,2,70,70,26,44,8,1,7,32,0,32,2,0,2
09/19/2020,Southeast,5,GACH,1,161,133,31,102,9,4,5,20,0,20,3,0,3,161,133,31,102,9,4,5,20,0,20,3,0,3
09/19/2020,Southwest,1,CAH,1,,,,,,,,,,,,,,22,12,2,10,0,0,0,2,0,2,0,0,0
09/19/2020,Southwest,1,GACH,1,62,45,14,31,8,0,8,4,0,4,0,0,0,62,45,14,31,8,0,8,4,0,4,0,0,0
09/20/2020,Anchorage,7,GACH,1,954,362,616,92,158,98,60,197,40,157,30,0,30,954,763,616,188,158,98,60,197,40,157,30,0,30
09/20/2020,Anchorage,7,LTACH,0,51,,28,,11,5,6,24,3,21,0,0,0,51,45,28,15,11,5,6,24,3,21,0,0,0
09/20/2020,Anchorage,7,Psych,0,,,,,,,,,,,,,,116,86,53,33,0,0,0,0,0,0,0,0,0
09/20/2020,Gulf Coast,4,CAH,1,112,51,27,36,2,0,2,19,0,19,0,0,0,112,94,27,71,4,0,4,19,0,19,0,0,0
09/20/2020,Gulf Coast,4,GACH,1,120,52,34,18,9,6,3,9,0,9,1,0,1,120,52,34,18,9,6,3,9,0,9,1,0,1
09/20/2020,Interior,6,GACH,1,94,81,52,29,13,7,6,16,3,13,1,0,1,94,81,52,29,13,7,6,16,3,13,1,0,1
09/20/2020,Matanuska-Susitna,3,GACH,1,192,125,69,56,14,6,8,11,1,10,0,0,0,192,125,69,56,14,6,8,11,1,10,0,0,0
09/20/2020,Northern,2,CAH,1,137,29,21,17,0,0,0,36,0,36,0,0,0,137,63,21,44,0,0,0,36,0,36,0,0,0
09/20/2020,Southeast,5,CAH,1,70,70,26,44,8,1,7,32,0,32,1,0,1,70,70,26,44,8,1,7,32,0,32,1,0,1
09/20/2020,Southeast,5,GACH,1,161,133,32,101,9,5,4,20,1,19,4,0,4,161,133,32,101,9,5,4,20,1,19,4,0,4
09/20/2020,Southwest,1,CAH,1,,,,,,,,,,,,,,22,12,2,10,0,0,0,2,0,2,0,0,0
09/20/2020,Southwest,1,GACH,1,62,45,15,30,8,0,8,4,0,4,0,0,0,62,45,15,30,8,0,8,4,0,4,0,0,0
09/21/2020,Anchorage,7,GACH,1,954,796,627,169,164,97,67,197,43,154,28,0,28,954,796,627,169,164,97,67,197,43,154,28,0,28
09/21/2020,Anchorage,7,LTACH,0,36,36,28,8,3,3,0,24,3,21,0,0,0,36,36,28,8,3,3,0,24,3,21,0,0,0
09/21/2020,Anchorage,7,Psych,0,,,,,,,,,,,,,,116,86,53,33,0,0,0,0,0,0,0,0,0
09/21/2020,Gulf Coast,4,CAH,1,116,85,27,61,4,0,4,19,0,19,0,0,0,116,94,27,69,4,0,4,19,0,19,0,0,0
09/21/2020,Gulf Coast,4,GACH,1,120,52,29,23,9,3,6,9,0,9,1,0,1,120,52,29,23,9,3,6,9,0,9,1,0,1
09/21/2020,Interior,6,GACH,1,94,81,42,39,13,9,4,16,2,14,1,0,1,94,81,42,39,13,9,4,16,2,14,1,0,1
09/21/2020,Matanuska-Susitna,3,GACH,1,192,,76,,14,6,8,11,3,8,0,0,0,192,125,76,56,14,6,8,11,3,8,0,0,0
09/21/2020,Northern,2,CAH,1,142,63,18,45,0,0,0,36,0,36,1,0,1,142,63,18,45,0,0,0,36,0,36,1,0,1
09/21/2020,Southeast,5,CAH,1,70,70,28,42,8,2,6,32,0,32,1,0,1,70,70,28,42,8,2,6,32,0,32,1,0,1
09/21/2020,Southeast,5,GACH,1,161,133,40,93,9,7,2,20,0,20,3,0,3,161,133,40,93,9,7,2,20,0,20,3,0,3
09/21/2020,Southwest,1,CAH,1,22,12,2,10,0,0,0,2,0,2,0,0,0,22,12,2,10,0,0,0,2,0,2,0,0,0
09/21/2020,Southwest,1,GACH,1,62,45,16,29,8,0,8,4,0,4,0,0,0,62,45,16,29,8,0,8,4,0,4,0,0,0
09/22/2020,Anchorage,7,GACH,1,954,796,677,119,164,108,56,197,38,159,29,0,29,954,796,677,119,164,108,56,197,38,159,29,0,29
09/22/2020,Anchorage,7,LTACH,0,36,36,28,8,5,5,0,24,3,21,0,0,0,36,36,28,8,5,5,0,24,3,21,0,0,0
09/22/2020,Anchorage,7,Psych,0,,,,,,,,,,,,,,116,86,53,33,0,0,0,0,0,0,0,0,0
09/22/2020,Gulf Coast,4,CAH,1,122,90,21,69,4,0,4,17,0,17,0,0,0,122,90,21,69,4,0,4,17,0,17,0,0,0
09/22/2020,Gulf Coast,4,GACH,1,120,52,27,25,9,2,7,9,0,9,1,0,1,120,52,27,25,9,2,7,9,0,9,1,0,1
09/22/2020,Interior,6,GACH,1,94,81,55,26,13,11,2,16,2,14,0,0,0,94,81,55,26,13,11,2,16,2,14,0,0,0
09/22/2020,Matanuska-Susitna,3,GACH,1,192,125,79,46,14,9,5,11,2,9,0,0,0,192,125,79,46,14,9,5,11,2,9,0,0,0
09/22/2020,Northern,2,CAH,1,142,63,18,45,0,0,0,36,0,36,1,0,1,142,63,18,45,0,0,0,36,0,36,1,0,1
09/22/2020,Southeast,5,CAH,1,70,70,26,44,8,2,6,32,0,32,1,0,1,70,70,26,44,8,2,6,32,0,32,1,0,1
09/22/2020,Southeast,5,GACH,1,161,133,38,95,9,5,4,20,0,20,4,0,4,161,133,38,95,9,5,4,20,0,20,4,0,4
09/22/2020,Southwest,1,CAH,1,22,12,2,10,0,0,0,2,0,2,0,0,0,22,12,2,10,0,0,0,2,0,2,0,0,0
09/22/2020,Southwest,1,GACH,1,53,45,11,34,0,0,0,4,0,4,0,0,0,53,45,11,34,0,0,0,4,0,4,0,0,0
09/23/2020,Anchorage,7,GACH,1,954,796,664,132,164,105,59,197,40,157,28,1,29,954,796,664,132,164,105,59,197,40,157,28,1,29
09/23/2020,Anchorage,7,LTACH,0,36,36,28,8,5,5,0,24,3,21,0,0,0,36,36,28,8,5,5,0,24,3,21,0,0,0
09/23/2020,Anchorage,7,Psych,0,,,,,,,,,,,,,,116,86,53,33,0,0,0,0,0,0,0,0,0
09/23/2020,Gulf Coast,4,CAH,1,122,90,23,67,4,1,3,17,0,17,0,0,0,122,90,23,67,4,1,3,17,0,17,0,0,0
09/23/2020,Gulf Coast,4,GACH,1,120,52,33,19,9,3,6,9,0,9,1,0,1,120,52,33,19,9,3,6,9,0,9,1,0,1
09/23/2020,Interior,6,GACH,1,94,81,56,25,13,12,1,16,2,14,1,0,1,94,81,56,25,13,12,1,16,2,14,1,0,1
09/23/2020,Matanuska-Susitna,3,GACH,1,192,125,81,44,14,12,2,11,2,9,0,0,0,192,125,81,44,14,12,2,11,2,9,0,0,0
09/23/2020,Northern,2,CAH,1,142,63,21,42,0,0,0,36,0,36,1,0,1,142,63,21,42,0,0,0,36,0,36,1,0,1
09/23/2020,Southeast,5,CAH,1,70,70,24,46,8,2,6,32,0,32,1,0,1,70,70,24,46,8,2,6,32,0,32,1,0,1
09/23/2020,Southeast,5,GACH,1,161,133,33,100,9,6,3,20,0,20,4,0,4,161,133,33,100,9,6,3,20,0,20,4,0,4
09/23/2020,Southwest,1,CAH,1,22,12,4,8,0,0,0,2,0,2,0,0,0,22,12,4,8,0,0,0,2,0,2,0,0,0
09/23/2020,Southwest,1,GACH,1,53,45,12,33,0,0,0,4,0,4,0,0,0,53,45,12,33,0,0,0,4,0,4,0,0,0
09/24/2020,Anchorage,7,GACH,1,954,796,630,166,164,104,60,197,45,152,27,1,28,954,796,630,166,164,104,60,197,45,152,27,1,28
09/24/2020,Anchorage,7,LTACH,0,36,36,25,11,6,6,0,24,3,21,0,0,0,36,36,25,11,6,6,0,24,3,21,0,0,0
09/24/2020,Anchorage,7,Psych,0,53,,53,,,,,0,0,0,0,0,0,89,86,61,33,0,0,0,0,0,0,0,0,0
09/24/2020,Gulf Coast,4,CAH,1,122,90,18,72,4,0,4,17,0,17,0,0,0,122,90,18,72,4,0,4,17,0,17,0,0,0
09/24/2020,Gulf Coast,4,GACH,1,120,52,35,17,9,5,4,9,0,9,2,0,2,120,52,35,17,9,5,4,9,0,9,2,0,2
09/24/2020,Interior,6,GACH,1,94,81,61,20,13,8,5,16,2,14,1,0,1,94,81,61,20,13,8,5,16,2,14,1,0,1
09/24/2020,Matanuska-Susitna,3,GACH,1,,,,,,,,,,,,,,192,125,81,44,14,12,2,11,2,9,0,0,0
09/24/2020,Northern,2,CAH,1,142,63,16,47,0,0,0,36,0,36,1,0,1,142,63,16,47,0,0,0,36,0,36,1,0,1
09/24/2020,Southeast,5,CAH,1,70,70,29,41,8,1,7,32,0,32,1,0,1,70,70,29,41,8,1,7,32,0,32,1,0,1
09/24/2020,Southeast,5,GACH,1,161,133,35,98,9,4,5,20,0,20,4,0,4,161,133,35,98,9,4,5,20,0,20,4,0,4
09/24/2020,Southwest,1,CAH,1,22,12,4,8,0,0,0,2,0,2,0,0,0,22,12,4,8,0,0,0,2,0,2,0,0,0
09/24/2020,Southwest,1,GACH,1,53,45,13,32,0,0,0,4,0,4,0,0,0,53,45,13,32,0,0,0,4,0,4,0,0,0
09/25/2020,Anchorage,7,GACH,1,954,796,662,134,164,107,57,197,37,160,26,0,26,954,796,662,134,164,107,57,197,37,160,26,0,26
09/25/2020,Anchorage,7,LTACH,0,36,36,25,11,6,6,0,24,3,21,0,0,0,36,36,25,11,6,6,0,24,3,21,0,0,0
09/25/2020,Anchorage,7,Psych,0,55,,55,,,,,0,0,0,0,0,0,91,86,63,33,0,0,0,0,0,0,0,0,0
09/25/2020,Gulf Coast,4,CAH,1,122,90,24,66,4,1,3,17,0,17,0,0,0,122,90,24,66,4,1,3,17,0,17,0,0,0
09/25/2020,Gulf Coast,4,GACH,1,120,52,39,13,9,5,4,9,0,9,1,0,1,120,52,39,13,9,5,4,9,0,9,1,0,1
09/25/2020,Interior,6,GACH,1,94,81,59,22,13,10,3,16,1,15,1,0,1,94,81,59,22,13,10,3,16,1,15,1,0,1
09/25/2020,Matanuska-Susitna,3,GACH,1,192,125,72,53,14,13,1,11,0,11,0,0,0,192,125,72,53,14,13,1,11,0,11,0,0,0
09/25/2020,Northern,2,CAH,1,142,63,15,48,0,0,0,36,0,36,2,0,2,142,63,15,48,0,0,0,36,0,36,2,0,2
09/25/2020,Southeast,5,CAH,1,70,70,34,36,8,1,7,32,0,32,1,0,1,70,70,34,36,8,1,7,32,0,32,1,0,1
09/25/2020,Southeast,5,GACH,1,161,133,34,99,9,4,5,20,0,20,5,0,5,161,133,34,99,9,4,5,20,0,20,5,0,5
09/25/2020,Southwest,1,CAH,1,22,12,4,8,0,0,0,2,0,2,0,0,0,22,12,4,8,0,0,0,2,0,2,0,0,0
09/25/2020,Southwest,1,GACH,1,53,45,17,28,0,0,0,4,0,4,0,0,0,53,45,17,28,0,0,0,4,0,4,0,0,0
09/26/2020,Anchorage,7,GACH,1,954,796,592,204,164,105,59,197,30,167,27,0,27,954,796,592,204,164,105,59,197,30,167,27,0,27
09/26/2020,Anchorage,7,LTACH,0,36,36,26,10,6,6,0,24,3,21,0,0,0,36,36,26,10,6,6,0,24,3,21,0,0,0
09/26/2020,Anchorage,7,Psych,0,,,,,,,,,,,,,,91,86,63,33,0,0,0,0,0,0,0,0,0
09/26/2020,Gulf Coast,4,CAH,1,122,90,15,75,4,1,3,17,0,17,0,0,0,122,90,15,75,4,1,3,17,0,17,0,0,0
09/26/2020,Gulf Coast,4,GACH,1,120,52,38,14,9,5,4,9,0,9,1,0,1,120,52,38,14,9,5,4,9,0,9,1,0,1
09/26/2020,Interior,6,GACH,1,94,81,62,19,13,10,3,16,1,15,1,0,1,94,81,62,19,13,10,3,16,1,15,1,0,1
09/26/2020,Matanuska-Susitna,3,GACH,1,192,125,67,58,14,10,4,11,2,9,0,0,0,192,125,67,58,14,10,4,11,2,9,0,0,0
09/26/2020,Northern,2,CAH,1,142,63,18,45,0,0,0,36,0,36,2,0,2,142,63,18,45,0,0,0,36,0,36,2,0,2
09/26/2020,Southeast,5,CAH,1,58,58,30,28,8,1,7,29,0,29,0,0,0,70,70,32,38,8,1,7,32,0,32,0,0,0
09/26/2020,Southeast,5,GACH,1,161,133,28,105,9,2,7,20,0,20,3,0,3,161,133,28,105,9,2,7,20,0,20,3,0,3
09/26/2020,Southwest,1,CAH,1,,,,,,,,,,,,,,22,12,4,8,0,0,0,2,0,2,0,0,0
09/26/2020,Southwest,1,GACH,1,53,45,17,28,0,0,0,4,0,4,0,0,0,53,45,17,28,0,0,0,4,0,4,0,0,0
09/27/2020,Anchorage,7,GACH,1,954,796,600,196,164,107,57,197,33,164,23,0,23,954,796,600,196,164,107,57,197,33,164,23,0,23
09/27/2020,Anchorage,7,LTACH,0,36,36,26,10,6,6,0,24,3,21,0,0,0,36,36,26,10,6,6,0,24,3,21,0,0,0
09/27/2020,Anchorage,7,Psych,0,,,,,,,,,,,,,,91,86,63,33,0,0,0,0,0,0,0,0,0
09/27/2020,Gulf Coast,4,CAH,1,122,90,16,74,4,2,2,17,0,17,0,0,0,122,90,16,74,4,2,2,17,0,17,0,0,0
09/27/2020,Gulf Coast,4,GACH,1,120,52,37,15,9,6,3,10,0,10,1,0,1,120,52,37,15,9,6,3,10,0,10,1,0,1
09/27/2020,Interior,6,GACH,1,94,81,56,25,13,7,6,16,1,15,1,0,1,94,81,56,25,13,7,6,16,1,15,1,0,1
09/27/2020,Matanuska-Susitna,3,GACH,1,192,125,67,58,14,12,2,11,3,8,0,0,0,192,125,67,58,14,12,2,11,3,8,0,0,0
09/27/2020,Northern,2,CAH,1,142,63,17,46,0,0,0,36,0,36,3,0,3,142,63,17,46,0,0,0,36,0,36,3,0,3
09/27/2020,Southeast,5,CAH,1,58,58,34,24,8,1,7,29,0,29,1,0,1,70,70,36,34,8,1,7,32,0,32,1,0,1
09/27/2020,Southeast,5,GACH,1,161,133,31,102,9,4,5,20,0,20,3,0,3,161,133,31,102,9,4,5,20,0,20,3,0,3
09/27/2020,Southwest,1,CAH,1,,,,,,,,,,,,,,22,12,4,8,0,0,0,2,0,2,0,0,0
09/27/2020,Southwest,1,GACH,1,53,45,16,29,0,0,0,4,0,4,0,0,0,53,45,16,29,0,0,0,4,0,4,0,0,0
09/28/2020,Anchorage,7,GACH,1,954,796,623,173,164,106,58,197,38,159,25,1,26,954,796,623,173,164,106,58,197,38,159,25,1,26
09/28/2020,Anchorage,7,LTACH,0,36,36,26,10,6,6,0,24,3,21,0,0,0,36,36,26,10,6,6,0,24,3,21,0,0,0
09/28/2020,Anchorage,7,Psych,0,60,,60,,,,,0,0,0,0,0,0,96,86,68,33,0,0,0,0,0,0,0,0,0
09/28/2020,Gulf Coast,4,CAH,1,122,90,20,70,4,1,3,17,0,17,0,0,0,122,90,20,70,4,1,3,17,0,17,0,0,0
09/28/2020,Gulf Coast,4,GACH,1,120,52,40,12,9,6,3,10,0,10,1,0,1,120,52,40,12,9,6,3,10,0,10,1,0,1
09/28/2020,Interior,6,GACH,1,94,81,49,32,13,8,5,16,1,15,1,0,1,94,81,49,32,13,8,5,16,1,15,1,0,1
09/28/2020,Matanuska-Susitna,3,GACH,1,192,125,81,44,14,12,2,11,2,9,0,0,0,192,125,81,44,14,12,2,11,2,9,0,0,0
09/28/2020,Northern,2,CAH,1,142,63,18,45,0,0,0,36,0,36,5,0,5,142,63,18,45,0,0,0,36,0,36,5,0,5
09/28/2020,Southeast,5,CAH,1,70,70,42,28,8,5,3,32,1,31,1,0,1,70,70,42,28,8,5,3,32,1,31,1,0,1
09/28/2020,Southeast,5,GACH,1,161,133,28,105,9,3,6,20,0,20,3,0,3,161,133,28,105,9,3,6,20,0,20,3,0,3
09/28/2020,Southwest,1,CAH,1,22,12,1,11,0,0,0,2,0,2,0,0,0,22,12,1,11,0,0,0,2,0,2,0,0,0
09/28/2020,Southwest,1,GACH,1,53,45,21,24,0,0,0,4,0,4,0,0,0,53,45,21,24,0,0,0,4,0,4,0,0,0
09/29/2020,Anchorage,7,GACH,1,954,796,649,147,164,107,57,197,38,159,25,0,25,954,796,649,147,164,107,57,197,38,159,25,0,25
09/29/2020,Anchorage,7,LTACH,0,36,36,28,8,6,6,0,24,1,23,0,0,0,36,36,28,8,6,6,0,24,1,23,0,0,0
09/29/2020,Anchorage,7,Psych,0,,,,,,,,,,,,,,96,86,68,33,0,0,0,0,0,0,0,0,0
09/29/2020,Gulf Coast,4,CAH,1,122,90,21,69,4,1,3,17,0,17,0,0,0,122,90,21,69,4,1,3,17,0,17,0,0,0
09/29/2020,Gulf Coast,4,GACH,1,120,52,40,12,9,4,5,10,0,10,0,0,0,120,52,40,12,9,4,5,10,0,10,0,0,0
09/29/2020,Interior,6,GACH,1,94,81,53,28,13,8,5,16,1,15,1,0,1,94,81,53,28,13,8,5,16,1,15,1,0,1
09/29/2020,Matanuska-Susitna,3,GACH,1,192,125,90,35,14,13,1,11,3,8,0,0,0,192,125,90,35,14,13,1,11,3,8,0,0,0
09/29/2020,Northern,2,CAH,1,142,68,19,49,0,0,0,36,0,36,5,0,5,142,68,19,49,0,0,0,36,0,36,5,0,5
09/29/2020,Southeast,5,CAH,1,70,70,45,25,8,5,3,32,1,31,1,0,1,70,70,45,25,8,5,3,32,1,31,1,0,1
09/29/2020,Southeast,5,GACH,1,161,133,32,101,9,4,5,20,0,20,1,0,1,161,133,32,101,9,4,5,20,0,20,1,0,1
09/29/2020,Southwest,1,CAH,1,22,12,2,10,0,0,0,2,0,2,0,0,0,22,12,2,10,0,0,0,2,0,2,0,0,0
09/29/2020,Southwest,1,GACH,1,53,45,19,26,0,0,0,4,0,4,0,0,0,53,45,19,26,0,0,0,4,0,4,0,0,0
09/30/2020,Anchorage,7,GACH,1,954,796,649,147,164,101,63,197,36,161,21,0,21,954,796,649,147,164,101,63,197,36,161,21,0,21
09/30/2020,Anchorage,7,LTACH,0,36,36,29,7,7,7,0,24,1,23,0,0,0,36,36,29,7,7,7,0,24,1,23,0,0,0
09/30/2020,Anchorage,7,Psych,0,60,,59,,,,,0,0,0,0,0,0,96,86,67,33,0,0,0,0,0,0,0,0,0
09/30/2020,Gulf Coast,4,CAH,1,122,90,27,63,4,1,3,17,0,17,0,0,0,122,90,27,63,4,1,3,17,0,17,0,0,0
09/30/2020,Gulf Coast,4,GACH,1,120,52,45,7,9,5,4,10,0,10,0,0,0,120,52,45,7,9,5,4,10,0,10,0,0,0
09/30/2020,Interior,6,GACH,1,94,81,62,19,13,10,3,16,1,15,1,0,1,94,81,62,19,13,10,3,16,1,15,1,0,1
09/30/2020,Matanuska-Susitna,3,GACH,1,192,125,81,44,14,14,0,11,2,9,0,0,0,192,125,81,44,14,14,0,11,2,9,0,0,0
09/30/2020,Northern,2,CAH,1,92,50,11,39,0,0,0,25,0,25,2,0,2,142,68,18,50,0,0,0,36,0,36,3,0,3
09/30/2020,Southeast,5,CAH,1,70,70,46,24,8,3,5,32,0,32,1,0,1,70,70,46,24,8,3,5,32,0,32,1,0,1
09/30/2020,Southeast,5,GACH,1,161,133,38,95,9,5,4,20,0,20,2,0,2,161,133,38,95,9,5,4,20,0,20,2,0,2
09/30/2020,Southwest,1,CAH,1,22,12,1,11,0,0,0,2,0,2,0,0,0,22,12,1,11,0,0,0,2,0,2,0,0,0
09/30/2020,Southwest,1,GACH,1,53,45,22,23,0,0,0,4,0,4,0,0,0,53,45,22,23,0,0,0,4,0,4,0,0,0
10/01/2020,Anchorage,7,GACH,1,954,796,638,158,164,106,58,197,34,163,24,0,24,954,796,638,158,164,106,58,197,34,163,24,0,24
10/01/2020,Anchorage,7,LTACH,0,36,36,27,9,7,6,1,24,2,22,0,0,0,36,36,27,9,7,6,1,24,2,22,0,0,0
10/01/2020,Anchorage,7,Psych,0,,,,,,,,,,,,,,96,86,67,33,0,0,0,0,0,0,0,0,0
10/01/2020,Gulf Coast,4,CAH,1,122,90,27,63,4,0,4,17,0,17,0,0,0,122,90,27,63,4,0,4,17,0,17,0,0,0
10/01/2020,Gulf Coast,4,GACH,1,120,52,47,5,9,7,2,10,0,10,0,0,0,120,52,47,5,9,7,2,10,0,10,0,0,0
10/01/2020,Interior,6,GACH,1,94,81,61,20,13,6,7,16,2,14,2,0,2,94,81,61,20,13,6,7,16,2,14,2,0,2
10/01/2020,Matanuska-Susitna,3,GACH,1,192,125,93,32,14,14,0,11,2,9,0,0,0,192,125,93,32,14,14,0,11,2,9,0,0,0
10/01/2020,Northern,2,CAH,1,142,68,26,42,0,0,0,36,0,36,2,0,2,142,68,26,42,0,0,0,36,0,36,2,0,2
10/01/2020,Southeast,5,CAH,1,70,70,47,23,8,0,8,32,0,32,0,0,0,70,70,47,23,8,0,8,32,0,32,0,0,0
10/01/2020,Southeast,5,GACH,1,161,133,39,94,9,6,3,20,0,20,1,0,1,161,133,39,94,9,6,3,20,0,20,1,0,1
10/01/2020,Southwest,1,CAH,1,22,12,1,11,0,0,0,2,0,2,0,0,0,22,12,1,11,0,0,0,2,0,2,0,0,0
10/01/2020,Southwest,1,GACH,1,53,45,24,21,0,0,0,4,0,4,0,0,0,53,45,24,21,0,0,0,4,0,4,0,0,0
10/02/2020,Anchorage,7,GACH,1,954,796,628,168,164,97,67,197,33,164,22,0,22,954,796,628,168,164,97,67,197,33,164,22,0,22
10/02/2020,Anchorage,7,LTACH,0,36,36,26,10,7,6,1,24,2,22,0,0,0,36,36,26,10,7,6,1,24,2,22,0,0,0
10/02/2020,Anchorage,7,Psych,0,,,,,,,,,,,,,,96,86,67,33,0,0,0,0,0,0,0,0,0
10/02/2020,Gulf Coast,4,CAH,1,122,90,28,62,4,0,4,17,0,17,0,0,0,122,90,28,62,4,0,4,17,0,17,0,0,0
10/02/2020,Gulf Coast,4,GACH,1,120,52,41,11,9,6,3,10,0,10,0,0,0,120,52,41,11,9,6,3,10,0,10,0,0,0
10/02/2020,Interior,6,GACH,1,94,81,63,18,13,8,5,16,2,14,2,0,2,94,81,63,18,13,8,5,16,2,14,2,0,2
10/02/2020,Matanuska-Susitna,3,GACH,1,192,125,91,34,15,15,0,11,2,9,0,0,0,192,125,91,34,15,15,0,11,2,9,0,0,0
10/02/2020,Northern,2,CAH,1,142,68,21,47,0,0,0,36,0,36,2,0,2,142,68,21,47,0,0,0,36,0,36,2,0,2
10/02/2020,Southeast,5,CAH,1,70,70,42,28,8,2,6,32,0,32,0,0,0,70,70,42,28,8,2,6,32,0,32,0,0,0
10/02/2020,Southeast,5,GACH,1,161,133,40,93,9,6,3,20,0,20,1,0,1,161,133,40,93,9,6,3,20,0,20,1,0,1
10/02/2020,Southwest,1,CAH,1,22,12,2,10,0,0,0,2,0,2,1,0,1,22,12,2,10,0,0,0,2,0,2,1,0,1
10/02/2020,Southwest,1,GACH,1,53,45,27,18,0,0,0,4,0,4,0,0,0,53,45,27,18,0,0,0,4,0,4,0,0,0
10/03/2020,Anchorage,7,GACH,1,954,796,566,230,164,106,58,197,33,164,23,0,23,954,796,566,230,164,106,58,197,33,164,23,0,23
10/03/2020,Anchorage,7,LTACH,0,36,36,28,8,7,5,2,24,3,21,0,0,0,36,36,28,8,7,5,2,24,3,21,0,0,0
10/03/2020,Anchorage,7,Psych,0,,,,,,,,,,,,,,96,86,67,33,0,0,0,0,0,0,0,0,0
10/03/2020,Gulf Coast,4,CAH,1,122,90,21,69,4,0,4,17,0,17,0,0,0,122,90,21,69,4,0,4,17,0,17,0,0,0
10/03/2020,Gulf Coast,4,GACH,1,120,52,44,8,9,6,3,10,0,10,0,0,0,120,52,44,8,9,6,3,10,0,10,0,0,0
10/03/2020,Interior,6,GACH,1,94,81,67,14,13,8,5,16,1,15,3,0,3,94,81,67,14,13,8,5,16,1,15,3,0,3
10/03/2020,Matanuska-Susitna,3,GACH,1,192,125,80,45,14,12,2,11,3,8,0,0,0,192,125,80,45,14,12,2,11,3,8,0,0,0
10/03/2020,Northern,2,CAH,1,142,68,19,49,0,0,0,36,0,36,2,0,2,142,68,19,49,0,0,0,36,0,36,2,0,2
10/03/2020,Southeast,5,CAH,1,70,70,40,30,8,1,7,32,0,32,0,0,0,70,70,40,30,8,1,7,32,0,32,0,0,0
10/03/2020,Southeast,5,GACH,1,161,133,42,91,9,6,3,20,0,20,2,0,2,161,133,42,91,9,6,3,20,0,20,2,0,2
10/03/2020,Southwest,1,CAH,1,22,12,2,10,0,0,0,2,0,2,1,0,1,22,12,2,10,0,0,0,2,0,2,1,0,1
10/03/2020,Southwest,1,GACH,1,53,45,28,17,0,0,0,4,0,4,0,0,0,53,45,28,17,0,0,0,4,0,4,0,0,0
10/04/2020,Anchorage,7,GACH,1,954,796,549,247,164,104,60,197,32,165,24,0,24,954,796,549,247,164,104,60,197,32,165,24,0,24
10/04/2020,Anchorage,7,LTACH,0,36,36,25,11,7,4,3,24,2,22,0,0,0,36,36,25,11,7,4,3,24,2,22,0,0,0
10/04/2020,Anchorage,7,Psych,0,,,,,,,,,,,,,,96,86,67,33,0,0,0,0,0,0,0,0,0
10/04/2020,Gulf Coast,4,CAH,1,122,90,21,69,4,0,4,17,0,17,0,0,0,122,90,21,69,4,0,4,17,0,17,0,0,0
10/04/2020,Gulf Coast,4,GACH,1,120,52,33,19,9,3,6,10,0,10,0,0,0,120,52,33,19,9,3,6,10,0,10,0,0,0
10/04/2020,Interior,6,GACH,1,94,81,61,20,13,4,9,16,1,15,4,0,4,94,81,61,20,13,4,9,16,1,15,4,0,4
10/04/2020,Matanuska-Susitna,3,GACH,1,192,125,71,54,14,11,3,11,2,9,0,0,0,192,125,71,54,14,11,3,11,2,9,0,0,0
10/04/2020,Northern,2,CAH,1,142,68,19,49,0,0,0,36,0,36,1,0,1,142,68,19,49,0,0,0,36,0,36,1,0,1
10/04/2020,Southeast,5,CAH,1,70,70,42,28,8,2,6,32,0,32,0,0,0,70,70,42,28,8,2,6,32,0,32,0,0,0
10/04/2020,Southeast,5,GACH,1,161,133,37,96,9,5,4,20,0,20,3,0,3,161,133,37,96,9,5,4,20,0,20,3,0,3
10/04/2020,Southwest,1,CAH,1,22,12,2,10,0,0,0,2,0,2,1,0,1,22,12,2,10,0,0,0,2,0,2,1,0,1
10/04/2020,Southwest,1,GACH,1,53,45,25,20,0,0,0,4,0,4,0,0,0,53,45,25,20,0,0,0,4,0,4,0,0,0
10/05/2020,Anchorage,7,GACH,1,1003,796,542,254,164,103,61,197,32,165,23,0,23,1003,796,542,254,164,103,61,197,32,165,23,0,23
10/05/2020,Anchorage,7,LTACH,0,36,36,23,13,7,3,4,24,4,20,0,0,0,36,36,23,13,7,3,4,24,4,20,0,0,0
10/05/2020,Anchorage,7,Psych,0,60,54,54,0,0,0,0,0,0,0,0,0,0,96,90,62,28,0,0,0,0,0,0,0,0,0
10/05/2020,Gulf Coast,4,CAH,1,117,92,23,69,4,0,4,19,0,19,0,0,0,117,92,23,69,4,0,4,19,0,19,0,0,0
10/05/2020,Gulf Coast,4,GACH,1,120,52,34,18,9,3,6,10,0,10,0,0,0,120,52,34,18,9,3,6,10,0,10,0,0,0
10/05/2020,Interior,6,GACH,1,94,81,65,16,13,3,10,16,2,14,4,0,4,94,81,65,16,13,3,10,16,2,14,4,0,4
10/05/2020,Matanuska-Susitna,3,GACH,1,192,125,72,53,14,9,5,11,1,10,0,0,0,192,125,72,53,14,9,5,11,1,10,0,0,0
10/05/2020,Northern,2,CAH,1,142,68,22,46,0,0,0,36,0,36,2,0,2,142,68,22,46,0,0,0,36,0,36,2,0,2
10/05/2020,Southeast,5,CAH,1,70,70,35,35,8,3,5,32,0,32,0,0,0,70,70,35,35,8,3,5,32,0,32,0,0,0
10/05/2020,Southeast,5,GACH,1,161,133,35,98,9,6,3,20,0,20,3,0,3,161,133,35,98,9,6,3,20,0,20,3,0,3
10/05/2020,Southwest,1,CAH,1,22,12,2,10,0,0,0,2,0,2,1,0,1,22,12,2,10,0,0,0,2,0,2,1,0,1
10/05/2020,Southwest,1,GACH,1,53,45,33,12,0,0,0,4,0,4,0,0,0,53,45,33,12,0,0,0,4,0,4,0,0,0
10/06/2020,Anchorage,7,GACH,1,1003,796,616,180,170,102,68,197,34,163,24,0,24,1003,796,616,180,170,102,68,197,34,163,24,0,24
10/06/2020,Anchorage,7,LTACH,0,36,36,24,12,7,3,4,24,2,22,0,0,0,36,36,24,12,7,3,4,24,2,22,0,0,0
10/06/2020,Anchorage,7,Psych,0,60,55,55,0,0,0,0,0,0,0,0,0,0,96,91,63,28,0,0,0,0,0,0,0,0,0
10/06/2020,Gulf Coast,4,CAH,1,117,92,26,66,4,0,4,19,0,19,0,0,0,117,92,26,66,4,0,4,19,0,19,0,0,0
10/06/2020,Gulf Coast,4,GACH,1,120,52,42,10,9,5,4,10,0,10,0,0,0,120,52,42,10,9,5,4,10,0,10,0,0,0
10/06/2020,Interior,6,GACH,1,94,81,58,23,13,10,3,16,2,14,4,0,4,94,81,58,23,13,10,3,16,2,14,4,0,4
10/06/2020,Matanuska-Susitna,3,GACH,1,192,125,74,51,14,6,8,11,0,11,0,0,0,192,125,74,51,14,6,8,11,0,11,0,0,0
10/06/2020,Northern,2,CAH,1,142,68,20,48,0,0,0,36,0,36,2,0,2,142,68,20,48,0,0,0,36,0,36,2,0,2
10/06/2020,Southeast,5,CAH,1,70,70,35,35,8,3,5,32,0,32,0,0,0,70,70,35,35,8,3,5,32,0,32,0,0,0
10/06/2020,Southeast,5,GACH,1,161,133,41,92,9,5,4,20,0,20,2,0,2,161,133,41,92,9,5,4,20,0,20,2,0,2
10/06/2020,Southwest,1,CAH,1,22,12,2,10,0,0,0,2,0,2,1,0,1,22,12,2,10,0,0,0,2,0,2,1,0,1
10/06/2020,Southwest,1,GACH,1,53,45,25,20,0,0,0,4,0,4,0,0,0,53,45,25,20,0,0,0,4,0,4,0,0,0
10/07/2020,Anchorage,7,GACH,1,1003,796,624,172,173,107,66,197,36,161,23,0,23,1003,796,624,172,173,107,66,197,36,161,23,0,23
10/07/2020,Anchorage,7,LTACH,0,36,36,22,14,7,3,4,24,2,22,0,0,0,36,36,22,14,7,3,4,24,2,22,0,0,0
10/07/2020,Anchorage,7,Psych,0,,,,,,,,,,,,,,96,91,63,28,0,0,0,0,0,0,0,0,0
10/07/2020,Gulf Coast,4,CAH,1,117,92,30,62,4,0,4,19,0,19,0,1,1,117,92,30,62,4,0,4,19,0,19,0,1,1
10/07/2020,Gulf Coast,4,GACH,1,120,52,41,11,9,6,3,10,0,10,0,0,0,120,52,41,11,9,6,3,10,0,10,0,0,0
10/07/2020,Interior,6,GACH,1,94,81,53,28,13,12,1,16,1,15,4,0,4,94,81,53,28,13,12,1,16,1,15,4,0,4
10/07/2020,Matanuska-Susitna,3,GACH,1,192,125,79,46,14,8,6,11,1,10,1,0,1,192,125,79,46,14,8,6,11,1,10,1,0,1
10/07/2020,Northern,2,CAH,1,142,68,18,50,0,0,0,36,0,36,1,0,1,142,68,18,50,0,0,0,36,0,36,1,0,1
10/07/2020,Southeast,5,CAH,1,70,70,34,36,8,1,7,32,0,32,0,0,0,70,70,34,36,8,1,7,32,0,32,0,0,0
10/07/2020,Southeast,5,GACH,1,161,133,43,90,9,5,4,20,1,19,2,0,2,161,133,43,90,9,5,4,20,1,19,2,0,2
10/07/2020,Southwest,1,CAH,1,22,12,2,10,0,0,0,2,0,2,1,0,1,22,12,2,10,0,0,0,2,0,2,1,0,1
10/07/2020,Southwest,1,GACH,1,53,45,10,35,0,0,0,4,0,4,0,0,0,53,45,10,35,0,0,0,4,0,4,0,0,0
10/08/2020,Anchorage,7,GACH,1,1003,796,644,152,172,99,73,199,32,167,23,0,23,1003,796,644,152,172,99,73,199,32,167,23,0,23
10/08/2020,Anchorage,7,LTACH,0,36,36,22,14,7,3,4,24,2,22,0,0,0,36,36,22,14,7,3,4,24,2,22,0,0,0
10/08/2020,Anchorage,7,Psych,0,60,59,59,0,0,0,0,0,0,0,0,0,0,96,95,67,28,0,0,0,0,0,0,0,0,0
10/08/2020,Gulf Coast,4,CAH,1,117,92,29,63,4,0,4,19,0,19,0,0,0,117,92,29,63,4,0,4,19,0,19,0,0,0
10/08/2020,Gulf Coast,4,GACH,1,120,52,39,13,9,4,5,10,0,10,0,0,0,120,52,39,13,9,4,5,10,0,10,0,0,0
10/08/2020,Interior,6,GACH,1,94,81,51,30,13,9,4,16,1,15,5,1,6,94,81,51,30,13,9,4,16,1,15,5,1,6
10/08/2020,Matanuska-Susitna,3,GACH,1,192,125,76,49,14,14,0,11,0,11,1,0,1,192,125,76,49,14,14,0,11,0,11,1,0,1
10/08/2020,Northern,2,CAH,1,142,68,17,51,0,0,0,36,0,36,2,0,2,142,68,17,51,0,0,0,36,0,36,2,0,2
10/08/2020,Southeast,5,CAH,1,70,70,40,30,8,1,7,32,0,32,0,0,0,70,70,40,30,8,1,7,32,0,32,0,0,0
10/08/2020,Southeast,5,GACH,1,161,133,43,90,9,5,4,20,1,19,3,0,3,161,133,43,90,9,5,4,20,1,19,3,0,3
10/08/2020,Southwest,1,CAH,1,22,12,2,10,0,0,0,2,0,2,1,0,1,22,12,2,10,0,0,0,2,0,2,1,0,1
10/08/2020,Southwest,1,GACH,1,53,45,20,25,0,0,0,4,0,4,0,0,0,53,45,20,25,0,0,0,4,0,4,0,0,0
10/09/2020,Anchorage,7,GACH,1,1003,796,671,125,168,103,65,199,32,167,31,0,31,1003,796,671,125,168,103,65,199,32,167,31,0,31
10/09/2020,Anchorage,7,LTACH,0,36,36,22,14,7,3,4,24,2,22,0,0,0,36,36,22,14,7,3,4,24,2,22,0,0,0
10/09/2020,Anchorage,7,Psych,0,,,,,,,,,,,,,,96,95,67,28,0,0,0,0,0,0,0,0,0
10/09/2020,Gulf Coast,4,CAH,1,117,92,24,68,4,0,4,19,0,19,0,0,0,117,92,24,68,4,0,4,19,0,19,0,0,0
10/09/2020,Gulf Coast,4,GACH,1,120,52,37,15,9,5,4,10,0,10,0,0,0,120,52,37,15,9,5,4,10,0,10,0,0,0
10/09/2020,Interior,6,GACH,1,94,81,58,23,13,3,10,16,0,16,5,0,5,94,81,58,23,13,3,10,16,0,16,5,0,5
10/09/2020,Matanuska-Susitna,3,GACH,1,184,160,80,80,14,10,4,11,0,11,2,0,2,184,160,80,80,14,10,4,11,0,11,2,0,2
10/09/2020,Northern,2,CAH,1,142,68,15,53,0,0,0,36,0,36,2,0,2,142,68,15,53,0,0,0,36,0,36,2,0,2
10/09/2020,Southeast,5,CAH,1,70,70,40,30,8,1,7,32,0,32,0,0,0,70,70,40,30,8,1,7,32,0,32,0,0,0
10/09/2020,Southeast,5,GACH,1,161,133,40,93,9,5,4,20,1,19,2,0,2,161,133,40,93,9,5,4,20,1,19,2,0,2
10/09/2020,Southwest,1,CAH,1,22,12,2,10,0,0,0,2,0,2,0,0,0,22,12,2,10,0,0,0,2,0,2,0,0,0
10/09/2020,Southwest,1,GACH,1,53,45,17,28,0,0,0,4,0,4,0,0,0,53,45,17,28,0,0,0,4,0,4,0,0,0
10/10/2020,Anchorage,7,GACH,1,1003,796,592,204,168,103,65,199,29,170,22,0,22,1003,796,592,204,168,103,65,199,29,170,22,0,22
10/10/2020,Anchorage,7,LTACH,0,36,36,27,9,7,5,2,24,3,21,0,0,0,36,36,27,9,7,5,2,24,3,21,0,0,0
10/10/2020,Anchorage,7,Psych,0,,,,,,,,,,,,,,96,95,67,28,0,0,0,0,0,0,0,0,0
10/10/2020,Gulf Coast,4,CAH,1,117,92,21,71,4,0,4,19,0,19,0,0,0,117,92,21,71,4,0,4,19,0,19,0,0,0
10/10/2020,Gulf Coast,4,GACH,1,120,52,33,19,9,6,3,10,0,10,0,0,0,120,52,33,19,9,6,3,10,0,10,0,0,0
10/10/2020,Interior,6,GACH,1,94,81,53,28,13,8,5,16,1,15,6,0,6,94,81,53,28,13,8,5,16,1,15,6,0,6
10/10/2020,Matanuska-Susitna,3,GACH,1,184,160,74,86,14,6,8,11,2,9,1,0,1,184,160,74,86,14,6,8,11,2,9,1,0,1
10/10/2020,Northern,2,CAH,1,142,68,18,50,0,0,0,36,0,36,4,0,4,142,68,18,50,0,0,0,36,0,36,4,0,4
10/10/2020,Southeast,5,CAH,1,70,70,37,33,8,1,7,32,0,32,0,0,0,70,70,37,33,8,1,7,32,0,32,0,0,0
10/10/2020,Southeast,5,GACH,1,161,133,36,97,9,5,4,20,0,20,5,0,5,161,133,36,97,9,5,4,20,0,20,5,0,5
10/10/2020,Southwest,1,CAH,1,22,12,2,10,0,0,0,2,0,2,0,0,0,22,12,2,10,0,0,0,2,0,2,0,0,0
10/10/2020,Southwest,1,GACH,1,53,45,17,28,0,0,0,4,0,4,0,0,0,53,45,17,28,0,0,0,4,0,4,0,0,0
10/11/2020,Anchorage,7,GACH,1,1003,796,567,229,168,90,78,199,26,173,18,0,18,1003,796,567,229,168,90,78,199,26,173,18,0,18
10/11/2020,Anchorage,7,LTACH,0,36,36,21,15,7,3,4,24,2,22,0,0,0,36,36,21,15,7,3,4,24,2,22,0,0,0
10/11/2020,Anchorage,7,Psych,0,,,,,,,,,,,,,,96,95,67,28,0,0,0,0,0,0,0,0,0
10/11/2020,Gulf Coast,4,CAH,1,117,92,17,75,4,0,4,19,0,19,0,0,0,117,92,17,75,4,0,4,19,0,19,0,0,0
10/11/2020,Gulf Coast,4,GACH,1,120,52,35,17,9,5,4,10,0,10,0,0,0,120,52,35,17,9,5,4,10,0,10,0,0,0
10/11/2020,Interior,6,GACH,1,94,81,55,26,13,7,6,16,1,15,6,0,6,94,81,55,26,13,7,6,16,1,15,6,0,6
10/11/2020,Matanuska-Susitna,3,GACH,1,184,160,81,79,14,11,3,11,3,8,1,0,1,184,160,81,79,14,11,3,11,3,8,1,0,1
10/11/2020,Northern,2,CAH,1,142,68,20,48,0,0,0,36,0,36,2,0,2,142,68,20,48,0,0,0,36,0,36,2,0,2
10/11/2020,Southeast,5,CAH,1,70,70,33,37,8,1,7,32,0,32,0,0,0,70,70,33,37,8,1,7,32,0,32,0,0,0
10/11/2020,Southeast,5,GACH,1,161,133,35,98,9,5,4,20,0,20,6,0,6,161,133,35,98,9,5,4,20,0,20,6,0,6
10/11/2020,Southwest,1,CAH,1,22,12,3,9,0,0,0,2,0,2,0,0,0,22,12,3,9,0,0,0,2,0,2,0,0,0
10/11/2020,Southwest,1,GACH,1,53,45,21,24,0,0,0,4,0,4,0,0,0,53,45,21,24,0,0,0,4,0,4,0,0,0
10/12/2020,Anchorage,7,GACH,1,1003,796,608,188,168,85,83,199,26,173,26,0,26,1003,796,608,188,168,85,83,199,26,173,26,0,26
10/12/2020,Anchorage,7,LTACH,0,36,36,20,16,7,3,4,24,2,22,0,0,0,36,36,20,16,7,3,4,24,2,22,0,0,0
10/12/2020,Anchorage,7,Psych,0,,,,,,,,,,,,,,96,95,67,28,0,0,0,0,0,0,0,0,0
10/12/2020,Gulf Coast,4,CAH,1,117,92,23,69,4,1,3,19,0,19,0,0,0,117,92,23,69,4,1,3,19,0,19,0,0,0
10/12/2020,Gulf Coast,4,GACH,1,120,52,34,18,9,2,7,10,0,10,0,0,0,120,52,34,18,9,2,7,10,0,10,0,0,0
10/12/2020,Interior,6,GACH,1,94,81,53,28,13,7,6,16,1,15,6,0,6,94,81,53,28,13,7,6,16,1,15,6,0,6
10/12/2020,Matanuska-Susitna,3,GACH,1,184,160,82,78,14,10,4,8,3,5,1,0,1,184,160,82,78,14,10,4,8,3,5,1,0,1
10/12/2020,Northern,2,CAH,1,142,50,14,43,0,0,0,36,0,36,2,0,2,142,68,14,51,0,0,0,36,0,36,2,0,2
10/12/2020,Southeast,5,CAH,1,70,70,33,37,8,0,8,32,0,32,0,0,0,70,70,33,37,8,0,8,32,0,32,0,0,0
10/12/2020,Southeast,5,GACH,1,161,133,29,104,9,5,4,20,0,20,5,0,5,161,133,29,104,9,5,4,20,0,20,5,0,5
10/12/2020,Southwest,1,CAH,1,22,12,2,10,0,0,0,2,0,2,0,0,0,22,12,2,10,0,0,0,2,0,2,0,0,0
10/12/2020,Southwest,1,GACH,1,53,45,20,25,0,0,0,4,0,4,0,0,0,53,45,20,25,0,0,0,4,0,4,0,0,0
10/13/2020,Anchorage,7,GACH,1,1016,809,627,182,168,93,75,199,23,176,23,1,24,1016,809,627,182,168,93,75,199,23,176,23,1,24
10/13/2020,Anchorage,7,LTACH,0,36,36,21,15,7,3,4,24,1,23,0,0,0,36,36,21,15,7,3,4,24,1,23,0,0,0
10/13/2020,Anchorage,7,Psych,0,,,,,,,,,,,,,,96,95,67,28,0,0,0,0,0,0,0,0,0
10/13/2020,Gulf Coast,4,CAH,1,117,92,23,69,4,0,4,19,0,19,0,0,0,117,92,23,69,4,0,4,19,0,19,0,0,0
10/13/2020,Gulf Coast,4,GACH,1,120,52,39,13,9,6,3,10,0,10,0,0,0,120,52,39,13,9,6,3,10,0,10,0,0,0
10/13/2020,Interior,6,GACH,1,94,81,50,31,13,8,5,16,3,13,5,0,5,94,81,50,31,13,8,5,16,3,13,5,0,5
10/13/2020,Matanuska-Susitna,3,GACH,1,184,160,81,79,14,8,6,11,2,9,2,0,2,184,160,81,79,14,8,6,11,2,9,2,0,2
10/13/2020,Northern,2,CAH,1,142,68,12,56,0,0,0,36,0,36,3,0,3,142,68,12,56,0,0,0,36,0,36,3,0,3
10/13/2020,Southeast,5,CAH,1,70,70,39,31,8,1,7,33,0,33,0,0,0,70,70,39,31,8,1,7,33,0,33,0,0,0
10/13/2020,Southeast,5,GACH,1,161,133,32,101,9,7,2,20,0,20,7,0,7,161,133,32,101,9,7,2,20,0,20,7,0,7
10/13/2020,Southwest,1,CAH,1,22,12,1,11,0,0,0,2,0,2,0,0,0,22,12,1,11,0,0,0,2,0,2,0,0,0
10/13/2020,Southwest,1,GACH,1,,,,,,,,,,,,,,53,45,20,25,0,0,0,4,0,4,0,0,0
10/14/2020,Anchorage,7,GACH,1,1016,809,630,179,169,98,71,203,29,174,33,1,34,1016,809,630,179,169,98,71,203,29,174,33,1,34
10/14/2020,Anchorage,7,LTACH,0,36,36,21,15,7,5,2,24,1,23,0,0,0,36,36,21,15,7,5,2,24,1,23,0,0,0
10/14/2020,Anchorage,7,Psych,0,,,,,,,,,,,,,,96,95,67,28,0,0,0,0,0,0,0,0,0
10/14/2020,Gulf Coast,4,CAH,1,117,92,29,63,4,1,3,19,0,19,0,0,0,117,92,29,63,4,1,3,19,0,19,0,0,0
10/14/2020,Gulf Coast,4,GACH,1,120,52,37,15,9,5,4,10,0,10,0,0,0,120,52,37,15,9,5,4,10,0,10,0,0,0
10/14/2020,Interior,6,GACH,1,94,81,57,24,20,12,8,16,1,15,4,0,4,94,81,57,24,20,12,8,16,1,15,4,0,4
10/14/2020,Matanuska-Susitna,3,GACH,1,184,160,66,94,14,11,3,11,1,10,3,0,3,184,160,66,94,14,11,3,11,1,10,3,0,3
10/14/2020,Northern,2,CAH,1,142,68,11,57,0,0,0,36,0,36,4,0,4,142,68,11,57,0,0,0,36,0,36,4,0,4
10/14/2020,Southeast,5,CAH,1,70,70,39,31,8,3,5,33,0,33,0,0,0,70,70,39,31,8,3,5,33,0,33,0,0,0
10/14/2020,Southeast,5,GACH,1,161,133,36,97,9,5,4,20,0,20,6,0,6,161,133,36,97,9,5,4,20,0,20,6,0,6
10/14/2020,Southwest,1,CAH,1,22,12,0,12,0,0,0,2,0,2,0,0,0,22,12,0,12,0,0,0,2,0,2,0,0,0
10/14/2020,Southwest,1,GACH,1,53,45,23,22,0,0,0,4,0,4,0,0,0,53,45,23,22,0,0,0,4,0,4,0,0,0
10/15/2020,Anchorage,7,GACH,1,1016,809,611,198,168,93,75,203,33,170,34,0,34,1016,809,611,198,168,93,75,203,33,170,34,0,34
10/15/2020,Anchorage,7,LTACH,0,36,36,21,15,7,5,2,24,1,23,0,0,0,36,36,21,15,7,5,2,24,1,23,0,0,0
10/15/2020,Anchorage,7,Psych,0,,,,,,,,,,,,,,96,95,67,28,0,0,0,0,0,0,0,0,0
10/15/2020,Gulf Coast,4,CAH,1,117,92,25,67,4,0,4,21,0,21,0,0,0,117,92,25,67,4,0,4,21,0,21,0,0,0
10/15/2020,Gulf Coast,4,GACH,1,120,52,38,14,9,4,5,10,0,10,1,0,1,120,52,38,14,9,4,5,10,0,10,1,0,1
10/15/2020,Interior,6,GACH,1,94,81,65,16,20,12,8,16,1,15,4,0,4,94,81,65,16,20,12,8,16,1,15,4,0,4
10/15/2020,Matanuska-Susitna,3,GACH,1,184,160,62,98,14,8,6,11,0,11,2,0,2,184,160,62,98,14,8,6,11,0,11,2,0,2
10/15/2020,Northern,2,CAH,1,142,68,17,51,0,0,0,36,0,36,4,0,4,142,68,17,51,0,0,0,36,0,36,4,0,4
10/15/2020,Southeast,5,CAH,1,70,70,34,36,8,2,6,33,0,33,0,0,0,70,70,34,36,8,2,6,33,0,33,0,0,0
10/15/2020,Southeast,5,GACH,1,161,133,32,101,9,3,6,20,0,20,5,0,5,161,133,32,101,9,3,6,20,0,20,5,0,5
10/15/2020,Southwest,1,CAH,1,22,12,0,12,0,0,0,2,0,2,0,0,0,22,12,0,12,0,0,0,2,0,2,0,0,0
10/15/2020,Southwest,1,GACH,1,53,45,23,22,0,0,0,4,0,4,1,0,1,53,45,23,22,0,0,0,4,0,4,1,0,1
10/16/2020,Anchorage,7,GACH,1,1016,809,590,219,169,95,74,203,33,170,33,0,33,1016,809,590,219,169,95,74,203,33,170,33,0,33
10/16/2020,Anchorage,7,LTACH,0,36,36,24,12,7,5,2,24,1,23,0,0,0,36,36,24,12,7,5,2,24,1,23,0,0,0
10/16/2020,Anchorage,7,Psych,0,60,57,57,0,0,0,0,0,0,0,0,0,0,96,93,65,28,0,0,0,0,0,0,0,0,0
10/16/2020,Gulf Coast,4,CAH,1,117,92,35,57,4,0,4,21,0,21,0,0,0,117,92,35,57,4,0,4,21,0,21,0,0,0
10/16/2020,Gulf Coast,4,GACH,1,120,52,37,15,9,5,4,10,0,10,1,0,1,120,52,37,15,9,5,4,10,0,10,1,0,1
10/16/2020,Interior,6,GACH,1,94,81,60,21,20,13,7,16,2,14,3,0,3,94,81,60,21,20,13,7,16,2,14,3,0,3
10/16/2020,Matanuska-Susitna,3,GACH,1,184,160,68,92,14,10,4,11,0,11,1,0,1,184,160,68,92,14,10,4,11,0,11,1,0,1
10/16/2020,Northern,2,CAH,1,142,68,18,50,0,0,0,36,0,36,6,0,6,142,68,18,50,0,0,0,36,0,36,6,0,6
10/16/2020,Southeast,5,CAH,1,70,70,43,27,8,4,4,33,0,33,0,0,0,70,70,43,27,8,4,4,33,0,33,0,0,0
10/16/2020,Southeast,5,GACH,1,161,133,36,97,9,5,4,20,0,20,5,0,5,161,133,36,97,9,5,4,20,0,20,5,0,5
10/16/2020,Southwest,1,CAH,1,22,12,0,12,0,0,0,2,0,2,0,0,0,22,12,0,12,0,0,0,2,0,2,0,0,0
10/16/2020,Southwest,1,GACH,1,53,45,23,22,0,0,0,4,0,4,1,0,1,53,45,23,22,0,0,0,4,0,4,1,0,1
10/17/2020,Anchorage,7,GACH,1,774,690,528,162,139,110,29,203,34,169,27,1,28,774,690,528,162,139,110,29,203,34,169,27,1,28
10/17/2020,Anchorage,7,LTACH,0,36,36,25,11,7,6,1,24,2,22,0,0,0,36,36,25,11,7,6,1,24,2,22,0,0,0
10/17/2020,Anchorage,7,Psych,0,,,,,,,,,,,,,,96,93,65,28,0,0,0,0,0,0,0,0,0
10/17/2020,Gulf Coast,4,CAH,1,117,90,26,64,4,1,3,21,0,21,0,0,0,117,90,26,64,4,1,3,21,0,21,0,0,0
10/17/2020,Gulf Coast,4,GACH,1,120,52,33,19,9,5,4,10,0,10,1,0,1,120,52,33,19,9,5,4,10,0,10,1,0,1
10/17/2020,Interior,6,GACH,1,94,81,54,27,20,13,7,16,1,15,2,0,2,94,81,54,27,20,13,7,16,1,15,2,0,2
10/17/2020,Matanuska-Susitna,3,GACH,1,184,160,81,79,14,13,1,11,1,10,1,0,1,184,160,81,79,14,13,1,11,1,10,1,0,1
10/17/2020,Northern,2,CAH,1,142,68,18,50,0,0,0,36,0,36,4,0,4,142,68,18,50,0,0,0,36,0,36,4,0,4
10/17/2020,Southeast,5,CAH,1,70,70,37,33,8,4,4,33,0,33,0,0,0,70,70,37,33,8,4,4,33,0,33,0,0,0
10/17/2020,Southeast,5,GACH,1,161,133,35,98,9,6,3,20,0,20,5,0,5,161,133,35,98,9,6,3,20,0,20,5,0,5
10/17/2020,Southwest,1,CAH,1,22,12,1,11,0,0,0,2,0,2,0,0,0,22,12,1,11,0,0,0,2,0,2,0,0,0
10/17/2020,Southwest,1,GACH,1,53,45,23,22,0,0,0,4,0,4,2,0,2,53,45,23,22,0,0,0,4,0,4,2,0,2
10/18/2020,Anchorage,7,GACH,1,777,693,510,183,141,100,41,203,30,173,28,0,28,777,693,510,183,141,100,41,203,30,173,28,0,28
10/18/2020,Anchorage,7,LTACH,0,36,36,25,11,7,6,1,24,2,22,0,0,0,36,36,25,11,7,6,1,24,2,22,0,0,0
10/18/2020,Anchorage,7,Psych,0,,,,,,,,,,,,,,96,93,65,28,0,0,0,0,0,0,0,0,0
10/18/2020,Gulf Coast,4,CAH,1,117,90,27,63,4,0,4,21,0,21,0,0,0,117,90,27,63,4,0,4,21,0,21,0,0,0
10/18/2020,Gulf Coast,4,GACH,1,120,52,33,19,9,5,4,10,0,10,1,0,1,120,52,33,19,9,5,4,10,0,10,1,0,1
10/18/2020,Interior,6,GACH,1,101,81,50,31,20,10,10,16,1,15,2,0,2,101,81,50,31,20,10,10,16,1,15,2,0,2
10/18/2020,Matanuska-Susitna,3,GACH,1,184,160,66,94,14,9,5,11,1,10,1,0,1,184,160,66,94,14,9,5,11,1,10,1,0,1
10/18/2020,Northern,2,CAH,1,142,68,18,50,0,0,0,36,0,36,4,0,4,142,68,18,50,0,0,0,36,0,36,4,0,4
10/18/2020,Southeast,5,CAH,1,70,70,37,33,8,4,4,33,0,33,0,0,0,70,70,37,33,8,4,4,33,0,33,0,0,0
10/18/2020,Southeast,5,GACH,1,161,133,34,99,9,6,3,20,0,20,4,0,4,161,133,34,99,9,6,3,20,0,20,4,0,4
10/18/2020,Southwest,1,CAH,1,22,12,2,10,0,0,0,2,0,2,0,0,0,22,12,2,10,0,0,0,2,0,2,0,0,0
10/18/2020,Southwest,1,GACH,1,53,45,25,20,0,0,0,4,0,4,2,0,2,53,45,25,20,0,0,0,4,0,4,2,0,2
10/19/2020,Anchorage,7,GACH,1,772,688,518,170,139,105,34,203,36,167,24,0,24,772,688,518,170,139,105,34,203,36,167,24,0,24
10/19/2020,Anchorage,7,LTACH,0,36,36,25,11,7,6,1,24,2,22,0,0,0,36,36,25,11,7,6,1,24,2,22,0,0,0
10/19/2020,Anchorage,7,Psych,0,,,,,,,,,,,,,,96,93,65,28,0,0,0,0,0,0,0,0,0
10/19/2020,Gulf Coast,4,CAH,1,117,90,27,63,4,1,3,21,0,21,0,0,0,117,90,27,63,4,1,3,21,0,21,0,0,0
10/19/2020,Gulf Coast,4,GACH,1,120,52,31,21,9,6,3,10,0,10,1,0,1,120,52,31,21,9,6,3,10,0,10,1,0,1
10/19/2020,Interior,6,GACH,1,101,81,45,36,20,8,12,16,1,15,3,0,3,101,81,45,36,20,8,12,16,1,15,3,0,3
10/19/2020,Matanuska-Susitna,3,GACH,1,184,160,66,94,14,9,5,11,1,10,1,0,1,184,160,66,94,14,9,5,11,1,10,1,0,1
10/19/2020,Northern,2,CAH,1,142,68,21,47,0,0,0,36,0,36,4,0,4,142,68,21,47,0,0,0,36,0,36,4,0,4
10/19/2020,Southeast,5,CAH,1,70,70,30,40,8,2,6,33,0,33,0,0,0,70,70,30,40,8,2,6,33,0,33,0,0,0
10/19/2020,Southeast,5,GACH,1,161,133,29,104,9,4,5,20,0,20,5,0,5,161,133,29,104,9,4,5,20,0,20,5,0,5
10/19/2020,Southwest,1,CAH,1,22,12,2,10,0,0,0,2,0,2,0,0,0,22,12,2,10,0,0,0,2,0,2,0,0,0
10/19/2020,Southwest,1,GACH,1,53,45,24,21,0,0,0,4,0,4,2,0,2,53,45,24,21,0,0,0,4,0,4,2,0,2
10/20/2020,Anchorage,7,GACH,1,772,688,534,154,139,113,26,203,31,172,26,0,26,772,688,534,154,139,113,26,203,31,172,26,0,26
10/20/2020,Anchorage,7,LTACH,0,36,36,25,11,7,3,4,24,2,22,0,0,0,36,36,25,11,7,3,4,24,2,22,0,0,0
10/20/2020,Anchorage,7,Psych,0,,,,,,,,,,,,,,96,93,65,28,0,0,0,0,0,0,0,0,0
10/20/2020,Gulf Coast,4,CAH,1,117,90,27,63,4,0,4,25,0,25,0,0,0,117,90,27,63,4,0,4,25,0,25,0,0,0
10/20/2020,Gulf Coast,4,GACH,1,120,52,40,12,9,6,3,10,0,10,1,0,1,120,52,40,12,9,6,3,10,0,10,1,0,1
10/20/2020,Interior,6,GACH,1,101,81,48,33,20,11,9,16,1,15,5,0,5,101,81,48,33,20,11,9,16,1,15,5,0,5
10/20/2020,Matanuska-Susitna,3,GACH,1,184,160,71,89,14,13,1,12,2,10,2,0,2,184,160,71,89,14,13,1,12,2,10,2,0,2
10/20/2020,Northern,2,CAH,1,142,68,20,48,0,0,0,36,0,36,3,0,3,142,68,20,48,0,0,0,36,0,36,3,0,3
10/20/2020,Southeast,5,CAH,1,70,70,27,43,8,2,6,33,0,33,0,0,0,70,70,27,43,8,2,6,33,0,33,0,0,0
10/20/2020,Southeast,5,GACH,1,161,133,29,104,9,7,2,20,1,19,5,0,5,161,133,29,104,9,7,2,20,1,19,5,0,5
10/20/2020,Southwest,1,CAH,1,22,12,3,9,0,0,0,2,0,2,0,0,0,22,12,3,9,0,0,0,2,0,2,0,0,0
10/20/2020,Southwest,1,GACH,1,53,45,25,20,0,0,0,4,0,4,2,0,2,53,45,25,20,0,0,0,4,0,4,2,0,2
10/21/2020,Anchorage,7,GACH,1,772,688,563,125,141,113,28,203,34,169,34,0,34,772,688,563,125,141,113,28,203,34,169,34,0,34
10/21/2020,Anchorage,7,LTACH,0,36,36,25,11,7,3,4,24,2,22,0,0,0,36,36,25,11,7,3,4,24,2,22,0,0,0
10/21/2020,Anchorage,7,Psych,0,,,,,,,,,,,,,,96,93,65,28,0,0,0,0,0,0,0,0,0
10/21/2020,Gulf Coast,4,CAH,1,117,91,37,54,4,0,4,25,0,25,0,0,0,117,91,37,54,4,0,4,25,0,25,0,0,0
10/21/2020,Gulf Coast,4,GACH,1,120,52,36,16,9,5,4,10,0,10,2,0,2,120,52,36,16,9,5,4,10,0,10,2,0,2
10/21/2020,Interior,6,GACH,1,101,81,54,27,20,8,12,16,1,15,4,0,4,101,81,54,27,20,8,12,16,1,15,4,0,4
10/21/2020,Matanuska-Susitna,3,GACH,1,184,160,80,80,14,11,3,12,2,10,2,0,2,184,160,80,80,14,11,3,12,2,10,2,0,2
10/21/2020,Northern,2,CAH,1,142,68,16,52,0,0,0,36,0,36,2,0,2,142,68,16,52,0,0,0,36,0,36,2,0,2
10/21/2020,Southeast,5,CAH,1,70,70,30,40,8,2,6,33,0,33,0,0,0,70,70,30,40,8,2,6,33,0,33,0,0,0
10/21/2020,Southeast,5,GACH,1,161,133,32,101,9,5,4,20,0,20,5,0,5,161,133,32,101,9,5,4,20,0,20,5,0,5
10/21/2020,Southwest,1,CAH,1,22,12,3,9,0,0,0,2,0,2,0,0,0,22,12,3,9,0,0,0,2,0,2,0,0,0
10/21/2020,Southwest,1,GACH,1,,,,,,,,,,,,,,53,45,25,20,0,0,0,4,0,4,2,0,2
10/22/2020,Anchorage,7,GACH,1,778,694,563,131,143,112,31,203,29,174,38,8,46,778,694,563,131,143,112,31,203,29,174,38,8,46
10/22/2020,Anchorage,7,LTACH,0,36,36,25,11,3,3,0,24,2,22,0,0,0,36,36,25,11,3,3,0,24,2,22,0,0,0
10/22/2020,Anchorage,7,Psych,0,,,,,,,,,,,,,,96,93,65,28,0,0,0,0,0,0,0,0,0
10/22/2020,Gulf Coast,4,CAH,1,113,91,26,65,4,0,4,26,0,26,0,0,0,113,91,26,65,4,0,4,26,0,26,0,0,0
10/22/2020,Gulf Coast,4,GACH,1,120,52,40,12,9,5,4,10,0,10,4,0,4,120,52,40,12,9,5,4,10,0,10,4,0,4
10/22/2020,Interior,6,GACH,1,101,81,52,29,20,5,15,16,2,14,6,0,6,101,81,52,29,20,5,15,16,2,14,6,0,6
10/22/2020,Matanuska-Susitna,3,GACH,1,184,160,68,92,14,9,5,30,2,28,4,0,4,184,160,68,92,14,9,5,30,2,28,4,0,4
10/22/2020,Northern,2,CAH,1,142,68,19,49,0,0,0,36,0,36,2,0,2,142,68,19,49,0,0,0,36,0,36,2,0,2
10/22/2020,Southeast,5,CAH,1,70,70,36,34,8,3,5,33,0,33,0,0,0,70,70,36,34,8,3,5,33,0,33,0,0,0
10/22/2020,Southeast,5,GACH,1,161,133,34,99,9,4,5,20,0,20,5,0,5,161,133,34,99,9,4,5,20,0,20,5,0,5
10/22/2020,Southwest,1,CAH,1,22,12,3,9,0,0,0,2,0,2,0,0,0,22,12,3,9,0,0,0,2,0,2,0,0,0
10/22/2020,Southwest,1,GACH,1,53,45,20,25,0,0,0,4,0,4,1,0,1,53,45,20,25,0,0,0,4,0,4,1,0,1
10/23/2020,Anchorage,7,GACH,1,778,694,558,136,143,110,33,203,34,169,38,0,38,778,694,558,136,143,110,33,203,34,169,38,0,38
10/23/2020,Anchorage,7,LTACH,0,36,36,25,11,7,3,4,24,1,23,0,0,0,36,36,25,11,7,3,4,24,1,23,0,0,0
10/23/2020,Anchorage,7,Psych,0,60,57,57,0,0,0,0,0,0,0,0,0,0,96,93,65,28,0,0,0,0,0,0,0,0,0
10/23/2020,Gulf Coast,4,CAH,1,113,91,25,66,4,0,4,26,0,26,1,0,1,113,91,25,66,4,0,4,26,0,26,1,0,1
10/23/2020,Gulf Coast,4,GACH,1,120,52,43,9,9,6,3,10,2,8,5,0,5,120,52,43,9,9,6,3,10,2,8,5,0,5
10/23/2020,Interior,6,GACH,1,101,81,53,28,20,8,12,16,2,14,5,0,5,101,81,53,28,20,8,12,16,2,14,5,0,5
10/23/2020,Matanuska-Susitna,3,GACH,1,184,160,71,89,14,12,2,30,2,28,2,0,2,184,160,71,89,14,12,2,30,2,28,2,0,2
10/23/2020,Northern,2,CAH,1,142,68,18,50,0,0,0,36,0,36,2,0,2,142,68,18,50,0,0,0,36,0,36,2,0,2
10/23/2020,Southeast,5,CAH,1,70,70,24,46,8,3,5,33,0,33,0,0,0,70,70,24,46,8,3,5,33,0,33,0,0,0
10/23/2020,Southeast,5,GACH,1,161,133,30,103,9,5,4,20,0,20,4,0,4,161,133,30,103,9,5,4,20,0,20,4,0,4
10/23/2020,Southwest,1,CAH,1,22,12,3,9,0,0,0,2,0,2,0,0,0,22,12,3,9,0,0,0,2,0,2,0,0,0
10/23/2020,Southwest,1,GACH,1,53,45,19,26,0,0,0,4,0,4,1,0,1,53,45,19,26,0,0,0,4,0,4,1,0,1
10/24/2020,Anchorage,7,GACH,1,779,695,564,131,140,105,35,203,30,173,32,0,32,779,695,564,131,140,105,35,203,30,173,32,0,32
10/24/2020,Anchorage,7,LTACH,0,36,36,25,11,7,3,4,24,0,24,0,0,0,36,36,25,11,7,3,4,24,0,24,0,0,0
10/24/2020,Anchorage,7,Psych,0,,,,,,,,,,,,,,96,93,65,28,0,0,0,0,0,0,0,0,0
10/24/2020,Gulf Coast,4,CAH,1,113,91,27,64,4,0,4,26,0,26,0,0,0,113,91,27,64,4,0,4,26,0,26,0,0,0
10/24/2020,Gulf Coast,4,GACH,1,120,52,44,8,9,6,3,10,1,9,6,0,6,120,52,44,8,9,6,3,10,1,9,6,0,6
10/24/2020,Interior,6,GACH,1,101,81,45,36,20,9,11,16,2,14,4,0,4,101,81,45,36,20,9,11,16,2,14,4,0,4
10/24/2020,Matanuska-Susitna,3,GACH,1,184,160,68,92,14,11,3,30,2,28,4,0,4,184,160,68,92,14,11,3,30,2,28,4,0,4
10/24/2020,Northern,2,CAH,1,142,68,22,46,0,0,0,36,0,36,2,0,2,142,68,22,46,0,0,0,36,0,36,2,0,2
10/24/2020,Southeast,5,CAH,1,70,70,24,46,8,3,5,33,0,33,0,0,0,70,70,24,46,8,3,5,33,0,33,0,0,0
10/24/2020,Southeast,5,GACH,1,161,133,26,107,9,3,6,20,0,20,3,0,3,161,133,26,107,9,3,6,20,0,20,3,0,3
10/24/2020,Southwest,1,CAH,1,22,12,1,11,0,0,0,2,0,2,0,0,0,22,12,1,11,0,0,0,2,0,2,0,0,0
10/24/2020,Southwest,1,GACH,1,53,45,19,26,0,0,0,4,0,4,1,0,1,53,45,19,26,0,0,0,4,0,4,1,0,1
10/25/2020,Anchorage,7,GACH,1,779,695,546,149,140,113,27,203,34,169,38,0,38,779,695,546,149,140,113,27,203,34,169,38,0,38
10/25/2020,Anchorage,7,LTACH,0,36,36,25,11,7,3,4,24,0,24,0,0,0,36,36,25,11,7,3,4,24,0,24,0,0,0
10/25/2020,Anchorage,7,Psych,0,,,,,,,,,,,,,,96,93,65,28,0,0,0,0,0,0,0,0,0
10/25/2020,Gulf Coast,4,CAH,1,113,91,23,68,4,0,4,26,0,26,0,0,0,113,91,23,68,4,0,4,26,0,26,0,0,0
10/25/2020,Gulf Coast,4,GACH,1,120,52,33,19,9,3,6,10,0,10,2,0,2,120,52,33,19,9,3,6,10,0,10,2,0,2
10/25/2020,Interior,6,GACH,1,101,81,48,33,20,12,8,16,0,16,3,1,4,101,81,48,33,20,12,8,16,0,16,3,1,4
10/25/2020,Matanuska-Susitna,3,GACH,1,184,160,59,101,14,9,5,30,2,28,3,0,3,184,160,59,101,14,9,5,30,2,28,3,0,3
10/25/2020,Northern,2,CAH,1,142,68,20,48,0,0,0,36,0,36,2,0,2,142,68,20,48,0,0,0,36,0,36,2,0,2
10/25/2020,Southeast,5,CAH,1,70,70,25,45,8,3,5,33,0,33,0,0,0,70,70,25,45,8,3,5,33,0,33,0,0,0
10/25/2020,Southeast,5,GACH,1,161,133,30,103,9,3,6,20,0,20,3,0,3,161,133,30,103,9,3,6,20,0,20,3,0,3
10/25/2020,Southwest,1,CAH,1,22,12,1,11,0,0,0,2,0,2,0,0,0,22,12,1,11,0,0,0,2,0,2,0,0,0
10/25/2020,Southwest,1,GACH,1,53,45,19,26,0,0,0,4,0,4,1,0,1,53,45,19,26,0,0,0,4,0,4,1,0,1
10/26/2020,Anchorage,7,GACH,1,779,695,546,149,130,95,35,203,33,170,41,0,41,779,695,546,149,130,95,35,203,33,170,41,0,41
10/26/2020,Anchorage,7,LTACH,0,36,36,24,12,7,3,4,24,0,24,0,0,0,36,36,24,12,7,3,4,24,0,24,0,0,0
10/26/2020,Anchorage,7,Psych,0,,,,,,,,,,,,,,96,93,65,28,0,0,0,0,0,0,0,0,0
10/26/2020,Gulf Coast,4,CAH,1,113,91,23,68,4,0,4,26,0,26,0,0,0,113,91,23,68,4,0,4,26,0,26,0,0,0
10/26/2020,Gulf Coast,4,GACH,1,120,52,39,13,9,7,2,10,0,10,4,0,4,120,52,39,13,9,7,2,10,0,10,4,0,4
10/26/2020,Interior,6,GACH,1,101,81,50,31,20,8,12,16,1,15,2,1,3,101,81,50,31,20,8,12,16,1,15,2,1,3
10/26/2020,Matanuska-Susitna,3,GACH,1,184,160,64,96,14,11,3,30,3,27,3,0,3,184,160,64,96,14,11,3,30,3,27,3,0,3
10/26/2020,Northern,2,CAH,1,142,68,24,44,0,0,0,36,0,36,2,0,2,142,68,24,44,0,0,0,36,0,36,2,0,2
10/26/2020,Southeast,5,CAH,1,70,70,24,46,8,3,5,33,0,33,0,0,0,70,70,24,46,8,3,5,33,0,33,0,0,0
10/26/2020,Southeast,5,GACH,1,161,133,27,106,9,5,4,20,0,20,4,0,4,161,133,27,106,9,5,4,20,0,20,4,0,4
10/26/2020,Southwest,1,CAH,1,22,12,1,11,0,0,0,2,0,2,0,0,0,22,12,1,11,0,0,0,2,0,2,0,0,0
10/26/2020,Southwest,1,GACH,1,53,45,19,26,0,0,0,4,0,4,1,0,1,53,45,19,26,0,0,0,4,0,4,1,0,1
10/27/2020,Anchorage,7,GACH,1,779,695,582,113,130,103,27,203,33,170,45,0,45,779,695,582,113,130,103,27,203,33,170,45,0,45
10/27/2020,Anchorage,7,LTACH,0,36,36,26,10,7,2,5,24,0,24,0,0,0,36,36,26,10,7,2,5,24,0,24,0,0,0
10/27/2020,Anchorage,7,Psych,0,,,,,,,,,,,,,,96,93,65,28,0,0,0,0,0,0,0,0,0
10/27/2020,Gulf Coast,4,CAH,1,113,91,24,67,4,1,3,26,0,26,0,0,0,113,91,24,67,4,1,3,26,0,26,0,0,0
10/27/2020,Gulf Coast,4,GACH,1,120,52,42,10,9,7,2,10,0,10,5,0,5,120,52,42,10,9,7,2,10,0,10,5,0,5
10/27/2020,Interior,6,GACH,1,101,81,55,26,20,13,7,16,1,15,2,0,2,101,81,55,26,20,13,7,16,1,15,2,0,2
10/27/2020,Matanuska-Susitna,3,GACH,1,184,160,68,92,14,14,0,30,3,27,4,0,4,184,160,68,92,14,14,0,30,3,27,4,0,4
10/27/2020,Northern,2,CAH,1,142,68,27,41,0,0,0,36,0,36,2,0,2,142,68,27,41,0,0,0,36,0,36,2,0,2
10/27/2020,Southeast,5,CAH,1,70,70,22,48,8,2,6,33,0,33,0,0,0,70,70,22,48,8,2,6,33,0,33,0,0,0
10/27/2020,Southeast,5,GACH,1,,,,,,,,,,,,,,161,133,27,106,9,5,4,20,0,20,4,0,4
10/27/2020,Southwest,1,CAH,1,22,12,2,10,0,0,0,2,0,2,0,0,0,22,12,2,10,0,0,0,2,0,2,0,0,0
10/27/2020,Southwest,1,GACH,1,,,,,,,,,,,,,,53,45,19,26,0,0,0,4,0,4,1,0,1
10/28/2020,Anchorage,7,GACH,1,779,706,585,121,137,109,28,203,31,172,49,7,56,779,706,585,121,137,109,28,203,31,172,49,7,56
10/28/2020,Anchorage,7,LTACH,0,36,36,21,15,7,2,5,24,0,24,0,0,0,36,36,21,15,7,2,5,24,0,24,0,0,0
10/28/2020,Anchorage,7,Psych,0,,,,,,,,,,,,,,96,93,65,28,0,0,0,0,0,0,0,0,0
10/28/2020,Gulf Coast,4,CAH,1,113,91,25,66,4,0,4,26,0,26,0,0,0,113,91,25,66,4,0,4,26,0,26,0,0,0
10/28/2020,Gulf Coast,4,GACH,1,120,52,38,14,9,5,4,10,0,10,6,0,6,120,52,38,14,9,5,4,10,0,10,6,0,6
10/28/2020,Interior,6,GACH,1,101,81,50,31,20,16,4,16,3,13,2,0,2,101,81,50,31,20,16,4,16,3,13,2,0,2
10/28/2020,Matanuska-Susitna,3,GACH,1,184,160,68,92,14,9,5,30,2,28,4,0,4,184,160,68,92,14,9,5,30,2,28,4,0,4
10/28/2020,Northern,2,CAH,1,142,68,23,45,0,0,0,36,0,36,2,0,2,142,68,23,45,0,0,0,36,0,36,2,0,2
10/28/2020,Southeast,5,CAH,1,70,70,24,46,8,2,6,33,0,33,0,0,0,70,70,24,46,8,2,6,33,0,33,0,0,0
10/28/2020,Southeast,5,GACH,1,161,133,34,99,9,4,5,20,0,20,3,0,3,161,133,34,99,9,4,5,20,0,20,3,0,3
10/28/2020,Southwest,1,CAH,1,22,12,3,9,0,0,0,2,0,2,0,0,0,22,12,3,9,0,0,0,2,0,2,0,0,0
10/28/2020,Southwest,1,GACH,1,53,45,16,29,0,0,0,4,0,4,2,0,2,53,45,16,29,0,0,0,4,0,4,2,0,2
10/29/2020,Anchorage,7,GACH,1,771,694,582,112,139,104,35,203,35,168,54,0,54,771,694,582,112,139,104,35,203,35,168,54,0,54
10/29/2020,Anchorage,7,LTACH,0,36,36,27,9,7,4,3,24,0,24,0,0,0,36,36,27,9,7,4,3,24,0,24,0,0,0
10/29/2020,Anchorage,7,Psych,0,60,59,59,0,0,0,0,0,0,0,0,0,0,96,95,67,28,0,0,0,0,0,0,0,0,0
10/29/2020,Gulf Coast,4,CAH,1,113,91,26,65,4,0,4,26,0,26,0,0,0,113,91,26,65,4,0,4,26,0,26,0,0,0
10/29/2020,Gulf Coast,4,GACH,1,120,52,39,13,9,5,4,10,0,10,4,0,4,120,52,39,13,9,5,4,10,0,10,4,0,4
10/29/2020,Interior,6,GACH,1,101,81,65,16,20,17,3,16,3,13,2,0,2,101,81,65,16,20,17,3,16,3,13,2,0,2
10/29/2020,Matanuska-Susitna,3,GACH,1,184,160,68,92,14,7,7,30,2,28,4,0,4,184,160,68,92,14,7,7,30,2,28,4,0,4
10/29/2020,Northern,2,CAH,1,142,68,19,49,0,0,0,36,0,36,2,0,2,142,68,19,49,0,0,0,36,0,36,2,0,2
10/29/2020,Southeast,5,CAH,1,70,70,28,42,8,2,6,33,0,33,0,0,0,70,70,28,42,8,2,6,33,0,33,0,0,0
10/29/2020,Southeast,5,GACH,1,161,133,32,101,9,6,3,20,0,20,3,0,3,161,133,32,101,9,6,3,20,0,20,3,0,3
10/29/2020,Southwest,1,CAH,1,22,12,2,10,0,0,0,2,0,2,0,0,0,22,12,2,10,0,0,0,2,0,2,0,0,0
10/29/2020,Southwest,1,GACH,1,53,45,26,19,0,0,0,4,0,4,3,0,3,53,45,26,19,0,0,0,4,0,4,3,0,3
10/30/2020,Anchorage,7,GACH,1,771,694,579,115,138,105,33,203,32,171,60,0,60,771,694,579,115,138,105,33,203,32,171,60,0,60
10/30/2020,Anchorage,7,LTACH,0,30,30,26,4,3,3,0,24,0,24,0,0,0,30,30,26,4,3,3,0,24,0,24,0,0,0
10/30/2020,Anchorage,7,Psych,0,,,,,,,,,,,,,,96,95,67,28,0,0,0,0,0,0,0,0,0
10/30/2020,Gulf Coast,4,CAH,1,113,91,29,62,4,2,2,26,0,26,0,0,0,113,91,29,62,4,2,2,26,0,26,0,0,0
10/30/2020,Gulf Coast,4,GACH,1,120,52,38,14,9,7,2,10,0,10,4,0,4,120,52,38,14,9,7,2,10,0,10,4,0,4
10/30/2020,Interior,6,GACH,1,101,81,58,23,20,14,6,16,1,15,0,0,0,101,81,58,23,20,14,6,16,1,15,0,0,0
10/30/2020,Matanuska-Susitna,3,GACH,1,184,160,67,93,14,8,6,30,1,29,4,0,4,184,160,67,93,14,8,6,30,1,29,4,0,4
10/30/2020,Northern,2,CAH,1,142,68,16,52,0,0,0,36,0,36,2,0,2,142,68,16,52,0,0,0,36,0,36,2,0,2
10/30/2020,Southeast,5,CAH,1,70,70,29,41,8,3,5,33,0,33,1,0,1,70,70,29,41,8,3,5,33,0,33,1,0,1
10/30/2020,Southeast,5,GACH,1,161,133,31,102,9,4,5,20,0,20,3,0,3,161,133,31,102,9,4,5,20,0,20,3,0,3
10/30/2020,Southwest,1,CAH,1,22,12,2,10,0,0,0,2,0,2,0,0,0,22,12,2,10,0,0,0,2,0,2,0,0,0
10/30/2020,Southwest,1,GACH,1,53,45,22,23,0,0,0,4,0,4,2,0,2,53,45,22,23,0,0,0,4,0,4,2,0,2
10/31/2020,Anchorage,7,GACH,1,770,693,562,131,141,105,36,203,32,171,61,0,61,770,693,562,131,141,105,36,203,32,171,61,0,61
10/31/2020,Anchorage,7,LTACH,0,30,30,24,6,3,3,0,23,0,23,0,0,0,30,30,24,6,3,3,0,23,0,23,0,0,0
10/31/2020,Anchorage,7,Psych,0,,,,,,,,,,,,,,96,95,67,28,0,0,0,0,0,0,0,0,0
10/31/2020,Gulf Coast,4,CAH,1,110,90,28,62,4,1,3,26,0,26,0,0,0,110,90,28,62,4,1,3,26,0,26,0,0,0
10/31/2020,Gulf Coast,4,GACH,1,115,52,35,17,9,6,3,10,0,10,5,0,5,115,52,35,17,9,6,3,10,0,10,5,0,5
10/31/2020,Interior,6,GACH,1,101,81,56,25,20,13,7,16,2,14,0,0,0,101,81,56,25,20,13,7,16,2,14,0,0,0
10/31/2020,Matanuska-Susitna,3,GACH,1,184,160,75,85,14,11,3,30,1,29,5,0,5,184,160,75,85,14,11,3,30,1,29,5,0,5
10/31/2020,Northern,2,CAH,1,142,68,16,52,0,0,0,36,0,36,2,0,2,142,68,16,52,0,0,0,36,0,36,2,0,2
10/31/2020,Southeast,5,CAH,1,70,70,31,39,8,3,5,33,0,33,1,0,1,70,70,31,39,8,3,5,33,0,33,1,0,1
10/31/2020,Southeast,5,GACH,1,161,133,30,103,9,6,3,20,0,20,3,0,3,161,133,30,103,9,6,3,20,0,20,3,0,3
10/31/2020,Southwest,1,CAH,1,22,12,3,9,0,0,0,2,0,2,0,0,0,22,12,3,9,0,0,0,2,0,2,0,0,0
10/31/2020,Southwest,1,GACH,1,53,45,23,22,0,0,0,4,0,4,3,0,3,53,45,23,22,0,0,0,4,0,4,3,0,3
11/01/2020,Anchorage,7,GACH,1,761,684,537,147,140,104,36,203,34,169,56,0,56,761,684,537,147,140,104,36,203,34,169,56,0,56
11/01/2020,Anchorage,7,LTACH,0,30,30,25,5,3,3,0,23,0,23,0,0,0,30,30,25,5,3,3,0,23,0,23,0,0,0
11/01/2020,Anchorage,7,Psych,0,,,,,,,,,,,,,,96,95,67,28,0,0,0,0,0,0,0,0,0
11/01/2020,Gulf Coast,4,CAH,1,110,90,30,60,4,1,3,26,0,26,0,0,0,110,90,30,60,4,1,3,26,0,26,0,0,0
11/01/2020,Gulf Coast,4,GACH,1,115,52,34,18,9,4,5,10,0,10,7,0,7,115,52,34,18,9,4,5,10,0,10,7,0,7
11/01/2020,Interior,6,GACH,1,101,81,48,33,20,15,5,16,3,13,0,0,0,101,81,48,33,20,15,5,16,3,13,0,0,0
11/01/2020,Matanuska-Susitna,3,GACH,1,184,160,73,87,14,10,4,30,1,29,7,0,7,184,160,73,87,14,10,4,30,1,29,7,0,7
11/01/2020,Northern,2,CAH,1,142,68,17,51,0,0,0,36,0,36,2,0,2,142,68,17,51,0,0,0,36,0,36,2,0,2
11/01/2020,Southeast,5,CAH,1,70,70,32,38,8,4,4,33,0,33,0,0,0,70,70,32,38,8,4,4,33,0,33,0,0,0
11/01/2020,Southeast,5,GACH,1,161,133,28,105,9,3,6,20,0,20,3,0,3,161,133,28,105,9,3,6,20,0,20,3,0,3
11/01/2020,Southwest,1,CAH,1,22,12,3,9,0,0,0,2,0,2,0,0,0,22,12,3,9,0,0,0,2,0,2,0,0,0
11/01/2020,Southwest,1,GACH,1,53,45,20,25,0,0,0,4,0,4,3,0,3,53,45,20,25,0,0,0,4,0,4,3,0,3
11/02/2020,Anchorage,7,GACH,1,761,684,531,153,137,99,38,203,35,168,54,0,54,761,684,531,153,137,99,38,203,35,168,54,0,54
11/02/2020,Anchorage,7,LTACH,0,30,30,25,5,3,3,0,23,0,23,0,0,0,30,30,25,5,3,3,0,23,0,23,0,0,0
11/02/2020,Anchorage,7,Psych,0,,,,,,,,,,,,,,96,95,67,28,0,0,0,0,0,0,0,0,0
11/02/2020,Gulf Coast,4,CAH,1,110,90,25,65,4,0,4,26,0,26,0,0,0,110,90,25,65,4,0,4,26,0,26,0,0,0
11/02/2020,Gulf Coast,4,GACH,1,115,52,36,16,9,4,5,10,0,10,7,0,7,115,52,36,16,9,4,5,10,0,10,7,0,7
11/02/2020,Interior,6,GACH,1,101,81,52,29,20,14,6,16,3,13,0,0,0,101,81,52,29,20,14,6,16,3,13,0,0,0
11/02/2020,Matanuska-Susitna,3,GACH,1,184,160,75,85,14,11,3,30,3,27,10,0,10,184,160,75,85,14,11,3,30,3,27,10,0,10
11/02/2020,Northern,2,CAH,1,142,68,18,50,0,0,0,36,0,36,2,0,2,142,68,18,50,0,0,0,36,0,36,2,0,2
11/02/2020,Southeast,5,CAH,1,70,70,28,42,8,3,5,33,0,33,0,0,0,70,70,28,42,8,3,5,33,0,33,0,0,0
11/02/2020,Southeast,5,GACH,1,161,133,28,105,9,2,7,20,0,20,2,0,2,161,133,28,105,9,2,7,20,0,20,2,0,2
11/02/2020,Southwest,1,CAH,1,22,12,1,11,0,0,0,2,0,2,0,0,0,22,12,1,11,0,0,0,2,0,2,0,0,0
11/02/2020,Southwest,1,GACH,1,53,45,22,23,0,0,0,4,0,4,5,0,5,53,45,22,23,0,0,0,4,0,4,5,0,5
11/03/2020,Anchorage,7,GACH,1,764,687,552,135,137,99,38,203,31,172,55,0,55,764,687,552,135,137,99,38,203,31,172,55,0,55
11/03/2020,Anchorage,7,LTACH,0,30,30,24,6,3,3,0,23,0,23,0,0,0,30,30,24,6,3,3,0,23,0,23,0,0,0
11/03/2020,Anchorage,7,Psych,0,,,,,,,,,,,,,,96,95,67,28,0,0,0,0,0,0,0,0,0
11/03/2020,Gulf Coast,4,CAH,1,110,90,21,69,4,0,4,26,0,26,1,0,1,110,90,21,69,4,0,4,26,0,26,1,0,1
11/03/2020,Gulf Coast,4,GACH,1,115,52,38,14,9,6,3,10,0,10,7,0,7,115,52,38,14,9,6,3,10,0,10,7,0,7
11/03/2020,Interior,6,GACH,1,101,81,43,38,20,15,5,16,2,14,0,0,0,101,81,43,38,20,15,5,16,2,14,0,0,0
11/03/2020,Matanuska-Susitna,3,GACH,1,184,160,81,79,14,14,0,30,4,26,9,0,9,184,160,81,79,14,14,0,30,4,26,9,0,9
11/03/2020,Northern,2,CAH,1,142,68,18,50,0,0,0,36,0,36,3,1,4,142,68,18,50,0,0,0,36,0,36,3,1,4
11/03/2020,Southeast,5,CAH,1,70,70,25,45,8,3,5,33,0,33,3,0,3,70,70,25,45,8,3,5,33,0,33,3,0,3
11/03/2020,Southeast,5,GACH,1,161,133,33,100,9,6,3,20,0,20,3,0,3,161,133,33,100,9,6,3,20,0,20,3,0,3
11/03/2020,Southwest,1,CAH,1,,,,,,,,,,,,,,22,12,1,11,0,0,0,2,0,2,0,0,0
11/03/2020,Southwest,1,GACH,1,53,45,20,25,0,0,0,4,0,4,5,0,5,53,45,20,25,0,0,0,4,0,4,5,0,5
11/04/2020,Anchorage,7,GACH,1,763,686,569,117,137,101,36,203,29,174,54,0,54,763,686,569,117,137,101,36,203,29,174,54,0,54
11/04/2020,Anchorage,7,LTACH,0,30,30,26,4,3,3,0,23,0,23,0,0,0,30,30,26,4,3,3,0,23,0,23,0,0,0
11/04/2020,Anchorage,7,Psych,0,200,192,122,70,0,0,0,0,0,0,5,0,5,200,192,122,70,0,0,0,0,0,0,5,0,5
11/04/2020,Gulf Coast,4,CAH,1,110,90,24,66,4,2,2,26,0,26,1,0,1,110,90,24,66,4,2,2,26,0,26,1,0,1
11/04/2020,Gulf Coast,4,GACH,1,115,52,40,12,9,6,3,10,0,10,7,0,7,115,52,40,12,9,6,3,10,0,10,7,0,7
11/04/2020,Interior,6,GACH,1,101,81,41,40,20,11,9,16,0,16,3,0,3,101,81,41,40,20,11,9,16,0,16,3,0,3
11/04/2020,Matanuska-Susitna,3,GACH,1,184,160,85,75,14,13,1,30,3,27,8,0,8,184,160,85,75,14,13,1,30,3,27,8,0,8
11/04/2020,Northern,2,CAH,1,142,68,20,48,0,0,0,36,0,36,3,1,4,142,68,20,48,0,0,0,36,0,36,3,1,4
11/04/2020,Southeast,5,CAH,1,70,70,29,41,8,2,6,33,0,33,4,0,4,70,70,29,41,8,2,6,33,0,33,4,0,4
11/04/2020,Southeast,5,GACH,1,161,133,36,97,9,6,3,20,0,20,4,0,4,161,133,36,97,9,6,3,20,0,20,4,0,4
11/04/2020,Southwest,1,CAH,1,22,12,1,11,0,0,0,2,0,2,0,0,0,22,12,1,11,0,0,0,2,0,2,0,0,0
11/04/2020,Southwest,1,GACH,1,53,45,21,24,0,0,0,4,0,4,5,0,5,53,45,21,24,0,0,0,4,0,4,5,0,5
11/05/2020,Anchorage,7,GACH,1,764,687,563,124,137,103,34,203,30,173,58,0,58,764,687,563,124,137,103,34,203,30,173,58,0,58
11/05/2020,Anchorage,7,LTACH,0,30,30,28,2,3,3,0,23,0,23,1,0,1,30,30,28,2,3,3,0,23,0,23,1,0,1
11/05/2020,Anchorage,7,Psych,0,,,,,,,,,,,,,,200,192,122,70,0,0,0,0,0,0,5,0,5
11/05/2020,Gulf Coast,4,CAH,1,95,84,26,58,4,3,1,26,0,26,1,0,1,95,84,26,58,4,3,1,26,0,26,1,0,1
11/05/2020,Gulf Coast,4,GACH,1,115,52,38,14,9,5,4,10,0,10,7,0,7,115,52,38,14,9,5,4,10,0,10,7,0,7
11/05/2020,Interior,6,GACH,1,101,81,44,37,20,6,14,16,0,16,4,0,4,101,81,44,37,20,6,14,16,0,16,4,0,4
11/05/2020,Matanuska-Susitna,3,GACH,1,184,160,89,71,14,12,2,30,2,28,8,0,8,184,160,89,71,14,12,2,30,2,28,8,0,8
11/05/2020,Northern,2,CAH,1,142,68,19,49,0,0,0,36,0,36,3,0,3,142,68,19,49,0,0,0,36,0,36,3,0,3
11/05/2020,Southeast,5,CAH,1,70,70,30,40,8,3,5,33,0,33,7,0,7,70,70,30,40,8,3,5,33,0,33,7,0,7
11/05/2020,Southeast,5,GACH,1,,,,,,,,,,,,,,161,133,36,97,9,6,3,20,0,20,4,0,4
11/05/2020,Southwest,1,CAH,1,22,12,3,9,0,0,0,2,0,2,0,0,0,22,12,3,9,0,0,0,2,0,2,0,0,0
11/05/2020,Southwest,1,GACH,1,53,45,22,23,0,0,0,4,0,4,5,0,5,53,45,22,23,0,0,0,4,0,4,5,0,5
11/06/2020,Anchorage,7,GACH,1,764,687,553,134,146,115,31,203,31,172,57,0,57,764,687,553,134,146,115,31,203,31,172,57,0,57
11/06/2020,Anchorage,7,LTACH,0,30,30,27,3,3,3,0,23,0,23,1,0,1,30,30,27,3,3,3,0,23,0,23,1,0,1
11/06/2020,Anchorage,7,Psych,0,,,,,,,,,,,,,,200,192,122,70,0,0,0,0,0,0,5,0,5
11/06/2020,Gulf Coast,4,CAH,1,95,85,22,63,4,1,3,26,0,26,0,0,0,95,85,22,63,4,1,3,26,0,26,0,0,0
11/06/2020,Gulf Coast,4,GACH,1,115,52,34,18,9,6,3,10,0,10,5,0,5,115,52,34,18,9,6,3,10,0,10,5,0,5
11/06/2020,Interior,6,GACH,1,101,81,42,39,20,8,12,16,2,14,5,0,5,101,81,42,39,20,8,12,16,2,14,5,0,5
11/06/2020,Matanuska-Susitna,3,GACH,1,184,160,83,77,14,12,2,30,2,28,11,1,12,184,160,83,77,14,12,2,30,2,28,11,1,12
11/06/2020,Northern,2,CAH,1,142,68,15,53,0,0,0,36,0,36,2,0,2,142,68,15,53,0,0,0,36,0,36,2,0,2
11/06/2020,Southeast,5,CAH,1,70,70,34,36,8,2,6,33,0,33,7,0,7,70,70,34,36,8,2,6,33,0,33,7,0,7
11/06/2020,Southeast,5,GACH,1,161,133,31,102,9,3,6,20,0,20,2,0,2,161,133,31,102,9,3,6,20,0,20,2,0,2
11/06/2020,Southwest,1,CAH,1,22,12,3,9,0,0,0,2,0,2,0,0,0,22,12,3,9,0,0,0,2,0,2,0,0,0
11/06/2020,Southwest,1,GACH,1,53,45,22,23,0,0,0,4,0,4,6,0,6,53,45,22,23,0,0,0,4,0,4,6,0,6
11/07/2020,Anchorage,7,GACH,1,774,697,557,140,138,111,27,203,33,170,65,0,65,774,697,557,140,138,111,27,203,33,170,65,0,65
11/07/2020,Anchorage,7,LTACH,0,30,30,28,2,3,3,0,23,0,23,1,0,1,30,30,28,2,3,3,0,23,0,23,1,0,1
11/07/2020,Anchorage,7,Psych,0,,,,,,,,,,,,,,200,192,122,70,0,0,0,0,0,0,5,0,5
11/07/2020,Gulf Coast,4,CAH,1,95,85,25,60,4,1,3,26,0,26,0,0,0,95,85,25,60,4,1,3,26,0,26,0,0,0
11/07/2020,Gulf Coast,4,GACH,1,115,52,33,19,9,5,4,10,0,10,3,0,3,115,52,33,19,9,5,4,10,0,10,3,0,3
11/07/2020,Interior,6,GACH,1,101,81,44,37,20,7,13,16,2,14,5,0,5,101,81,44,37,20,7,13,16,2,14,5,0,5
11/07/2020,Matanuska-Susitna,3,GACH,1,184,160,79,81,14,14,0,30,3,27,15,1,16,184,160,79,81,14,14,0,30,3,27,15,1,16
11/07/2020,Northern,2,CAH,1,142,68,13,55,0,0,0,36,0,36,2,0,2,142,68,13,55,0,0,0,36,0,36,2,0,2
11/07/2020,Southeast,5,CAH,1,70,70,44,26,8,2,6,33,0,33,7,0,7,70,70,44,26,8,2,6,33,0,33,7,0,7
11/07/2020,Southeast,5,GACH,1,161,133,35,98,9,3,6,20,1,19,2,0,2,161,133,35,98,9,3,6,20,1,19,2,0,2
11/07/2020,Southwest,1,CAH,1,22,12,0,12,0,0,0,2,0,2,0,0,0,22,12,0,12,0,0,0,2,0,2,0,0,0
11/07/2020,Southwest,1,GACH,1,53,45,23,22,0,0,0,4,0,4,7,0,7,53,45,23,22,0,0,0,4,0,4,7,0,7
11/08/2020,Anchorage,7,GACH,1,763,686,532,154,136,100,36,203,29,174,62,0,62,763,686,532,154,136,100,36,203,29,174,62,0,62
11/08/2020,Anchorage,7,LTACH,0,30,30,28,2,3,3,0,23,1,22,2,0,2,30,30,28,2,3,3,0,23,1,22,2,0,2
11/08/2020,Anchorage,7,Psych,0,,,,,,,,,,,,,,200,192,122,70,0,0,0,0,0,0,5,0,5
11/08/2020,Gulf Coast,4,CAH,1,95,85,24,61,4,0,4,26,0,26,0,0,0,95,85,24,61,4,0,4,26,0,26,0,0,0
11/08/2020,Gulf Coast,4,GACH,1,115,52,35,17,9,4,5,9,1,8,3,0,3,115,52,35,17,9,4,5,9,1,8,3,0,3
11/08/2020,Interior,6,GACH,1,101,81,42,39,20,8,12,16,2,14,5,0,5,101,81,42,39,20,8,12,16,2,14,5,0,5
11/08/2020,Matanuska-Susitna,3,GACH,1,184,160,76,84,14,13,1,30,4,26,12,0,12,184,160,76,84,14,13,1,30,4,26,12,0,12
11/08/2020,Northern,2,CAH,1,142,68,14,54,0,0,0,36,0,36,2,0,2,142,68,14,54,0,0,0,36,0,36,2,0,2
11/08/2020,Southeast,5,CAH,1,70,70,40,30,8,2,6,33,0,33,6,0,6,70,70,40,30,8,2,6,33,0,33,6,0,6
11/08/2020,Southeast,5,GACH,1,161,133,35,98,9,3,6,20,1,19,2,0,2,161,133,35,98,9,3,6,20,1,19,2,0,2
11/08/2020,Southwest,1,CAH,1,22,12,0,12,0,0,0,2,0,2,0,0,0,22,12,0,12,0,0,0,2,0,2,0,0,0
11/08/2020,Southwest,1,GACH,1,53,45,28,17,0,0,0,4,0,4,9,0,9,53,45,28,17,0,0,0,4,0,4,9,0,9
11/09/2020,Anchorage,7,GACH,1,742,658,514,144,143,100,43,203,32,171,62,1,63,742,658,514,144,143,100,43,203,32,171,62,1,63
11/09/2020,Anchorage,7,LTACH,0,30,30,28,2,3,3,0,23,1,22,2,0,2,30,30,28,2,3,3,0,23,1,22,2,0,2
11/09/2020,Anchorage,7,Psych,0,,,,,,,,,,,,,,200,192,122,70,0,0,0,0,0,0,5,0,5
11/09/2020,Gulf Coast,4,CAH,1,94,85,21,64,4,0,4,26,0,26,0,0,0,94,85,21,64,4,0,4,26,0,26,0,0,0
11/09/2020,Gulf Coast,4,GACH,1,115,52,37,15,9,3,6,10,0,10,4,0,4,115,52,37,15,9,3,6,10,0,10,4,0,4
11/09/2020,Interior,6,GACH,1,101,81,42,39,20,9,11,16,0,16,6,0,6,101,81,42,39,20,9,11,16,0,16,6,0,6
11/09/2020,Matanuska-Susitna,3,GACH,1,184,160,80,80,14,14,0,30,4,26,15,0,15,184,160,80,80,14,14,0,30,4,26,15,0,15
11/09/2020,Northern,2,CAH,1,142,68,15,53,0,0,0,36,0,36,2,0,2,142,68,15,53,0,0,0,36,0,36,2,0,2
11/09/2020,Southeast,5,CAH,1,70,70,38,32,8,2,6,33,0,33,6,0,6,70,70,38,32,8,2,6,33,0,33,6,0,6
11/09/2020,Southeast,5,GACH,1,161,133,37,96,9,4,5,20,0,20,2,0,2,161,133,37,96,9,4,5,20,0,20,2,0,2
11/09/2020,Southwest,1,CAH,1,22,12,0,12,0,0,0,2,0,2,0,0,0,22,12,0,12,0,0,0,2,0,2,0,0,0
11/09/2020,Southwest,1,GACH,1,53,45,22,23,0,0,0,4,0,4,6,0,6,53,45,22,23,0,0,0,4,0,4,6,0,6
11/10/2020,Anchorage,7,GACH,1,758,681,539,142,150,104,46,203,30,173,64,0,64,758,681,539,142,150,104,46,203,30,173,64,0,64
11/10/2020,Anchorage,7,LTACH,0,30,30,30,0,3,3,0,23,1,22,2,0,2,30,30,30,0,3,3,0,23,1,22,2,0,2
11/10/2020,Anchorage,7,Psych,0,,,,,,,,,,,,,,200,192,122,70,0,0,0,0,0,0,5,0,5
11/10/2020,Gulf Coast,4,CAH,1,94,85,21,64,4,1,3,26,0,26,0,0,0,94,85,21,64,4,1,3,26,0,26,0,0,0
11/10/2020,Gulf Coast,4,GACH,1,115,52,45,7,9,7,2,10,0,10,5,0,5,115,52,45,7,9,7,2,10,0,10,5,0,5
11/10/2020,Interior,6,GACH,1,101,81,52,29,20,12,8,16,0,16,3,0,3,101,81,52,29,20,12,8,16,0,16,3,0,3
11/10/2020,Matanuska-Susitna,3,GACH,1,184,160,80,80,14,14,0,30,3,27,16,0,16,184,160,80,80,14,14,0,30,3,27,16,0,16
11/10/2020,Northern,2,CAH,1,142,68,11,57,0,0,0,36,0,36,2,0,2,142,68,11,57,0,0,0,36,0,36,2,0,2
11/10/2020,Southeast,5,CAH,1,70,70,31,39,8,6,2,33,0,33,3,0,3,70,70,31,39,8,6,2,33,0,33,3,0,3
11/10/2020,Southeast,5,GACH,1,161,133,36,97,9,2,7,20,0,20,2,0,2,161,133,36,97,9,2,7,20,0,20,2,0,2
11/10/2020,Southwest,1,CAH,1,22,12,0,12,0,0,0,2,0,2,0,0,0,22,12,0,12,0,0,0,2,0,2,0,0,0
11/10/2020,Southwest,1,GACH,1,53,45,21,24,0,0,0,4,0,4,6,0,6,53,45,21,24,0,0,0,4,0,4,6,0,6
11/11/2020,Anchorage,7,GACH,1,764,687,585,102,149,105,44,203,27,176,62,0,62,764,687,585,102,149,105,44,203,27,176,62,0,62
11/11/2020,Anchorage,7,LTACH,0,30,30,30,0,3,3,0,23,0,23,2,0,2,30,30,30,0,3,3,0,23,0,23,2,0,2
11/11/2020,Anchorage,7,Psych,0,200,190,113,77,0,0,0,0,0,0,4,0,4,200,190,113,77,0,0,0,0,0,0,4,0,4
11/11/2020,Gulf Coast,4,CAH,1,94,85,23,62,4,0,4,26,0,26,1,0,1,94,85,23,62,4,0,4,26,0,26,1,0,1
11/11/2020,Gulf Coast,4,GACH,1,115,52,48,4,9,9,0,10,1,9,4,0,4,115,52,48,4,9,9,0,10,1,9,4,0,4
11/11/2020,Interior,6,GACH,1,101,81,58,23,20,12,8,16,0,16,4,0,4,101,81,58,23,20,12,8,16,0,16,4,0,4
11/11/2020,Matanuska-Susitna,3,GACH,1,184,160,94,66,14,12,2,30,2,28,16,0,16,184,160,94,66,14,12,2,30,2,28,16,0,16
11/11/2020,Northern,2,CAH,1,89,57,12,45,0,0,0,19,0,19,1,0,1,142,68,14,54,0,0,0,36,0,36,3,0,3
11/11/2020,Southeast,5,CAH,1,70,70,30,40,8,6,2,33,0,33,3,0,3,70,70,30,40,8,6,2,33,0,33,3,0,3
11/11/2020,Southeast,5,GACH,1,161,133,35,98,9,2,7,20,0,20,0,0,0,161,133,35,98,9,2,7,20,0,20,0,0,0
11/11/2020,Southwest,1,CAH,1,22,12,0,12,0,0,0,2,0,2,0,0,0,22,12,0,12,0,0,0,2,0,2,0,0,0
11/11/2020,Southwest,1,GACH,1,53,45,20,25,0,0,0,4,0,4,7,0,7,53,45,20,25,0,0,0,4,0,4,7,0,7
11/12/2020,Anchorage,7,GACH,1,775,698,599,99,149,100,49,203,25,178,69,0,69,775,698,599,99,149,100,49,203,25,178,69,0,69
11/12/2020,Anchorage,7,LTACH,0,31,30,30,0,3,3,0,23,0,23,2,0,2,31,30,30,0,3,3,0,23,0,23,2,0,2
11/12/2020,Anchorage,7,Psych,0,,,,,,,,,,,,,,200,190,113,77,0,0,0,0,0,0,4,0,4
11/12/2020,Gulf Coast,4,CAH,1,95,85,24,61,4,1,3,26,0,26,3,0,3,95,85,24,61,4,1,3,26,0,26,3,0,3
11/12/2020,Gulf Coast,4,GACH,1,115,52,45,7,9,6,3,10,0,10,5,0,5,115,52,45,7,9,6,3,10,0,10,5,0,5
11/12/2020,Interior,6,GACH,1,101,81,66,15,20,10,10,16,0,16,4,0,4,101,81,66,15,20,10,10,16,0,16,4,0,4
11/12/2020,Matanuska-Susitna,3,GACH,1,184,160,91,69,14,8,6,30,5,25,17,0,17,184,160,91,69,14,8,6,30,5,25,17,0,17
11/12/2020,Northern,2,CAH,1,142,68,9,59,0,0,0,36,0,36,3,0,3,142,68,9,59,0,0,0,36,0,36,3,0,3
11/12/2020,Southeast,5,CAH,1,70,70,34,36,8,2,6,33,0,33,2,0,2,70,70,34,36,8,2,6,33,0,33,2,0,2
11/12/2020,Southeast,5,GACH,1,161,133,30,103,9,2,7,20,0,20,0,0,0,161,133,30,103,9,2,7,20,0,20,0,0,0
11/12/2020,Southwest,1,CAH,1,22,12,0,12,0,0,0,2,0,2,0,0,0,22,12,0,12,0,0,0,2,0,2,0,0,0
11/12/2020,Southwest,1,GACH,1,53,45,18,27,0,0,0,4,0,4,5,0,5,53,45,18,27,0,0,0,4,0,4,5,0,5
11/13/2020,Anchorage,7,GACH,1,775,698,593,105,151,118,33,203,30,173,70,0,70,775,698,593,105,151,118,33,203,30,173,70,0,70
11/13/2020,Anchorage,7,LTACH,0,31,30,29,1,3,3,0,23,0,23,2,0,2,31,30,29,1,3,3,0,23,0,23,2,0,2
11/13/2020,Anchorage,7,Psych,0,,,,,,,,,,,,,,200,190,113,77,0,0,0,0,0,0,4,0,4
11/13/2020,Gulf Coast,4,CAH,1,94,84,29,55,4,2,2,18,0,18,3,0,3,94,84,29,55,4,2,2,18,0,18,3,0,3
11/13/2020,Gulf Coast,4,GACH,1,120,52,40,12,9,6,3,10,0,10,1,0,1,120,52,40,12,9,6,3,10,0,10,1,0,1
11/13/2020,Interior,6,GACH,1,101,81,66,15,20,11,9,16,2,14,4,0,4,101,81,66,15,20,11,9,16,2,14,4,0,4
11/13/2020,Matanuska-Susitna,3,GACH,1,184,160,86,74,14,10,4,30,6,24,17,0,17,184,160,86,74,14,10,4,30,6,24,17,0,17
11/13/2020,Northern,2,CAH,1,142,68,11,57,0,0,0,36,0,36,1,0,1,142,68,11,57,0,0,0,36,0,36,1,0,1
11/13/2020,Southeast,5,CAH,1,70,70,38,32,8,2,6,33,0,33,1,0,1,70,70,38,32,8,2,6,33,0,33,1,0,1
11/13/2020,Southeast,5,GACH,1,161,133,28,105,9,2,7,20,0,20,1,0,1,161,133,28,105,9,2,7,20,0,20,1,0,1
11/13/2020,Southwest,1,CAH,1,22,12,1,11,0,0,0,2,0,2,0,0,0,22,12,1,11,0,0,0,2,0,2,0,0,0
11/13/2020,Southwest,1,GACH,1,53,45,16,29,0,0,0,4,0,4,3,0,3,53,45,16,29,0,0,0,4,0,4,3,0,3
11/14/2020,Anchorage,7,GACH,1,774,697,583,114,149,116,33,173,29,144,79,0,79,774,697,583,114,149,116,33,173,29,144,79,0,79
11/14/2020,Anchorage,7,LTACH,0,31,30,28,2,3,3,0,23,0,23,2,0,2,31,30,28,2,3,3,0,23,0,23,2,0,2
11/14/2020,Anchorage,7,Psych,0,,,,,,,,,,,,,,200,190,113,77,0,0,0,0,0,0,4,0,4
11/14/2020,Gulf Coast,4,CAH,1,94,85,27,58,4,2,2,18,0,18,5,0,5,94,85,27,58,4,2,2,18,0,18,5,0,5
11/14/2020,Gulf Coast,4,GACH,1,115,52,42,10,9,5,4,10,0,10,8,0,8,115,52,42,10,9,5,4,10,0,10,8,0,8
11/14/2020,Interior,6,GACH,1,101,81,64,17,20,12,8,16,2,14,5,1,6,101,81,64,17,20,12,8,16,2,14,5,1,6
11/14/2020,Matanuska-Susitna,3,GACH,1,184,160,85,75,14,14,0,30,6,24,14,0,14,184,160,85,75,14,14,0,30,6,24,14,0,14
11/14/2020,Northern,2,CAH,1,142,68,10,58,0,0,0,36,0,36,0,0,0,142,68,10,58,0,0,0,36,0,36,0,0,0
11/14/2020,Southeast,5,CAH,1,70,70,36,34,8,2,6,33,0,33,1,0,1,70,70,36,34,8,2,6,33,0,33,1,0,1
11/14/2020,Southeast,5,GACH,1,161,133,28,105,9,5,4,20,0,20,0,0,0,161,133,28,105,9,5,4,20,0,20,0,0,0
11/14/2020,Southwest,1,CAH,1,22,12,0,12,0,0,0,2,0,2,0,0,0,22,12,0,12,0,0,0,2,0,2,0,0,0
11/14/2020,Southwest,1,GACH,1,53,45,21,24,0,0,0,4,0,4,5,0,5,53,45,21,24,0,0,0,4,0,4,5,0,5
11/15/2020,Anchorage,7,GACH,1,764,687,566,121,141,104,37,173,35,138,81,0,81,764,687,566,121,141,104,37,173,35,138,81,0,81
11/15/2020,Anchorage,7,LTACH,0,31,30,28,2,3,3,0,23,0,23,2,0,2,31,30,28,2,3,3,0,23,0,23,2,0,2
11/15/2020,Anchorage,7,Psych,0,,,,,,,,,,,,,,200,190,113,77,0,0,0,0,0,0,4,0,4
11/15/2020,Gulf Coast,4,CAH,1,94,85,28,57,3,1,2,18,0,18,4,0,4,94,85,28,57,3,1,2,18,0,18,4,0,4
11/15/2020,Gulf Coast,4,GACH,1,115,52,44,8,9,8,1,10,0,10,9,0,9,115,52,44,8,9,8,1,10,0,10,9,0,9
11/15/2020,Interior,6,GACH,1,101,81,50,31,20,12,8,16,1,15,7,1,8,101,81,50,31,20,12,8,16,1,15,7,1,8
11/15/2020,Matanuska-Susitna,3,GACH,1,184,160,82,78,14,11,3,30,5,25,14,0,14,184,160,82,78,14,11,3,30,5,25,14,0,14
11/15/2020,Northern,2,CAH,1,142,68,13,55,0,0,0,36,0,36,1,0,1,142,68,13,55,0,0,0,36,0,36,1,0,1
11/15/2020,Southeast,5,CAH,1,70,70,32,38,8,2,6,33,0,33,0,0,0,70,70,32,38,8,2,6,33,0,33,0,0,0
11/15/2020,Southeast,5,GACH,1,161,133,21,112,9,4,5,20,0,20,0,0,0,161,133,21,112,9,4,5,20,0,20,0,0,0
11/15/2020,Southwest,1,CAH,1,22,12,0,12,0,0,0,2,0,2,0,0,0,22,12,0,12,0,0,0,2,0,2,0,0,0
11/15/2020,Southwest,1,GACH,1,53,45,23,22,0,0,0,4,0,4,5,0,5,53,45,23,22,0,0,0,4,0,4,5,0,5
11/16/2020,Anchorage,7,GACH,1,755,678,533,145,145,100,45,173,37,136,81,1,82,755,678,533,145,145,100,45,173,37,136,81,1,82
11/16/2020,Anchorage,7,LTACH,0,31,30,28,2,3,3,0,23,0,23,2,0,2,31,30,28,2,3,3,0,23,0,23,2,0,2
11/16/2020,Anchorage,7,Psych,0,,,,,,,,,,,,,,200,190,113,77,0,0,0,0,0,0,4,0,4
11/16/2020,Gulf Coast,4,CAH,1,94,85,24,61,3,1,2,18,0,18,1,0,1,94,85,24,61,3,1,2,18,0,18,1,0,1
11/16/2020,Gulf Coast,4,GACH,1,115,52,44,8,9,6,3,10,0,10,11,0,11,115,52,44,8,9,6,3,10,0,10,11,0,11
11/16/2020,Interior,6,GACH,1,101,81,54,27,20,7,13,16,0,16,9,1,10,101,81,54,27,20,7,13,16,0,16,9,1,10
11/16/2020,Matanuska-Susitna,3,GACH,1,184,160,84,76,14,14,0,30,5,25,13,0,13,184,160,84,76,14,14,0,30,5,25,13,0,13
11/16/2020,Northern,2,CAH,1,142,68,11,57,0,0,0,36,0,36,0,0,0,142,68,11,57,0,0,0,36,0,36,0,0,0
11/16/2020,Southeast,5,CAH,1,70,70,29,41,8,1,7,33,1,32,0,0,0,70,70,29,41,8,1,7,33,1,32,0,0,0
11/16/2020,Southeast,5,GACH,1,161,133,32,101,9,2,7,20,0,20,0,0,0,161,133,32,101,9,2,7,20,0,20,0,0,0
11/16/2020,Southwest,1,CAH,1,22,12,0,12,0,0,0,2,0,2,0,0,0,22,12,0,12,0,0,0,2,0,2,0,0,0
11/16/2020,Southwest,1,GACH,1,53,45,22,23,0,0,0,4,0,4,4,0,4,53,45,22,23,0,0,0,4,0,4,4,0,4
11/17/2020,Anchorage,7,GACH,1,752,675,515,160,144,100,44,173,33,140,83,1,84,752,675,515,160,144,100,44,173,33,140,83,1,84
11/17/2020,Anchorage,7,LTACH,0,31,30,28,2,3,3,0,23,0,23,2,0,2,31,30,28,2,3,3,0,23,0,23,2,0,2
11/17/2020,Anchorage,7,Psych,0,60,48,48,0,0,0,0,0,0,0,0,0,0,200,188,111,77,0,0,0,0,0,0,4,0,4
11/17/2020,Gulf Coast,4,CAH,1,93,84,28,56,3,2,1,18,0,18,1,0,1,93,84,28,56,3,2,1,18,0,18,1,0,1
11/17/2020,Gulf Coast,4,GACH,1,115,57,57,0,9,9,0,10,0,10,14,0,14,115,57,57,0,9,9,0,10,0,10,14,0,14
11/17/2020,Interior,6,GACH,1,101,81,65,16,20,10,10,16,0,16,10,0,10,101,81,65,16,20,10,10,16,0,16,10,0,10
11/17/2020,Matanuska-Susitna,3,GACH,1,184,160,94,66,14,12,2,30,4,26,14,0,14,184,160,94,66,14,12,2,30,4,26,14,0,14
11/17/2020,Northern,2,CAH,1,142,68,15,53,0,0,0,36,0,36,0,0,0,142,68,15,53,0,0,0,36,0,36,0,0,0
11/17/2020,Southeast,5,CAH,1,70,70,32,38,8,2,6,33,0,33,0,0,0,70,70,32,38,8,2,6,33,0,33,0,0,0
11/17/2020,Southeast,5,GACH,1,161,133,34,99,9,3,6,20,0,20,1,0,1,161,133,34,99,9,3,6,20,0,20,1,0,1
11/17/2020,Southwest,1,CAH,1,22,12,0,12,0,0,0,2,0,2,0,0,0,22,12,0,12,0,0,0,2,0,2,0,0,0
11/17/2020,Southwest,1,GACH,1,53,45,17,28,0,0,0,4,0,4,6,0,6,53,45,17,28,0,0,0,4,0,4,6,0,6
11/18/2020,Anchorage,7,GACH,1,763,686,550,136,145,99,46,173,31,142,78,12,90,763,686,550,136,145,99,46,173,31,142,78,12,90
11/18/2020,Anchorage,7,LTACH,0,31,30,26,4,3,3,0,23,0,23,2,0,2,31,30,26,4,3,3,0,23,0,23,2,0,2
11/18/2020,Anchorage,7,Psych,0,,,,,,,,,,,,,,200,188,111,77,0,0,0,0,0,0,4,0,4
11/18/2020,Gulf Coast,4,CAH,1,94,84,26,58,3,1,2,18,0,18,2,0,2,94,84,26,58,3,1,2,18,0,18,2,0,2
11/18/2020,Gulf Coast,4,GACH,1,115,59,50,9,9,7,2,10,0,10,11,0,11,115,59,50,9,9,7,2,10,0,10,11,0,11
11/18/2020,Interior,6,GACH,1,101,81,66,15,20,12,8,16,1,15,8,0,8,101,81,66,15,20,12,8,16,1,15,8,0,8
11/18/2020,Matanuska-Susitna,3,GACH,1,184,160,97,63,14,12,2,30,4,26,11,0,11,184,160,97,63,14,12,2,30,4,26,11,0,11
11/18/2020,Northern,2,CAH,1,142,68,12,56,0,0,0,36,0,36,0,0,0,142,68,12,56,0,0,0,36,0,36,0,0,0
11/18/2020,Southeast,5,CAH,1,70,70,42,28,8,4,4,33,0,33,0,0,0,70,70,42,28,8,4,4,33,0,33,0,0,0
11/18/2020,Southeast,5,GACH,1,161,133,46,87,9,5,4,20,0,20,1,0,1,161,133,46,87,9,5,4,20,0,20,1,0,1
11/18/2020,Southwest,1,CAH,1,22,12,1,11,0,0,0,2,0,2,1,0,1,22,12,1,11,0,0,0,2,0,2,1,0,1
11/18/2020,Southwest,1,GACH,1,53,45,16,29,0,0,0,4,0,4,4,0,4,53,45,16,29,0,0,0,4,0,4,4,0,4
11/19/2020,Anchorage,7,GACH,1,763,686,560,126,144,98,46,173,32,141,80,0,80,763,686,560,126,144,98,46,173,32,141,80,0,80
11/19/2020,Anchorage,7,LTACH,0,31,30,26,4,3,3,0,23,0,23,1,0,1,31,30,26,4,3,3,0,23,0,23,1,0,1
11/19/2020,Anchorage,7,Psych,0,,,,,,,,,,,,,,200,188,111,77,0,0,0,0,0,0,4,0,4
11/19/2020,Gulf Coast,4,CAH,1,94,85,23,62,2,1,1,18,0,18,1,0,1,94,85,23,62,2,1,1,18,0,18,1,0,1
11/19/2020,Gulf Coast,4,GACH,1,115,61,41,20,9,7,2,10,1,9,10,0,10,115,61,41,20,9,7,2,10,1,9,10,0,10
11/19/2020,Interior,6,GACH,1,101,81,65,16,20,15,5,16,0,16,7,0,7,101,81,65,16,20,15,5,16,0,16,7,0,7
11/19/2020,Matanuska-Susitna,3,GACH,1,184,160,81,79,14,12,2,30,4,26,10,0,10,184,160,81,79,14,12,2,30,4,26,10,0,10
11/19/2020,Northern,2,CAH,1,142,68,13,55,0,0,0,36,0,36,0,0,0,142,68,13,55,0,0,0,36,0,36,0,0,0
11/19/2020,Southeast,5,CAH,1,70,70,38,32,8,5,3,33,0,33,0,0,0,70,70,38,32,8,5,3,33,0,33,0,0,0
11/19/2020,Southeast,5,GACH,1,161,133,42,91,9,4,5,20,0,20,0,0,0,161,133,42,91,9,4,5,20,0,20,0,0,0
11/19/2020,Southwest,1,CAH,1,22,12,3,9,0,0,0,2,0,2,1,0,1,22,12,3,9,0,0,0,2,0,2,1,0,1
11/19/2020,Southwest,1,GACH,1,53,45,17,28,0,0,0,4,0,4,4,0,4,53,45,17,28,0,0,0,4,0,4,4,0,4
11/20/2020,Anchorage,7,GACH,1,762,685,562,123,140,94,46,173,33,140,76,0,76,762,685,562,123,140,94,46,173,33,140,76,0,76
11/20/2020,Anchorage,7,LTACH,0,31,30,27,3,3,3,0,23,1,22,1,0,1,31,30,27,3,3,3,0,23,1,22,1,0,1
11/20/2020,Anchorage,7,Psych,0,,,,,,,,,,,,,,200,188,111,77,0,0,0,0,0,0,4,0,4
11/20/2020,Gulf Coast,4,CAH,1,94,85,26,59,2,1,1,18,0,18,2,0,2,94,85,26,59,2,1,1,18,0,18,2,0,2
11/20/2020,Gulf Coast,4,GACH,1,115,61,37,24,9,7,2,10,2,8,8,0,8,115,61,37,24,9,7,2,10,2,8,8,0,8
11/20/2020,Interior,6,GACH,1,101,81,54,27,20,10,10,16,1,15,8,0,8,101,81,54,27,20,10,10,16,1,15,8,0,8
11/20/2020,Matanuska-Susitna,3,GACH,1,184,160,75,85,14,11,3,30,5,25,11,0,11,184,160,75,85,14,11,3,30,5,25,11,0,11
11/20/2020,Northern,2,CAH,1,142,68,20,48,0,0,0,36,0,36,0,0,0,142,68,20,48,0,0,0,36,0,36,0,0,0
11/20/2020,Southeast,5,CAH,1,70,70,38,32,8,2,6,33,0,33,1,0,1,70,70,38,32,8,2,6,33,0,33,1,0,1
11/20/2020,Southeast,5,GACH,1,161,133,32,101,9,4,5,20,0,20,0,0,0,161,133,32,101,9,4,5,20,0,20,0,0,0
11/20/2020,Southwest,1,CAH,1,22,12,3,9,0,0,0,2,0,2,2,0,2,22,12,3,9,0,0,0,2,0,2,2,0,2
11/20/2020,Southwest,1,GACH,1,53,45,16,29,0,0,0,4,0,4,4,0,4,53,45,16,29,0,0,0,4,0,4,4,0,4
11/21/2020,Anchorage,7,GACH,1,765,688,541,147,143,91,52,173,36,137,79,0,79,765,688,541,147,143,91,52,173,36,137,79,0,79
11/21/2020,Anchorage,7,LTACH,0,31,30,29,1,3,3,0,23,1,22,1,0,1,31,30,29,1,3,3,0,23,1,22,1,0,1
11/21/2020,Anchorage,7,Psych,0,,,,,,,,,,,,,,200,188,111,77,0,0,0,0,0,0,4,0,4
11/21/2020,Gulf Coast,4,CAH,1,92,83,24,59,3,2,1,18,0,18,3,1,4,92,83,24,59,3,2,1,18,0,18,3,1,4
11/21/2020,Gulf Coast,4,GACH,1,115,61,40,21,9,7,2,10,1,9,11,0,11,115,61,40,21,9,7,2,10,1,9,11,0,11
11/21/2020,Interior,6,GACH,1,101,81,58,23,20,10,10,16,1,15,8,0,8,101,81,58,23,20,10,10,16,1,15,8,0,8
11/21/2020,Matanuska-Susitna,3,GACH,1,184,160,84,76,14,9,5,30,5,25,13,0,13,184,160,84,76,14,9,5,30,5,25,13,0,13
11/21/2020,Northern,2,CAH,1,142,68,15,53,0,0,0,36,0,36,0,0,0,142,68,15,53,0,0,0,36,0,36,0,0,0
11/21/2020,Southeast,5,CAH,1,70,70,39,31,8,2,6,33,0,33,1,0,1,70,70,39,31,8,2,6,33,0,33,1,0,1
11/21/2020,Southeast,5,GACH,1,161,133,32,101,9,3,6,20,0,20,0,0,0,161,133,32,101,9,3,6,20,0,20,0,0,0
11/21/2020,Southwest,1,CAH,1,22,12,3,9,0,0,0,2,0,2,2,0,2,22,12,3,9,0,0,0,2,0,2,2,0,2
11/21/2020,Southwest,1,GACH,1,53,45,19,26,0,0,0,4,0,4,4,0,4,53,45,19,26,0,0,0,4,0,4,4,0,4
11/22/2020,Anchorage,7,GACH,1,771,694,521,173,149,92,57,173,37,136,82,0,82,771,694,521,173,149,92,57,173,37,136,82,0,82
11/22/2020,Anchorage,7,LTACH,0,31,30,29,1,3,3,0,23,1,22,1,0,1,31,30,29,1,3,3,0,23,1,22,1,0,1
11/22/2020,Anchorage,7,Psych,0,,,,,,,,,,,,,,200,188,111,77,0,0,0,0,0,0,4,0,4
11/22/2020,Gulf Coast,4,CAH,1,93,84,28,56,3,2,1,18,0,18,3,1,4,93,84,28,56,3,2,1,18,0,18,3,1,4
11/22/2020,Gulf Coast,4,GACH,1,115,61,45,16,9,7,2,10,0,10,12,0,12,115,61,45,16,9,7,2,10,0,10,12,0,12
11/22/2020,Interior,6,GACH,1,101,81,53,28,20,6,14,16,1,15,8,0,8,101,81,53,28,20,6,14,16,1,15,8,0,8
11/22/2020,Matanuska-Susitna,3,GACH,1,184,160,75,85,14,7,7,30,4,26,14,0,14,184,160,75,85,14,7,7,30,4,26,14,0,14
11/22/2020,Northern,2,CAH,1,142,68,15,53,0,0,0,36,0,36,0,0,0,142,68,15,53,0,0,0,36,0,36,0,0,0
11/22/2020,Southeast,5,CAH,1,70,70,40,30,8,2,6,33,0,33,1,0,1,70,70,40,30,8,2,6,33,0,33,1,0,1
11/22/2020,Southeast,5,GACH,1,161,133,33,100,9,4,5,20,0,20,1,0,1,161,133,33,100,9,4,5,20,0,20,1,0,1
11/22/2020,Southwest,1,CAH,1,22,12,2,10,0,0,0,2,0,2,1,0,1,22,12,2,10,0,0,0,2,0,2,1,0,1
11/22/2020,Southwest,1,GACH,1,53,45,22,23,0,0,0,4,0,4,5,0,5,53,45,22,23,0,0,0,4,0,4,5,0,5
11/23/2020,Anchorage,7,GACH,1,771,694,513,181,149,92,57,173,43,130,82,0,82,771,694,513,181,149,92,57,173,43,130,82,0,82
11/23/2020,Anchorage,7,LTACH,0,31,30,29,1,3,3,0,23,1,22,1,0,1,31,30,29,1,3,3,0,23,1,22,1,0,1
11/23/2020,Anchorage,7,Psych,0,,,,,,,,,,,,,,200,188,111,77,0,0,0,0,0,0,4,0,4
11/23/2020,Gulf Coast,4,CAH,1,93,84,31,53,3,2,1,18,0,18,4,1,5,93,84,31,53,3,2,1,18,0,18,4,1,5
11/23/2020,Gulf Coast,4,GACH,1,115,61,46,15,9,7,2,10,1,9,10,0,10,115,61,46,15,9,7,2,10,1,9,10,0,10
11/23/2020,Interior,6,GACH,1,101,81,43,38,20,6,14,16,0,16,5,0,5,101,81,43,38,20,6,14,16,0,16,5,0,5
11/23/2020,Matanuska-Susitna,3,GACH,1,184,160,72,88,14,8,6,30,3,27,16,0,16,184,160,72,88,14,8,6,30,3,27,16,0,16
11/23/2020,Northern,2,CAH,1,142,68,14,54,0,0,0,36,0,36,0,0,0,142,68,14,54,0,0,0,36,0,36,0,0,0
11/23/2020,Southeast,5,CAH,1,70,70,46,24,8,3,5,33,0,33,1,0,1,70,70,46,24,8,3,5,33,0,33,1,0,1
11/23/2020,Southeast,5,GACH,1,161,133,31,102,9,2,7,20,0,20,2,0,2,161,133,31,102,9,2,7,20,0,20,2,0,2
11/23/2020,Southwest,1,CAH,1,22,12,0,12,0,0,0,2,0,2,0,0,0,22,12,0,12,0,0,0,2,0,2,0,0,0
11/23/2020,Southwest,1,GACH,1,53,45,25,20,0,0,0,4,0,4,5,0,5,53,45,25,20,0,0,0,4,0,4,5,0,5
11/24/2020,Anchorage,7,GACH,1,768,691,555,136,133,94,39,173,39,134,83,0,83,768,691,555,136,133,94,39,173,39,134,83,0,83
11/24/2020,Anchorage,7,LTACH,0,31,30,28,2,3,3,0,23,1,22,1,0,1,31,30,28,2,3,3,0,23,1,22,1,0,1
11/24/2020,Anchorage,7,Psych,0,,,,,,,,,,,,,,200,188,111,77,0,0,0,0,0,0,4,0,4
11/24/2020,Gulf Coast,4,CAH,1,95,86,27,59,3,1,2,18,0,18,6,1,7,95,86,27,59,3,1,2,18,0,18,6,1,7
11/24/2020,Gulf Coast,4,GACH,1,115,61,55,6,9,7,2,10,1,9,13,0,13,115,61,55,6,9,7,2,10,1,9,13,0,13
11/24/2020,Interior,6,GACH,1,101,81,57,24,20,8,12,16,0,16,5,0,5,101,81,57,24,20,8,12,16,0,16,5,0,5
11/24/2020,Matanuska-Susitna,3,GACH,1,184,160,82,78,14,9,5,30,3,27,18,0,18,184,160,82,78,14,9,5,30,3,27,18,0,18
11/24/2020,Northern,2,CAH,1,142,68,20,48,0,0,0,36,0,36,1,0,1,142,68,20,48,0,0,0,36,0,36,1,0,1
11/24/2020,Southeast,5,CAH,1,70,70,36,34,8,1,7,33,0,33,0,0,0,70,70,36,34,8,1,7,33,0,33,0,0,0
11/24/2020,Southeast,5,GACH,1,161,133,31,102,9,1,8,20,0,20,3,0,3,161,133,31,102,9,1,8,20,0,20,3,0,3
11/24/2020,Southwest,1,CAH,1,22,12,0,12,0,0,0,2,0,2,0,0,0,22,12,0,12,0,0,0,2,0,2,0,0,0
11/24/2020,Southwest,1,GACH,1,53,45,25,20,0,0,0,4,0,4,5,0,5,53,45,25,20,0,0,0,4,0,4,5,0,5
11/25/2020,Anchorage,7,GACH,1,771,694,575,119,138,92,46,173,41,132,90,1,91,771,694,575,119,138,92,46,173,41,132,90,1,91
11/25/2020,Anchorage,7,LTACH,0,31,30,28,2,3,3,0,23,2,21,1,0,1,31,30,28,2,3,3,0,23,2,21,1,0,1
11/25/2020,Anchorage,7,Psych,0,200,189,102,87,0,0,0,0,0,0,1,0,1,200,189,102,87,0,0,0,0,0,0,1,0,1
11/25/2020,Gulf Coast,4,CAH,1,95,85,33,52,3,1,2,18,0,18,6,1,7,95,85,33,52,3,1,2,18,0,18,6,1,7
11/25/2020,Gulf Coast,4,GACH,1,115,63,63,0,9,9,0,10,1,9,16,0,16,115,63,63,0,9,9,0,10,1,9,16,0,16
11/25/2020,Interior,6,GACH,1,101,81,46,35,20,10,10,16,1,15,6,0,6,101,81,46,35,20,10,10,16,1,15,6,0,6
11/25/2020,Matanuska-Susitna,3,GACH,1,184,160,74,86,14,8,6,30,4,26,21,0,21,184,160,74,86,14,8,6,30,4,26,21,0,21
11/25/2020,Northern,2,CAH,1,142,68,20,48,0,0,0,36,0,36,1,0,1,142,68,20,48,0,0,0,36,0,36,1,0,1
11/25/2020,Southeast,5,CAH,1,70,70,35,35,8,2,6,33,0,33,1,0,1,70,70,35,35,8,2,6,33,0,33,1,0,1
11/25/2020,Southeast,5,GACH,1,161,133,31,102,9,2,7,20,0,20,2,0,2,161,133,31,102,9,2,7,20,0,20,2,0,2
11/25/2020,Southwest,1,CAH,1,22,12,0,12,0,0,0,2,0,2,0,0,0,22,12,0,12,0,0,0,2,0,2,0,0,0
11/25/2020,Southwest,1,GACH,1,53,45,16,29,0,0,0,4,0,4,4,0,4,53,45,16,29,0,0,0,4,0,4,4,0,4
11/26/2020,Anchorage,7,GACH,1,771,694,575,119,142,100,42,173,46,127,93,0,93,771,694,575,119,142,100,42,173,46,127,93,0,93
11/26/2020,Anchorage,7,LTACH,0,31,30,28,2,3,3,0,23,2,21,1,0,1,31,30,28,2,3,3,0,23,2,21,1,0,1
11/26/2020,Anchorage,7,Psych,0,,,,,,,,,,,,,,200,189,102,87,0,0,0,0,0,0,1,0,1
11/26/2020,Gulf Coast,4,CAH,1,95,85,36,49,2,0,2,18,0,18,7,1,8,95,85,36,49,2,0,2,18,0,18,7,1,8
11/26/2020,Gulf Coast,4,GACH,1,115,61,53,8,9,7,2,10,1,9,15,0,15,115,61,53,8,9,7,2,10,1,9,15,0,15
11/26/2020,Interior,6,GACH,1,101,81,41,40,20,12,8,16,1,15,4,0,4,101,81,41,40,20,12,8,16,1,15,4,0,4
11/26/2020,Matanuska-Susitna,3,GACH,1,184,160,76,84,14,9,5,30,3,27,21,0,21,184,160,76,84,14,9,5,30,3,27,21,0,21
11/26/2020,Northern,2,CAH,1,142,68,19,49,0,0,0,36,0,36,1,0,1,142,68,19,49,0,0,0,36,0,36,1,0,1
11/26/2020,Southeast,5,CAH,1,70,70,34,36,8,2,6,33,0,33,1,0,1,70,70,34,36,8,2,6,33,0,33,1,0,1
11/26/2020,Southeast,5,GACH,1,161,133,24,109,9,5,4,20,0,20,1,0,1,161,133,24,109,9,5,4,20,0,20,1,0,1
11/26/2020,Southwest,1,CAH,1,22,12,5,7,0,0,0,2,0,2,0,0,0,22,12,5,7,0,0,0,2,0,2,0,0,0
11/26/2020,Southwest,1,GACH,1,53,45,14,31,0,0,0,4,0,4,3,0,3,53,45,14,31,0,0,0,4,0,4,3,0,3
11/27/2020,Anchorage,7,GACH,1,760,699,561,138,137,101,36,173,48,125,92,1,93,760,699,561,138,137,101,36,173,48,125,92,1,93
11/27/2020,Anchorage,7,LTACH,0,31,30,27,3,3,3,0,23,2,21,1,0,1,31,30,27,3,3,3,0,23,2,21,1,0,1
11/27/2020,Anchorage,7,Psych,0,,,,,,,,,,,,,,200,189,102,87,0,0,0,0,0,0,1,0,1
11/27/2020,Gulf Coast,4,CAH,1,95,85,23,62,2,0,2,18,0,18,6,1,7,95,85,23,62,2,0,2,18,0,18,6,1,7
11/27/2020,Gulf Coast,4,GACH,1,115,61,44,17,9,5,4,10,1,9,9,0,9,115,61,44,17,9,5,4,10,1,9,9,0,9
11/27/2020,Interior,6,GACH,1,101,81,35,46,20,7,13,16,1,15,6,0,6,101,81,35,46,20,7,13,16,1,15,6,0,6
11/27/2020,Matanuska-Susitna,3,GACH,1,184,160,75,85,14,10,4,30,4,26,22,1,23,184,160,75,85,14,10,4,30,4,26,22,1,23
11/27/2020,Northern,2,CAH,1,142,68,19,49,0,0,0,36,0,36,1,0,1,142,68,19,49,0,0,0,36,0,36,1,0,1
11/27/2020,Southeast,5,CAH,1,70,70,31,39,8,2,6,33,0,33,1,0,1,70,70,31,39,8,2,6,33,0,33,1,0,1
11/27/2020,Southeast,5,GACH,1,161,133,30,103,9,4,5,20,0,20,1,0,1,161,133,30,103,9,4,5,20,0,20,1,0,1
11/27/2020,Southwest,1,CAH,1,22,12,2,10,0,0,0,2,0,2,0,0,0,22,12,2,10,0,0,0,2,0,2,0,0,0
11/27/2020,Southwest,1,GACH,1,53,45,18,27,0,0,0,4,0,4,3,0,3,53,45,18,27,0,0,0,4,0,4,3,0,3
11/28/2020,Anchorage,7,GACH,1,760,699,558,141,137,101,36,173,51,122,98,1,99,760,699,558,141,137,101,36,173,51,122,98,1,99
11/28/2020,Anchorage,7,LTACH,0,31,30,27,3,3,3,0,23,2,21,1,0,1,31,30,27,3,3,3,0,23,2,21,1,0,1
11/28/2020,Anchorage,7,Psych,0,,,,,,,,,,,,,,200,189,102,87,0,0,0,0,0,0,1,0,1
11/28/2020,Gulf Coast,4,CAH,1,94,84,24,60,2,0,2,18,0,18,4,1,5,94,84,24,60,2,0,2,18,0,18,4,1,5
11/28/2020,Gulf Coast,4,GACH,1,115,61,50,11,9,5,4,10,1,9,10,0,10,115,61,50,11,9,5,4,10,1,9,10,0,10
11/28/2020,Interior,6,GACH,1,101,81,35,46,20,9,11,16,1,15,7,0,7,101,81,35,46,20,9,11,16,1,15,7,0,7
11/28/2020,Matanuska-Susitna,3,GACH,1,184,160,79,81,14,14,0,30,4,26,22,0,22,184,160,79,81,14,14,0,30,4,26,22,0,22
11/28/2020,Northern,2,CAH,1,142,68,20,48,0,0,0,36,0,36,2,0,2,142,68,20,48,0,0,0,36,0,36,2,0,2
11/28/2020,Southeast,5,CAH,1,70,70,29,41,8,2,6,33,0,33,1,0,1,70,70,29,41,8,2,6,33,0,33,1,0,1
11/28/2020,Southeast,5,GACH,1,161,133,31,102,9,7,2,20,1,19,1,0,1,161,133,31,102,9,7,2,20,1,19,1,0,1
11/28/2020,Southwest,1,CAH,1,22,12,2,10,0,0,0,2,0,2,0,0,0,22,12,2,10,0,0,0,2,0,2,0,0,0
11/28/2020,Southwest,1,GACH,1,53,45,17,28,0,0,0,4,0,4,2,0,2,53,45,17,28,0,0,0,4,0,4,2,0,2
11/29/2020,Anchorage,7,GACH,1,757,696,543,153,137,108,29,173,53,120,92,0,92,757,696,543,153,137,108,29,173,53,120,92,0,92
11/29/2020,Anchorage,7,LTACH,0,31,30,27,3,3,3,0,23,2,21,1,0,1,31,30,27,3,3,3,0,23,2,21,1,0,1
11/29/2020,Anchorage,7,Psych,0,,,,,,,,,,,,,,200,189,102,87,0,0,0,0,0,0,1,0,1
11/29/2020,Gulf Coast,4,CAH,1,94,84,24,60,2,0,2,18,0,18,4,1,5,94,84,24,60,2,0,2,18,0,18,4,1,5
11/29/2020,Gulf Coast,4,GACH,1,115,61,47,14,9,4,5,10,1,9,10,0,10,115,61,47,14,9,4,5,10,1,9,10,0,10
11/29/2020,Interior,6,GACH,1,101,81,36,45,20,9,11,16,0,16,9,0,9,101,81,36,45,20,9,11,16,0,16,9,0,9
11/29/2020,Matanuska-Susitna,3,GACH,1,184,160,85,75,14,11,3,30,4,26,25,0,25,184,160,85,75,14,11,3,30,4,26,25,0,25
11/29/2020,Northern,2,CAH,1,142,68,26,42,0,0,0,36,0,36,2,0,2,142,68,26,42,0,0,0,36,0,36,2,0,2
11/29/2020,Southeast,5,CAH,1,70,70,26,44,8,2,6,33,0,33,2,0,2,70,70,26,44,8,2,6,33,0,33,2,0,2
11/29/2020,Southeast,5,GACH,1,161,133,31,102,9,6,3,20,0,20,1,0,1,161,133,31,102,9,6,3,20,0,20,1,0,1
11/29/2020,Southwest,1,CAH,1,22,12,2,10,0,0,0,2,0,2,0,0,0,22,12,2,10,0,0,0,2,0,2,0,0,0
11/29/2020,Southwest,1,GACH,1,53,45,23,22,0,0,0,4,0,4,2,0,2,53,45,23,22,0,0,0,4,0,4,2,0,2
11/30/2020,Anchorage,7,GACH,1,755,694,538,156,137,105,32,173,48,125,86,0,86,755,694,538,156,137,105,32,173,48,125,86,0,86
11/30/2020,Anchorage,7,LTACH,0,31,30,27,3,3,3,0,23,1,22,0,0,0,31,30,27,3,3,3,0,23,1,22,0,0,0
11/30/2020,Anchorage,7,Psych,0,,,,,,,,,,,,,,200,189,102,87,0,0,0,0,0,0,1,0,1
11/30/2020,Gulf Coast,4,CAH,1,93,84,24,60,2,0,2,18,0,18,4,0,4,93,84,24,60,2,0,2,18,0,18,4,0,4
11/30/2020,Gulf Coast,4,GACH,1,115,61,46,15,9,6,3,10,1,9,10,0,10,115,61,46,15,9,6,3,10,1,9,10,0,10
11/30/2020,Interior,6,GACH,1,101,81,33,48,20,8,12,16,0,16,11,0,11,101,81,33,48,20,8,12,16,0,16,11,0,11
11/30/2020,Matanuska-Susitna,3,GACH,1,184,160,84,76,14,14,0,30,6,24,23,0,23,184,160,84,76,14,14,0,30,6,24,23,0,23
11/30/2020,Northern,2,CAH,1,142,68,27,41,0,0,0,36,0,36,1,0,1,142,68,27,41,0,0,0,36,0,36,1,0,1
11/30/2020,Southeast,5,CAH,1,70,70,26,44,8,3,5,33,0,33,2,0,2,70,70,26,44,8,3,5,33,0,33,2,0,2
11/30/2020,Southeast,5,GACH,1,161,133,31,102,9,7,2,20,0,20,1,0,1,161,133,31,102,9,7,2,20,0,20,1,0,1
11/30/2020,Southwest,1,CAH,1,22,12,1,11,0,0,0,2,0,2,0,0,0,22,12,1,11,0,0,0,2,0,2,0,0,0
11/30/2020,Southwest,1,GACH,1,53,45,22,23,0,0,0,4,0,4,4,0,4,53,45,22,23,0,0,0,4,0,4,4,0,4
12/01/2020,Anchorage,7,GACH,1,755,694,553,141,136,108,28,175,47,128,94,0,94,755,694,553,141,136,108,28,175,47,128,94,0,94
12/01/2020,Anchorage,7,LTACH,0,31,30,28,2,3,3,0,23,1,22,0,0,0,31,30,28,2,3,3,0,23,1,22,0,0,0
12/01/2020,Anchorage,7,Psych,0,,,,,,,,,,,,,,200,189,102,87,0,0,0,0,0,0,1,0,1
12/01/2020,Gulf Coast,4,CAH,1,94,85,25,60,2,0,2,18,0,18,5,0,5,94,85,25,60,2,0,2,18,0,18,5,0,5
12/01/2020,Gulf Coast,4,GACH,1,115,61,50,11,9,6,3,10,1,9,8,0,8,115,61,50,11,9,6,3,10,1,9,8,0,8
12/01/2020,Interior,6,GACH,1,101,81,49,32,20,13,7,16,0,16,10,0,10,101,81,49,32,20,13,7,16,0,16,10,0,10
12/01/2020,Matanuska-Susitna,3,GACH,1,184,160,73,87,14,12,2,30,2,28,24,0,24,184,160,73,87,14,12,2,30,2,28,24,0,24
12/01/2020,Northern,2,CAH,1,142,68,26,42,0,0,0,36,0,36,2,0,2,142,68,26,42,0,0,0,36,0,36,2,0,2
12/01/2020,Southeast,5,CAH,1,70,70,32,38,8,3,5,33,0,33,3,0,3,70,70,32,38,8,3,5,33,0,33,3,0,3
12/01/2020,Southeast,5,GACH,1,161,133,40,93,9,5,4,20,1,19,2,0,2,161,133,40,93,9,5,4,20,1,19,2,0,2
12/01/2020,Southwest,1,CAH,1,22,12,0,12,0,0,0,2,0,2,0,0,0,22,12,0,12,0,0,0,2,0,2,0,0,0
12/01/2020,Southwest,1,GACH,1,53,45,21,24,0,0,0,4,0,4,2,0,2,53,45,21,24,0,0,0,4,0,4,2,0,2
12/02/2020,Anchorage,7,GACH,1,752,691,573,118,142,112,30,175,45,130,89,1,90,752,691,573,118,142,112,30,175,45,130,89,1,90
12/02/2020,Anchorage,7,LTACH,0,31,30,28,2,3,3,0,23,1,22,0,0,0,31,30,28,2,3,3,0,23,1,22,0,0,0
12/02/2020,Anchorage,7,Psych,0,140,140,53,87,0,0,0,0,0,0,2,0,2,200,189,102,87,0,0,0,0,0,0,2,0,2
12/02/2020,Gulf Coast,4,CAH,1,93,84,25,59,3,1,2,18,0,18,4,0,4,93,84,25,59,3,1,2,18,0,18,4,0,4
12/02/2020,Gulf Coast,4,GACH,1,115,61,46,15,9,5,4,10,2,8,9,0,9,115,61,46,15,9,5,4,10,2,8,9,0,9
12/02/2020,Interior,6,GACH,1,101,81,61,20,20,9,11,16,0,16,8,0,8,101,81,61,20,20,9,11,16,0,16,8,0,8
12/02/2020,Matanuska-Susitna,3,GACH,1,184,160,88,72,14,13,1,30,6,24,24,0,24,184,160,88,72,14,13,1,30,6,24,24,0,24
12/02/2020,Northern,2,CAH,1,142,68,23,45,0,0,0,36,0,36,3,0,3,142,68,23,45,0,0,0,36,0,36,3,0,3
12/02/2020,Southeast,5,CAH,1,70,70,32,38,8,4,4,33,0,33,2,0,2,70,70,32,38,8,4,4,33,0,33,2,0,2
12/02/2020,Southeast,5,GACH,1,161,133,38,95,9,7,2,20,0,20,0,0,0,161,133,38,95,9,7,2,20,0,20,0,0,0
12/02/2020,Southwest,1,CAH,1,22,12,0,12,0,0,0,2,0,2,0,0,0,22,12,0,12,0,0,0,2,0,2,0,0,0
12/02/2020,Southwest,1,GACH,1,53,45,19,26,0,0,0,4,0,4,3,0,3,53,45,19,26,0,0,0,4,0,4,3,0,3
12/03/2020,Anchorage,7,GACH,1,802,721,604,117,137,108,29,175,40,135,85,2,87,802,721,604,117,137,108,29,175,40,135,85,2,87
12/03/2020,Anchorage,7,LTACH,0,31,30,28,2,3,3,0,23,0,23,0,0,0,31,30,28,2,3,3,0,23,0,23,0,0,0
12/03/2020,Anchorage,7,Psych,0,,,,,,,,,,,,,,200,189,102,87,0,0,0,0,0,0,2,0,2
12/03/2020,Gulf Coast,4,CAH,1,94,85,24,61,3,1,2,18,0,18,3,0,3,94,85,24,61,3,1,2,18,0,18,3,0,3
12/03/2020,Gulf Coast,4,GACH,1,115,61,49,12,9,6,3,10,2,8,8,0,8,115,61,49,12,9,6,3,10,2,8,8,0,8
12/03/2020,Interior,6,GACH,1,101,81,54,27,20,6,14,16,0,16,6,0,6,101,81,54,27,20,6,14,16,0,16,6,0,6
12/03/2020,Matanuska-Susitna,3,GACH,1,184,160,90,70,14,14,0,30,6,24,24,0,24,184,160,90,70,14,14,0,30,6,24,24,0,24
12/03/2020,Northern,2,CAH,1,142,68,22,46,0,0,0,36,0,36,3,0,3,142,68,22,46,0,0,0,36,0,36,3,0,3
12/03/2020,Southeast,5,CAH,1,70,70,29,41,8,2,6,33,0,33,2,0,2,70,70,29,41,8,2,6,33,0,33,2,0,2
12/03/2020,Southeast,5,GACH,1,161,133,41,92,9,7,2,20,0,20,0,0,0,161,133,41,92,9,7,2,20,0,20,0,0,0
12/03/2020,Southwest,1,CAH,1,22,12,1,11,0,0,0,2,0,2,0,0,0,22,12,1,11,0,0,0,2,0,2,0,0,0
12/03/2020,Southwest,1,GACH,1,53,45,21,24,0,0,0,4,0,4,3,0,3,53,45,21,24,0,0,0,4,0,4,3,0,3
12/04/2020,Anchorage,7,GACH,1,801,734,615,119,143,114,29,175,39,136,92,1,93,801,734,615,119,143,114,29,175,39,136,92,1,93
12/04/2020,Anchorage,7,LTACH,0,31,30,27,3,3,3,0,23,0,23,0,0,0,31,30,27,3,3,3,0,23,0,23,0,0,0
12/04/2020,Anchorage,7,Psych,0,,,,,,,,,,,,,,200,189,102,87,0,0,0,0,0,0,2,0,2
12/04/2020,Gulf Coast,4,CAH,1,96,86,23,63,3,1,2,18,0,18,4,0,4,96,86,23,63,3,1,2,18,0,18,4,0,4
12/04/2020,Gulf Coast,4,GACH,1,115,61,48,13,9,6,3,10,3,7,13,0,13,115,61,48,13,9,6,3,10,3,7,13,0,13
12/04/2020,Interior,6,GACH,1,101,81,51,30,20,8,12,16,0,16,7,0,7,101,81,51,30,20,8,12,16,0,16,7,0,7
12/04/2020,Matanuska-Susitna,3,GACH,1,184,160,85,75,14,14,0,30,5,25,26,0,26,184,160,85,75,14,14,0,30,5,25,26,0,26
12/04/2020,Northern,2,CAH,1,142,68,19,49,0,0,0,36,0,36,3,0,3,142,68,19,49,0,0,0,36,0,36,3,0,3
12/04/2020,Southeast,5,CAH,1,70,70,31,39,8,0,8,33,0,33,2,0,2,70,70,31,39,8,0,8,33,0,33,2,0,2
12/04/2020,Southeast,5,GACH,1,161,133,39,94,9,4,5,20,0,20,0,0,0,161,133,39,94,9,4,5,20,0,20,0,0,0
12/04/2020,Southwest,1,CAH,1,22,12,0,12,0,0,0,2,0,2,0,0,0,22,12,0,12,0,0,0,2,0,2,0,0,0
12/04/2020,Southwest,1,GACH,1,53,45,19,26,0,0,0,4,0,4,3,0,3,53,45,19,26,0,0,0,4,0,4,3,0,3
12/05/2020,Anchorage,7,GACH,1,777,709,575,134,140,105,35,175,37,138,92,1,93,777,709,575,134,140,105,35,175,37,138,92,1,93
12/05/2020,Anchorage,7,LTACH,0,31,30,28,2,3,3,0,23,0,23,0,0,0,31,30,28,2,3,3,0,23,0,23,0,0,0
12/05/2020,Anchorage,7,Psych,0,,,,,,,,,,,,,,200,189,102,87,0,0,0,0,0,0,2,0,2
12/05/2020,Gulf Coast,4,CAH,1,96,86,25,61,3,1,2,18,0,18,3,0,3,96,86,25,61,3,1,2,18,0,18,3,0,3
12/05/2020,Gulf Coast,4,GACH,1,115,61,43,18,9,6,3,10,3,7,11,0,11,115,61,43,18,9,6,3,10,3,7,11,0,11
12/05/2020,Interior,6,GACH,1,101,81,56,25,20,8,12,16,0,16,8,0,8,101,81,56,25,20,8,12,16,0,16,8,0,8
12/05/2020,Matanuska-Susitna,3,GACH,1,184,160,84,76,14,14,0,30,4,26,25,0,25,184,160,84,76,14,14,0,30,4,26,25,0,25
12/05/2020,Northern,2,CAH,1,142,68,22,46,0,0,0,36,0,36,6,0,6,142,68,22,46,0,0,0,36,0,36,6,0,6
12/05/2020,Southeast,5,CAH,1,70,70,31,39,8,0,8,33,0,33,2,0,2,70,70,31,39,8,0,8,33,0,33,2,0,2
12/05/2020,Southeast,5,GACH,1,161,133,41,92,9,7,2,20,0,20,0,0,0,161,133,41,92,9,7,2,20,0,20,0,0,0
12/05/2020,Southwest,1,CAH,1,22,12,3,9,0,0,0,2,0,2,0,0,0,22,12,3,9,0,0,0,2,0,2,0,0,0
12/05/2020,Southwest,1,GACH,1,53,45,15,30,0,0,0,4,0,4,3,0,3,53,45,15,30,0,0,0,4,0,4,3,0,3
12/06/2020,Anchorage,7,GACH,1,773,705,540,165,139,94,45,175,41,134,86,0,86,773,705,540,165,139,94,45,175,41,134,86,0,86
12/06/2020,Anchorage,7,LTACH,0,31,30,29,1,3,3,0,23,1,22,0,0,0,31,30,29,1,3,3,0,23,1,22,0,0,0
12/06/2020,Anchorage,7,Psych,0,,,,,,,,,,,,,,200,189,102,87,0,0,0,0,0,0,2,0,2
12/06/2020,Gulf Coast,4,CAH,1,93,84,25,59,3,1,2,18,0,18,3,0,3,93,84,25,59,3,1,2,18,0,18,3,0,3
12/06/2020,Gulf Coast,4,GACH,1,115,61,50,11,9,5,4,10,4,6,13,0,13,115,61,50,11,9,5,4,10,4,6,13,0,13
12/06/2020,Interior,6,GACH,1,101,81,55,26,20,10,10,16,0,16,9,0,9,101,81,55,26,20,10,10,16,0,16,9,0,9
12/06/2020,Matanuska-Susitna,3,GACH,1,184,160,77,83,14,10,4,30,5,25,26,0,26,184,160,77,83,14,10,4,30,5,25,26,0,26
12/06/2020,Northern,2,CAH,1,142,68,20,48,0,0,0,36,0,36,6,0,6,142,68,20,48,0,0,0,36,0,36,6,0,6
12/06/2020,Southeast,5,CAH,1,70,70,28,42,8,0,8,33,0,33,2,0,2,70,70,28,42,8,0,8,33,0,33,2,0,2
12/06/2020,Southeast,5,GACH,1,161,133,32,101,9,5,4,20,0,20,0,0,0,161,133,32,101,9,5,4,20,0,20,0,0,0
12/06/2020,Southwest,1,CAH,1,22,12,2,10,0,0,0,2,0,2,0,0,0,22,12,2,10,0,0,0,2,0,2,0,0,0
12/06/2020,Southwest,1,GACH,1,53,45,16,29,0,0,0,4,0,4,3,0,3,53,45,16,29,0,0,0,4,0,4,3,0,3
12/07/2020,Anchorage,7,GACH,1,767,699,526,173,136,98,38,175,37,138,85,0,85,767,699,526,173,136,98,38,175,37,138,85,0,85
12/07/2020,Anchorage,7,LTACH,0,31,30,29,1,3,3,0,23,1,22,0,0,0,31,30,29,1,3,3,0,23,1,22,0,0,0
12/07/2020,Anchorage,7,Psych,0,,,,,,,,,,,,,,200,189,102,87,0,0,0,0,0,0,2,0,2
12/07/2020,Gulf Coast,4,CAH,1,99,90,23,67,4,1,3,18,0,18,1,0,1,99,90,23,67,4,1,3,18,0,18,1,0,1
12/07/2020,Gulf Coast,4,GACH,1,115,61,48,13,9,7,2,10,6,4,13,0,13,115,61,48,13,9,7,2,10,6,4,13,0,13
12/07/2020,Interior,6,GACH,1,101,81,56,25,20,12,8,16,0,16,10,0,10,101,81,56,25,20,12,8,16,0,16,10,0,10
12/07/2020,Matanuska-Susitna,3,GACH,1,184,160,67,93,14,10,4,30,4,26,25,0,25,184,160,67,93,14,10,4,30,4,26,25,0,25
12/07/2020,Northern,2,CAH,1,142,68,17,51,0,0,0,36,0,36,6,0,6,142,68,17,51,0,0,0,36,0,36,6,0,6
12/07/2020,Southeast,5,CAH,1,70,70,29,41,8,2,6,33,0,33,2,0,2,70,70,29,41,8,2,6,33,0,33,2,0,2
12/07/2020,Southeast,5,GACH,1,161,133,32,101,9,4,5,20,0,20,0,0,0,161,133,32,101,9,4,5,20,0,20,0,0,0
12/07/2020,Southwest,1,CAH,1,22,12,2,10,0,0,0,2,0,2,0,0,0,22,12,2,10,0,0,0,2,0,2,0,0,0
12/07/2020,Southwest,1,GACH,1,53,45,18,27,0,0,0,4,0,4,3,0,3,53,45,18,27,0,0,0,4,0,4,3,0,3
12/08/2020,Anchorage,7,GACH,1,766,699,566,133,138,108,30,175,39,136,90,0,90,766,699,566,133,138,108,30,175,39,136,90,0,90
12/08/2020,Anchorage,7,LTACH,0,31,30,28,2,3,3,0,23,2,21,0,0,0,31,30,28,2,3,3,0,23,2,21,0,0,0
12/08/2020,Anchorage,7,Psych,0,,,,,,,,,,,,,,200,189,102,87,0,0,0,0,0,0,2,0,2
12/08/2020,Gulf Coast,4,CAH,1,99,90,26,64,4,0,4,18,0,18,4,0,4,99,90,26,64,4,0,4,18,0,18,4,0,4
12/08/2020,Gulf Coast,4,GACH,1,115,61,45,16,9,7,2,10,4,6,12,0,12,115,61,45,16,9,7,2,10,4,6,12,0,12
12/08/2020,Interior,6,GACH,1,101,81,59,22,20,13,7,16,0,16,11,1,12,101,81,59,22,20,13,7,16,0,16,11,1,12
12/08/2020,Matanuska-Susitna,3,GACH,1,184,160,79,81,14,12,2,30,4,26,23,0,23,184,160,79,81,14,12,2,30,4,26,23,0,23
12/08/2020,Northern,2,CAH,1,142,68,22,46,0,0,0,36,0,36,7,0,7,142,68,22,46,0,0,0,36,0,36,7,0,7
12/08/2020,Southeast,5,CAH,1,70,70,31,39,8,3,5,33,0,33,2,0,2,70,70,31,39,8,3,5,33,0,33,2,0,2
12/08/2020,Southeast,5,GACH,1,161,133,30,103,9,4,5,20,0,20,0,0,0,161,133,30,103,9,4,5,20,0,20,0,0,0
12/08/2020,Southwest,1,CAH,1,22,12,1,11,0,0,0,2,0,2,0,0,0,22,12,1,11,0,0,0,2,0,2,0,0,0
12/08/2020,Southwest,1,GACH,1,53,45,15,30,0,0,0,4,0,4,2,0,2,53,45,15,30,0,0,0,4,0,4,2,0,2
12/09/2020,Anchorage,7,GACH,1,779,711,569,142,143,108,35,175,36,139,84,0,84,779,711,569,142,143,108,35,175,36,139,84,0,84
12/09/2020,Anchorage,7,LTACH,0,31,30,29,1,3,3,0,23,1,22,0,0,0,31,30,29,1,3,3,0,23,1,22,0,0,0
12/09/2020,Anchorage,7,Psych,0,200,190,97,93,50,0,50,0,0,0,8,0,8,200,190,97,93,50,0,50,0,0,0,8,0,8
12/09/2020,Gulf Coast,4,CAH,1,99,89,24,65,4,2,2,18,0,18,4,0,4,99,89,24,65,4,2,2,18,0,18,4,0,4
12/09/2020,Gulf Coast,4,GACH,1,115,61,46,15,9,6,3,10,2,8,10,0,10,115,61,46,15,9,6,3,10,2,8,10,0,10
12/09/2020,Interior,6,GACH,1,101,81,58,23,20,11,9,16,0,16,10,0,10,101,81,58,23,20,11,9,16,0,16,10,0,10
12/09/2020,Matanuska-Susitna,3,GACH,1,184,160,80,80,14,9,5,30,5,25,23,0,23,184,160,80,80,14,9,5,30,5,25,23,0,23
12/09/2020,Northern,2,CAH,1,142,68,19,49,0,0,0,36,0,36,7,0,7,142,68,19,49,0,0,0,36,0,36,7,0,7
12/09/2020,Southeast,5,CAH,1,70,70,34,36,8,3,5,33,0,33,1,0,1,70,70,34,36,8,3,5,33,0,33,1,0,1
12/09/2020,Southeast,5,GACH,1,161,133,30,103,9,5,4,20,0,20,0,0,0,161,133,30,103,9,5,4,20,0,20,0,0,0
12/09/2020,Southwest,1,CAH,1,22,12,1,11,0,0,0,2,0,2,0,0,0,22,12,1,11,0,0,0,2,0,2,0,0,0
12/09/2020,Southwest,1,GACH,1,53,45,14,31,0,0,0,4,0,4,2,0,2,53,45,14,31,0,0,0,4,0,4,2,0,2
12/10/2020,Anchorage,7,GACH,1,749,682,542,140,144,107,37,175,40,135,79,0,79,749,682,542,140,144,107,37,175,40,135,79,0,79
12/10/2020,Anchorage,7,LTACH,0,31,30,29,1,3,3,0,23,1,22,0,0,0,31,30,29,1,3,3,0,23,1,22,0,0,0
12/10/2020,Anchorage,7,Psych,0,60,54,54,0,0,0,0,0,0,0,0,0,0,200,194,101,93,0,0,0,0,0,0,8,0,8
12/10/2020,Gulf Coast,4,CAH,1,101,91,20,71,4,2,2,18,0,18,4,0,4,101,91,20,71,4,2,2,18,0,18,4,0,4
12/10/2020,Gulf Coast,4,GACH,1,115,61,41,20,9,5,4,10,2,8,7,0,7,115,61,41,20,9,5,4,10,2,8,7,0,7
12/10/2020,Interior,6,GACH,1,101,81,60,21,20,9,11,16,0,16,9,0,9,101,81,60,21,20,9,11,16,0,16,9,0,9
12/10/2020,Matanuska-Susitna,3,GACH,1,184,160,74,86,14,7,7,30,5,25,19,0,19,184,160,74,86,14,7,7,30,5,25,19,0,19
12/10/2020,Northern,2,CAH,1,142,68,18,50,0,0,0,36,0,36,6,0,6,142,68,18,50,0,0,0,36,0,36,6,0,6
12/10/2020,Southeast,5,CAH,1,70,70,29,41,8,3,5,33,0,33,1,0,1,70,70,29,41,8,3,5,33,0,33,1,0,1
12/10/2020,Southeast,5,GACH,1,161,133,26,107,9,4,5,20,0,20,1,0,1,161,133,26,107,9,4,5,20,0,20,1,0,1
12/10/2020,Southwest,1,CAH,1,22,12,1,11,0,0,0,2,0,2,0,0,0,22,12,1,11,0,0,0,2,0,2,0,0,0
12/10/2020,Southwest,1,GACH,1,53,45,12,33,0,0,0,4,0,4,2,0,2,53,45,12,33,0,0,0,4,0,4,2,0,2
12/11/2020,Anchorage,7,GACH,1,752,685,540,145,147,110,37,175,38,137,74,0,74,752,685,540,145,147,110,37,175,38,137,74,0,74
12/11/2020,Anchorage,7,LTACH,0,31,30,28,2,3,3,0,23,1,22,0,0,0,31,30,28,2,3,3,0,23,1,22,0,0,0
12/11/2020,Anchorage,7,Psych,0,60,52,52,0,0,0,0,0,0,0,0,0,0,200,192,99,93,0,0,0,0,0,0,8,0,8
12/11/2020,Gulf Coast,4,CAH,1,100,90,20,70,4,1,3,18,0,18,3,0,3,100,90,20,70,4,1,3,18,0,18,3,0,3
12/11/2020,Gulf Coast,4,GACH,1,115,61,36,25,9,6,3,10,2,8,7,0,7,115,61,36,25,9,6,3,10,2,8,7,0,7
12/11/2020,Interior,6,GACH,1,101,81,58,23,20,7,13,16,0,16,10,0,10,101,81,58,23,20,7,13,16,0,16,10,0,10
12/11/2020,Matanuska-Susitna,3,GACH,1,184,160,76,84,14,9,5,30,5,25,21,0,21,184,160,76,84,14,9,5,30,5,25,21,0,21
12/11/2020,Northern,2,CAH,1,139,68,17,51,0,0,0,36,0,36,6,0,6,139,68,17,51,0,0,0,36,0,36,6,0,6
12/11/2020,Southeast,5,CAH,1,70,70,33,37,8,3,5,33,0,33,1,0,1,70,70,33,37,8,3,5,33,0,33,1,0,1
12/11/2020,Southeast,5,GACH,1,161,133,36,97,9,4,5,20,1,19,1,0,1,161,133,36,97,9,4,5,20,1,19,1,0,1
12/11/2020,Southwest,1,CAH,1,22,12,1,11,0,0,0,2,0,2,0,0,0,22,12,1,11,0,0,0,2,0,2,0,0,0
12/11/2020,Southwest,1,GACH,1,53,45,10,35,0,0,0,4,0,4,3,0,3,53,45,10,35,0,0,0,4,0,4,3,0,3
12/12/2020,Anchorage,7,GACH,1,740,679,548,131,139,106,33,175,37,138,76,0,76,740,679,548,131,139,106,33,175,37,138,76,0,76
12/12/2020,Anchorage,7,LTACH,0,31,30,28,2,3,3,0,23,2,21,0,0,0,31,30,28,2,3,3,0,23,2,21,0,0,0
12/12/2020,Anchorage,7,Psych,0,,,,,,,,,,,,,,200,192,99,93,0,0,0,0,0,0,8,0,8
12/12/2020,Gulf Coast,4,CAH,1,98,89,16,73,4,1,3,18,0,18,3,0,3,98,89,16,73,4,1,3,18,0,18,3,0,3
12/12/2020,Gulf Coast,4,GACH,1,115,61,38,23,9,5,4,10,2,8,5,0,5,115,61,38,23,9,5,4,10,2,8,5,0,5
12/12/2020,Interior,6,GACH,1,101,81,52,29,20,7,13,16,0,16,8,0,8,101,81,52,29,20,7,13,16,0,16,8,0,8
12/12/2020,Matanuska-Susitna,3,GACH,1,184,160,72,88,14,9,5,30,5,25,18,2,20,184,160,72,88,14,9,5,30,5,25,18,2,20
12/12/2020,Northern,2,CAH,1,139,68,20,48,0,0,0,36,0,36,6,0,6,139,68,20,48,0,0,0,36,0,36,6,0,6
12/12/2020,Southeast,5,CAH,1,70,70,36,34,8,3,5,33,0,33,0,0,0,70,70,36,34,8,3,5,33,0,33,0,0,0
12/12/2020,Southeast,5,GACH,1,161,133,31,102,9,4,5,20,0,20,1,0,1,161,133,31,102,9,4,5,20,0,20,1,0,1
12/12/2020,Southwest,1,CAH,1,22,12,1,11,0,0,0,2,0,2,1,0,1,22,12,1,11,0,0,0,2,0,2,1,0,1
12/12/2020,Southwest,1,GACH,1,53,45,12,33,0,0,0,4,0,4,3,0,3,53,45,12,33,0,0,0,4,0,4,3,0,3
12/13/2020,Anchorage,7,GACH,1,737,676,557,119,125,102,23,175,40,135,83,1,84,737,676,557,119,125,102,23,175,40,135,83,1,84
12/13/2020,Anchorage,7,LTACH,0,31,30,28,2,3,3,0,23,3,20,0,0,0,31,30,28,2,3,3,0,23,3,20,0,0,0
12/13/2020,Anchorage,7,Psych,0,,,,,,,,,,,,,,200,192,99,93,0,0,0,0,0,0,8,0,8
12/13/2020,Gulf Coast,4,CAH,1,100,90,17,73,4,0,4,18,0,18,2,0,2,100,90,17,73,4,0,4,18,0,18,2,0,2
12/13/2020,Gulf Coast,4,GACH,1,115,61,30,31,9,2,7,10,1,9,2,0,2,115,61,30,31,9,2,7,10,1,9,2,0,2
12/13/2020,Interior,6,GACH,1,101,81,37,44,20,11,9,16,0,16,5,0,5,101,81,37,44,20,11,9,16,0,16,5,0,5
12/13/2020,Matanuska-Susitna,3,GACH,1,184,160,64,96,14,13,1,30,5,25,21,0,21,184,160,64,96,14,13,1,30,5,25,21,0,21
12/13/2020,Northern,2,CAH,1,139,68,22,46,0,0,0,36,0,36,6,0,6,139,68,22,46,0,0,0,36,0,36,6,0,6
12/13/2020,Southeast,5,CAH,1,70,70,32,38,8,2,6,33,0,33,0,0,0,70,70,32,38,8,2,6,33,0,33,0,0,0
12/13/2020,Southeast,5,GACH,1,161,133,32,101,9,5,4,20,0,20,1,0,1,161,133,32,101,9,5,4,20,0,20,1,0,1
12/13/2020,Southwest,1,CAH,1,22,12,1,11,0,0,0,2,0,2,1,0,1,22,12,1,11,0,0,0,2,0,2,1,0,1
12/13/2020,Southwest,1,GACH,1,53,45,14,31,0,0,0,4,0,4,3,0,3,53,45,14,31,0,0,0,4,0,4,3,0,3
12/14/2020,Anchorage,7,GACH,1,742,681,529,152,141,107,34,175,36,139,85,1,86,742,681,529,152,141,107,34,175,36,139,85,1,86
12/14/2020,Anchorage,7,LTACH,0,31,30,28,2,3,3,0,23,2,21,0,0,0,31,30,28,2,3,3,0,23,2,21,0,0,0
12/14/2020,Anchorage,7,Psych,0,60,54,54,0,0,0,0,0,0,0,0,0,0,200,194,101,93,0,0,0,0,0,0,8,0,8
12/14/2020,Gulf Coast,4,CAH,1,100,90,19,71,4,1,3,18,0,18,5,0,5,100,90,19,71,4,1,3,18,0,18,5,0,5
12/14/2020,Gulf Coast,4,GACH,1,115,61,26,35,9,1,8,10,1,9,1,0,1,115,61,26,35,9,1,8,10,1,9,1,0,1
12/14/2020,Interior,6,GACH,1,101,81,38,43,20,8,12,16,1,15,7,0,7,101,81,38,43,20,8,12,16,1,15,7,0,7
12/14/2020,Matanuska-Susitna,3,GACH,1,184,160,73,87,14,10,4,30,4,26,18,0,18,184,160,73,87,14,10,4,30,4,26,18,0,18
12/14/2020,Northern,2,CAH,1,139,68,23,45,0,0,0,36,0,36,6,0,6,139,68,23,45,0,0,0,36,0,36,6,0,6
12/14/2020,Southeast,5,CAH,1,70,70,27,43,8,2,6,33,0,33,0,0,0,70,70,27,43,8,2,6,33,0,33,0,0,0
12/14/2020,Southeast,5,GACH,1,161,133,36,97,9,5,4,20,0,20,2,0,2,161,133,36,97,9,5,4,20,0,20,2,0,2
12/14/2020,Southwest,1,CAH,1,22,12,1,11,0,0,0,2,0,2,0,0,0,22,12,1,11,0,0,0,2,0,2,0,0,0
12/14/2020,Southwest,1,GACH,1,53,45,13,32,0,0,0,4,0,4,2,0,2,53,45,13,32,0,0,0,4,0,4,2,0,2
12/15/2020,Anchorage,7,GACH,1,742,681,545,136,141,109,32,175,37,138,88,1,89,742,681,545,136,141,109,32,175,37,138,88,1,89
12/15/2020,Anchorage,7,LTACH,0,31,30,29,1,3,3,0,23,3,20,0,0,0,31,30,29,1,3,3,0,23,3,20,0,0,0
12/15/2020,Anchorage,7,Psych,0,60,54,54,0,54,0,54,0,0,0,0,0,0,200,194,101,93,54,0,54,0,0,0,8,0,8
12/15/2020,Gulf Coast,4,CAH,1,100,90,21,69,4,2,2,18,0,18,5,0,5,100,90,21,69,4,2,2,18,0,18,5,0,5
12/15/2020,Gulf Coast,4,GACH,1,115,61,33,28,9,2,7,10,1,9,0,0,0,115,61,33,28,9,2,7,10,1,9,0,0,0
12/15/2020,Interior,6,GACH,1,101,81,42,39,20,7,13,16,1,15,5,0,5,101,81,42,39,20,7,13,16,1,15,5,0,5
12/15/2020,Matanuska-Susitna,3,GACH,1,184,160,73,87,14,13,1,30,5,25,19,0,19,184,160,73,87,14,13,1,30,5,25,19,0,19
12/15/2020,Northern,2,CAH,1,139,68,23,45,0,0,0,36,0,36,7,0,7,139,68,23,45,0,0,0,36,0,36,7,0,7
12/15/2020,Southeast,5,CAH,1,70,70,29,41,8,4,4,33,0,33,0,0,0,70,70,29,41,8,4,4,33,0,33,0,0,0
12/15/2020,Southeast,5,GACH,1,161,133,29,104,9,4,5,20,0,20,0,0,0,161,133,29,104,9,4,5,20,0,20,0,0,0
12/15/2020,Southwest,1,CAH,1,22,12,2,10,0,0,0,2,0,2,0,0,0,22,12,2,10,0,0,0,2,0,2,0,0,0
12/15/2020,Southwest,1,GACH,1,53,45,14,31,0,0,0,4,0,4,3,0,3,53,45,14,31,0,0,0,4,0,4,3,0,3
12/16/2020,Anchorage,7,GACH,1,708,683,541,142,129,98,31,164,40,124,83,1,84,708,683,541,142,129,98,31,164,40,124,83,1,84
12/16/2020,Anchorage,7,LTACH,0,31,30,29,1,3,3,0,23,3,20,0,0,0,31,30,29,1,3,3,0,23,3,20,0,0,0
12/16/2020,Anchorage,7,Psych,0,200,192,99,93,52,0,52,0,0,0,12,0,12,200,192,99,93,52,0,52,0,0,0,12,0,12
12/16/2020,Gulf Coast,4,CAH,1,101,91,29,62,4,2,2,18,0,18,7,0,7,101,91,29,62,4,2,2,18,0,18,7,0,7
12/16/2020,Gulf Coast,4,GACH,1,115,61,38,23,9,3,6,10,1,9,0,0,0,115,61,38,23,9,3,6,10,1,9,0,0,0
12/16/2020,Interior,6,GACH,1,101,81,48,33,20,12,8,16,1,15,4,0,4,101,81,48,33,20,12,8,16,1,15,4,0,4
12/16/2020,Matanuska-Susitna,3,GACH,1,184,160,71,89,14,8,6,30,7,23,15,0,15,184,160,71,89,14,8,6,30,7,23,15,0,15
12/16/2020,Northern,2,CAH,1,139,68,26,42,0,0,0,36,0,36,8,0,8,139,68,26,42,0,0,0,36,0,36,8,0,8
12/16/2020,Southeast,5,CAH,1,70,70,32,38,8,2,6,33,0,33,0,0,0,70,70,32,38,8,2,6,33,0,33,0,0,0
12/16/2020,Southeast,5,GACH,1,161,133,27,106,9,3,6,20,0,20,0,0,0,161,133,27,106,9,3,6,20,0,20,0,0,0
12/16/2020,Southwest,1,CAH,1,22,12,2,10,0,0,0,2,0,2,0,0,0,22,12,2,10,0,0,0,2,0,2,0,0,0
12/16/2020,Southwest,1,GACH,1,53,45,14,31,0,0,0,4,0,4,4,0,4,53,45,14,31,0,0,0,4,0,4,4,0,4
12/17/2020,Anchorage,7,GACH,1,700,674,560,114,124,96,28,179,41,138,77,2,79,700,674,560,114,124,96,28,179,41,138,77,2,79
12/17/2020,Anchorage,7,LTACH,0,31,30,29,1,3,3,0,23,3,20,0,0,0,31,30,29,1,3,3,0,23,3,20,0,0,0
12/17/2020,Anchorage,7,Psych,0,60,52,52,0,0,0,0,0,0,0,0,0,0,200,192,99,93,0,0,0,0,0,0,12,0,12
12/17/2020,Gulf Coast,4,CAH,1,101,92,31,61,4,2,2,18,0,18,6,0,6,101,92,31,61,4,2,2,18,0,18,6,0,6
12/17/2020,Gulf Coast,4,GACH,1,115,61,39,22,9,5,4,10,1,9,1,0,1,115,61,39,22,9,5,4,10,1,9,1,0,1
12/17/2020,Interior,6,GACH,1,101,81,59,22,20,11,9,16,1,15,3,0,3,101,81,59,22,20,11,9,16,1,15,3,0,3
12/17/2020,Matanuska-Susitna,3,GACH,1,184,160,68,92,14,10,4,30,8,22,14,0,14,184,160,68,92,14,10,4,30,8,22,14,0,14
12/17/2020,Northern,2,CAH,1,139,68,27,41,0,0,0,36,0,36,7,0,7,139,68,27,41,0,0,0,36,0,36,7,0,7
12/17/2020,Southeast,5,CAH,1,70,70,36,34,8,3,5,33,0,33,1,0,1,70,70,36,34,8,3,5,33,0,33,1,0,1
12/17/2020,Southeast,5,GACH,1,161,133,29,104,9,4,5,20,0,20,0,0,0,161,133,29,104,9,4,5,20,0,20,0,0,0
12/17/2020,Southwest,1,CAH,1,22,12,1,11,0,0,0,2,0,2,0,0,0,22,12,1,11,0,0,0,2,0,2,0,0,0
12/17/2020,Southwest,1,GACH,1,53,45,19,26,0,0,0,4,0,4,4,0,4,53,45,19,26,0,0,0,4,0,4,4,0,4
12/18/2020,Anchorage,7,GACH,1,707,677,538,139,124,93,31,179,36,143,81,0,81,707,677,538,139,124,93,31,179,36,143,81,0,81
12/18/2020,Anchorage,7,LTACH,0,31,30,29,1,3,3,0,23,3,20,0,0,0,31,30,29,1,3,3,0,23,3,20,0,0,0
12/18/2020,Anchorage,7,Psych,0,60,52,52,0,0,0,0,0,0,0,0,0,0,200,192,99,93,0,0,0,0,0,0,12,0,12
12/18/2020,Gulf Coast,4,CAH,1,101,92,28,64,4,1,3,18,0,18,5,0,5,101,92,28,64,4,1,3,18,0,18,5,0,5
12/18/2020,Gulf Coast,4,GACH,1,115,61,37,24,9,7,2,10,1,9,2,0,2,115,61,37,24,9,7,2,10,1,9,2,0,2
12/18/2020,Interior,6,GACH,1,101,81,53,28,20,8,12,16,1,15,2,0,2,101,81,53,28,20,8,12,16,1,15,2,0,2
12/18/2020,Matanuska-Susitna,3,GACH,1,184,160,84,76,14,14,0,30,8,22,15,1,16,184,160,84,76,14,14,0,30,8,22,15,1,16
12/18/2020,Northern,2,CAH,1,139,68,24,44,0,0,0,36,0,36,5,0,5,139,68,24,44,0,0,0,36,0,36,5,0,5
12/18/2020,Southeast,5,CAH,1,70,70,34,36,8,3,5,33,0,33,1,0,1,70,70,34,36,8,3,5,33,0,33,1,0,1
12/18/2020,Southeast,5,GACH,1,161,133,40,93,9,4,5,20,0,20,1,0,1,161,133,40,93,9,4,5,20,0,20,1,0,1
12/18/2020,Southwest,1,CAH,1,22,12,1,11,0,0,0,2,0,2,0,0,0,22,12,1,11,0,0,0,2,0,2,0,0,0
12/18/2020,Southwest,1,GACH,1,53,45,22,23,0,0,0,4,0,4,4,0,4,53,45,22,23,0,0,0,4,0,4,4,0,4
12/19/2020,Anchorage,7,GACH,1,711,682,555,127,128,98,30,179,42,137,69,1,70,711,682,555,127,128,98,30,179,42,137,69,1,70
12/19/2020,Anchorage,7,LTACH,0,31,30,28,2,3,3,0,23,3,20,0,0,0,31,30,28,2,3,3,0,23,3,20,0,0,0
12/19/2020,Anchorage,7,Psych,0,60,50,50,0,0,0,0,0,0,0,0,0,0,200,190,97,93,0,0,0,0,0,0,12,0,12
12/19/2020,Gulf Coast,4,CAH,1,100,91,32,59,4,1,3,18,0,18,5,0,5,100,91,32,59,4,1,3,18,0,18,5,0,5
12/19/2020,Gulf Coast,4,GACH,1,115,61,40,21,9,4,5,10,1,9,3,0,3,115,61,40,21,9,4,5,10,1,9,3,0,3
12/19/2020,Interior,6,GACH,1,101,81,49,32,20,9,11,16,2,14,2,0,2,101,81,49,32,20,9,11,16,2,14,2,0,2
12/19/2020,Matanuska-Susitna,3,GACH,1,184,160,80,80,14,14,0,30,7,23,15,1,16,184,160,80,80,14,14,0,30,7,23,15,1,16
12/19/2020,Northern,2,CAH,1,139,68,25,43,0,0,0,36,0,36,3,0,3,139,68,25,43,0,0,0,36,0,36,3,0,3
12/19/2020,Southeast,5,CAH,1,70,70,29,41,8,3,5,33,0,33,1,0,1,70,70,29,41,8,3,5,33,0,33,1,0,1
12/19/2020,Southeast,5,GACH,1,161,133,28,105,9,3,6,20,0,20,1,0,1,161,133,28,105,9,3,6,20,0,20,1,0,1
12/19/2020,Southwest,1,CAH,1,22,12,1,11,0,0,0,2,0,2,0,0,0,22,12,1,11,0,0,0,2,0,2,0,0,0
12/19/2020,Southwest,1,GACH,1,53,45,24,21,0,0,0,4,0,4,3,0,3,53,45,24,21,0,0,0,4,0,4,3,0,3
12/20/2020,Anchorage,7,GACH,1,720,685,556,129,125,89,36,179,42,137,72,1,73,720,685,556,129,125,89,36,179,42,137,72,1,73
12/20/2020,Anchorage,7,LTACH,0,31,30,29,1,3,3,0,23,3,20,0,0,0,31,30,29,1,3,3,0,23,3,20,0,0,0
12/20/2020,Anchorage,7,Psych,0,,,,,,,,,,,,,,200,190,97,93,0,0,0,0,0,0,12,0,12
12/20/2020,Gulf Coast,4,CAH,1,99,89,24,65,4,1,3,18,0,18,5,0,5,99,89,24,65,4,1,3,18,0,18,5,0,5
12/20/2020,Gulf Coast,4,GACH,1,115,61,35,26,9,5,4,10,1,9,3,0,3,115,61,35,26,9,5,4,10,1,9,3,0,3
12/20/2020,Interior,6,GACH,1,101,81,41,40,20,11,9,16,1,15,3,0,3,101,81,41,40,20,11,9,16,1,15,3,0,3
12/20/2020,Matanuska-Susitna,3,GACH,1,184,160,68,92,14,13,1,30,7,23,13,0,13,184,160,68,92,14,13,1,30,7,23,13,0,13
12/20/2020,Northern,2,CAH,1,139,68,27,41,0,0,0,36,0,36,3,0,3,139,68,27,41,0,0,0,36,0,36,3,0,3
12/20/2020,Southeast,5,CAH,1,70,70,34,36,8,3,5,33,0,33,1,0,1,70,70,34,36,8,3,5,33,0,33,1,0,1
12/20/2020,Southeast,5,GACH,1,161,133,25,108,9,4,5,20,0,20,1,0,1,161,133,25,108,9,4,5,20,0,20,1,0,1
12/20/2020,Southwest,1,CAH,1,22,12,1,11,0,0,0,2,0,2,0,0,0,22,12,1,11,0,0,0,2,0,2,0,0,0
12/20/2020,Southwest,1,GACH,1,53,45,25,20,0,0,0,4,0,4,3,0,3,53,45,25,20,0,0,0,4,0,4,3,0,3
12/21/2020,Anchorage,7,GACH,1,720,685,571,114,126,98,28,179,30,149,65,1,66,720,685,571,114,126,98,28,179,30,149,65,1,66
12/21/2020,Anchorage,7,LTACH,0,31,30,29,1,3,3,0,23,4,19,0,0,0,31,30,29,1,3,3,0,23,4,19,0,0,0
12/21/2020,Anchorage,7,Psych,0,60,50,50,0,0,0,0,0,0,0,0,0,0,200,190,97,93,0,0,0,0,0,0,12,0,12
12/21/2020,Gulf Coast,4,CAH,1,99,89,25,64,4,1,3,18,0,18,5,0,5,99,89,25,64,4,1,3,18,0,18,5,0,5
12/21/2020,Gulf Coast,4,GACH,1,115,61,37,24,9,6,3,10,1,9,4,0,4,115,61,37,24,9,6,3,10,1,9,4,0,4
12/21/2020,Interior,6,GACH,1,101,81,47,34,20,6,14,16,1,15,4,0,4,101,81,47,34,20,6,14,16,1,15,4,0,4
12/21/2020,Matanuska-Susitna,3,GACH,1,184,160,65,95,14,14,0,30,7,23,14,0,14,184,160,65,95,14,14,0,30,7,23,14,0,14
12/21/2020,Northern,2,CAH,1,139,78,30,48,0,0,0,36,0,36,3,0,3,139,78,30,48,0,0,0,36,0,36,3,0,3
12/21/2020,Southeast,5,CAH,1,70,70,35,35,8,1,7,33,0,33,1,0,1,70,70,35,35,8,1,7,33,0,33,1,0,1
12/21/2020,Southeast,5,GACH,1,161,133,30,103,9,2,7,20,0,20,0,0,0,161,133,30,103,9,2,7,20,0,20,0,0,0
12/21/2020,Southwest,1,CAH,1,22,12,1,11,0,0,0,2,0,2,0,0,0,22,12,1,11,0,0,0,2,0,2,0,0,0
12/21/2020,Southwest,1,GACH,1,53,45,21,24,0,0,0,4,0,4,4,0,4,53,45,21,24,0,0,0,4,0,4,4,0,4
12/22/2020,Anchorage,7,GACH,1,721,685,582,103,129,105,24,179,37,142,64,1,65,721,685,582,103,129,105,24,179,37,142,64,1,65
12/22/2020,Anchorage,7,LTACH,0,31,30,29,1,3,3,0,23,4,19,0,0,0,31,30,29,1,3,3,0,23,4,19,0,0,0
12/22/2020,Anchorage,7,Psych,0,60,50,50,0,0,0,0,0,0,0,0,0,0,200,190,97,93,0,0,0,0,0,0,12,0,12
12/22/2020,Gulf Coast,4,CAH,1,101,92,29,63,4,1,3,18,0,18,3,0,3,101,92,29,63,4,1,3,18,0,18,3,0,3
12/22/2020,Gulf Coast,4,GACH,1,115,61,41,20,9,5,4,10,2,8,2,0,2,115,61,41,20,9,5,4,10,2,8,2,0,2
12/22/2020,Interior,6,GACH,1,101,81,35,46,20,6,14,16,1,15,5,0,5,101,81,35,46,20,6,14,16,1,15,5,0,5
12/22/2020,Matanuska-Susitna,3,GACH,1,184,160,74,86,14,14,0,30,8,22,12,0,12,184,160,74,86,14,14,0,30,8,22,12,0,12
12/22/2020,Northern,2,CAH,1,139,78,25,53,0,0,0,36,0,36,3,0,3,139,78,25,53,0,0,0,36,0,36,3,0,3
12/22/2020,Southeast,5,CAH,1,70,70,40,30,8,4,4,33,0,33,1,0,1,70,70,40,30,8,4,4,33,0,33,1,0,1
12/22/2020,Southeast,5,GACH,1,161,133,30,103,9,2,7,20,0,20,0,0,0,161,133,30,103,9,2,7,20,0,20,0,0,0
12/22/2020,Southwest,1,CAH,1,22,12,1,11,0,0,0,2,0,2,0,0,0,22,12,1,11,0,0,0,2,0,2,0,0,0
12/22/2020,Southwest,1,GACH,1,53,45,18,27,0,0,0,4,0,4,4,0,4,53,45,18,27,0,0,0,4,0,4,4,0,4
12/23/2020,Anchorage,7,GACH,1,707,676,535,141,125,92,33,179,32,147,61,0,61,707,676,535,141,125,92,33,179,32,147,61,0,61
12/23/2020,Anchorage,7,LTACH,0,31,30,28,2,3,3,0,23,3,20,0,0,0,31,30,28,2,3,3,0,23,3,20,0,0,0
12/23/2020,Anchorage,7,Psych,0,200,192,99,93,0,0,0,0,0,0,2,0,2,200,192,99,93,0,0,0,0,0,0,2,0,2
12/23/2020,Gulf Coast,4,CAH,1,101,92,29,63,4,1,3,18,0,18,5,0,5,101,92,29,63,4,1,3,18,0,18,5,0,5
12/23/2020,Gulf Coast,4,GACH,1,115,61,41,20,9,6,3,10,2,8,3,0,3,115,61,41,20,9,6,3,10,2,8,3,0,3
12/23/2020,Interior,6,GACH,1,101,81,41,40,20,6,14,16,1,15,5,0,5,101,81,41,40,20,6,14,16,1,15,5,0,5
12/23/2020,Matanuska-Susitna,3,GACH,1,184,160,71,89,14,14,0,30,5,25,12,0,12,184,160,71,89,14,14,0,30,5,25,12,0,12
12/23/2020,Northern,2,CAH,1,139,78,23,55,0,0,0,36,0,36,1,0,1,139,78,23,55,0,0,0,36,0,36,1,0,1
12/23/2020,Southeast,5,CAH,1,70,70,34,36,8,5,3,33,0,33,1,0,1,70,70,34,36,8,5,3,33,0,33,1,0,1
12/23/2020,Southeast,5,GACH,1,161,133,40,93,9,3,6,20,0,20,0,0,0,161,133,40,93,9,3,6,20,0,20,0,0,0
12/23/2020,Southwest,1,CAH,1,22,12,1,11,0,0,0,2,0,2,0,0,0,22,12,1,11,0,0,0,2,0,2,0,0,0
12/23/2020,Southwest,1,GACH,1,53,45,11,34,0,0,0,4,0,4,2,0,2,53,45,11,34,0,0,0,4,0,4,2,0,2
12/24/2020,Anchorage,7,GACH,1,697,670,520,150,123,88,35,179,31,148,61,1,62,697,670,520,150,123,88,35,179,31,148,61,1,62
12/24/2020,Anchorage,7,LTACH,0,31,30,30,0,3,3,0,23,3,20,0,0,0,31,30,30,0,3,3,0,23,3,20,0,0,0
12/24/2020,Anchorage,7,Psych,0,60,56,56,0,0,0,0,0,0,0,0,0,0,200,196,103,93,0,0,0,0,0,0,2,0,2
12/24/2020,Gulf Coast,4,CAH,1,101,92,29,63,4,1,3,18,0,18,4,0,4,101,92,29,63,4,1,3,18,0,18,4,0,4
12/24/2020,Gulf Coast,4,GACH,1,115,61,37,24,9,6,3,10,1,9,4,0,4,115,61,37,24,9,6,3,10,1,9,4,0,4
12/24/2020,Interior,6,GACH,1,101,81,48,33,20,8,12,16,1,15,4,0,4,101,81,48,33,20,8,12,16,1,15,4,0,4
12/24/2020,Matanuska-Susitna,3,GACH,1,184,160,63,97,14,7,7,30,5,25,11,0,11,184,160,63,97,14,7,7,30,5,25,11,0,11
12/24/2020,Northern,2,CAH,1,139,78,18,60,0,0,0,36,0,36,1,0,1,139,78,18,60,0,0,0,36,0,36,1,0,1
12/24/2020,Southeast,5,CAH,1,70,70,35,35,8,4,4,33,0,33,1,0,1,70,70,35,35,8,4,4,33,0,33,1,0,1
12/24/2020,Southeast,5,GACH,1,161,133,22,111,9,1,8,20,0,20,1,0,1,161,133,22,111,9,1,8,20,0,20,1,0,1
12/24/2020,Southwest,1,CAH,1,22,12,0,12,0,0,0,2,0,2,0,0,0,22,12,0,12,0,0,0,2,0,2,0,0,0
12/24/2020,Southwest,1,GACH,1,53,45,11,34,0,0,0,4,0,4,2,0,2,53,45,11,34,0,0,0,4,0,4,2,0,2
12/25/2020,Anchorage,7,GACH,1,700,672,480,192,126,91,35,179,33,146,42,1,43,700,672,480,192,126,91,35,179,33,146,42,1,43
12/25/2020,Anchorage,7,LTACH,0,31,30,28,2,3,3,0,23,3,20,0,0,0,31,30,28,2,3,3,0,23,3,20,0,0,0
12/25/2020,Anchorage,7,Psych,0,60,53,53,0,0,0,0,0,0,0,0,0,0,200,193,100,93,0,0,0,0,0,0,2,0,2
12/25/2020,Gulf Coast,4,CAH,1,99,90,22,68,4,2,2,18,0,18,3,0,3,99,90,22,68,4,2,2,18,0,18,3,0,3
12/25/2020,Gulf Coast,4,GACH,1,115,61,25,36,9,4,5,10,1,9,4,0,4,115,61,25,36,9,4,5,10,1,9,4,0,4
12/25/2020,Interior,6,GACH,1,101,81,41,40,20,6,14,16,1,15,3,0,3,101,81,41,40,20,6,14,16,1,15,3,0,3
12/25/2020,Matanuska-Susitna,3,GACH,1,184,160,52,108,14,7,7,30,6,24,8,0,8,184,160,52,108,14,7,7,30,6,24,8,0,8
12/25/2020,Northern,2,CAH,1,139,78,19,59,0,0,0,36,0,36,1,0,1,139,78,19,59,0,0,0,36,0,36,1,0,1
12/25/2020,Southeast,5,CAH,1,70,70,34,36,8,4,4,33,0,33,0,0,0,70,70,34,36,8,4,4,33,0,33,0,0,0
12/25/2020,Southeast,5,GACH,1,161,133,19,114,9,2,7,20,0,20,1,0,1,161,133,19,114,9,2,7,20,0,20,1,0,1
12/25/2020,Southwest,1,CAH,1,22,12,0,12,0,0,0,2,0,2,0,0,0,22,12,0,12,0,0,0,2,0,2,0,0,0
12/25/2020,Southwest,1,GACH,1,53,45,13,32,0,0,0,4,0,4,2,0,2,53,45,13,32,0,0,0,4,0,4,2,0,2
12/26/2020,Anchorage,7,GACH,1,697,671,441,230,126,89,37,179,36,143,40,2,42,697,671,441,230,126,89,37,179,36,143,40,2,42
12/26/2020,Anchorage,7,LTACH,0,31,30,27,3,3,3,0,23,2,21,0,0,0,31,30,27,3,3,3,0,23,2,21,0,0,0
12/26/2020,Anchorage,7,Psych,0,60,53,53,0,0,0,0,0,0,0,0,0,0,200,193,100,93,0,0,0,0,0,0,2,0,2
12/26/2020,Gulf Coast,4,CAH,1,99,90,23,67,4,1,3,18,0,18,4,0,4,99,90,23,67,4,1,3,18,0,18,4,0,4
12/26/2020,Gulf Coast,4,GACH,1,115,61,27,34,9,3,6,10,0,10,6,0,6,115,61,27,34,9,3,6,10,0,10,6,0,6
12/26/2020,Interior,6,GACH,1,101,81,33,48,20,6,14,16,1,15,3,0,3,101,81,33,48,20,6,14,16,1,15,3,0,3
12/26/2020,Matanuska-Susitna,3,GACH,1,184,160,70,90,14,9,5,30,5,25,8,0,8,184,160,70,90,14,9,5,30,5,25,8,0,8
12/26/2020,Northern,2,CAH,1,139,78,16,62,0,0,0,36,0,36,1,0,1,139,78,16,62,0,0,0,36,0,36,1,0,1
12/26/2020,Southeast,5,CAH,1,70,70,31,39,8,4,4,33,0,33,0,0,0,70,70,31,39,8,4,4,33,0,33,0,0,0
12/26/2020,Southeast,5,GACH,1,161,133,18,115,9,2,7,20,0,20,1,0,1,161,133,18,115,9,2,7,20,0,20,1,0,1
12/26/2020,Southwest,1,CAH,1,22,12,0,12,0,0,0,2,0,2,0,0,0,22,12,0,12,0,0,0,2,0,2,0,0,0
12/26/2020,Southwest,1,GACH,1,53,45,14,31,0,0,0,4,0,4,3,0,3,53,45,14,31,0,0,0,4,0,4,3,0,3
12/27/2020,Anchorage,7,GACH,1,695,669,462,207,124,90,34,179,33,146,46,2,48,695,669,462,207,124,90,34,179,33,146,46,2,48
12/27/2020,Anchorage,7,LTACH,0,31,30,27,3,3,3,0,23,2,21,0,0,0,31,30,27,3,3,3,0,23,2,21,0,0,0
12/27/2020,Anchorage,7,Psych,0,60,54,54,0,0,0,0,0,0,0,0,0,0,200,194,101,93,0,0,0,0,0,0,2,0,2
12/27/2020,Gulf Coast,4,CAH,1,99,90,23,67,4,2,2,18,0,18,3,0,3,99,90,23,67,4,2,2,18,0,18,3,0,3
12/27/2020,Gulf Coast,4,GACH,1,115,61,35,26,9,4,5,10,0,10,6,0,6,115,61,35,26,9,4,5,10,0,10,6,0,6
12/27/2020,Interior,6,GACH,1,101,81,36,45,20,5,15,16,2,14,7,0,7,101,81,36,45,20,5,15,16,2,14,7,0,7
12/27/2020,Matanuska-Susitna,3,GACH,1,184,160,68,92,14,12,2,30,4,26,5,0,5,184,160,68,92,14,12,2,30,4,26,5,0,5
12/27/2020,Northern,2,CAH,1,139,78,19,59,0,0,0,36,0,36,1,0,1,139,78,19,59,0,0,0,36,0,36,1,0,1
12/27/2020,Southeast,5,CAH,1,70,70,32,38,8,4,4,33,0,33,0,0,0,70,70,32,38,8,4,4,33,0,33,0,0,0
12/27/2020,Southeast,5,GACH,1,161,133,20,113,9,4,5,20,0,20,1,0,1,161,133,20,113,9,4,5,20,0,20,1,0,1
12/27/2020,Southwest,1,CAH,1,22,12,0,12,0,0,0,2,0,2,0,0,0,22,12,0,12,0,0,0,2,0,2,0,0,0
12/27/2020,Southwest,1,GACH,1,53,45,11,34,0,0,0,4,0,4,3,0,3,53,45,11,34,0,0,0,4,0,4,3,0,3
12/28/2020,Anchorage,7,GACH,1,693,669,449,220,124,90,34,179,31,148,46,1,47,693,669,449,220,124,90,34,179,31,148,46,1,47
12/28/2020,Anchorage,7,LTACH,0,31,30,28,2,3,3,0,23,3,20,0,0,0,31,30,28,2,3,3,0,23,3,20,0,0,0
12/28/2020,Anchorage,7,Psych,0,60,55,55,0,0,0,0,0,0,0,0,0,0,200,195,102,93,0,0,0,0,0,0,2,0,2
12/28/2020,Gulf Coast,4,CAH,1,99,90,25,65,4,1,3,18,0,18,3,0,3,99,90,25,65,4,1,3,18,0,18,3,0,3
12/28/2020,Gulf Coast,4,GACH,1,115,61,36,25,9,3,6,10,0,10,7,0,7,115,61,36,25,9,3,6,10,0,10,7,0,7
12/28/2020,Interior,6,GACH,1,101,81,40,41,20,9,11,16,2,14,7,0,7,101,81,40,41,20,9,11,16,2,14,7,0,7
12/28/2020,Matanuska-Susitna,3,GACH,1,184,160,70,90,14,11,3,30,5,25,2,0,2,184,160,70,90,14,11,3,30,5,25,2,0,2
12/28/2020,Northern,2,CAH,1,139,78,19,59,0,0,0,36,0,36,2,0,2,139,78,19,59,0,0,0,36,0,36,2,0,2
12/28/2020,Southeast,5,CAH,1,70,70,25,45,8,3,5,33,0,33,0,0,0,70,70,25,45,8,3,5,33,0,33,0,0,0
12/28/2020,Southeast,5,GACH,1,161,133,24,109,9,4,5,20,0,20,1,0,1,161,133,24,109,9,4,5,20,0,20,1,0,1
12/28/2020,Southwest,1,CAH,1,22,12,1,11,0,0,0,2,0,2,0,0,0,22,12,1,11,0,0,0,2,0,2,0,0,0
12/28/2020,Southwest,1,GACH,1,53,45,14,31,0,0,0,4,0,4,4,0,4,53,45,14,31,0,0,0,4,0,4,4,0,4
12/29/2020,Anchorage,7,GACH,1,707,683,476,207,125,98,27,179,29,150,50,0,50,707,683,476,207,125,98,27,179,29,150,50,0,50
12/29/2020,Anchorage,7,LTACH,0,31,30,28,2,3,3,0,23,3,20,0,0,0,31,30,28,2,3,3,0,23,3,20,0,0,0
12/29/2020,Anchorage,7,Psych,0,60,55,55,0,0,0,0,0,0,0,0,0,0,200,195,102,93,0,0,0,0,0,0,2,0,2
12/29/2020,Gulf Coast,4,CAH,1,100,91,26,65,4,2,2,18,0,18,3,0,3,100,91,26,65,4,2,2,18,0,18,3,0,3
12/29/2020,Gulf Coast,4,GACH,1,115,61,43,18,9,3,6,10,0,10,6,0,6,115,61,43,18,9,3,6,10,0,10,6,0,6
12/29/2020,Interior,6,GACH,1,101,81,37,44,20,10,10,16,2,14,4,0,4,101,81,37,44,20,10,10,16,2,14,4,0,4
12/29/2020,Matanuska-Susitna,3,GACH,1,184,160,69,91,14,11,3,33,4,29,4,0,4,184,160,69,91,14,11,3,33,4,29,4,0,4
12/29/2020,Northern,2,CAH,1,139,78,19,59,0,0,0,36,0,36,3,0,3,139,78,19,59,0,0,0,36,0,36,3,0,3
12/29/2020,Southeast,5,CAH,1,70,70,25,45,8,5,3,33,0,33,0,0,0,70,70,25,45,8,5,3,33,0,33,0,0,0
12/29/2020,Southeast,5,GACH,1,161,133,39,94,9,5,4,20,0,20,1,0,1,161,133,39,94,9,5,4,20,0,20,1,0,1
12/29/2020,Southwest,1,CAH,1,22,12,0,12,0,0,0,2,0,2,0,0,0,22,12,0,12,0,0,0,2,0,2,0,0,0
12/29/2020,Southwest,1,GACH,1,53,45,14,31,0,0,0,4,0,4,3,0,3,53,45,14,31,0,0,0,4,0,4,3,0,3
12/30/2020,Anchorage,7,GACH,1,717,683,517,166,126,100,26,179,32,147,46,0,46,717,683,517,166,126,100,26,179,32,147,46,0,46
12/30/2020,Anchorage,7,LTACH,0,31,30,28,2,3,3,0,23,3,20,0,0,0,31,30,28,2,3,3,0,23,3,20,0,0,0
12/30/2020,Anchorage,7,Psych,0,200,196,105,91,0,0,0,0,0,0,8,0,8,200,196,105,91,0,0,0,0,0,0,8,0,8
12/30/2020,Gulf Coast,4,CAH,1,99,90,21,69,4,2,2,18,0,18,3,0,3,99,90,21,69,4,2,2,18,0,18,3,0,3
12/30/2020,Gulf Coast,4,GACH,1,115,61,42,19,9,7,2,10,1,9,6,0,6,115,61,42,19,9,7,2,10,1,9,6,0,6
12/30/2020,Interior,6,GACH,1,101,81,36,45,20,8,12,16,2,14,3,0,3,101,81,36,45,20,8,12,16,2,14,3,0,3
12/30/2020,Matanuska-Susitna,3,GACH,1,184,160,64,96,14,4,10,33,3,30,3,0,3,184,160,64,96,14,4,10,33,3,30,3,0,3
12/30/2020,Northern,2,CAH,1,139,78,19,59,0,0,0,36,0,36,2,0,2,139,78,19,59,0,0,0,36,0,36,2,0,2
12/30/2020,Southeast,5,CAH,1,70,70,27,43,8,4,4,33,0,33,0,0,0,70,70,27,43,8,4,4,33,0,33,0,0,0
12/30/2020,Southeast,5,GACH,1,161,133,35,98,9,5,4,20,0,20,1,0,1,161,133,35,98,9,5,4,20,0,20,1,0,1
12/30/2020,Southwest,1,CAH,1,22,12,1,11,0,0,0,2,0,2,0,0,0,22,12,1,11,0,0,0,2,0,2,0,0,0
12/30/2020,Southwest,1,GACH,1,53,45,14,31,0,0,0,4,0,4,3,0,3,53,45,14,31,0,0,0,4,0,4,3,0,3
12/31/2020,Anchorage,7,GACH,1,712,684,466,218,126,99,27,179,29,150,40,0,40,712,684,466,218,126,99,27,179,29,150,40,0,40
12/31/2020,Anchorage,7,LTACH,0,31,30,30,0,3,3,0,23,3,20,0,0,0,31,30,30,0,3,3,0,23,3,20,0,0,0
12/31/2020,Anchorage,7,Psych,0,,,,,,,,,,,,,,200,196,105,91,0,0,0,0,0,0,8,0,8
12/31/2020,Gulf Coast,4,CAH,1,102,92,26,66,4,3,1,18,0,18,3,0,3,102,92,26,66,4,3,1,18,0,18,3,0,3
12/31/2020,Gulf Coast,4,GACH,1,115,61,33,28,9,7,2,10,1,9,7,0,7,115,61,33,28,9,7,2,10,1,9,7,0,7
12/31/2020,Interior,6,GACH,1,101,81,47,34,20,10,10,16,1,15,5,0,5,101,81,47,34,20,10,10,16,1,15,5,0,5
12/31/2020,Matanuska-Susitna,3,GACH,1,184,160,52,108,14,3,11,33,2,31,5,0,5,184,160,52,108,14,3,11,33,2,31,5,0,5
12/31/2020,Northern,2,CAH,1,139,78,22,56,0,0,0,36,0,36,2,0,2,139,78,22,56,0,0,0,36,0,36,2,0,2
12/31/2020,Southeast,5,CAH,1,70,70,33,37,8,3,5,33,2,31,0,0,0,70,70,33,37,8,3,5,33,2,31,0,0,0
12/31/2020,Southeast,5,GACH,1,161,133,35,98,9,6,3,20,0,20,1,0,1,161,133,35,98,9,6,3,20,0,20,1,0,1
12/31/2020,Southwest,1,CAH,1,22,12,2,10,0,0,0,2,0,2,0,0,0,22,12,2,10,0,0,0,2,0,2,0,0,0
12/31/2020,Southwest,1,GACH,1,53,45,17,28,0,0,0,4,0,4,4,0,4,53,45,17,28,0,0,0,4,0,4,4,0,4
01/01/2021,Anchorage,7,GACH,1,712,685,457,228,127,103,24,179,31,148,38,0,38,712,685,457,228,127,103,24,179,31,148,38,0,38
01/01/2021,Anchorage,7,LTACH,0,31,30,28,2,3,3,0,23,3,20,0,0,0,31,30,28,2,3,3,0,23,3,20,0,0,0
01/01/2021,Anchorage,7,Psych,0,,,,,,,,,,,,,,200,196,105,91,0,0,0,0,0,0,8,0,8
01/01/2021,Gulf Coast,4,CAH,1,103,92,24,68,4,0,4,18,0,18,4,0,4,103,92,24,68,4,0,4,18,0,18,4,0,4
01/01/2021,Gulf Coast,4,GACH,1,115,61,36,25,9,7,2,10,0,10,4,0,4,115,61,36,25,9,7,2,10,0,10,4,0,4
01/01/2021,Interior,6,GACH,1,101,81,40,41,20,9,11,16,1,15,4,0,4,101,81,40,41,20,9,11,16,1,15,4,0,4
01/01/2021,Matanuska-Susitna,3,GACH,1,184,160,52,108,14,5,9,33,0,33,5,0,5,184,160,52,108,14,5,9,33,0,33,5,0,5
01/01/2021,Northern,2,CAH,1,139,78,21,57,0,0,0,36,0,36,3,0,3,139,78,21,57,0,0,0,36,0,36,3,0,3
01/01/2021,Southeast,5,CAH,1,70,70,31,39,8,3,5,33,0,33,0,0,0,70,70,31,39,8,3,5,33,0,33,0,0,0
01/01/2021,Southeast,5,GACH,1,161,133,29,104,9,2,7,20,0,20,1,0,1,161,133,29,104,9,2,7,20,0,20,1,0,1
01/01/2021,Southwest,1,CAH,1,22,12,1,11,0,0,0,2,0,2,0,0,0,22,12,1,11,0,0,0,2,0,2,0,0,0
01/01/2021,Southwest,1,GACH,1,53,45,22,23,0,0,0,4,0,4,3,0,3,53,45,22,23,0,0,0,4,0,4,3,0,3
01/02/2021,Anchorage,7,GACH,1,710,684,469,215,127,104,23,179,33,146,38,1,39,710,684,469,215,127,104,23,179,33,146,38,1,39
01/02/2021,Anchorage,7,LTACH,0,31,30,28,2,3,3,0,23,3,20,0,0,0,31,30,28,2,3,3,0,23,3,20,0,0,0
01/02/2021,Anchorage,7,Psych,0,,,,,,,,,,,,,,200,196,105,91,0,0,0,0,0,0,8,0,8
01/02/2021,Gulf Coast,4,CAH,1,103,91,30,61,4,0,4,18,0,18,3,0,3,103,91,30,61,4,0,4,18,0,18,3,0,3
01/02/2021,Gulf Coast,4,GACH,1,115,61,33,28,9,5,4,10,1,9,3,0,3,115,61,33,28,9,5,4,10,1,9,3,0,3
01/02/2021,Interior,6,GACH,1,101,81,39,42,20,10,10,16,1,15,7,0,7,101,81,39,42,20,10,10,16,1,15,7,0,7
01/02/2021,Matanuska-Susitna,3,GACH,1,184,160,53,107,14,4,10,33,0,33,6,0,6,184,160,53,107,14,4,10,33,0,33,6,0,6
01/02/2021,Northern,2,CAH,1,139,78,22,56,0,0,0,36,0,36,3,0,3,139,78,22,56,0,0,0,36,0,36,3,0,3
01/02/2021,Southeast,5,CAH,1,70,70,27,43,8,3,5,33,0,33,0,0,0,70,70,27,43,8,3,5,33,0,33,0,0,0
01/02/2021,Southeast,5,GACH,1,161,133,26,107,9,1,8,20,0,20,1,0,1,161,133,26,107,9,1,8,20,0,20,1,0,1
01/02/2021,Southwest,1,CAH,1,22,12,1,11,0,0,0,2,0,2,0,0,0,22,12,1,11,0,0,0,2,0,2,0,0,0
01/02/2021,Southwest,1,GACH,1,53,45,19,26,0,0,0,4,0,4,5,0,5,53,45,19,26,0,0,0,4,0,4,5,0,5
01/03/2021,Anchorage,7,GACH,1,714,686,491,195,127,105,22,179,33,146,46,1,47,714,686,491,195,127,105,22,179,33,146,46,1,47
01/03/2021,Anchorage,7,LTACH,0,31,30,28,2,3,3,0,23,1,22,0,0,0,31,30,28,2,3,3,0,23,1,22,0,0,0
01/03/2021,Anchorage,7,Psych,0,,,,,,,,,,,,,,200,196,105,91,0,0,0,0,0,0,8,0,8
01/03/2021,Gulf Coast,4,CAH,1,103,91,25,66,4,0,4,18,0,18,1,0,1,103,91,25,66,4,0,4,18,0,18,1,0,1
01/03/2021,Gulf Coast,4,GACH,1,115,61,36,25,9,5,4,10,1,9,5,0,5,115,61,36,25,9,5,4,10,1,9,5,0,5
01/03/2021,Interior,6,GACH,1,101,81,38,43,20,9,11,16,1,15,5,0,5,101,81,38,43,20,9,11,16,1,15,5,0,5
01/03/2021,Matanuska-Susitna,3,GACH,1,184,160,53,107,14,5,9,33,0,33,8,0,8,184,160,53,107,14,5,9,33,0,33,8,0,8
01/03/2021,Northern,2,CAH,1,139,78,21,57,0,0,0,36,0,36,3,0,3,139,78,21,57,0,0,0,36,0,36,3,0,3
01/03/2021,Southeast,5,CAH,1,70,70,27,43,8,3,5,33,0,33,0,0,0,70,70,27,43,8,3,5,33,0,33,0,0,0
01/03/2021,Southeast,5,GACH,1,161,133,27,106,9,4,5,20,0,20,1,0,1,161,133,27,106,9,4,5,20,0,20,1,0,1
01/03/2021,Southwest,1,CAH,1,22,12,1,11,0,0,0,2,0,2,0,0,0,22,12,1,11,0,0,0,2,0,2,0,0,0
01/03/2021,Southwest,1,GACH,1,53,45,23,22,0,0,0,4,0,4,8,0,8,53,45,23,22,0,0,0,4,0,4,8,0,8
01/04/2021,Anchorage,7,GACH,1,714,687,497,190,128,106,22,179,33,146,44,1,45,714,687,497,190,128,106,22,179,33,146,44,1,45
01/04/2021,Anchorage,7,LTACH,0,31,30,28,2,3,3,0,23,1,22,0,0,0,31,30,28,2,3,3,0,23,1,22,0,0,0
01/04/2021,Anchorage,7,Psych,0,,,,,,,,,,,,,,200,196,105,91,0,0,0,0,0,0,8,0,8
01/04/2021,Gulf Coast,4,CAH,1,100,90,25,65,4,1,3,18,0,18,1,0,1,100,90,25,65,4,1,3,18,0,18,1,0,1
01/04/2021,Gulf Coast,4,GACH,1,115,61,36,25,9,5,4,10,0,10,4,0,4,115,61,36,25,9,5,4,10,0,10,4,0,4
01/04/2021,Interior,6,GACH,1,101,81,44,37,20,13,7,16,1,15,8,0,8,101,81,44,37,20,13,7,16,1,15,8,0,8
01/04/2021,Matanuska-Susitna,3,GACH,1,184,160,55,105,14,3,11,33,0,33,5,0,5,184,160,55,105,14,3,11,33,0,33,5,0,5
01/04/2021,Northern,2,CAH,1,139,78,25,53,0,0,0,36,0,36,4,0,4,139,78,25,53,0,0,0,36,0,36,4,0,4
01/04/2021,Southeast,5,CAH,1,70,70,30,40,8,3,5,33,0,33,1,0,1,70,70,30,40,8,3,5,33,0,33,1,0,1
01/04/2021,Southeast,5,GACH,1,161,133,30,103,9,4,5,20,0,20,2,0,2,161,133,30,103,9,4,5,20,0,20,2,0,2
01/04/2021,Southwest,1,CAH,1,22,12,2,10,0,0,0,2,0,2,0,0,0,22,12,2,10,0,0,0,2,0,2,0,0,0
01/04/2021,Southwest,1,GACH,1,53,45,19,26,0,0,0,4,0,4,7,0,7,53,45,19,26,0,0,0,4,0,4,7,0,7
01/05/2021,Anchorage,7,GACH,1,726,692,500,192,127,109,18,179,33,146,51,1,52,726,692,500,192,127,109,18,179,33,146,51,1,52
01/05/2021,Anchorage,7,LTACH,0,31,30,27,3,3,3,0,23,1,22,0,0,0,31,30,27,3,3,3,0,23,1,22,0,0,0
01/05/2021,Anchorage,7,Psych,0,,,,,,,,,,,,,,200,196,105,91,0,0,0,0,0,0,8,0,8
01/05/2021,Gulf Coast,4,CAH,1,91,82,29,53,2,0,2,18,0,18,1,0,1,91,82,29,53,2,0,2,18,0,18,1,0,1
01/05/2021,Gulf Coast,4,GACH,1,115,61,41,20,9,6,3,10,1,9,6,0,6,115,61,41,20,9,6,3,10,1,9,6,0,6
01/05/2021,Interior,6,GACH,1,101,81,51,30,20,13,7,16,1,15,8,0,8,101,81,51,30,20,13,7,16,1,15,8,0,8
01/05/2021,Matanuska-Susitna,3,GACH,1,184,160,54,106,14,2,12,33,0,33,3,0,3,184,160,54,106,14,2,12,33,0,33,3,0,3
01/05/2021,Northern,2,CAH,1,139,78,25,53,0,0,0,36,0,36,5,0,5,139,78,25,53,0,0,0,36,0,36,5,0,5
01/05/2021,Southeast,5,CAH,1,70,70,35,35,8,3,5,33,0,33,2,0,2,70,70,35,35,8,3,5,33,0,33,2,0,2
01/05/2021,Southeast,5,GACH,1,161,133,29,104,9,2,7,20,0,20,2,0,2,161,133,29,104,9,2,7,20,0,20,2,0,2
01/05/2021,Southwest,1,CAH,1,22,12,2,10,0,0,0,2,0,2,0,0,0,22,12,2,10,0,0,0,2,0,2,0,0,0
01/05/2021,Southwest,1,GACH,1,53,45,24,21,0,0,0,4,0,4,7,0,7,53,45,24,21,0,0,0,4,0,4,7,0,7
01/06/2021,Anchorage,7,GACH,1,727,693,495,198,127,102,25,179,28,151,51,1,52,727,693,495,198,127,102,25,179,28,151,51,1,52
01/06/2021,Anchorage,7,LTACH,0,31,30,29,1,3,3,0,23,2,21,0,0,0,31,30,29,1,3,3,0,23,2,21,0,0,0
01/06/2021,Anchorage,7,Psych,0,200,194,107,87,0,0,0,0,0,0,2,0,2,200,194,107,87,0,0,0,0,0,0,2,0,2
01/06/2021,Gulf Coast,4,CAH,1,99,90,29,61,4,0,4,18,0,18,2,0,2,99,90,29,61,4,0,4,18,0,18,2,0,2
01/06/2021,Gulf Coast,4,GACH,1,115,61,40,21,9,4,5,10,1,9,4,0,4,115,61,40,21,9,4,5,10,1,9,4,0,4
01/06/2021,Interior,6,GACH,1,101,81,52,29,20,14,6,16,2,14,10,0,10,101,81,52,29,20,14,6,16,2,14,10,0,10
01/06/2021,Matanuska-Susitna,3,GACH,1,184,160,44,116,14,2,12,33,1,32,3,0,3,184,160,44,116,14,2,12,33,1,32,3,0,3
01/06/2021,Northern,2,CAH,1,139,78,24,54,0,0,0,36,0,36,5,0,5,139,78,24,54,0,0,0,36,0,36,5,0,5
01/06/2021,Southeast,5,CAH,1,70,70,35,35,8,3,5,33,0,33,2,0,2,70,70,35,35,8,3,5,33,0,33,2,0,2
01/06/2021,Southeast,5,GACH,1,161,133,37,96,9,5,4,20,0,20,2,0,2,161,133,37,96,9,5,4,20,0,20,2,0,2
01/06/2021,Southwest,1,CAH,1,22,12,0,12,0,0,0,2,0,2,0,0,0,22,12,0,12,0,0,0,2,0,2,0,0,0
01/06/2021,Southwest,1,GACH,1,53,45,17,28,0,0,0,4,0,4,3,0,3,53,45,17,28,0,0,0,4,0,4,3,0,3
01/07/2021,Anchorage,7,GACH,1,694,663,490,173,117,95,22,179,26,153,47,1,48,694,663,490,173,117,95,22,179,26,153,47,1,48
01/07/2021,Anchorage,7,LTACH,0,31,30,27,3,3,3,0,23,2,21,0,0,0,31,30,27,3,3,3,0,23,2,21,0,0,0
01/07/2021,Anchorage,7,Psych,0,,,,,,,,,,,,,,200,194,107,87,0,0,0,0,0,0,2,0,2
01/07/2021,Gulf Coast,4,CAH,1,107,98,28,70,4,0,4,18,0,18,2,0,2,107,98,28,70,4,0,4,18,0,18,2,0,2
01/07/2021,Gulf Coast,4,GACH,1,115,61,38,23,9,5,4,10,1,9,4,0,4,115,61,38,23,9,5,4,10,1,9,4,0,4
01/07/2021,Interior,6,GACH,1,101,81,63,18,20,15,5,16,2,14,11,0,11,101,81,63,18,20,15,5,16,2,14,11,0,11
01/07/2021,Matanuska-Susitna,3,GACH,1,184,160,69,91,14,4,10,33,1,32,2,0,2,184,160,69,91,14,4,10,33,1,32,2,0,2
01/07/2021,Northern,2,CAH,1,139,78,25,53,0,0,0,36,0,36,5,0,5,139,78,25,53,0,0,0,36,0,36,5,0,5
01/07/2021,Southeast,5,CAH,1,70,70,36,34,8,3,5,33,0,33,2,0,2,70,70,36,34,8,3,5,33,0,33,2,0,2
01/07/2021,Southeast,5,GACH,1,161,133,34,99,9,6,3,20,0,20,2,0,2,161,133,34,99,9,6,3,20,0,20,2,0,2
01/07/2021,Southwest,1,CAH,1,22,12,0,12,0,0,0,2,0,2,0,0,0,22,12,0,12,0,0,0,2,0,2,0,0,0
01/07/2021,Southwest,1,GACH,1,53,45,13,32,0,0,0,4,0,4,2,0,2,53,45,13,32,0,0,0,4,0,4,2,0,2
01/08/2021,Anchorage,7,GACH,1,693,663,498,165,119,93,26,179,24,155,44,1,45,693,663,498,165,119,93,26,179,24,155,44,1,45
01/08/2021,Anchorage,7,LTACH,0,31,30,28,2,3,3,0,23,2,21,0,0,0,31,30,28,2,3,3,0,23,2,21,0,0,0
01/08/2021,Anchorage,7,Psych,0,,,,,,,,,,,,,,200,194,107,87,0,0,0,0,0,0,2,0,2
01/08/2021,Gulf Coast,4,CAH,1,106,97,22,75,4,0,4,18,0,18,1,0,1,106,97,22,75,4,0,4,18,0,18,1,0,1
01/08/2021,Gulf Coast,4,GACH,1,115,61,39,22,9,3,6,10,1,9,4,0,4,115,61,39,22,9,3,6,10,1,9,4,0,4
01/08/2021,Interior,6,GACH,1,101,81,48,33,20,15,5,16,2,14,10,0,10,101,81,48,33,20,15,5,16,2,14,10,0,10
01/08/2021,Matanuska-Susitna,3,GACH,1,184,160,61,99,14,7,7,33,2,31,3,0,3,184,160,61,99,14,7,7,33,2,31,3,0,3
01/08/2021,Northern,2,CAH,1,139,78,26,52,0,0,0,36,0,36,6,0,6,139,78,26,52,0,0,0,36,0,36,6,0,6
01/08/2021,Southeast,5,CAH,1,45,45,18,27,2,1,1,16,0,16,0,0,0,70,70,35,35,8,4,4,33,0,33,2,0,2
01/08/2021,Southeast,5,GACH,1,161,133,33,100,9,1,8,20,0,20,2,0,2,161,133,33,100,9,1,8,20,0,20,2,0,2
01/08/2021,Southwest,1,CAH,1,22,12,1,11,0,0,0,2,0,2,0,0,0,22,12,1,11,0,0,0,2,0,2,0,0,0
01/08/2021,Southwest,1,GACH,1,53,45,15,30,0,0,0,4,0,4,2,0,2,53,45,15,30,0,0,0,4,0,4,2,0,2
01/09/2021,Anchorage,7,GACH,1,693,663,479,184,119,91,28,179,27,152,41,1,42,693,663,479,184,119,91,28,179,27,152,41,1,42
01/09/2021,Anchorage,7,LTACH,0,31,30,28,2,3,3,0,23,2,21,0,0,0,31,30,28,2,3,3,0,23,2,21,0,0,0
01/09/2021,Anchorage,7,Psych,0,,,,,,,,,,,,,,200,194,107,87,0,0,0,0,0,0,2,0,2
01/09/2021,Gulf Coast,4,CAH,1,106,97,22,75,4,0,4,18,0,18,1,0,1,106,97,22,75,4,0,4,18,0,18,1,0,1
01/09/2021,Gulf Coast,4,GACH,1,115,61,41,20,9,4,5,10,1,9,5,0,5,115,61,41,20,9,4,5,10,1,9,5,0,5
01/09/2021,Interior,6,GACH,1,101,81,52,29,20,17,3,16,2,14,8,1,9,101,81,52,29,20,17,3,16,2,14,8,1,9
01/09/2021,Matanuska-Susitna,3,GACH,1,184,160,74,86,14,10,4,33,1,32,2,0,2,184,160,74,86,14,10,4,33,1,32,2,0,2
01/09/2021,Northern,2,CAH,1,139,78,20,58,0,0,0,36,0,36,6,0,6,139,78,20,58,0,0,0,36,0,36,6,0,6
01/09/2021,Southeast,5,CAH,1,70,70,37,33,8,5,3,33,0,33,2,0,2,70,70,37,33,8,5,3,33,0,33,2,0,2
01/09/2021,Southeast,5,GACH,1,161,133,30,103,9,2,7,20,1,19,2,0,2,161,133,30,103,9,2,7,20,1,19,2,0,2
01/09/2021,Southwest,1,CAH,1,22,12,1,11,0,0,0,2,0,2,0,0,0,22,12,1,11,0,0,0,2,0,2,0,0,0
01/09/2021,Southwest,1,GACH,1,53,45,18,27,0,0,0,4,0,4,2,0,2,53,45,18,27,0,0,0,4,0,4,2,0,2
01/10/2021,Anchorage,7,GACH,1,692,661,469,192,117,93,24,179,27,152,36,1,37,692,661,469,192,117,93,24,179,27,152,36,1,37
01/10/2021,Anchorage,7,LTACH,0,31,30,27,3,3,3,0,23,2,21,0,0,0,31,30,27,3,3,3,0,23,2,21,0,0,0
01/10/2021,Anchorage,7,Psych,0,,,,,,,,,,,,,,200,194,107,87,0,0,0,0,0,0,2,0,2
01/10/2021,Gulf Coast,4,CAH,1,108,99,24,75,4,0,4,18,0,18,1,0,1,108,99,24,75,4,0,4,18,0,18,1,0,1
01/10/2021,Gulf Coast,4,GACH,1,115,61,40,21,9,5,4,10,0,10,6,0,6,115,61,40,21,9,5,4,10,0,10,6,0,6
01/10/2021,Interior,6,GACH,1,101,81,43,38,20,11,9,16,2,14,7,0,7,101,81,43,38,20,11,9,16,2,14,7,0,7
01/10/2021,Matanuska-Susitna,3,GACH,1,184,160,63,97,14,3,11,33,1,32,3,0,3,184,160,63,97,14,3,11,33,1,32,3,0,3
01/10/2021,Northern,2,CAH,1,139,78,21,57,0,0,0,36,0,36,6,0,6,139,78,21,57,0,0,0,36,0,36,6,0,6
01/10/2021,Southeast,5,CAH,1,70,70,36,34,8,4,4,33,0,33,2,0,2,70,70,36,34,8,4,4,33,0,33,2,0,2
01/10/2021,Southeast,5,GACH,1,161,133,30,103,9,5,4,20,1,19,1,0,1,161,133,30,103,9,5,4,20,1,19,1,0,1
01/10/2021,Southwest,1,CAH,1,22,12,1,11,0,0,0,2,0,2,0,0,0,22,12,1,11,0,0,0,2,0,2,0,0,0
01/10/2021,Southwest,1,GACH,1,53,45,17,28,0,0,0,4,0,4,0,0,0,53,45,17,28,0,0,0,4,0,4,0,0,0
01/11/2021,Anchorage,7,GACH,1,703,670,469,201,121,96,25,179,26,153,35,0,35,703,670,469,201,121,96,25,179,26,153,35,0,35
01/11/2021,Anchorage,7,LTACH,0,31,30,27,3,3,3,0,23,1,22,0,0,0,31,30,27,3,3,3,0,23,1,22,0,0,0
01/11/2021,Anchorage,7,Psych,0,,,,,,,,,,,,,,200,194,107,87,0,0,0,0,0,0,2,0,2
01/11/2021,Gulf Coast,4,CAH,1,110,100,25,75,4,0,4,18,0,18,1,0,1,110,100,25,75,4,0,4,18,0,18,1,0,1
01/11/2021,Gulf Coast,4,GACH,1,115,61,35,26,9,4,5,10,0,10,6,0,6,115,61,35,26,9,4,5,10,0,10,6,0,6
01/11/2021,Interior,6,GACH,1,101,81,48,33,20,12,8,16,2,14,10,0,10,101,81,48,33,20,12,8,16,2,14,10,0,10
01/11/2021,Matanuska-Susitna,3,GACH,1,184,160,59,101,14,2,12,33,1,32,4,0,4,184,160,59,101,14,2,12,33,1,32,4,0,4
01/11/2021,Northern,2,CAH,1,139,78,24,54,0,0,0,36,0,36,5,0,5,139,78,24,54,0,0,0,36,0,36,5,0,5
01/11/2021,Southeast,5,CAH,1,70,70,39,31,8,4,4,33,0,33,1,0,1,70,70,39,31,8,4,4,33,0,33,1,0,1
01/11/2021,Southeast,5,GACH,1,161,133,29,104,9,7,2,20,1,19,1,0,1,161,133,29,104,9,7,2,20,1,19,1,0,1
01/11/2021,Southwest,1,CAH,1,22,12,1,11,0,0,0,2,0,2,0,0,0,22,12,1,11,0,0,0,2,0,2,0,0,0
01/11/2021,Southwest,1,GACH,1,53,45,13,32,0,0,0,4,0,4,0,0,0,53,45,13,32,0,0,0,4,0,4,0,0,0
01/12/2021,Anchorage,7,GACH,1,696,662,502,160,120,102,18,179,27,152,36,0,36,696,662,502,160,120,102,18,179,27,152,36,0,36
01/12/2021,Anchorage,7,LTACH,0,31,30,27,3,3,3,0,23,1,22,0,0,0,31,30,27,3,3,3,0,23,1,22,0,0,0
01/12/2021,Anchorage,7,Psych,0,,,,,,,,,,,,,,200,194,107,87,0,0,0,0,0,0,2,0,2
01/12/2021,Gulf Coast,4,CAH,1,110,100,23,77,4,0,4,18,0,18,1,0,1,110,100,23,77,4,0,4,18,0,18,1,0,1
01/12/2021,Gulf Coast,4,GACH,1,115,61,34,27,9,2,7,10,0,10,3,0,3,115,61,34,27,9,2,7,10,0,10,3,0,3
01/12/2021,Interior,6,GACH,1,101,81,42,39,20,11,9,16,2,14,8,0,8,101,81,42,39,20,11,9,16,2,14,8,0,8
01/12/2021,Matanuska-Susitna,3,GACH,1,184,160,68,92,14,5,9,33,0,33,3,0,3,184,160,68,92,14,5,9,33,0,33,3,0,3
01/12/2021,Northern,2,CAH,1,139,78,24,54,0,0,0,36,0,36,5,0,5,139,78,24,54,0,0,0,36,0,36,5,0,5
01/12/2021,Southeast,5,CAH,1,70,70,35,35,8,3,5,33,0,33,1,0,1,70,70,35,35,8,3,5,33,0,33,1,0,1
01/12/2021,Southeast,5,GACH,1,161,133,31,102,9,6,3,20,1,19,1,0,1,161,133,31,102,9,6,3,20,1,19,1,0,1
01/12/2021,Southwest,1,CAH,1,22,12,0,12,0,0,0,2,0,2,0,0,0,22,12,0,12,0,0,0,2,0,2,0,0,0
01/12/2021,Southwest,1,GACH,1,53,45,16,29,0,0,0,4,0,4,2,0,2,53,45,16,29,0,0,0,4,0,4,2,0,2
01/13/2021,Anchorage,7,GACH,1,720,681,531,150,124,103,21,179,32,147,41,0,41,720,681,531,150,124,103,21,179,32,147,41,0,41
01/13/2021,Anchorage,7,LTACH,0,31,30,27,3,3,3,0,23,1,22,0,0,0,31,30,27,3,3,3,0,23,1,22,0,0,0
01/13/2021,Anchorage,7,Psych,0,260,258,115,143,0,0,0,0,0,0,6,0,6,260,258,115,143,0,0,0,0,0,0,6,0,6
01/13/2021,Gulf Coast,4,CAH,1,109,99,26,73,4,0,4,18,0,18,1,0,1,109,99,26,73,4,0,4,18,0,18,1,0,1
01/13/2021,Gulf Coast,4,GACH,1,115,61,42,19,9,3,6,10,0,10,4,0,4,115,61,42,19,9,3,6,10,0,10,4,0,4
01/13/2021,Interior,6,GACH,1,101,81,53,28,20,16,4,16,2,14,5,0,5,101,81,53,28,20,16,4,16,2,14,5,0,5
01/13/2021,Matanuska-Susitna,3,GACH,1,184,160,65,95,14,6,8,33,0,33,5,0,5,184,160,65,95,14,6,8,33,0,33,5,0,5
01/13/2021,Northern,2,CAH,1,139,78,21,57,0,0,0,36,0,36,2,0,2,139,78,21,57,0,0,0,36,0,36,2,0,2
01/13/2021,Southeast,5,CAH,1,70,70,37,33,8,2,6,33,0,33,1,0,1,70,70,37,33,8,2,6,33,0,33,1,0,1
01/13/2021,Southeast,5,GACH,1,161,133,33,100,9,4,5,20,1,19,2,0,2,161,133,33,100,9,4,5,20,1,19,2,0,2
01/13/2021,Southwest,1,CAH,1,22,12,0,12,0,0,0,2,0,2,0,0,0,22,12,0,12,0,0,0,2,0,2,0,0,0
01/13/2021,Southwest,1,GACH,1,53,45,12,33,0,0,0,4,0,4,2,0,2,53,45,12,33,0,0,0,4,0,4,2,0,2
01/14/2021,Anchorage,7,GACH,1,723,688,531,157,128,104,24,179,27,152,37,0,37,723,688,531,157,128,104,24,179,27,152,37,0,37
01/14/2021,Anchorage,7,LTACH,0,31,30,28,2,3,3,0,23,1,22,0,0,0,31,30,28,2,3,3,0,23,1,22,0,0,0
01/14/2021,Anchorage,7,Psych,0,,,,,,,,,,,,,,260,258,115,143,0,0,0,0,0,0,6,0,6
01/14/2021,Gulf Coast,4,CAH,1,107,97,30,67,4,0,4,18,0,18,2,0,2,107,97,30,67,4,0,4,18,0,18,2,0,2
01/14/2021,Gulf Coast,4,GACH,1,115,61,41,20,9,3,6,10,0,10,5,0,5,115,61,41,20,9,3,6,10,0,10,5,0,5
01/14/2021,Interior,6,GACH,1,101,81,53,28,20,12,8,16,1,15,5,0,5,101,81,53,28,20,12,8,16,1,15,5,0,5
01/14/2021,Matanuska-Susitna,3,GACH,1,184,160,69,91,14,7,7,33,0,33,5,0,5,184,160,69,91,14,7,7,33,0,33,5,0,5
01/14/2021,Northern,2,CAH,1,139,78,17,61,0,0,0,36,0,36,2,0,2,139,78,17,61,0,0,0,36,0,36,2,0,2
01/14/2021,Southeast,5,CAH,1,70,70,29,41,8,2,6,33,0,33,1,0,1,70,70,29,41,8,2,6,33,0,33,1,0,1
01/14/2021,Southeast,5,GACH,1,161,133,27,106,9,1,8,20,0,20,2,0,2,161,133,27,106,9,1,8,20,0,20,2,0,2
01/14/2021,Southwest,1,CAH,1,22,12,0,12,0,0,0,4,0,4,0,0,0,22,12,0,12,0,0,0,4,0,4,0,0,0
01/14/2021,Southwest,1,GACH,1,53,45,12,33,0,0,0,4,0,4,3,0,3,53,45,12,33,0,0,0,4,0,4,3,0,3
01/15/2021,Anchorage,7,GACH,1,707,678,500,178,125,95,30,179,25,154,31,0,31,707,678,500,178,125,95,30,179,25,154,31,0,31
01/15/2021,Anchorage,7,LTACH,0,31,30,30,0,3,3,0,23,2,21,0,0,0,31,30,30,0,3,3,0,23,2,21,0,0,0
01/15/2021,Anchorage,7,Psych,0,,,,,,,,,,,,,,260,258,115,143,0,0,0,0,0,0,6,0,6
01/15/2021,Gulf Coast,4,CAH,1,106,97,26,71,4,0,4,18,0,18,2,0,2,106,97,26,71,4,0,4,18,0,18,2,0,2
01/15/2021,Gulf Coast,4,GACH,1,115,61,35,26,9,4,5,10,0,10,4,0,4,115,61,35,26,9,4,5,10,0,10,4,0,4
01/15/2021,Interior,6,GACH,1,101,81,53,28,20,17,3,16,1,15,3,0,3,101,81,53,28,20,17,3,16,1,15,3,0,3
01/15/2021,Matanuska-Susitna,3,GACH,1,184,160,68,92,14,5,9,33,0,33,4,0,4,184,160,68,92,14,5,9,33,0,33,4,0,4
01/15/2021,Northern,2,CAH,1,139,78,22,56,0,0,0,36,0,36,3,0,3,139,78,22,56,0,0,0,36,0,36,3,0,3
01/15/2021,Southeast,5,CAH,1,70,70,29,41,8,1,7,33,0,33,1,0,1,70,70,29,41,8,1,7,33,0,33,1,0,1
01/15/2021,Southeast,5,GACH,1,161,133,30,103,9,4,5,20,0,20,2,0,2,161,133,30,103,9,4,5,20,0,20,2,0,2
01/15/2021,Southwest,1,CAH,1,22,12,1,11,0,0,0,4,0,4,0,0,0,22,12,1,11,0,0,0,4,0,4,0,0,0
01/15/2021,Southwest,1,GACH,1,53,45,14,31,0,0,0,4,0,4,4,0,4,53,45,14,31,0,0,0,4,0,4,4,0,4
01/16/2021,Anchorage,7,GACH,1,703,676,490,186,125,92,33,179,24,155,35,0,35,703,676,490,186,125,92,33,179,24,155,35,0,35
01/16/2021,Anchorage,7,LTACH,0,31,30,30,0,3,3,0,23,2,21,0,0,0,31,30,30,0,3,3,0,23,2,21,0,0,0
01/16/2021,Anchorage,7,Psych,0,,,,,,,,,,,,,,260,258,115,143,0,0,0,0,0,0,6,0,6
01/16/2021,Gulf Coast,4,CAH,1,106,97,24,73,4,1,3,18,0,18,0,0,0,106,97,24,73,4,1,3,18,0,18,0,0,0
01/16/2021,Gulf Coast,4,GACH,1,115,61,35,26,9,3,6,10,0,10,3,0,3,115,61,35,26,9,3,6,10,0,10,3,0,3
01/16/2021,Interior,6,GACH,1,101,81,48,33,20,9,11,16,1,15,4,0,4,101,81,48,33,20,9,11,16,1,15,4,0,4
01/16/2021,Matanuska-Susitna,3,GACH,1,184,160,59,101,14,6,8,33,0,33,4,0,4,184,160,59,101,14,6,8,33,0,33,4,0,4
01/16/2021,Northern,2,CAH,1,139,78,23,55,0,0,0,36,0,36,3,0,3,139,78,23,55,0,0,0,36,0,36,3,0,3
01/16/2021,Southeast,5,CAH,1,70,70,34,36,8,1,7,33,0,33,1,0,1,70,70,34,36,8,1,7,33,0,33,1,0,1
01/16/2021,Southeast,5,GACH,1,161,133,23,110,9,3,6,20,0,20,0,0,0,161,133,23,110,9,3,6,20,0,20,0,0,0
01/16/2021,Southwest,1,CAH,1,22,12,1,11,0,0,0,4,0,4,0,0,0,22,12,1,11,0,0,0,4,0,4,0,0,0
01/16/2021,Southwest,1,GACH,1,53,45,14,31,0,0,0,4,0,4,4,0,4,53,45,14,31,0,0,0,4,0,4,4,0,4
01/17/2021,Anchorage,7,GACH,1,701,675,480,195,125,91,34,179,27,152,29,0,29,701,675,480,195,125,91,34,179,27,152,29,0,29
01/17/2021,Anchorage,7,LTACH,0,31,30,25,5,3,3,0,23,2,21,0,0,0,31,30,25,5,3,3,0,23,2,21,0,0,0
01/17/2021,Anchorage,7,Psych,0,,,,,,,,,,,,,,260,258,115,143,0,0,0,0,0,0,6,0,6
01/17/2021,Gulf Coast,4,CAH,1,107,98,23,75,4,1,3,18,0,18,0,0,0,107,98,23,75,4,1,3,18,0,18,0,0,0
01/17/2021,Gulf Coast,4,GACH,1,115,61,33,28,9,5,4,10,1,9,3,0,3,115,61,33,28,9,5,4,10,1,9,3,0,3
01/17/2021,Interior,6,GACH,1,101,81,35,46,20,10,10,16,1,15,3,0,3,101,81,35,46,20,10,10,16,1,15,3,0,3
01/17/2021,Matanuska-Susitna,3,GACH,1,184,160,66,94,14,6,8,33,0,33,3,0,3,184,160,66,94,14,6,8,33,0,33,3,0,3
01/17/2021,Northern,2,CAH,1,139,78,23,55,0,0,0,36,0,36,3,0,3,139,78,23,55,0,0,0,36,0,36,3,0,3
01/17/2021,Southeast,5,CAH,1,70,70,34,36,8,1,7,33,0,33,1,0,1,70,70,34,36,8,1,7,33,0,33,1,0,1
01/17/2021,Southeast,5,GACH,1,161,133,22,111,9,3,6,20,0,20,1,0,1,161,133,22,111,9,3,6,20,0,20,1,0,1
01/17/2021,Southwest,1,CAH,1,22,12,1,11,0,0,0,4,0,4,0,0,0,22,12,1,11,0,0,0,4,0,4,0,0,0
01/17/2021,Southwest,1,GACH,1,53,45,10,35,0,0,0,4,0,4,3,0,3,53,45,10,35,0,0,0,4,0,4,3,0,3
01/18/2021,Anchorage,7,GACH,1,702,677,469,208,125,94,31,179,27,152,33,0,33,702,677,469,208,125,94,31,179,27,152,33,0,33
01/18/2021,Anchorage,7,LTACH,0,31,30,25,5,3,3,0,23,2,21,0,0,0,31,30,25,5,3,3,0,23,2,21,0,0,0
01/18/2021,Anchorage,7,Psych,0,,,,,,,,,,,,,,260,258,115,143,0,0,0,0,0,0,6,0,6
01/18/2021,Gulf Coast,4,CAH,1,109,99,21,78,4,1,3,18,0,18,0,0,0,109,99,21,78,4,1,3,18,0,18,0,0,0
01/18/2021,Gulf Coast,4,GACH,1,115,61,32,29,9,4,5,10,1,9,3,0,3,115,61,32,29,9,4,5,10,1,9,3,0,3
01/18/2021,Interior,6,GACH,1,101,81,28,53,20,15,5,16,2,14,4,0,4,101,81,28,53,20,15,5,16,2,14,4,0,4
01/18/2021,Matanuska-Susitna,3,GACH,1,184,160,55,105,14,6,8,33,0,33,3,0,3,184,160,55,105,14,6,8,33,0,33,3,0,3
01/18/2021,Northern,2,CAH,1,139,78,19,59,0,0,0,36,0,36,2,0,2,139,78,19,59,0,0,0,36,0,36,2,0,2
01/18/2021,Southeast,5,CAH,1,70,70,32,38,8,2,6,33,0,33,1,0,1,70,70,32,38,8,2,6,33,0,33,1,0,1
01/18/2021,Southeast,5,GACH,1,161,133,27,106,9,2,7,20,0,20,1,0,1,161,133,27,106,9,2,7,20,0,20,1,0,1
01/18/2021,Southwest,1,CAH,1,22,12,1,11,0,0,0,4,0,4,0,0,0,22,12,1,11,0,0,0,4,0,4,0,0,0
01/18/2021,Southwest,1,GACH,1,53,45,16,29,0,0,0,4,0,4,4,0,4,53,45,16,29,0,0,0,4,0,4,4,0,4
01/19/2021,Anchorage,7,GACH,1,718,691,502,189,128,100,28,179,28,151,31,0,31,718,691,502,189,128,100,28,179,28,151,31,0,31
01/19/2021,Anchorage,7,LTACH,0,31,30,26,4,3,3,0,23,2,21,0,0,0,31,30,26,4,3,3,0,23,2,21,0,0,0
01/19/2021,Anchorage,7,Psych,0,,,,,,,,,,,,,,260,258,115,143,0,0,0,0,0,0,6,0,6
01/19/2021,Gulf Coast,4,CAH,1,109,99,23,76,4,1,3,18,0,18,0,0,0,109,99,23,76,4,1,3,18,0,18,0,0,0
01/19/2021,Gulf Coast,4,GACH,1,115,61,33,28,9,4,5,10,0,10,2,0,2,115,61,33,28,9,4,5,10,0,10,2,0,2
01/19/2021,Interior,6,GACH,1,101,81,29,52,20,15,5,16,3,13,4,0,4,101,81,29,52,20,15,5,16,3,13,4,0,4
01/19/2021,Matanuska-Susitna,3,GACH,1,184,160,56,104,14,8,6,33,0,33,2,0,2,184,160,56,104,14,8,6,33,0,33,2,0,2
01/19/2021,Northern,2,CAH,1,139,78,22,56,0,0,0,36,0,36,2,0,2,139,78,22,56,0,0,0,36,0,36,2,0,2
01/19/2021,Southeast,5,CAH,1,70,70,33,37,8,1,7,33,0,33,2,0,2,70,70,33,37,8,1,7,33,0,33,2,0,2
01/19/2021,Southeast,5,GACH,1,161,133,31,102,9,2,7,20,0,20,1,0,1,161,133,31,102,9,2,7,20,0,20,1,0,1
01/19/2021,Southwest,1,CAH,1,22,12,1,11,0,0,0,4,0,4,0,0,0,22,12,1,11,0,0,0,4,0,4,0,0,0
01/19/2021,Southwest,1,GACH,1,53,45,15,30,0,0,0,4,0,4,3,0,3,53,45,15,30,0,0,0,4,0,4,3,0,3
01/20/2021,Anchorage,7,GACH,1,712,685,503,182,126,96,30,179,33,146,31,0,31,712,685,503,182,126,96,30,179,33,146,31,0,31
01/20/2021,Anchorage,7,LTACH,0,31,30,27,3,3,3,0,23,2,21,0,0,0,31,30,27,3,3,3,0,23,2,21,0,0,0
01/20/2021,Anchorage,7,Psych,0,200,193,114,79,0,0,0,0,0,0,6,0,6,200,193,114,79,0,0,0,0,0,0,6,0,6
01/20/2021,Gulf Coast,4,CAH,1,109,100,21,79,4,1,3,18,0,18,0,0,0,109,100,21,79,4,1,3,18,0,18,0,0,0
01/20/2021,Gulf Coast,4,GACH,1,115,61,38,23,9,4,5,10,0,10,2,0,2,115,61,38,23,9,4,5,10,0,10,2,0,2
01/20/2021,Interior,6,GACH,1,101,81,33,48,20,16,4,16,2,14,4,0,4,101,81,33,48,20,16,4,16,2,14,4,0,4
01/20/2021,Matanuska-Susitna,3,GACH,1,184,160,75,85,14,9,5,33,0,33,3,0,3,184,160,75,85,14,9,5,33,0,33,3,0,3
01/20/2021,Northern,2,CAH,1,139,78,24,54,0,0,0,36,0,36,2,0,2,139,78,24,54,0,0,0,36,0,36,2,0,2
01/20/2021,Southeast,5,CAH,1,70,70,35,35,8,3,5,33,0,33,3,0,3,70,70,35,35,8,3,5,33,0,33,3,0,3
01/20/2021,Southeast,5,GACH,1,161,133,34,99,9,2,7,20,0,20,0,0,0,161,133,34,99,9,2,7,20,0,20,0,0,0
01/20/2021,Southwest,1,CAH,1,22,12,2,10,0,0,0,4,0,4,0,0,0,22,12,2,10,0,0,0,4,0,4,0,0,0
01/20/2021,Southwest,1,GACH,1,53,45,13,32,0,0,0,4,0,4,2,0,2,53,45,13,32,0,0,0,4,0,4,2,0,2
01/21/2021,Anchorage,7,GACH,1,723,691,502,189,127,98,29,179,33,146,34,0,34,723,691,502,189,127,98,29,179,33,146,34,0,34
01/21/2021,Anchorage,7,LTACH,0,31,30,28,2,3,3,0,23,2,21,0,0,0,31,30,28,2,3,3,0,23,2,21,0,0,0
01/21/2021,Anchorage,7,Psych,0,,,,,,,,,,,,,,200,193,114,79,0,0,0,0,0,0,6,0,6
01/21/2021,Gulf Coast,4,CAH,1,108,99,23,76,4,1,3,18,0,18,1,0,1,108,99,23,76,4,1,3,18,0,18,1,0,1
01/21/2021,Gulf Coast,4,GACH,1,115,61,37,24,9,5,4,10,0,10,2,0,2,115,61,37,24,9,5,4,10,0,10,2,0,2
01/21/2021,Interior,6,GACH,1,101,81,33,48,20,14,6,16,3,13,3,0,3,101,81,33,48,20,14,6,16,3,13,3,0,3
01/21/2021,Matanuska-Susitna,3,GACH,1,184,160,67,93,14,10,4,33,0,33,1,0,1,184,160,67,93,14,10,4,33,0,33,1,0,1
01/21/2021,Northern,2,CAH,1,139,78,18,60,0,0,0,36,0,36,2,0,2,139,78,18,60,0,0,0,36,0,36,2,0,2
01/21/2021,Southeast,5,CAH,1,70,70,36,34,8,2,6,33,0,33,2,0,2,70,70,36,34,8,2,6,33,0,33,2,0,2
01/21/2021,Southeast,5,GACH,1,161,133,28,105,9,1,8,20,0,20,0,0,0,161,133,28,105,9,1,8,20,0,20,0,0,0
01/21/2021,Southwest,1,CAH,1,22,12,1,11,0,0,0,4,0,4,0,0,0,22,12,1,11,0,0,0,4,0,4,0,0,0
01/21/2021,Southwest,1,GACH,1,53,45,13,32,0,0,0,4,0,4,2,0,2,53,45,13,32,0,0,0,4,0,4,2,0,2
01/22/2021,Anchorage,7,GACH,1,712,680,491,189,121,95,26,179,34,145,30,0,30,712,680,491,189,121,95,26,179,34,145,30,0,30
01/22/2021,Anchorage,7,LTACH,0,31,30,30,0,3,3,0,23,1,22,0,0,0,31,30,30,0,3,3,0,23,1,22,0,0,0
01/22/2021,Anchorage,7,Psych,0,,,,,,,,,,,,,,200,193,114,79,0,0,0,0,0,0,6,0,6
01/22/2021,Gulf Coast,4,CAH,1,111,102,22,80,4,1,3,18,0,18,0,0,0,111,102,22,80,4,1,3,18,0,18,0,0,0
01/22/2021,Gulf Coast,4,GACH,1,115,61,38,23,9,6,3,10,0,10,1,0,1,115,61,38,23,9,6,3,10,0,10,1,0,1
01/22/2021,Interior,6,GACH,1,101,81,43,38,20,14,6,16,3,13,3,0,3,101,81,43,38,20,14,6,16,3,13,3,0,3
01/22/2021,Matanuska-Susitna,3,GACH,1,184,160,63,97,14,9,5,33,0,33,2,0,2,184,160,63,97,14,9,5,33,0,33,2,0,2
01/22/2021,Northern,2,CAH,1,139,78,17,61,0,0,0,36,0,36,2,0,2,139,78,17,61,0,0,0,36,0,36,2,0,2
01/22/2021,Southeast,5,CAH,1,70,70,32,38,8,4,4,33,0,33,2,0,2,70,70,32,38,8,4,4,33,0,33,2,0,2
01/22/2021,Southeast,5,GACH,1,161,133,25,108,9,2,7,20,0,20,1,0,1,161,133,25,108,9,2,7,20,0,20,1,0,1
01/22/2021,Southwest,1,CAH,1,22,12,1,11,0,0,0,4,0,4,0,0,0,22,12,1,11,0,0,0,4,0,4,0,0,0
01/22/2021,Southwest,1,GACH,1,53,45,17,28,0,0,0,4,0,4,3,0,3,53,45,17,28,0,0,0,4,0,4,3,0,3
01/23/2021,Anchorage,7,GACH,1,713,680,482,198,126,99,27,179,32,147,28,6,34,713,680,482,198,126,99,27,179,32,147,28,6,34
01/23/2021,Anchorage,7,LTACH,0,31,30,30,0,3,3,0,23,1,22,0,0,0,31,30,30,0,3,3,0,23,1,22,0,0,0
01/23/2021,Anchorage,7,Psych,0,,,,,,,,,,,,,,200,193,114,79,0,0,0,0,0,0,6,0,6
01/23/2021,Gulf Coast,4,CAH,1,111,102,27,75,4,1,3,18,0,18,0,0,0,111,102,27,75,4,1,3,18,0,18,0,0,0
01/23/2021,Gulf Coast,4,GACH,1,115,61,38,23,9,6,3,10,0,10,0,0,0,115,61,38,23,9,6,3,10,0,10,0,0,0
01/23/2021,Interior,6,GACH,1,101,81,45,36,20,10,10,16,3,13,1,0,1,101,81,45,36,20,10,10,16,3,13,1,0,1
01/23/2021,Matanuska-Susitna,3,GACH,1,184,160,59,101,14,8,6,33,0,33,6,0,6,184,160,59,101,14,8,6,33,0,33,6,0,6
01/23/2021,Northern,2,CAH,1,139,78,15,63,0,0,0,36,0,36,2,0,2,139,78,15,63,0,0,0,36,0,36,2,0,2
01/23/2021,Southeast,5,CAH,1,70,70,30,40,8,4,4,33,0,33,2,0,2,70,70,30,40,8,4,4,33,0,33,2,0,2
01/23/2021,Southeast,5,GACH,1,161,133,30,103,9,4,5,20,0,20,1,0,1,161,133,30,103,9,4,5,20,0,20,1,0,1
01/23/2021,Southwest,1,CAH,1,22,12,1,11,0,0,0,4,0,4,0,0,0,22,12,1,11,0,0,0,4,0,4,0,0,0
01/23/2021,Southwest,1,GACH,1,53,45,18,27,0,0,0,4,0,4,3,0,3,53,45,18,27,0,0,0,4,0,4,3,0,3
01/24/2021,Anchorage,7,GACH,1,713,684,498,186,129,100,29,179,33,146,31,0,31,713,684,498,186,129,100,29,179,33,146,31,0,31
01/24/2021,Anchorage,7,LTACH,0,31,30,30,0,3,3,0,23,1,22,0,0,0,31,30,30,0,3,3,0,23,1,22,0,0,0
01/24/2021,Anchorage,7,Psych,0,,,,,,,,,,,,,,200,193,114,79,0,0,0,0,0,0,6,0,6
01/24/2021,Gulf Coast,4,CAH,1,108,98,23,75,4,1,3,18,0,18,0,0,0,108,98,23,75,4,1,3,18,0,18,0,0,0
01/24/2021,Gulf Coast,4,GACH,1,115,61,34,27,9,4,5,10,0,10,0,0,0,115,61,34,27,9,4,5,10,0,10,0,0,0
01/24/2021,Interior,6,GACH,1,101,81,45,36,20,7,13,16,4,12,2,0,2,101,81,45,36,20,7,13,16,4,12,2,0,2
01/24/2021,Matanuska-Susitna,3,GACH,1,184,160,53,107,14,6,8,33,0,33,5,0,5,184,160,53,107,14,6,8,33,0,33,5,0,5
01/24/2021,Northern,2,CAH,1,139,78,14,64,0,0,0,36,0,36,1,0,1,139,78,14,64,0,0,0,36,0,36,1,0,1
01/24/2021,Southeast,5,CAH,1,70,70,32,38,8,4,4,33,0,33,2,0,2,70,70,32,38,8,4,4,33,0,33,2,0,2
01/24/2021,Southeast,5,GACH,1,161,133,29,104,9,2,7,20,0,20,1,0,1,161,133,29,104,9,2,7,20,0,20,1,0,1
01/24/2021,Southwest,1,CAH,1,22,12,1,11,0,0,0,4,0,4,0,0,0,22,12,1,11,0,0,0,4,0,4,0,0,0
01/24/2021,Southwest,1,GACH,1,53,45,16,29,0,0,0,4,0,4,3,0,3,53,45,16,29,0,0,0,4,0,4,3,0,3
01/25/2021,Anchorage,7,GACH,1,725,697,505,192,134,107,27,179,34,145,31,0,31,725,697,505,192,134,107,27,179,34,145,31,0,31
01/25/2021,Anchorage,7,LTACH,0,31,30,30,0,3,3,0,23,1,22,0,0,0,31,30,30,0,3,3,0,23,1,22,0,0,0
01/25/2021,Anchorage,7,Psych,0,,,,,,,,,,,,,,200,193,114,79,0,0,0,0,0,0,6,0,6
01/25/2021,Gulf Coast,4,CAH,1,109,100,24,76,4,0,4,18,0,18,0,0,0,109,100,24,76,4,0,4,18,0,18,0,0,0
01/25/2021,Gulf Coast,4,GACH,1,115,61,34,27,9,5,4,10,0,10,2,0,2,115,61,34,27,9,5,4,10,0,10,2,0,2
01/25/2021,Interior,6,GACH,1,101,81,46,35,20,12,8,16,4,12,2,0,2,101,81,46,35,20,12,8,16,4,12,2,0,2
01/25/2021,Matanuska-Susitna,3,GACH,1,184,160,58,102,14,3,11,33,0,33,6,0,6,184,160,58,102,14,3,11,33,0,33,6,0,6
01/25/2021,Northern,2,CAH,1,139,78,15,63,0,0,0,36,0,36,2,0,2,139,78,15,63,0,0,0,36,0,36,2,0,2
01/25/2021,Southeast,5,CAH,1,70,70,34,36,8,4,4,33,0,33,2,0,2,70,70,34,36,8,4,4,33,0,33,2,0,2
01/25/2021,Southeast,5,GACH,1,161,133,31,102,9,3,6,20,0,20,0,0,0,161,133,31,102,9,3,6,20,0,20,0,0,0
01/25/2021,Southwest,1,CAH,1,22,12,1,11,0,0,0,4,0,4,0,0,0,22,12,1,11,0,0,0,4,0,4,0,0,0
01/25/2021,Southwest,1,GACH,1,53,45,16,29,0,0,0,4,0,4,3,0,3,53,45,16,29,0,0,0,4,0,4,3,0,3
01/26/2021,Anchorage,7,GACH,1,733,701,521,180,134,111,23,179,29,150,31,0,31,733,701,521,180,134,111,23,179,29,150,31,0,31
01/26/2021,Anchorage,7,LTACH,0,34,34,32,2,3,3,0,23,3,20,0,0,0,34,34,32,2,3,3,0,23,3,20,0,0,0
01/26/2021,Anchorage,7,Psych,0,,,,,,,,,,,,,,200,193,114,79,0,0,0,0,0,0,6,0,6
01/26/2021,Gulf Coast,4,CAH,1,109,100,25,75,4,0,4,18,0,18,0,0,0,109,100,25,75,4,0,4,18,0,18,0,0,0
01/26/2021,Gulf Coast,4,GACH,1,115,61,36,25,9,3,6,10,0,10,0,0,0,115,61,36,25,9,3,6,10,0,10,0,0,0
01/26/2021,Interior,6,GACH,1,101,81,58,23,20,11,9,16,2,14,2,0,2,101,81,58,23,20,11,9,16,2,14,2,0,2
01/26/2021,Matanuska-Susitna,3,GACH,1,184,160,72,88,14,5,9,33,1,32,6,0,6,184,160,72,88,14,5,9,33,1,32,6,0,6
01/26/2021,Northern,2,CAH,1,139,78,13,65,0,0,0,36,0,36,0,0,0,139,78,13,65,0,0,0,36,0,36,0,0,0
01/26/2021,Southeast,5,CAH,1,70,70,26,44,8,3,5,33,0,33,2,0,2,70,70,26,44,8,3,5,33,0,33,2,0,2
01/26/2021,Southeast,5,GACH,1,161,133,37,96,9,6,3,20,0,20,0,0,0,161,133,37,96,9,6,3,20,0,20,0,0,0
01/26/2021,Southwest,1,CAH,1,22,12,2,10,0,0,0,4,0,4,0,0,0,22,12,2,10,0,0,0,4,0,4,0,0,0
01/26/2021,Southwest,1,GACH,1,53,45,18,27,0,0,0,4,0,4,3,0,3,53,45,18,27,0,0,0,4,0,4,3,0,3
01/27/2021,Anchorage,7,GACH,1,742,710,538,172,138,115,23,179,36,143,32,0,32,742,710,538,172,138,115,23,179,36,143,32,0,32
01/27/2021,Anchorage,7,LTACH,0,34,34,30,4,3,3,0,23,2,21,0,0,0,34,34,30,4,3,3,0,23,2,21,0,0,0
01/27/2021,Anchorage,7,Psych,0,200,189,109,80,0,0,0,0,0,0,0,0,0,200,189,109,80,0,0,0,0,0,0,0,0,0
01/27/2021,Gulf Coast,4,CAH,1,111,101,27,74,4,0,4,18,0,18,0,0,0,111,101,27,74,4,0,4,18,0,18,0,0,0
01/27/2021,Gulf Coast,4,GACH,1,115,61,41,20,9,4,5,10,0,10,0,0,0,115,61,41,20,9,4,5,10,0,10,0,0,0
01/27/2021,Interior,6,GACH,1,101,81,51,30,20,11,9,16,0,16,0,0,0,101,81,51,30,20,11,9,16,0,16,0,0,0
01/27/2021,Matanuska-Susitna,3,GACH,1,184,160,72,88,14,3,11,33,1,32,5,0,5,184,160,72,88,14,3,11,33,1,32,5,0,5
01/27/2021,Northern,2,CAH,1,139,78,14,64,0,0,0,36,0,36,1,0,1,139,78,14,64,0,0,0,36,0,36,1,0,1
01/27/2021,Southeast,5,CAH,1,70,70,27,43,8,3,5,33,0,33,1,0,1,70,70,27,43,8,3,5,33,0,33,1,0,1
01/27/2021,Southeast,5,GACH,1,161,133,38,95,9,6,3,20,0,20,0,0,0,161,133,38,95,9,6,3,20,0,20,0,0,0
01/27/2021,Southwest,1,CAH,1,22,12,1,11,0,0,0,4,0,4,0,0,0,22,12,1,11,0,0,0,4,0,4,0,0,0
01/27/2021,Southwest,1,GACH,1,53,45,17,28,0,0,0,4,0,4,1,0,1,53,45,17,28,0,0,0,4,0,4,1,0,1
01/28/2021,Anchorage,7,GACH,1,747,712,542,170,137,114,23,179,38,141,30,1,31,747,712,542,170,137,114,23,179,38,141,30,1,31
01/28/2021,Anchorage,7,LTACH,0,34,34,30,4,3,3,0,23,2,21,0,0,0,34,34,30,4,3,3,0,23,2,21,0,0,0
01/28/2021,Anchorage,7,Psych,0,,,,,,,,,,,,,,200,189,109,80,0,0,0,0,0,0,0,0,0
01/28/2021,Gulf Coast,4,CAH,1,109,100,32,68,4,0,4,18,0,18,0,0,0,109,100,32,68,4,0,4,18,0,18,0,0,0
01/28/2021,Gulf Coast,4,GACH,1,115,61,42,19,9,6,3,10,0,10,0,0,0,115,61,42,19,9,6,3,10,0,10,0,0,0
01/28/2021,Interior,6,GACH,1,101,81,46,35,20,9,11,16,0,16,1,0,1,101,81,46,35,20,9,11,16,0,16,1,0,1
01/28/2021,Matanuska-Susitna,3,GACH,1,184,160,71,89,14,6,8,33,0,33,3,0,3,184,160,71,89,14,6,8,33,0,33,3,0,3
01/28/2021,Northern,2,CAH,1,139,78,16,62,0,0,0,36,0,36,0,0,0,139,78,16,62,0,0,0,36,0,36,0,0,0
01/28/2021,Southeast,5,CAH,1,70,70,26,44,8,2,6,33,0,33,2,0,2,70,70,26,44,8,2,6,33,0,33,2,0,2
01/28/2021,Southeast,5,GACH,1,161,133,37,96,9,5,4,20,0,20,0,0,0,161,133,37,96,9,5,4,20,0,20,0,0,0
01/28/2021,Southwest,1,CAH,1,22,12,1,11,0,0,0,4,0,4,0,0,0,22,12,1,11,0,0,0,4,0,4,0,0,0
01/28/2021,Southwest,1,GACH,1,53,45,13,32,0,0,0,4,0,4,2,0,2,53,45,13,32,0,0,0,4,0,4,2,0,2
01/29/2021,Anchorage,7,GACH,1,732,704,513,191,135,109,26,179,44,135,29,0,29,732,704,513,191,135,109,26,179,44,135,29,0,29
01/29/2021,Anchorage,7,LTACH,0,34,34,33,1,3,3,0,23,2,21,0,0,0,34,34,33,1,3,3,0,23,2,21,0,0,0
01/29/2021,Anchorage,7,Psych,0,,,,,,,,,,,,,,200,189,109,80,0,0,0,0,0,0,0,0,0
01/29/2021,Gulf Coast,4,CAH,1,108,99,31,68,4,0,4,18,0,18,0,0,0,108,99,31,68,4,0,4,18,0,18,0,0,0
01/29/2021,Gulf Coast,4,GACH,1,115,61,33,28,9,4,5,10,0,10,1,0,1,115,61,33,28,9,4,5,10,0,10,1,0,1
01/29/2021,Interior,6,GACH,1,101,81,50,31,20,9,11,16,0,16,1,0,1,101,81,50,31,20,9,11,16,0,16,1,0,1
01/29/2021,Matanuska-Susitna,3,GACH,1,184,160,69,91,14,4,10,33,0,33,4,0,4,184,160,69,91,14,4,10,33,0,33,4,0,4
01/29/2021,Northern,2,CAH,1,139,78,16,62,0,0,0,36,0,36,0,0,0,139,78,16,62,0,0,0,36,0,36,0,0,0
01/29/2021,Southeast,5,CAH,1,70,70,29,41,8,4,4,33,0,33,0,0,0,70,70,29,41,8,4,4,33,0,33,0,0,0
01/29/2021,Southeast,5,GACH,1,161,133,35,98,9,5,4,20,0,20,0,0,0,161,133,35,98,9,5,4,20,0,20,0,0,0
01/29/2021,Southwest,1,CAH,1,22,12,2,10,0,0,0,4,0,4,0,0,0,22,12,2,10,0,0,0,4,0,4,0,0,0
01/29/2021,Southwest,1,GACH,1,53,45,17,28,0,0,0,4,0,4,2,0,2,53,45,17,28,0,0,0,4,0,4,2,0,2
01/30/2021,Anchorage,7,GACH,1,725,700,499,201,131,103,28,179,41,138,32,0,32,725,700,499,201,131,103,28,179,41,138,32,0,32
01/30/2021,Anchorage,7,LTACH,0,34,34,30,4,3,3,0,23,2,21,0,0,0,34,34,30,4,3,3,0,23,2,21,0,0,0
01/30/2021,Anchorage,7,Psych,0,,,,,,,,,,,,,,200,189,109,80,0,0,0,0,0,0,0,0,0
01/30/2021,Gulf Coast,4,CAH,1,108,99,28,71,4,0,4,18,0,18,0,0,0,108,99,28,71,4,0,4,18,0,18,0,0,0
01/30/2021,Gulf Coast,4,GACH,1,115,61,33,28,9,3,6,10,0,10,1,0,1,115,61,33,28,9,3,6,10,0,10,1,0,1
01/30/2021,Interior,6,GACH,1,101,81,47,34,20,11,9,16,0,16,1,0,1,101,81,47,34,20,11,9,16,0,16,1,0,1
01/30/2021,Matanuska-Susitna,3,GACH,1,184,160,65,95,14,4,10,33,0,33,3,0,3,184,160,65,95,14,4,10,33,0,33,3,0,3
01/30/2021,Northern,2,CAH,1,139,78,16,62,0,0,0,36,0,36,0,0,0,139,78,16,62,0,0,0,36,0,36,0,0,0
01/30/2021,Southeast,5,CAH,1,70,70,33,37,8,4,4,33,0,33,0,0,0,70,70,33,37,8,4,4,33,0,33,0,0,0
01/30/2021,Southeast,5,GACH,1,161,133,33,100,9,4,5,20,0,20,0,0,0,161,133,33,100,9,4,5,20,0,20,0,0,0
01/30/2021,Southwest,1,CAH,1,22,12,0,12,0,0,0,4,0,4,0,0,0,22,12,0,12,0,0,0,4,0,4,0,0,0
01/30/2021,Southwest,1,GACH,1,53,45,21,24,0,0,0,4,0,4,2,0,2,53,45,21,24,0,0,0,4,0,4,2,0,2
01/31/2021,Anchorage,7,GACH,1,726,701,515,186,131,103,28,179,39,140,34,0,34,726,701,515,186,131,103,28,179,39,140,34,0,34
01/31/2021,Anchorage,7,LTACH,0,34,34,30,4,3,3,0,23,2,21,0,0,0,34,34,30,4,3,3,0,23,2,21,0,0,0
01/31/2021,Anchorage,7,Psych,0,,,,,,,,,,,,,,200,189,109,80,0,0,0,0,0,0,0,0,0
01/31/2021,Gulf Coast,4,CAH,1,108,99,28,71,4,0,4,18,0,18,0,0,0,108,99,28,71,4,0,4,18,0,18,0,0,0
01/31/2021,Gulf Coast,4,GACH,1,115,61,31,30,9,4,5,10,0,10,1,0,1,115,61,31,30,9,4,5,10,0,10,1,0,1
01/31/2021,Interior,6,GACH,1,101,81,47,34,20,6,14,16,0,16,1,0,1,101,81,47,34,20,6,14,16,0,16,1,0,1
01/31/2021,Matanuska-Susitna,3,GACH,1,184,160,54,106,14,4,10,33,0,33,3,0,3,184,160,54,106,14,4,10,33,0,33,3,0,3
01/31/2021,Northern,2,CAH,1,139,78,18,60,0,0,0,36,0,36,0,0,0,139,78,18,60,0,0,0,36,0,36,0,0,0
01/31/2021,Southeast,5,CAH,1,70,70,25,45,8,5,3,33,0,33,0,0,0,70,70,25,45,8,5,3,33,0,33,0,0,0
01/31/2021,Southeast,5,GACH,1,161,133,37,96,9,5,4,20,0,20,0,0,0,161,133,37,96,9,5,4,20,0,20,0,0,0
01/31/2021,Southwest,1,CAH,1,22,12,1,11,0,0,0,4,0,4,0,0,0,22,12,1,11,0,0,0,4,0,4,0,0,0
01/31/2021,Southwest,1,GACH,1,53,45,20,25,0,0,0,4,0,4,1,0,1,53,45,20,25,0,0,0,4,0,4,1,0,1
02/01/2021,Anchorage,7,GACH,1,720,696,504,192,130,107,23,179,35,144,34,0,34,720,696,504,192,130,107,23,179,35,144,34,0,34
02/01/2021,Anchorage,7,LTACH,0,34,34,30,4,3,3,0,23,2,21,0,0,0,34,34,30,4,3,3,0,23,2,21,0,0,0
02/01/2021,Anchorage,7,Psych,0,,,,,,,,,,,,,,200,189,109,80,0,0,0,0,0,0,0,0,0
02/01/2021,Gulf Coast,4,CAH,1,108,99,28,71,4,0,4,18,0,18,0,0,0,108,99,28,71,4,0,4,18,0,18,0,0,0
02/01/2021,Gulf Coast,4,GACH,1,115,61,35,26,9,4,5,10,0,10,1,0,1,115,61,35,26,9,4,5,10,0,10,1,0,1
02/01/2021,Interior,6,GACH,1,101,81,48,33,20,7,13,16,0,16,1,0,1,101,81,48,33,20,7,13,16,0,16,1,0,1
02/01/2021,Matanuska-Susitna,3,GACH,1,184,160,60,100,14,3,11,33,0,33,2,0,2,184,160,60,100,14,3,11,33,0,33,2,0,2
02/01/2021,Northern,2,CAH,1,139,78,16,62,0,0,0,36,0,36,0,0,0,139,78,16,62,0,0,0,36,0,36,0,0,0
02/01/2021,Southeast,5,CAH,1,70,70,34,36,8,4,4,33,0,33,0,0,0,70,70,34,36,8,4,4,33,0,33,0,0,0
02/01/2021,Southeast,5,GACH,1,161,133,29,104,9,5,4,20,0,20,0,0,0,161,133,29,104,9,5,4,20,0,20,0,0,0
02/01/2021,Southwest,1,CAH,1,22,12,2,10,0,0,0,4,0,4,0,0,0,22,12,2,10,0,0,0,4,0,4,0,0,0
02/01/2021,Southwest,1,GACH,1,53,45,25,20,0,0,0,4,0,4,1,0,1,53,45,25,20,0,0,0,4,0,4,1,0,1
02/02/2021,Anchorage,7,GACH,1,722,698,498,200,133,113,20,179,38,141,40,0,40,722,698,498,200,133,113,20,179,38,141,40,0,40
02/02/2021,Anchorage,7,LTACH,0,34,34,29,5,3,3,0,23,2,21,0,0,0,34,34,29,5,3,3,0,23,2,21,0,0,0
02/02/2021,Anchorage,7,Psych,0,,,,,,,,,,,,,,200,189,109,80,0,0,0,0,0,0,0,0,0
02/02/2021,Gulf Coast,4,CAH,1,107,98,33,65,4,0,4,18,0,18,0,0,0,107,98,33,65,4,0,4,18,0,18,0,0,0
02/02/2021,Gulf Coast,4,GACH,1,115,61,44,17,9,8,1,10,0,10,1,0,1,115,61,44,17,9,8,1,10,0,10,1,0,1
02/02/2021,Interior,6,GACH,1,101,81,56,25,20,7,13,16,0,16,0,0,0,101,81,56,25,20,7,13,16,0,16,0,0,0
02/02/2021,Matanuska-Susitna,3,GACH,1,184,160,64,96,14,2,12,33,0,33,1,0,1,184,160,64,96,14,2,12,33,0,33,1,0,1
02/02/2021,Northern,2,CAH,1,139,78,15,63,0,0,0,36,0,36,0,0,0,139,78,15,63,0,0,0,36,0,36,0,0,0
02/02/2021,Southeast,5,CAH,1,70,70,34,36,8,5,3,33,0,33,0,0,0,70,70,34,36,8,5,3,33,0,33,0,0,0
02/02/2021,Southeast,5,GACH,1,161,133,36,97,9,5,4,20,0,20,0,0,0,161,133,36,97,9,5,4,20,0,20,0,0,0
02/02/2021,Southwest,1,CAH,1,22,12,1,11,0,0,0,4,0,4,0,0,0,22,12,1,11,0,0,0,4,0,4,0,0,0
02/02/2021,Southwest,1,GACH,1,53,45,22,23,0,0,0,4,0,4,1,0,1,53,45,22,23,0,0,0,4,0,4,1,0,1
02/03/2021,Anchorage,7,GACH,1,728,700,521,179,134,112,22,179,37,142,40,0,40,728,700,521,179,134,112,22,179,37,142,40,0,40
02/03/2021,Anchorage,7,LTACH,0,34,34,30,4,3,3,0,23,2,21,0,0,0,34,34,30,4,3,3,0,23,2,21,0,0,0
02/03/2021,Anchorage,7,Psych,0,200,192,124,68,0,0,0,0,0,0,0,0,0,200,192,124,68,0,0,0,0,0,0,0,0,0
02/03/2021,Gulf Coast,4,CAH,1,110,101,31,70,4,0,4,18,0,18,0,0,0,110,101,31,70,4,0,4,18,0,18,0,0,0
02/03/2021,Gulf Coast,4,GACH,1,115,61,37,24,9,3,6,8,0,8,0,0,0,115,61,37,24,9,3,6,8,0,8,0,0,0
02/03/2021,Interior,6,GACH,1,101,81,51,30,20,9,11,16,0,16,0,0,0,101,81,51,30,20,9,11,16,0,16,0,0,0
02/03/2021,Matanuska-Susitna,3,GACH,1,184,160,72,88,14,8,6,33,2,31,0,0,0,184,160,72,88,14,8,6,33,2,31,0,0,0
02/03/2021,Northern,2,CAH,1,139,78,17,61,0,0,0,36,0,36,0,0,0,139,78,17,61,0,0,0,36,0,36,0,0,0
02/03/2021,Southeast,5,CAH,1,70,70,29,41,8,4,4,33,0,33,0,0,0,70,70,29,41,8,4,4,33,0,33,0,0,0
02/03/2021,Southeast,5,GACH,1,161,133,38,95,9,6,3,20,0,20,0,0,0,161,133,38,95,9,6,3,20,0,20,0,0,0
02/03/2021,Southwest,1,CAH,1,22,12,3,9,0,0,0,4,0,4,0,0,0,22,12,3,9,0,0,0,4,0,4,0,0,0
02/03/2021,Southwest,1,GACH,1,53,45,19,26,0,0,0,4,0,4,0,0,0,53,45,19,26,0,0,0,4,0,4,0,0,0
02/04/2021,Anchorage,7,GACH,1,712,687,492,195,128,103,25,179,36,143,36,0,36,712,687,492,195,128,103,25,179,36,143,36,0,36
02/04/2021,Anchorage,7,LTACH,0,34,34,30,4,3,3,0,23,3,20,0,0,0,34,34,30,4,3,3,0,23,3,20,0,0,0
02/04/2021,Anchorage,7,Psych,0,,,,,,,,,,,,,,200,192,124,68,0,0,0,0,0,0,0,0,0
02/04/2021,Gulf Coast,4,CAH,1,109,100,32,68,4,0,4,18,0,18,0,0,0,109,100,32,68,4,0,4,18,0,18,0,0,0
02/04/2021,Gulf Coast,4,GACH,1,115,61,33,28,9,3,6,8,0,8,0,0,0,115,61,33,28,9,3,6,8,0,8,0,0,0
02/04/2021,Interior,6,GACH,1,101,81,53,28,20,6,14,16,0,16,1,0,1,101,81,53,28,20,6,14,16,0,16,1,0,1
02/04/2021,Matanuska-Susitna,3,GACH,1,184,160,67,93,14,4,10,33,2,31,2,0,2,184,160,67,93,14,4,10,33,2,31,2,0,2
02/04/2021,Northern,2,CAH,1,139,78,19,59,0,0,0,36,0,36,0,0,0,139,78,19,59,0,0,0,36,0,36,0,0,0
02/04/2021,Southeast,5,CAH,1,70,70,32,38,8,4,4,33,0,33,0,0,0,70,70,32,38,8,4,4,33,0,33,0,0,0
02/04/2021,Southeast,5,GACH,1,161,133,42,91,9,3,6,20,0,20,0,0,0,161,133,42,91,9,3,6,20,0,20,0,0,0
02/04/2021,Southwest,1,CAH,1,22,12,3,9,0,0,0,4,0,4,0,0,0,22,12,3,9,0,0,0,4,0,4,0,0,0
02/04/2021,Southwest,1,GACH,1,53,45,26,19,0,0,0,4,0,4,0,0,0,53,45,26,19,0,0,0,4,0,4,0,0,0
02/05/2021,Anchorage,7,GACH,1,697,673,501,172,123,102,21,179,33,146,35,0,35,697,673,501,172,123,102,21,179,33,146,35,0,35
02/05/2021,Anchorage,7,LTACH,0,34,34,31,3,3,3,0,23,3,20,0,0,0,34,34,31,3,3,3,0,23,3,20,0,0,0
02/05/2021,Anchorage,7,Psych,0,,,,,,,,,,,,,,200,192,124,68,0,0,0,0,0,0,0,0,0
02/05/2021,Gulf Coast,4,CAH,1,108,99,29,70,4,0,4,18,0,18,0,0,0,108,99,29,70,4,0,4,18,0,18,0,0,0
02/05/2021,Gulf Coast,4,GACH,1,115,61,31,30,9,4,5,8,0,8,1,0,1,115,61,31,30,9,4,5,8,0,8,1,0,1
02/05/2021,Interior,6,GACH,1,101,81,57,24,20,12,8,16,0,16,2,0,2,101,81,57,24,20,12,8,16,0,16,2,0,2
02/05/2021,Matanuska-Susitna,3,GACH,1,184,160,73,87,14,7,7,33,2,31,3,0,3,184,160,73,87,14,7,7,33,2,31,3,0,3
02/05/2021,Northern,2,CAH,1,139,78,18,60,0,0,0,36,0,36,0,0,0,139,78,18,60,0,0,0,36,0,36,0,0,0
02/05/2021,Southeast,5,CAH,1,70,70,34,36,8,3,5,33,0,33,0,0,0,70,70,34,36,8,3,5,33,0,33,0,0,0
02/05/2021,Southeast,5,GACH,1,161,133,41,92,9,6,3,20,0,20,0,0,0,161,133,41,92,9,6,3,20,0,20,0,0,0
02/05/2021,Southwest,1,CAH,1,22,12,2,10,0,0,0,4,0,4,0,0,0,22,12,2,10,0,0,0,4,0,4,0,0,0
02/05/2021,Southwest,1,GACH,1,53,45,25,20,0,0,0,4,0,4,0,0,0,53,45,25,20,0,0,0,4,0,4,0,0,0
02/06/2021,Anchorage,7,GACH,1,692,666,476,190,121,95,26,179,31,148,33,0,33,692,666,476,190,121,95,26,179,31,148,33,0,33
02/06/2021,Anchorage,7,LTACH,0,34,34,31,3,3,3,0,23,3,20,0,0,0,34,34,31,3,3,3,0,23,3,20,0,0,0
02/06/2021,Anchorage,7,Psych,0,,,,,,,,,,,,,,200,192,124,68,0,0,0,0,0,0,0,0,0
02/06/2021,Gulf Coast,4,CAH,1,108,99,26,73,4,0,4,18,0,18,0,0,0,108,99,26,73,4,0,4,18,0,18,0,0,0
02/06/2021,Gulf Coast,4,GACH,1,115,61,37,24,9,6,3,8,1,7,2,0,2,115,61,37,24,9,6,3,8,1,7,2,0,2
02/06/2021,Interior,6,GACH,1,101,81,48,33,20,8,12,16,0,16,0,0,0,101,81,48,33,20,8,12,16,0,16,0,0,0
02/06/2021,Matanuska-Susitna,3,GACH,1,184,160,65,95,14,12,2,33,2,31,1,0,1,184,160,65,95,14,12,2,33,2,31,1,0,1
02/06/2021,Northern,2,CAH,1,139,78,19,59,0,0,0,36,0,36,1,0,1,139,78,19,59,0,0,0,36,0,36,1,0,1
02/06/2021,Southeast,5,CAH,1,70,70,32,38,8,4,4,33,0,33,0,0,0,70,70,32,38,8,4,4,33,0,33,0,0,0
02/06/2021,Southeast,5,GACH,1,161,133,52,81,9,6,3,20,0,20,0,0,0,161,133,52,81,9,6,3,20,0,20,0,0,0
02/06/2021,Southwest,1,CAH,1,22,12,1,11,0,0,0,4,0,4,0,0,0,22,12,1,11,0,0,0,4,0,4,0,0,0
02/06/2021,Southwest,1,GACH,1,53,45,16,29,0,0,0,4,0,4,0,0,0,53,45,16,29,0,0,0,4,0,4,0,0,0
02/07/2021,Anchorage,7,GACH,1,694,668,466,202,125,101,24,179,32,147,32,0,32,694,668,466,202,125,101,24,179,32,147,32,0,32
02/07/2021,Anchorage,7,LTACH,0,34,34,31,3,3,3,0,23,4,19,0,0,0,34,34,31,3,3,3,0,23,4,19,0,0,0
02/07/2021,Anchorage,7,Psych,0,,,,,,,,,,,,,,200,192,124,68,0,0,0,0,0,0,0,0,0
02/07/2021,Gulf Coast,4,CAH,1,108,99,26,73,4,0,4,18,0,18,0,0,0,108,99,26,73,4,0,4,18,0,18,0,0,0
02/07/2021,Gulf Coast,4,GACH,1,115,61,37,24,9,4,5,8,1,7,3,0,3,115,61,37,24,9,4,5,8,1,7,3,0,3
02/07/2021,Interior,6,GACH,1,101,81,46,35,20,8,12,16,0,16,0,0,0,101,81,46,35,20,8,12,16,0,16,0,0,0
02/07/2021,Matanuska-Susitna,3,GACH,1,184,160,70,90,14,8,6,33,2,31,1,0,1,184,160,70,90,14,8,6,33,2,31,1,0,1
02/07/2021,Northern,2,CAH,1,139,78,14,64,0,0,0,36,1,35,1,0,1,139,78,14,64,0,0,0,36,1,35,1,0,1
02/07/2021,Southeast,5,CAH,1,70,70,32,38,8,4,4,33,0,33,0,0,0,70,70,32,38,8,4,4,33,0,33,0,0,0
02/07/2021,Southeast,5,GACH,1,161,133,52,81,9,5,4,20,0,20,1,0,1,161,133,52,81,9,5,4,20,0,20,1,0,1
02/07/2021,Southwest,1,CAH,1,22,12,3,9,0,0,0,4,0,4,0,0,0,22,12,3,9,0,0,0,4,0,4,0,0,0
02/07/2021,Southwest,1,GACH,1,53,45,20,25,0,0,0,4,0,4,0,0,0,53,45,20,25,0,0,0,4,0,4,0,0,0
02/08/2021,Anchorage,7,GACH,1,726,700,497,203,136,110,26,179,34,145,28,0,28,726,700,497,203,136,110,26,179,34,145,28,0,28
02/08/2021,Anchorage,7,LTACH,0,34,34,32,2,3,3,0,23,4,19,0,0,0,34,34,32,2,3,3,0,23,4,19,0,0,0
02/08/2021,Anchorage,7,Psych,0,,,,,,,,,,,,,,200,192,124,68,0,0,0,0,0,0,0,0,0
02/08/2021,Gulf Coast,4,CAH,1,108,98,26,72,4,0,4,18,0,18,0,0,0,108,98,26,72,4,0,4,18,0,18,0,0,0
02/08/2021,Gulf Coast,4,GACH,1,115,61,37,24,9,4,5,8,1,7,2,0,2,115,61,37,24,9,4,5,8,1,7,2,0,2
02/08/2021,Interior,6,GACH,1,101,81,34,47,20,6,14,16,0,16,0,0,0,101,81,34,47,20,6,14,16,0,16,0,0,0
02/08/2021,Matanuska-Susitna,3,GACH,1,184,160,73,87,14,7,7,33,2,31,1,0,1,184,160,73,87,14,7,7,33,2,31,1,0,1
02/08/2021,Northern,2,CAH,1,139,78,13,65,0,0,0,36,0,36,1,0,1,139,78,13,65,0,0,0,36,0,36,1,0,1
02/08/2021,Southeast,5,CAH,1,70,70,26,44,8,3,5,33,0,33,0,0,0,70,70,26,44,8,3,5,33,0,33,0,0,0
02/08/2021,Southeast,5,GACH,1,161,133,35,98,9,3,6,20,0,20,1,0,1,161,133,35,98,9,3,6,20,0,20,1,0,1
02/08/2021,Southwest,1,CAH,1,22,12,1,11,0,0,0,4,0,4,0,0,0,22,12,1,11,0,0,0,4,0,4,0,0,0
02/08/2021,Southwest,1,GACH,1,53,45,18,27,0,0,0,4,0,4,1,0,1,53,45,18,27,0,0,0,4,0,4,1,0,1
02/09/2021,Anchorage,7,GACH,1,726,699,483,216,137,108,29,179,36,143,26,0,26,726,699,483,216,137,108,29,179,36,143,26,0,26
02/09/2021,Anchorage,7,LTACH,0,34,34,32,2,3,3,0,23,4,19,0,0,0,34,34,32,2,3,3,0,23,4,19,0,0,0
02/09/2021,Anchorage,7,Psych,0,,,,,,,,,,,,,,200,192,124,68,0,0,0,0,0,0,0,0,0
02/09/2021,Gulf Coast,4,CAH,1,108,98,24,74,4,0,4,18,0,18,0,0,0,108,98,24,74,4,0,4,18,0,18,0,0,0
02/09/2021,Gulf Coast,4,GACH,1,115,61,44,17,9,6,3,8,0,8,1,0,1,115,61,44,17,9,6,3,8,0,8,1,0,1
02/09/2021,Interior,6,GACH,1,101,81,51,30,20,6,14,16,0,16,1,0,1,101,81,51,30,20,6,14,16,0,16,1,0,1
02/09/2021,Matanuska-Susitna,3,GACH,1,184,160,68,92,14,6,8,33,2,31,1,0,1,184,160,68,92,14,6,8,33,2,31,1,0,1
02/09/2021,Northern,2,CAH,1,139,78,14,64,0,0,0,36,0,36,1,0,1,139,78,14,64,0,0,0,36,0,36,1,0,1
02/09/2021,Southeast,5,CAH,1,70,70,30,40,8,4,4,33,0,33,0,0,0,70,70,30,40,8,4,4,33,0,33,0,0,0
02/09/2021,Southeast,5,GACH,1,161,133,32,101,9,5,4,20,0,20,1,0,1,161,133,32,101,9,5,4,20,0,20,1,0,1
02/09/2021,Southwest,1,CAH,1,22,12,1,11,0,0,0,4,0,4,0,0,0,22,12,1,11,0,0,0,4,0,4,0,0,0
02/09/2021,Southwest,1,GACH,1,53,45,15,30,0,0,0,4,0,4,1,0,1,53,45,15,30,0,0,0,4,0,4,1,0,1
02/10/2021,Anchorage,7,GACH,1,725,699,501,198,134,102,32,179,29,150,25,0,25,725,699,501,198,134,102,32,179,29,150,25,0,25
02/10/2021,Anchorage,7,LTACH,0,34,34,33,1,3,3,0,23,4,19,0,0,0,34,34,33,1,3,3,0,23,4,19,0,0,0
02/10/2021,Anchorage,7,Psych,0,60,48,48,0,0,0,0,0,0,0,0,0,0,200,188,120,68,0,0,0,0,0,0,0,0,0
02/10/2021,Gulf Coast,4,CAH,1,108,98,27,71,4,0,4,18,0,18,0,0,0,108,98,27,71,4,0,4,18,0,18,0,0,0
02/10/2021,Gulf Coast,4,GACH,1,115,61,45,16,9,9,0,8,0,8,0,0,0,115,61,45,16,9,9,0,8,0,8,0,0,0
02/10/2021,Interior,6,GACH,1,101,81,44,37,20,7,13,16,0,16,2,0,2,101,81,44,37,20,7,13,16,0,16,2,0,2
02/10/2021,Matanuska-Susitna,3,GACH,1,184,160,69,91,14,12,2,33,2,31,2,0,2,184,160,69,91,14,12,2,33,2,31,2,0,2
02/10/2021,Northern,2,CAH,1,139,78,17,61,0,0,0,36,0,36,1,0,1,139,78,17,61,0,0,0,36,0,36,1,0,1
02/10/2021,Southeast,5,CAH,1,70,70,37,33,8,1,7,33,0,33,1,0,1,70,70,37,33,8,1,7,33,0,33,1,0,1
02/10/2021,Southeast,5,GACH,1,161,133,42,91,9,5,4,20,0,20,1,0,1,161,133,42,91,9,5,4,20,0,20,1,0,1
02/10/2021,Southwest,1,CAH,1,22,12,3,9,0,0,0,4,0,4,0,0,0,22,12,3,9,0,0,0,4,0,4,0,0,0
02/10/2021,Southwest,1,GACH,1,53,45,17,28,0,0,0,4,0,4,1,0,1,53,45,17,28,0,0,0,4,0,4,1,0,1
02/11/2021,Anchorage,7,GACH,1,722,698,522,176,138,108,30,179,30,149,27,0,27,722,698,522,176,138,108,30,179,30,149,27,0,27
02/11/2021,Anchorage,7,LTACH,0,34,34,33,1,3,3,0,23,4,19,0,0,0,34,34,33,1,3,3,0,23,4,19,0,0,0
02/11/2021,Anchorage,7,Psych,0,,,,,,,,,,,,,,200,188,120,68,0,0,0,0,0,0,0,0,0
02/11/2021,Gulf Coast,4,CAH,1,108,98,26,72,4,0,4,18,0,18,0,0,0,108,98,26,72,4,0,4,18,0,18,0,0,0
02/11/2021,Gulf Coast,4,GACH,1,115,61,42,19,9,7,2,8,0,8,0,0,0,115,61,42,19,9,7,2,8,0,8,0,0,0
02/11/2021,Interior,6,GACH,1,101,81,44,37,20,8,12,16,0,16,2,0,2,101,81,44,37,20,8,12,16,0,16,2,0,2
02/11/2021,Matanuska-Susitna,3,GACH,1,184,160,70,90,14,8,6,33,2,31,0,0,0,184,160,70,90,14,8,6,33,2,31,0,0,0
02/11/2021,Northern,2,CAH,1,139,78,15,63,0,0,0,36,0,36,1,0,1,139,78,15,63,0,0,0,36,0,36,1,0,1
02/11/2021,Southeast,5,CAH,1,70,70,37,33,8,1,7,33,0,33,0,0,0,70,70,37,33,8,1,7,33,0,33,0,0,0
02/11/2021,Southeast,5,GACH,1,161,133,37,96,9,5,4,20,0,20,1,0,1,161,133,37,96,9,5,4,20,0,20,1,0,1
02/11/2021,Southwest,1,CAH,1,22,12,4,8,0,0,0,4,0,4,0,0,0,22,12,4,8,0,0,0,4,0,4,0,0,0
02/11/2021,Southwest,1,GACH,1,53,45,15,30,0,0,0,4,0,4,2,0,2,53,45,15,30,0,0,0,4,0,4,2,0,2
02/12/2021,Anchorage,7,GACH,1,732,707,534,173,134,107,27,179,32,147,28,0,28,732,707,534,173,134,107,27,179,32,147,28,0,28
02/12/2021,Anchorage,7,LTACH,0,34,34,32,2,3,3,0,23,4,19,0,0,0,34,34,32,2,3,3,0,23,4,19,0,0,0
02/12/2021,Anchorage,7,Psych,0,,,,,,,,,,,,,,200,188,120,68,0,0,0,0,0,0,0,0,0
02/12/2021,Gulf Coast,4,CAH,1,106,96,24,72,4,0,4,18,0,18,0,0,0,106,96,24,72,4,0,4,18,0,18,0,0,0
02/12/2021,Gulf Coast,4,GACH,1,115,61,38,23,9,8,1,8,0,8,0,0,0,115,61,38,23,9,8,1,8,0,8,0,0,0
02/12/2021,Interior,6,GACH,1,101,81,46,35,20,11,9,16,0,16,2,0,2,101,81,46,35,20,11,9,16,0,16,2,0,2
02/12/2021,Matanuska-Susitna,3,GACH,1,184,160,72,88,14,9,5,33,2,31,0,0,0,184,160,72,88,14,9,5,33,2,31,0,0,0
02/12/2021,Northern,2,CAH,1,139,78,16,62,0,0,0,36,0,36,1,0,1,139,78,16,62,0,0,0,36,0,36,1,0,1
02/12/2021,Southeast,5,CAH,1,70,70,34,36,8,2,6,33,0,33,0,0,0,70,70,34,36,8,2,6,33,0,33,0,0,0
02/12/2021,Southeast,5,GACH,1,161,133,33,100,9,7,2,20,0,20,1,0,1,161,133,33,100,9,7,2,20,0,20,1,0,1
02/12/2021,Southwest,1,CAH,1,22,12,5,7,0,0,0,4,0,4,0,0,0,22,12,5,7,0,0,0,4,0,4,0,0,0
02/12/2021,Southwest,1,GACH,1,53,45,12,33,0,0,0,4,0,4,2,0,2,53,45,12,33,0,0,0,4,0,4,2,0,2
02/13/2021,Anchorage,7,GACH,1,726,702,520,182,133,102,31,179,31,148,25,0,25,726,702,520,182,133,102,31,179,31,148,25,0,25
02/13/2021,Anchorage,7,LTACH,0,34,34,32,2,3,3,0,23,4,19,0,0,0,34,34,32,2,3,3,0,23,4,19,0,0,0
02/13/2021,Anchorage,7,Psych,0,,,,,,,,,,,,,,200,188,120,68,0,0,0,0,0,0,0,0,0
02/13/2021,Gulf Coast,4,CAH,1,106,96,25,71,4,0,4,18,0,18,0,0,0,106,96,25,71,4,0,4,18,0,18,0,0,0
02/13/2021,Gulf Coast,4,GACH,1,115,61,33,28,9,5,4,8,0,8,0,0,0,115,61,33,28,9,5,4,8,0,8,0,0,0
02/13/2021,Interior,6,GACH,1,101,81,46,35,20,12,8,16,2,14,1,0,1,101,81,46,35,20,12,8,16,2,14,1,0,1
02/13/2021,Matanuska-Susitna,3,GACH,1,184,160,69,91,14,8,6,33,0,33,0,0,0,184,160,69,91,14,8,6,33,0,33,0,0,0
02/13/2021,Northern,2,CAH,1,139,78,17,61,0,0,0,36,0,36,1,0,1,139,78,17,61,0,0,0,36,0,36,1,0,1
02/13/2021,Southeast,5,CAH,1,70,70,31,39,8,2,6,33,0,33,0,0,0,70,70,31,39,8,2,6,33,0,33,0,0,0
02/13/2021,Southeast,5,GACH,1,161,133,31,102,9,6,3,20,0,20,1,0,1,161,133,31,102,9,6,3,20,0,20,1,0,1
02/13/2021,Southwest,1,CAH,1,22,12,2,10,0,0,0,4,0,4,0,0,0,22,12,2,10,0,0,0,4,0,4,0,0,0
02/13/2021,Southwest,1,GACH,1,53,45,18,27,0,0,0,4,0,4,2,0,2,53,45,18,27,0,0,0,4,0,4,2,0,2
02/14/2021,Anchorage,7,GACH,1,730,707,522,185,135,108,27,179,32,147,23,0,23,730,707,522,185,135,108,27,179,32,147,23,0,23
02/14/2021,Anchorage,7,LTACH,0,34,34,33,1,3,3,0,23,4,19,0,0,0,34,34,33,1,3,3,0,23,4,19,0,0,0
02/14/2021,Anchorage,7,Psych,0,,,,,,,,,,,,,,200,188,120,68,0,0,0,0,0,0,0,0,0
02/14/2021,Gulf Coast,4,CAH,1,106,97,26,71,4,0,4,18,0,18,0,0,0,106,97,26,71,4,0,4,18,0,18,0,0,0
02/14/2021,Gulf Coast,4,GACH,1,115,61,32,29,9,3,6,8,0,8,0,0,0,115,61,32,29,9,3,6,8,0,8,0,0,0
02/14/2021,Interior,6,GACH,1,101,81,48,33,20,9,11,16,1,15,1,0,1,101,81,48,33,20,9,11,16,1,15,1,0,1
02/14/2021,Matanuska-Susitna,3,GACH,1,184,160,63,97,14,5,9,33,1,32,0,0,0,184,160,63,97,14,5,9,33,1,32,0,0,0
02/14/2021,Northern,2,CAH,1,139,78,18,60,0,0,0,36,8,28,1,0,1,139,78,18,60,0,0,0,36,8,28,1,0,1
02/14/2021,Southeast,5,CAH,1,70,70,28,42,8,2,6,33,0,33,0,0,0,70,70,28,42,8,2,6,33,0,33,0,0,0
02/14/2021,Southeast,5,GACH,1,161,133,37,96,9,8,1,20,0,20,1,0,1,161,133,37,96,9,8,1,20,0,20,1,0,1
02/14/2021,Southwest,1,CAH,1,22,12,2,10,0,0,0,4,0,4,0,0,0,22,12,2,10,0,0,0,4,0,4,0,0,0
02/14/2021,Southwest,1,GACH,1,53,45,29,16,0,0,0,4,0,4,2,0,2,53,45,29,16,0,0,0,4,0,4,2,0,2
02/15/2021,Anchorage,7,GACH,1,728,705,524,181,131,104,27,179,32,147,24,8,32,728,705,524,181,131,104,27,179,32,147,24,8,32
02/15/2021,Anchorage,7,LTACH,0,34,34,33,1,3,3,0,23,4,19,0,0,0,34,34,33,1,3,3,0,23,4,19,0,0,0
02/15/2021,Anchorage,7,Psych,0,,,,,,,,,,,,,,200,188,120,68,0,0,0,0,0,0,0,0,0
02/15/2021,Gulf Coast,4,CAH,1,107,97,20,77,4,0,4,18,0,18,0,0,0,107,97,20,77,4,0,4,18,0,18,0,0,0
02/15/2021,Gulf Coast,4,GACH,1,115,61,34,27,9,3,6,8,0,8,0,0,0,115,61,34,27,9,3,6,8,0,8,0,0,0
02/15/2021,Interior,6,GACH,1,101,81,55,26,20,9,11,16,1,15,1,0,1,101,81,55,26,20,9,11,16,1,15,1,0,1
02/15/2021,Matanuska-Susitna,3,GACH,1,184,160,63,97,14,5,9,33,1,32,0,0,0,184,160,63,97,14,5,9,33,1,32,0,0,0
02/15/2021,Northern,2,CAH,1,139,78,12,66,0,0,0,36,0,36,1,0,1,139,78,12,66,0,0,0,36,0,36,1,0,1
02/15/2021,Southeast,5,CAH,1,70,70,21,49,8,0,8,33,0,33,0,0,0,70,70,21,49,8,0,8,33,0,33,0,0,0
02/15/2021,Southeast,5,GACH,1,161,133,42,91,9,6,3,20,0,20,1,0,1,161,133,42,91,9,6,3,20,0,20,1,0,1
02/15/2021,Southwest,1,CAH,1,22,12,3,9,0,0,0,4,0,4,0,0,0,22,12,3,9,0,0,0,4,0,4,0,0,0
02/15/2021,Southwest,1,GACH,1,53,45,30,15,0,0,0,4,0,4,2,0,2,53,45,30,15,0,0,0,4,0,4,2,0,2
02/16/2021,Anchorage,7,GACH,1,743,712,548,164,135,107,28,179,36,143,26,0,26,743,712,548,164,135,107,28,179,36,143,26,0,26
02/16/2021,Anchorage,7,LTACH,0,34,34,33,1,3,3,0,23,3,20,0,0,0,34,34,33,1,3,3,0,23,3,20,0,0,0
02/16/2021,Anchorage,7,Psych,0,140,140,64,76,0,0,0,0,0,0,0,0,0,200,188,112,76,0,0,0,0,0,0,0,0,0
02/16/2021,Gulf Coast,4,CAH,1,107,97,22,75,4,1,3,18,0,18,0,0,0,107,97,22,75,4,1,3,18,0,18,0,0,0
02/16/2021,Gulf Coast,4,GACH,1,115,61,37,24,9,3,6,8,0,8,1,0,1,115,61,37,24,9,3,6,8,0,8,1,0,1
02/16/2021,Interior,6,GACH,1,101,81,54,27,20,8,12,16,1,15,1,0,1,101,81,54,27,20,8,12,16,1,15,1,0,1
02/16/2021,Matanuska-Susitna,3,GACH,1,184,160,64,96,14,7,7,33,2,31,1,0,1,184,160,64,96,14,7,7,33,2,31,1,0,1
02/16/2021,Northern,2,CAH,1,139,78,14,64,0,0,0,36,0,36,2,0,2,139,78,14,64,0,0,0,36,0,36,2,0,2
02/16/2021,Southeast,5,CAH,1,70,70,24,46,8,0,8,33,0,33,0,0,0,70,70,24,46,8,0,8,33,0,33,0,0,0
02/16/2021,Southeast,5,GACH,1,161,133,39,94,9,5,4,20,0,20,1,0,1,161,133,39,94,9,5,4,20,0,20,1,0,1
02/16/2021,Southwest,1,CAH,1,22,12,3,9,0,0,0,4,0,4,0,0,0,22,12,3,9,0,0,0,4,0,4,0,0,0
02/16/2021,Southwest,1,GACH,1,53,45,23,22,0,0,0,4,0,4,1,0,1,53,45,23,22,0,0,0,4,0,4,1,0,1
02/17/2021,Anchorage,7,GACH,1,735,709,513,196,135,107,28,166,34,132,18,0,18,735,709,513,196,135,107,28,166,34,132,18,0,18
02/17/2021,Anchorage,7,LTACH,0,34,34,33,1,3,3,0,23,3,20,0,0,0,34,34,33,1,3,3,0,23,3,20,0,0,0
02/17/2021,Anchorage,7,Psych,0,60,55,55,0,0,0,0,0,0,0,0,0,0,200,195,119,76,0,0,0,0,0,0,0,0,0
02/17/2021,Gulf Coast,4,CAH,1,107,97,23,74,4,0,4,18,0,18,0,0,0,107,97,23,74,4,0,4,18,0,18,0,0,0
02/17/2021,Gulf Coast,4,GACH,1,115,61,44,17,9,7,2,8,0,8,1,0,1,115,61,44,17,9,7,2,8,0,8,1,0,1
02/17/2021,Interior,6,GACH,1,101,81,60,21,20,10,10,16,3,13,1,0,1,101,81,60,21,20,10,10,16,3,13,1,0,1
02/17/2021,Matanuska-Susitna,3,GACH,1,184,160,70,90,14,8,6,33,2,31,4,0,4,184,160,70,90,14,8,6,33,2,31,4,0,4
02/17/2021,Northern,2,CAH,1,139,78,13,65,0,0,0,36,0,36,2,0,2,139,78,13,65,0,0,0,36,0,36,2,0,2
02/17/2021,Southeast,5,CAH,1,70,70,26,44,8,1,7,33,0,33,1,0,1,70,70,26,44,8,1,7,33,0,33,1,0,1
02/17/2021,Southeast,5,GACH,1,161,133,41,92,9,7,2,20,0,20,1,0,1,161,133,41,92,9,7,2,20,0,20,1,0,1
02/17/2021,Southwest,1,CAH,1,22,12,4,8,0,0,0,4,0,4,0,0,0,22,12,4,8,0,0,0,4,0,4,0,0,0
02/17/2021,Southwest,1,GACH,1,53,45,11,34,0,0,0,4,0,4,1,0,1,53,45,11,34,0,0,0,4,0,4,1,0,1
02/18/2021,Anchorage,7,GACH,1,741,715,521,194,140,115,25,163,40,123,16,0,16,741,715,521,194,140,115,25,163,40,123,16,0,16
02/18/2021,Anchorage,7,LTACH,0,34,34,33,1,3,3,0,23,2,21,0,0,0,34,34,33,1,3,3,0,23,2,21,0,0,0
02/18/2021,Anchorage,7,Psych,0,,,,,,,,,,,,,,200,195,119,76,0,0,0,0,0,0,0,0,0
02/18/2021,Gulf Coast,4,CAH,1,107,97,22,75,4,0,4,18,0,18,0,0,0,107,97,22,75,4,0,4,18,0,18,0,0,0
02/18/2021,Gulf Coast,4,GACH,1,115,61,40,21,9,2,7,8,0,8,2,0,2,115,61,40,21,9,2,7,8,0,8,2,0,2
02/18/2021,Interior,6,GACH,1,101,81,63,18,20,13,7,16,1,15,1,0,1,101,81,63,18,20,13,7,16,1,15,1,0,1
02/18/2021,Matanuska-Susitna,3,GACH,1,184,160,64,96,14,7,7,33,1,32,3,0,3,184,160,64,96,14,7,7,33,1,32,3,0,3
02/18/2021,Northern,2,CAH,1,139,78,13,65,0,0,0,36,0,36,1,0,1,139,78,13,65,0,0,0,36,0,36,1,0,1
02/18/2021,Southeast,5,CAH,1,70,70,28,42,8,3,5,33,0,33,2,0,2,70,70,28,42,8,3,5,33,0,33,2,0,2
02/18/2021,Southeast,5,GACH,1,161,133,22,111,9,2,7,20,0,20,1,0,1,161,133,22,111,9,2,7,20,0,20,1,0,1
02/18/2021,Southwest,1,CAH,1,22,12,4,8,0,0,0,4,0,4,0,0,0,22,12,4,8,0,0,0,4,0,4,0,0,0
02/18/2021,Southwest,1,GACH,1,53,45,13,32,0,0,0,4,0,4,1,0,1,53,45,13,32,0,0,0,4,0,4,1,0,1
02/19/2021,Anchorage,7,GACH,1,717,694,500,194,132,103,29,163,37,126,15,0,15,717,694,500,194,132,103,29,163,37,126,15,0,15
02/19/2021,Anchorage,7,LTACH,0,34,34,33,1,3,3,0,23,2,21,0,0,0,34,34,33,1,3,3,0,23,2,21,0,0,0
02/19/2021,Anchorage,7,Psych,0,140,140,61,79,0,0,0,0,0,0,0,0,0,200,195,116,79,0,0,0,0,0,0,0,0,0
02/19/2021,Gulf Coast,4,CAH,1,108,99,24,75,4,0,4,18,0,18,0,0,0,108,99,24,75,4,0,4,18,0,18,0,0,0
02/19/2021,Gulf Coast,4,GACH,1,115,61,33,28,9,4,5,8,0,8,2,0,2,115,61,33,28,9,4,5,8,0,8,2,0,2
02/19/2021,Interior,6,GACH,1,101,81,41,40,20,14,6,16,1,15,2,0,2,101,81,41,40,20,14,6,16,1,15,2,0,2
02/19/2021,Matanuska-Susitna,3,GACH,1,184,160,60,100,14,8,6,33,2,31,5,0,5,184,160,60,100,14,8,6,33,2,31,5,0,5
02/19/2021,Northern,2,CAH,1,139,78,13,65,0,0,0,36,0,36,1,0,1,139,78,13,65,0,0,0,36,0,36,1,0,1
02/19/2021,Southeast,5,CAH,1,70,70,27,43,8,1,7,33,0,33,2,0,2,70,70,27,43,8,1,7,33,0,33,2,0,2
02/19/2021,Southeast,5,GACH,1,161,133,30,103,9,6,3,20,1,19,1,0,1,161,133,30,103,9,6,3,20,1,19,1,0,1
02/19/2021,Southwest,1,CAH,1,22,12,2,10,0,0,0,4,0,4,0,0,0,22,12,2,10,0,0,0,4,0,4,0,0,0
02/19/2021,Southwest,1,GACH,1,53,45,14,31,0,0,0,4,0,4,2,0,2,53,45,14,31,0,0,0,4,0,4,2,0,2
02/20/2021,Anchorage,7,GACH,1,713,693,501,192,131,96,35,163,37,126,16,8,24,713,693,501,192,131,96,35,163,37,126,16,8,24
02/20/2021,Anchorage,7,LTACH,0,34,34,32,2,3,3,0,23,3,20,0,0,0,34,34,32,2,3,3,0,23,3,20,0,0,0
02/20/2021,Anchorage,7,Psych,0,,,,,,,,,,,,,,200,195,116,79,0,0,0,0,0,0,0,0,0
02/20/2021,Gulf Coast,4,CAH,1,108,99,22,77,4,0,4,18,0,18,0,0,0,108,99,22,77,4,0,4,18,0,18,0,0,0
02/20/2021,Gulf Coast,4,GACH,1,115,61,35,26,9,2,7,8,0,8,2,0,2,115,61,35,26,9,2,7,8,0,8,2,0,2
02/20/2021,Interior,6,GACH,1,101,81,43,38,20,13,7,16,0,16,3,0,3,101,81,43,38,20,13,7,16,0,16,3,0,3
02/20/2021,Matanuska-Susitna,3,GACH,1,184,160,63,97,14,7,7,33,5,28,6,0,6,184,160,63,97,14,7,7,33,5,28,6,0,6
02/20/2021,Northern,2,CAH,1,139,78,14,64,0,0,0,36,0,36,1,0,1,139,78,14,64,0,0,0,36,0,36,1,0,1
02/20/2021,Southeast,5,CAH,1,70,70,28,42,8,1,7,33,0,33,3,0,3,70,70,28,42,8,1,7,33,0,33,3,0,3
02/20/2021,Southeast,5,GACH,1,161,133,26,107,9,4,5,20,1,19,1,0,1,161,133,26,107,9,4,5,20,1,19,1,0,1
02/20/2021,Southwest,1,CAH,1,22,12,1,11,0,0,0,4,0,4,0,0,0,22,12,1,11,0,0,0,4,0,4,0,0,0
02/20/2021,Southwest,1,GACH,1,53,45,13,32,0,0,0,4,0,4,2,0,2,53,45,13,32,0,0,0,4,0,4,2,0,2
02/21/2021,Anchorage,7,GACH,1,711,690,499,191,130,106,24,163,37,126,16,0,16,711,690,499,191,130,106,24,163,37,126,16,0,16
02/21/2021,Anchorage,7,LTACH,0,34,34,33,1,3,3,0,23,4,19,0,0,0,34,34,33,1,3,3,0,23,4,19,0,0,0
02/21/2021,Anchorage,7,Psych,0,,,,,,,,,,,,,,200,195,116,79,0,0,0,0,0,0,0,0,0
02/21/2021,Gulf Coast,4,CAH,1,107,98,28,70,4,0,4,18,0,18,0,0,0,107,98,28,70,4,0,4,18,0,18,0,0,0
02/21/2021,Gulf Coast,4,GACH,1,115,61,33,28,9,3,6,8,0,8,2,0,2,115,61,33,28,9,3,6,8,0,8,2,0,2
02/21/2021,Interior,6,GACH,1,101,81,36,45,20,13,7,16,0,16,2,0,2,101,81,36,45,20,13,7,16,0,16,2,0,2
02/21/2021,Matanuska-Susitna,3,GACH,1,184,160,63,97,14,12,2,33,2,31,7,0,7,184,160,63,97,14,12,2,33,2,31,7,0,7
02/21/2021,Northern,2,CAH,1,139,78,15,63,0,0,0,36,0,36,1,0,1,139,78,15,63,0,0,0,36,0,36,1,0,1
02/21/2021,Southeast,5,CAH,1,70,70,32,38,8,1,7,33,0,33,4,0,4,70,70,32,38,8,1,7,33,0,33,4,0,4
02/21/2021,Southeast,5,GACH,1,161,133,30,103,9,5,4,20,0,20,1,0,1,161,133,30,103,9,5,4,20,0,20,1,0,1
02/21/2021,Southwest,1,CAH,1,22,12,1,11,0,0,0,4,0,4,0,0,0,22,12,1,11,0,0,0,4,0,4,0,0,0
02/21/2021,Southwest,1,GACH,1,53,45,17,28,0,0,0,4,0,4,2,0,2,53,45,17,28,0,0,0,4,0,4,2,0,2
02/22/2021,Anchorage,7,GACH,1,714,694,524,170,131,107,24,165,34,131,19,0,19,714,694,524,170,131,107,24,165,34,131,19,0,19
02/22/2021,Anchorage,7,LTACH,0,34,34,33,1,3,3,0,23,4,19,0,0,0,34,34,33,1,3,3,0,23,4,19,0,0,0
02/22/2021,Anchorage,7,Psych,0,,,,,,,,,,,,,,200,195,116,79,0,0,0,0,0,0,0,0,0
02/22/2021,Gulf Coast,4,CAH,1,108,99,23,76,4,0,4,18,0,18,0,0,0,108,99,23,76,4,0,4,18,0,18,0,0,0
02/22/2021,Gulf Coast,4,GACH,1,115,61,37,24,9,4,5,8,0,8,3,0,3,115,61,37,24,9,4,5,8,0,8,3,0,3
02/22/2021,Interior,6,GACH,1,101,81,38,43,20,8,12,16,0,16,2,0,2,101,81,38,43,20,8,12,16,0,16,2,0,2
02/22/2021,Matanuska-Susitna,3,GACH,1,184,160,71,89,14,14,0,33,4,29,9,0,9,184,160,71,89,14,14,0,33,4,29,9,0,9
02/22/2021,Northern,2,CAH,1,139,78,20,58,0,0,0,36,0,36,1,0,1,139,78,20,58,0,0,0,36,0,36,1,0,1
02/22/2021,Southeast,5,CAH,1,70,70,26,44,8,0,8,33,0,33,2,0,2,70,70,26,44,8,0,8,33,0,33,2,0,2
02/22/2021,Southeast,5,GACH,1,161,133,30,103,9,3,6,20,0,20,1,0,1,161,133,30,103,9,3,6,20,0,20,1,0,1
02/22/2021,Southwest,1,CAH,1,22,12,2,10,0,0,0,4,0,4,0,0,0,22,12,2,10,0,0,0,4,0,4,0,0,0
02/22/2021,Southwest,1,GACH,1,53,45,18,27,0,0,0,4,0,4,2,0,2,53,45,18,27,0,0,0,4,0,4,2,0,2
02/23/2021,Anchorage,7,GACH,1,725,705,528,177,131,109,22,162,38,124,19,0,19,725,705,528,177,131,109,22,162,38,124,19,0,19
02/23/2021,Anchorage,7,LTACH,0,40,40,35,5,3,3,0,23,3,20,0,0,0,40,40,35,5,3,3,0,23,3,20,0,0,0
02/23/2021,Anchorage,7,Psych,0,,,,,,,,,,,,,,200,195,116,79,0,0,0,0,0,0,0,0,0
02/23/2021,Gulf Coast,4,CAH,1,108,99,23,76,4,0,4,18,0,18,1,0,1,108,99,23,76,4,0,4,18,0,18,1,0,1
02/23/2021,Gulf Coast,4,GACH,1,115,61,39,22,9,5,4,8,0,8,1,0,1,115,61,39,22,9,5,4,8,0,8,1,0,1
02/23/2021,Interior,6,GACH,1,101,81,47,34,20,10,10,16,1,15,3,1,4,101,81,47,34,20,10,10,16,1,15,3,1,4
02/23/2021,Matanuska-Susitna,3,GACH,1,184,160,91,69,14,13,1,33,4,29,11,0,11,184,160,91,69,14,13,1,33,4,29,11,0,11
02/23/2021,Northern,2,CAH,1,139,78,17,61,0,0,0,36,0,36,1,0,1,139,78,17,61,0,0,0,36,0,36,1,0,1
02/23/2021,Southeast,5,CAH,1,70,70,30,40,8,2,6,33,0,33,0,0,0,70,70,30,40,8,2,6,33,0,33,0,0,0
02/23/2021,Southeast,5,GACH,1,161,133,32,101,9,6,3,20,1,19,1,0,1,161,133,32,101,9,6,3,20,1,19,1,0,1
02/23/2021,Southwest,1,CAH,1,22,12,3,9,0,0,0,4,0,4,0,0,0,22,12,3,9,0,0,0,4,0,4,0,0,0
02/23/2021,Southwest,1,GACH,1,53,45,18,27,0,0,0,4,0,4,2,0,2,53,45,18,27,0,0,0,4,0,4,2,0,2
02/24/2021,Anchorage,7,GACH,1,724,703,550,153,127,105,22,168,28,140,22,0,22,724,703,550,153,127,105,22,168,28,140,22,0,22
02/24/2021,Anchorage,7,LTACH,0,40,40,37,3,3,3,0,23,3,20,0,0,0,40,40,37,3,3,3,0,23,3,20,0,0,0
02/24/2021,Anchorage,7,Psych,0,200,191,110,81,0,0,0,0,0,0,0,0,0,200,191,110,81,0,0,0,0,0,0,0,0,0
02/24/2021,Gulf Coast,4,CAH,1,107,98,22,76,4,0,4,18,0,18,1,0,1,107,98,22,76,4,0,4,18,0,18,1,0,1
02/24/2021,Gulf Coast,4,GACH,1,115,61,42,19,9,6,3,8,0,8,1,0,1,115,61,42,19,9,6,3,8,0,8,1,0,1
02/24/2021,Interior,6,GACH,1,101,81,55,26,20,11,9,16,1,15,3,1,4,101,81,55,26,20,11,9,16,1,15,3,1,4
02/24/2021,Matanuska-Susitna,3,GACH,1,184,160,91,69,14,12,2,33,4,29,10,0,10,184,160,91,69,14,12,2,33,4,29,10,0,10
02/24/2021,Northern,2,CAH,1,139,78,19,59,0,0,0,36,0,36,1,0,1,139,78,19,59,0,0,0,36,0,36,1,0,1
02/24/2021,Southeast,5,CAH,1,70,70,30,40,8,2,6,33,0,33,0,0,0,70,70,30,40,8,2,6,33,0,33,0,0,0
02/24/2021,Southeast,5,GACH,1,161,133,32,101,9,3,6,20,0,20,1,0,1,161,133,32,101,9,3,6,20,0,20,1,0,1
02/24/2021,Southwest,1,CAH,1,22,12,4,8,0,0,0,4,0,4,0,0,0,22,12,4,8,0,0,0,4,0,4,0,0,0
02/24/2021,Southwest,1,GACH,1,53,45,14,31,0,0,0,4,0,4,2,0,2,53,45,14,31,0,0,0,4,0,4,2,0,2
02/25/2021,Anchorage,7,GACH,1,734,701,546,155,131,109,22,171,27,144,18,0,18,734,701,546,155,131,109,22,171,27,144,18,0,18
02/25/2021,Anchorage,7,LTACH,0,40,40,36,4,3,3,0,23,3,20,0,0,0,40,40,36,4,3,3,0,23,3,20,0,0,0
02/25/2021,Anchorage,7,Psych,0,,,,,,,,,,,,,,200,191,110,81,0,0,0,0,0,0,0,0,0
02/25/2021,Gulf Coast,4,CAH,1,107,98,27,71,4,0,4,18,0,18,0,0,0,107,98,27,71,4,0,4,18,0,18,0,0,0
02/25/2021,Gulf Coast,4,GACH,1,115,61,43,18,9,8,1,8,1,7,2,0,2,115,61,43,18,9,8,1,8,1,7,2,0,2
02/25/2021,Interior,6,GACH,1,101,81,58,23,20,13,7,16,1,15,2,1,3,101,81,58,23,20,13,7,16,1,15,2,1,3
02/25/2021,Matanuska-Susitna,3,GACH,1,184,160,83,77,14,12,2,33,3,30,10,0,10,184,160,83,77,14,12,2,33,3,30,10,0,10
02/25/2021,Northern,2,CAH,1,139,78,18,60,0,0,0,36,0,36,1,0,1,139,78,18,60,0,0,0,36,0,36,1,0,1
02/25/2021,Southeast,5,CAH,1,70,70,30,40,8,2,6,33,0,33,0,0,0,70,70,30,40,8,2,6,33,0,33,0,0,0
02/25/2021,Southeast,5,GACH,1,161,133,31,102,9,5,4,20,0,20,1,0,1,161,133,31,102,9,5,4,20,0,20,1,0,1
02/25/2021,Southwest,1,CAH,1,22,12,4,8,0,0,0,4,0,4,0,0,0,22,12,4,8,0,0,0,4,0,4,0,0,0
02/25/2021,Southwest,1,GACH,1,53,45,21,24,0,0,0,4,0,4,2,0,2,53,45,21,24,0,0,0,4,0,4,2,0,2
02/26/2021,Anchorage,7,GACH,1,728,700,555,145,131,105,26,170,30,140,18,0,18,728,700,555,145,131,105,26,170,30,140,18,0,18
02/26/2021,Anchorage,7,LTACH,0,40,40,37,3,3,3,0,23,3,20,0,0,0,40,40,37,3,3,3,0,23,3,20,0,0,0
02/26/2021,Anchorage,7,Psych,0,,,,,,,,,,,,,,200,191,110,81,0,0,0,0,0,0,0,0,0
02/26/2021,Gulf Coast,4,CAH,1,108,99,31,68,4,0,4,18,0,18,0,0,0,108,99,31,68,4,0,4,18,0,18,0,0,0
02/26/2021,Gulf Coast,4,GACH,1,115,61,37,24,9,3,6,8,0,8,0,0,0,115,61,37,24,9,3,6,8,0,8,0,0,0
02/26/2021,Interior,6,GACH,1,101,81,49,32,20,12,8,16,1,15,1,1,2,101,81,49,32,20,12,8,16,1,15,1,1,2
02/26/2021,Matanuska-Susitna,3,GACH,1,184,160,91,69,14,14,0,33,2,31,10,0,10,184,160,91,69,14,14,0,33,2,31,10,0,10
02/26/2021,Northern,2,CAH,1,139,78,21,57,0,0,0,36,0,36,0,0,0,139,78,21,57,0,0,0,36,0,36,0,0,0
02/26/2021,Southeast,5,CAH,1,70,70,29,41,8,3,5,33,0,33,0,0,0,70,70,29,41,8,3,5,33,0,33,0,0,0
02/26/2021,Southeast,5,GACH,1,161,133,31,102,9,3,6,20,0,20,1,0,1,161,133,31,102,9,3,6,20,0,20,1,0,1
02/26/2021,Southwest,1,CAH,1,22,12,4,8,0,0,0,4,0,4,0,0,0,22,12,4,8,0,0,0,4,0,4,0,0,0
02/26/2021,Southwest,1,GACH,1,53,45,13,32,0,0,0,4,0,4,2,0,2,53,45,13,32,0,0,0,4,0,4,2,0,2
02/27/2021,Anchorage,7,GACH,1,726,698,528,170,130,103,27,166,35,131,16,0,16,726,698,528,170,130,103,27,166,35,131,16,0,16
02/27/2021,Anchorage,7,LTACH,0,40,40,38,2,3,3,0,23,3,20,0,0,0,40,40,38,2,3,3,0,23,3,20,0,0,0
02/27/2021,Anchorage,7,Psych,0,,,,,,,,,,,,,,200,191,110,81,0,0,0,0,0,0,0,0,0
02/27/2021,Gulf Coast,4,CAH,1,108,99,27,72,4,0,4,18,0,18,0,0,0,108,99,27,72,4,0,4,18,0,18,0,0,0
02/27/2021,Gulf Coast,4,GACH,1,115,61,38,23,9,6,3,8,0,8,0,0,0,115,61,38,23,9,6,3,8,0,8,0,0,0
02/27/2021,Interior,6,GACH,1,101,81,52,29,20,10,10,16,0,16,0,1,1,101,81,52,29,20,10,10,16,0,16,0,1,1
02/27/2021,Matanuska-Susitna,3,GACH,1,184,160,76,84,14,8,6,33,2,31,7,0,7,184,160,76,84,14,8,6,33,2,31,7,0,7
02/27/2021,Northern,2,CAH,1,139,78,19,59,0,0,0,36,0,36,0,0,0,139,78,19,59,0,0,0,36,0,36,0,0,0
02/27/2021,Southeast,5,CAH,1,70,70,34,36,8,2,6,33,0,33,1,0,1,70,70,34,36,8,2,6,33,0,33,1,0,1
02/27/2021,Southeast,5,GACH,1,161,133,29,104,9,3,6,20,0,20,1,0,1,161,133,29,104,9,3,6,20,0,20,1,0,1
02/27/2021,Southwest,1,CAH,1,22,12,3,9,0,0,0,4,0,4,0,0,0,22,12,3,9,0,0,0,4,0,4,0,0,0
02/27/2021,Southwest,1,GACH,1,53,45,11,34,0,0,0,4,0,4,2,0,2,53,45,11,34,0,0,0,4,0,4,2,0,2
02/28/2021,Anchorage,7,GACH,1,726,696,525,171,128,96,32,169,31,138,13,0,13,726,696,525,171,128,96,32,169,31,138,13,0,13
02/28/2021,Anchorage,7,LTACH,0,40,40,38,2,6,6,0,23,3,20,0,0,0,40,40,38,2,6,6,0,23,3,20,0,0,0
02/28/2021,Anchorage,7,Psych,0,,,,,,,,,,,,,,200,191,110,81,0,0,0,0,0,0,0,0,0
02/28/2021,Gulf Coast,4,CAH,1,108,99,28,71,4,0,4,18,0,18,0,0,0,108,99,28,71,4,0,4,18,0,18,0,0,0
02/28/2021,Gulf Coast,4,GACH,1,115,61,43,18,9,6,3,8,0,8,0,0,0,115,61,43,18,9,6,3,8,0,8,0,0,0
02/28/2021,Interior,6,GACH,1,101,81,48,33,20,8,12,16,2,14,0,1,1,101,81,48,33,20,8,12,16,2,14,0,1,1
02/28/2021,Matanuska-Susitna,3,GACH,1,184,160,72,88,14,5,9,33,3,30,4,0,4,184,160,72,88,14,5,9,33,3,30,4,0,4
02/28/2021,Northern,2,CAH,1,139,78,19,59,0,0,0,36,0,36,0,0,0,139,78,19,59,0,0,0,36,0,36,0,0,0
02/28/2021,Southeast,5,CAH,1,70,70,30,40,8,2,6,33,0,33,1,0,1,70,70,30,40,8,2,6,33,0,33,1,0,1
02/28/2021,Southeast,5,GACH,1,161,133,30,103,9,2,7,20,0,20,1,0,1,161,133,30,103,9,2,7,20,0,20,1,0,1
02/28/2021,Southwest,1,CAH,1,22,12,3,9,0,0,0,4,0,4,0,0,0,22,12,3,9,0,0,0,4,0,4,0,0,0
02/28/2021,Southwest,1,GACH,1,53,45,15,30,0,0,0,4,0,4,1,0,1,53,45,15,30,0,0,0,4,0,4,1,0,1
03/01/2021,Anchorage,7,GACH,1,724,696,509,187,127,95,32,169,27,142,14,0,14,724,696,509,187,127,95,32,169,27,142,14,0,14
03/01/2021,Anchorage,7,LTACH,0,44,44,37,7,6,6,0,23,2,21,0,0,0,44,44,37,7,6,6,0,23,2,21,0,0,0
03/01/2021,Anchorage,7,Psych,0,,,,,,,,,,,,,,200,191,110,81,0,0,0,0,0,0,0,0,0
03/01/2021,Gulf Coast,4,CAH,1,108,99,27,72,4,0,4,18,0,18,0,0,0,108,99,27,72,4,0,4,18,0,18,0,0,0
03/01/2021,Gulf Coast,4,GACH,1,115,61,39,22,9,4,5,8,0,8,0,0,0,115,61,39,22,9,4,5,8,0,8,0,0,0
03/01/2021,Interior,6,GACH,1,101,81,47,34,20,8,12,16,1,15,2,0,2,101,81,47,34,20,8,12,16,1,15,2,0,2
03/01/2021,Matanuska-Susitna,3,GACH,1,184,160,65,95,14,8,6,33,3,30,5,0,5,184,160,65,95,14,8,6,33,3,30,5,0,5
03/01/2021,Northern,2,CAH,1,139,78,19,59,0,0,0,36,0,36,0,0,0,139,78,19,59,0,0,0,36,0,36,0,0,0
03/01/2021,Southeast,5,CAH,1,70,70,26,44,8,0,8,33,0,33,1,0,1,70,70,26,44,8,0,8,33,0,33,1,0,1
03/01/2021,Southeast,5,GACH,1,161,133,35,98,9,4,5,20,0,20,0,0,0,161,133,35,98,9,4,5,20,0,20,0,0,0
03/01/2021,Southwest,1,CAH,1,22,12,2,10,0,0,0,4,0,4,0,0,0,22,12,2,10,0,0,0,4,0,4,0,0,0
03/01/2021,Southwest,1,GACH,1,53,45,10,35,0,0,0,4,0,4,0,0,0,53,45,10,35,0,0,0,4,0,4,0,0,0
03/02/2021,Anchorage,7,GACH,1,722,696,514,182,124,95,29,179,24,155,12,0,12,722,696,514,182,124,95,29,179,24,155,12,0,12
03/02/2021,Anchorage,7,LTACH,0,44,44,40,4,6,6,0,23,3,20,0,0,0,44,44,40,4,6,6,0,23,3,20,0,0,0
03/02/2021,Anchorage,7,Psych,0,140,140,61,79,0,0,0,0,0,0,0,0,0,200,191,112,79,0,0,0,0,0,0,0,0,0
03/02/2021,Gulf Coast,4,CAH,1,109,100,25,75,4,0,4,18,0,18,0,0,0,109,100,25,75,4,0,4,18,0,18,0,0,0
03/02/2021,Gulf Coast,4,GACH,1,115,61,41,20,9,6,3,8,1,7,1,0,1,115,61,41,20,9,6,3,8,1,7,1,0,1
03/02/2021,Interior,6,GACH,1,101,81,64,17,20,6,14,16,1,15,3,0,3,101,81,64,17,20,6,14,16,1,15,3,0,3
03/02/2021,Matanuska-Susitna,3,GACH,1,184,160,78,82,14,8,6,33,3,30,4,0,4,184,160,78,82,14,8,6,33,3,30,4,0,4
03/02/2021,Northern,2,CAH,1,139,78,19,59,0,0,0,36,0,36,1,0,1,139,78,19,59,0,0,0,36,0,36,1,0,1
03/02/2021,Southeast,5,CAH,1,70,70,28,42,8,1,7,33,0,33,1,0,1,70,70,28,42,8,1,7,33,0,33,1,0,1
03/02/2021,Southeast,5,GACH,1,161,133,36,97,9,5,4,20,1,19,0,0,0,161,133,36,97,9,5,4,20,1,19,0,0,0
03/02/2021,Southwest,1,CAH,1,22,12,1,11,0,0,0,4,0,4,0,0,0,22,12,1,11,0,0,0,4,0,4,0,0,0
03/02/2021,Southwest,1,GACH,1,53,45,9,36,0,0,0,4,0,4,1,0,1,53,45,9,36,0,0,0,4,0,4,1,0,1
03/03/2021,Anchorage,7,GACH,1,723,699,500,199,126,98,28,179,27,152,13,0,13,723,699,500,199,126,98,28,179,27,152,13,0,13
03/03/2021,Anchorage,7,LTACH,0,44,44,41,3,6,6,0,23,4,19,0,0,0,44,44,41,3,6,6,0,23,4,19,0,0,0
03/03/2021,Anchorage,7,Psych,0,60,58,58,0,0,0,0,0,0,0,0,0,0,200,198,119,79,0,0,0,0,0,0,0,0,0
03/03/2021,Gulf Coast,4,CAH,1,111,102,29,73,4,0,4,18,0,18,0,0,0,111,102,29,73,4,0,4,18,0,18,0,0,0
03/03/2021,Gulf Coast,4,GACH,1,115,61,42,19,9,7,2,8,0,8,2,0,2,115,61,42,19,9,7,2,8,0,8,2,0,2
03/03/2021,Interior,6,GACH,1,101,81,63,18,20,8,12,16,0,16,3,0,3,101,81,63,18,20,8,12,16,0,16,3,0,3
03/03/2021,Matanuska-Susitna,3,GACH,1,184,160,82,78,14,10,4,33,3,30,5,0,5,184,160,82,78,14,10,4,33,3,30,5,0,5
03/03/2021,Northern,2,CAH,1,139,78,23,55,0,0,0,36,0,36,1,0,1,139,78,23,55,0,0,0,36,0,36,1,0,1
03/03/2021,Southeast,5,CAH,1,70,70,27,43,8,1,7,33,0,33,2,0,2,70,70,27,43,8,1,7,33,0,33,2,0,2
03/03/2021,Southeast,5,GACH,1,161,133,36,97,9,3,6,20,1,19,0,0,0,161,133,36,97,9,3,6,20,1,19,0,0,0
03/03/2021,Southwest,1,CAH,1,22,12,1,11,0,0,0,4,0,4,0,0,0,22,12,1,11,0,0,0,4,0,4,0,0,0
03/03/2021,Southwest,1,GACH,1,53,45,11,34,0,0,0,4,0,4,1,0,1,53,45,11,34,0,0,0,4,0,4,1,0,1
03/04/2021,Anchorage,7,GACH,1,725,701,507,194,126,94,32,179,20,159,13,1,14,725,701,507,194,126,94,32,179,20,159,13,1,14
03/04/2021,Anchorage,7,LTACH,0,44,44,40,4,6,6,0,23,2,21,0,0,0,44,44,40,4,6,6,0,23,2,21,0,0,0
03/04/2021,Anchorage,7,Psych,0,,,,,,,,,,,,,,200,198,119,79,0,0,0,0,0,0,0,0,0
03/04/2021,Gulf Coast,4,CAH,1,112,103,19,84,4,0,4,18,0,18,0,0,0,112,103,19,84,4,0,4,18,0,18,0,0,0
03/04/2021,Gulf Coast,4,GACH,1,115,61,41,20,9,7,2,8,0,8,2,0,2,115,61,41,20,9,7,2,8,0,8,2,0,2
03/04/2021,Interior,6,GACH,1,101,81,61,20,20,7,13,16,0,16,5,0,5,101,81,61,20,20,7,13,16,0,16,5,0,5
03/04/2021,Matanuska-Susitna,3,GACH,1,184,160,81,79,14,8,6,33,3,30,5,0,5,184,160,81,79,14,8,6,33,3,30,5,0,5
03/04/2021,Northern,2,CAH,1,139,78,23,55,0,0,0,36,0,36,1,0,1,139,78,23,55,0,0,0,36,0,36,1,0,1
03/04/2021,Southeast,5,CAH,1,70,70,33,37,8,2,6,33,0,33,0,0,0,70,70,33,37,8,2,6,33,0,33,0,0,0
03/04/2021,Southeast,5,GACH,1,161,133,35,98,9,3,6,20,0,20,0,0,0,161,133,35,98,9,3,6,20,0,20,0,0,0
03/04/2021,Southwest,1,CAH,1,22,12,1,11,0,0,0,4,0,4,0,0,0,22,12,1,11,0,0,0,4,0,4,0,0,0
03/04/2021,Southwest,1,GACH,1,53,45,14,31,0,0,0,4,0,4,1,0,1,53,45,14,31,0,0,0,4,0,4,1,0,1
03/05/2021,Anchorage,7,GACH,1,720,694,496,198,127,93,34,179,22,157,15,0,15,720,694,496,198,127,93,34,179,22,157,15,0,15
03/05/2021,Anchorage,7,LTACH,0,44,44,40,4,6,6,0,23,4,19,0,0,0,44,44,40,4,6,6,0,23,4,19,0,0,0
03/05/2021,Anchorage,7,Psych,0,,,,,,,,,,,,,,200,198,119,79,0,0,0,0,0,0,0,0,0
03/05/2021,Gulf Coast,4,CAH,1,111,102,19,83,4,1,3,18,0,18,0,0,0,111,102,19,83,4,1,3,18,0,18,0,0,0
03/05/2021,Gulf Coast,4,GACH,1,115,61,39,22,9,3,6,8,0,8,2,0,2,115,61,39,22,9,3,6,8,0,8,2,0,2
03/05/2021,Interior,6,GACH,1,101,81,66,15,20,8,12,16,0,16,4,0,4,101,81,66,15,20,8,12,16,0,16,4,0,4
03/05/2021,Matanuska-Susitna,3,GACH,1,184,160,77,83,14,9,5,33,3,30,5,0,5,184,160,77,83,14,9,5,33,3,30,5,0,5
03/05/2021,Northern,2,CAH,1,139,78,22,56,0,0,0,36,0,36,1,0,1,139,78,22,56,0,0,0,36,0,36,1,0,1
03/05/2021,Southeast,5,CAH,1,70,70,25,45,8,2,6,33,0,33,0,0,0,70,70,25,45,8,2,6,33,0,33,0,0,0
03/05/2021,Southeast,5,GACH,1,161,133,31,102,9,1,8,20,0,20,0,0,0,161,133,31,102,9,1,8,20,0,20,0,0,0
03/05/2021,Southwest,1,CAH,1,22,12,1,11,0,0,0,4,0,4,0,0,0,22,12,1,11,0,0,0,4,0,4,0,0,0
03/05/2021,Southwest,1,GACH,1,53,45,15,30,0,0,0,4,0,4,1,0,1,53,45,15,30,0,0,0,4,0,4,1,0,1
03/06/2021,Anchorage,7,GACH,1,721,695,497,198,127,96,31,179,25,154,16,0,16,721,695,497,198,127,96,31,179,25,154,16,0,16
03/06/2021,Anchorage,7,LTACH,0,44,44,38,6,6,6,0,23,3,20,0,0,0,44,44,38,6,6,6,0,23,3,20,0,0,0
03/06/2021,Anchorage,7,Psych,0,,,,,,,,,,,,,,200,198,119,79,0,0,0,0,0,0,0,0,0
03/06/2021,Gulf Coast,4,CAH,1,111,102,21,81,4,1,3,18,0,18,0,0,0,111,102,21,81,4,1,3,18,0,18,0,0,0
03/06/2021,Gulf Coast,4,GACH,1,115,61,36,25,9,5,4,8,0,8,3,0,3,115,61,36,25,9,5,4,8,0,8,3,0,3
03/06/2021,Interior,6,GACH,1,101,81,50,31,20,6,14,16,0,16,4,0,4,101,81,50,31,20,6,14,16,0,16,4,0,4
03/06/2021,Matanuska-Susitna,3,GACH,1,184,160,74,86,14,11,3,33,3,30,5,0,5,184,160,74,86,14,11,3,33,3,30,5,0,5
03/06/2021,Northern,2,CAH,1,139,110,21,89,8,8,0,38,0,38,1,0,1,139,110,21,89,8,8,0,38,0,38,1,0,1
03/06/2021,Southeast,5,CAH,1,70,70,29,41,8,2,6,33,0,33,0,0,0,70,70,29,41,8,2,6,33,0,33,0,0,0
03/06/2021,Southeast,5,GACH,1,161,133,33,100,9,2,7,20,0,20,0,0,0,161,133,33,100,9,2,7,20,0,20,0,0,0
03/06/2021,Southwest,1,CAH,1,22,12,1,11,0,0,0,4,0,4,0,0,0,22,12,1,11,0,0,0,4,0,4,0,0,0
03/06/2021,Southwest,1,GACH,1,53,45,17,28,0,0,0,4,0,4,1,0,1,53,45,17,28,0,0,0,4,0,4,1,0,1
03/07/2021,Anchorage,7,GACH,1,720,694,500,194,127,98,29,179,21,158,19,0,19,720,694,500,194,127,98,29,179,21,158,19,0,19
03/07/2021,Anchorage,7,LTACH,0,44,44,37,7,6,6,0,23,3,20,0,0,0,44,44,37,7,6,6,0,23,3,20,0,0,0
03/07/2021,Anchorage,7,Psych,0,,,,,,,,,,,,,,200,198,119,79,0,0,0,0,0,0,0,0,0
03/07/2021,Gulf Coast,4,CAH,1,111,102,21,81,4,1,3,18,0,18,0,0,0,111,102,21,81,4,1,3,18,0,18,0,0,0
03/07/2021,Gulf Coast,4,GACH,1,115,61,39,22,9,5,4,8,0,8,3,0,3,115,61,39,22,9,5,4,8,0,8,3,0,3
03/07/2021,Interior,6,GACH,1,101,81,49,32,20,6,14,16,0,16,3,0,3,101,81,49,32,20,6,14,16,0,16,3,0,3
03/07/2021,Matanuska-Susitna,3,GACH,1,184,160,75,85,14,8,6,33,2,31,5,0,5,184,160,75,85,14,8,6,33,2,31,5,0,5
03/07/2021,Northern,2,CAH,1,139,78,19,59,0,0,0,38,0,38,1,0,1,139,78,19,59,0,0,0,38,0,38,1,0,1
03/07/2021,Southeast,5,CAH,1,70,70,27,43,8,2,6,33,0,33,0,0,0,70,70,27,43,8,2,6,33,0,33,0,0,0
03/07/2021,Southeast,5,GACH,1,161,133,31,102,9,2,7,20,0,20,0,0,0,161,133,31,102,9,2,7,20,0,20,0,0,0
03/07/2021,Southwest,1,CAH,1,22,12,1,11,0,0,0,4,0,4,0,0,0,22,12,1,11,0,0,0,4,0,4,0,0,0
03/07/2021,Southwest,1,GACH,1,53,45,17,28,0,0,0,4,0,4,1,0,1,53,45,17,28,0,0,0,4,0,4,1,0,1
03/08/2021,Anchorage,7,GACH,1,728,697,485,212,129,98,31,179,23,156,17,0,17,728,697,485,212,129,98,31,179,23,156,17,0,17
03/08/2021,Anchorage,7,LTACH,0,44,44,37,7,6,6,0,23,3,20,0,0,0,44,44,37,7,6,6,0,23,3,20,0,0,0
03/08/2021,Anchorage,7,Psych,0,,,,,,,,,,,,,,200,198,119,79,0,0,0,0,0,0,0,0,0
03/08/2021,Gulf Coast,4,CAH,1,111,102,23,79,4,1,3,18,0,18,1,0,1,111,102,23,79,4,1,3,18,0,18,1,0,1
03/08/2021,Gulf Coast,4,GACH,1,115,61,41,20,9,5,4,8,0,8,2,0,2,115,61,41,20,9,5,4,8,0,8,2,0,2
03/08/2021,Interior,6,GACH,1,101,81,35,46,20,9,11,16,1,15,2,0,2,101,81,35,46,20,9,11,16,1,15,2,0,2
03/08/2021,Matanuska-Susitna,3,GACH,1,184,160,76,84,14,12,2,33,4,29,6,0,6,184,160,76,84,14,12,2,33,4,29,6,0,6
03/08/2021,Northern,2,CAH,1,139,78,18,60,0,0,0,38,0,38,1,0,1,139,78,18,60,0,0,0,38,0,38,1,0,1
03/08/2021,Southeast,5,CAH,1,70,70,33,37,8,1,7,33,0,33,0,0,0,70,70,33,37,8,1,7,33,0,33,0,0,0
03/08/2021,Southeast,5,GACH,1,161,133,39,94,9,5,4,20,0,20,0,0,0,161,133,39,94,9,5,4,20,0,20,0,0,0
03/08/2021,Southwest,1,CAH,1,22,12,2,10,0,0,0,4,0,4,0,0,0,22,12,2,10,0,0,0,4,0,4,0,0,0
03/08/2021,Southwest,1,GACH,1,53,45,14,31,0,0,0,4,0,4,1,0,1,53,45,14,31,0,0,0,4,0,4,1,0,1
03/09/2021,Anchorage,7,GACH,1,729,697,486,211,126,101,25,179,24,155,20,0,20,729,697,486,211,126,101,25,179,24,155,20,0,20
03/09/2021,Anchorage,7,LTACH,0,44,44,39,5,6,5,1,23,2,21,0,0,0,44,44,39,5,6,5,1,23,2,21,0,0,0
03/09/2021,Anchorage,7,Psych,0,140,140,63,77,0,0,0,0,0,0,0,0,0,200,198,121,77,0,0,0,0,0,0,0,0,0
03/09/2021,Gulf Coast,4,CAH,1,111,102,23,79,4,1,3,18,0,18,1,0,1,111,102,23,79,4,1,3,18,0,18,1,0,1
03/09/2021,Gulf Coast,4,GACH,1,115,61,35,26,9,5,4,8,0,8,2,0,2,115,61,35,26,9,5,4,8,0,8,2,0,2
03/09/2021,Interior,6,GACH,1,101,81,42,39,20,8,12,16,0,16,1,0,1,101,81,42,39,20,8,12,16,0,16,1,0,1
03/09/2021,Matanuska-Susitna,3,GACH,1,184,160,93,67,14,10,4,33,2,31,5,0,5,184,160,93,67,14,10,4,33,2,31,5,0,5
03/09/2021,Northern,2,CAH,1,139,57,21,36,8,8,0,38,0,38,1,0,1,139,57,21,36,8,8,0,38,0,38,1,0,1
03/09/2021,Southeast,5,CAH,1,70,70,30,40,8,1,7,33,0,33,0,0,0,70,70,30,40,8,1,7,33,0,33,0,0,0
03/09/2021,Southeast,5,GACH,1,161,133,38,95,9,5,4,20,0,20,1,0,1,161,133,38,95,9,5,4,20,0,20,1,0,1
03/09/2021,Southwest,1,CAH,1,22,12,3,9,0,0,0,4,0,4,0,0,0,22,12,3,9,0,0,0,4,0,4,0,0,0
03/09/2021,Southwest,1,GACH,1,53,45,21,24,0,0,0,4,0,4,1,0,1,53,45,21,24,0,0,0,4,0,4,1,0,1
03/10/2021,Anchorage,7,GACH,1,730,698,515,183,128,103,25,179,21,158,20,0,20,730,698,515,183,128,103,25,179,21,158,20,0,20
03/10/2021,Anchorage,7,LTACH,0,44,44,39,5,6,5,1,23,3,20,0,0,0,44,44,39,5,6,5,1,23,3,20,0,0,0
03/10/2021,Anchorage,7,Psych,0,60,56,56,0,0,0,0,0,0,0,0,0,0,200,196,119,77,0,0,0,0,0,0,0,0,0
03/10/2021,Gulf Coast,4,CAH,1,112,103,32,71,4,1,3,18,0,18,1,0,1,112,103,32,71,4,1,3,18,0,18,1,0,1
03/10/2021,Gulf Coast,4,GACH,1,115,61,38,23,9,4,5,8,0,8,2,0,2,115,61,38,23,9,4,5,8,0,8,2,0,2
03/10/2021,Interior,6,GACH,1,101,81,53,28,20,11,9,16,0,16,3,0,3,101,81,53,28,20,11,9,16,0,16,3,0,3
03/10/2021,Matanuska-Susitna,3,GACH,1,184,160,95,65,14,11,3,33,3,30,6,0,6,184,160,95,65,14,11,3,33,3,30,6,0,6
03/10/2021,Northern,2,CAH,1,139,78,18,60,0,0,0,38,0,38,1,0,1,139,78,18,60,0,0,0,38,0,38,1,0,1
03/10/2021,Southeast,5,CAH,1,70,70,31,39,8,4,4,33,1,32,0,0,0,70,70,31,39,8,4,4,33,1,32,0,0,0
03/10/2021,Southeast,5,GACH,1,161,133,37,96,9,3,6,20,0,20,1,0,1,161,133,37,96,9,3,6,20,0,20,1,0,1
03/10/2021,Southwest,1,CAH,1,22,12,5,7,0,0,0,4,0,4,0,0,0,22,12,5,7,0,0,0,4,0,4,0,0,0
03/10/2021,Southwest,1,GACH,1,53,45,11,34,0,0,0,4,0,4,0,0,0,53,45,11,34,0,0,0,4,0,4,0,0,0
03/11/2021,Anchorage,7,GACH,1,751,724,582,142,126,104,22,179,25,154,21,0,21,751,724,582,142,126,104,22,179,25,154,21,0,21
03/11/2021,Anchorage,7,LTACH,0,44,44,38,6,6,4,2,23,2,21,0,0,0,44,44,38,6,6,4,2,23,2,21,0,0,0
03/11/2021,Anchorage,7,Psych,0,,,,,,,,,,,,,,200,196,119,77,0,0,0,0,0,0,0,0,0
03/11/2021,Gulf Coast,4,CAH,1,83,74,24,50,4,2,2,18,0,18,2,0,2,83,74,24,50,4,2,2,18,0,18,2,0,2
03/11/2021,Gulf Coast,4,GACH,1,115,61,35,26,9,3,6,8,0,8,0,0,0,115,61,35,26,9,3,6,8,0,8,0,0,0
03/11/2021,Interior,6,GACH,1,101,81,55,26,20,10,10,16,0,16,6,0,6,101,81,55,26,20,10,10,16,0,16,6,0,6
03/11/2021,Matanuska-Susitna,3,GACH,1,184,160,86,74,14,10,4,33,3,30,7,0,7,184,160,86,74,14,10,4,33,3,30,7,0,7
03/11/2021,Northern,2,CAH,1,139,78,17,61,0,0,0,38,0,38,1,0,1,139,78,17,61,0,0,0,38,0,38,1,0,1
03/11/2021,Southeast,5,CAH,1,70,70,43,27,8,3,5,33,0,33,0,0,0,70,70,43,27,8,3,5,33,0,33,0,0,0
03/11/2021,Southeast,5,GACH,1,161,133,38,95,9,3,6,20,0,20,1,0,1,161,133,38,95,9,3,6,20,0,20,1,0,1
03/11/2021,Southwest,1,CAH,1,22,12,3,9,0,0,0,4,0,4,0,0,0,22,12,3,9,0,0,0,4,0,4,0,0,0
03/11/2021,Southwest,1,GACH,1,53,45,13,32,0,0,0,4,0,4,0,0,0,53,45,13,32,0,0,0,4,0,4,0,0,0
03/12/2021,Anchorage,7,GACH,1,734,701,495,206,125,96,29,179,25,154,21,5,26,734,701,495,206,125,96,29,179,25,154,21,5,26
03/12/2021,Anchorage,7,LTACH,0,44,44,37,7,6,4,2,23,2,21,0,0,0,44,44,37,7,6,4,2,23,2,21,0,0,0
03/12/2021,Anchorage,7,Psych,0,,,,,,,,,,,,,,200,196,119,77,0,0,0,0,0,0,0,0,0
03/12/2021,Gulf Coast,4,CAH,1,83,74,19,55,4,2,2,18,0,18,1,0,1,83,74,19,55,4,2,2,18,0,18,1,0,1
03/12/2021,Gulf Coast,4,GACH,1,115,61,34,27,9,3,6,8,0,8,0,0,0,115,61,34,27,9,3,6,8,0,8,0,0,0
03/12/2021,Interior,6,GACH,1,101,81,52,29,20,11,9,16,0,16,3,0,3,101,81,52,29,20,11,9,16,0,16,3,0,3
03/12/2021,Matanuska-Susitna,3,GACH,1,184,160,92,68,14,8,6,33,3,30,10,0,10,184,160,92,68,14,8,6,33,3,30,10,0,10
03/12/2021,Northern,2,CAH,1,139,67,16,51,8,8,0,38,0,38,0,0,0,139,67,16,51,8,8,0,38,0,38,0,0,0
03/12/2021,Southeast,5,CAH,1,70,70,31,39,8,1,7,33,0,33,0,0,0,70,70,31,39,8,1,7,33,0,33,0,0,0
03/12/2021,Southeast,5,GACH,1,161,133,30,103,9,4,5,20,0,20,1,0,1,161,133,30,103,9,4,5,20,0,20,1,0,1
03/12/2021,Southwest,1,CAH,1,22,12,1,11,0,0,0,4,0,4,0,0,0,22,12,1,11,0,0,0,4,0,4,0,0,0
03/12/2021,Southwest,1,GACH,1,53,45,15,30,0,0,0,4,0,4,0,0,0,53,45,15,30,0,0,0,4,0,4,0,0,0
03/13/2021,Anchorage,7,GACH,1,732,700,499,201,127,90,37,179,25,154,19,6,25,732,700,499,201,127,90,37,179,25,154,19,6,25
03/13/2021,Anchorage,7,LTACH,0,44,44,34,10,6,4,2,23,2,21,0,0,0,44,44,34,10,6,4,2,23,2,21,0,0,0
03/13/2021,Anchorage,7,Psych,0,,,,,,,,,,,,,,200,196,119,77,0,0,0,0,0,0,0,0,0
03/13/2021,Gulf Coast,4,CAH,1,80,69,20,49,4,2,2,18,0,18,1,0,1,80,69,20,49,4,2,2,18,0,18,1,0,1
03/13/2021,Gulf Coast,4,GACH,1,115,61,35,26,9,2,7,8,0,8,0,0,0,115,61,35,26,9,2,7,8,0,8,0,0,0
03/13/2021,Interior,6,GACH,1,101,81,48,33,20,8,12,16,0,16,2,0,2,101,81,48,33,20,8,12,16,0,16,2,0,2
03/13/2021,Matanuska-Susitna,3,GACH,1,184,160,70,90,14,9,5,33,3,30,10,0,10,184,160,70,90,14,9,5,33,3,30,10,0,10
03/13/2021,Northern,2,CAH,1,139,110,11,99,0,0,0,38,0,38,0,0,0,139,110,11,99,0,0,0,38,0,38,0,0,0
03/13/2021,Southeast,5,CAH,1,70,70,29,41,8,1,7,33,0,33,0,0,0,70,70,29,41,8,1,7,33,0,33,0,0,0
03/13/2021,Southeast,5,GACH,1,161,133,37,96,9,2,7,20,0,20,1,0,1,161,133,37,96,9,2,7,20,0,20,1,0,1
03/13/2021,Southwest,1,CAH,1,22,12,1,11,0,0,0,4,0,4,0,0,0,22,12,1,11,0,0,0,4,0,4,0,0,0
03/13/2021,Southwest,1,GACH,1,53,45,20,25,0,0,0,4,0,4,0,0,0,53,45,20,25,0,0,0,4,0,4,0,0,0
03/14/2021,Anchorage,7,GACH,1,731,701,493,208,126,91,35,179,24,155,18,5,23,731,701,493,208,126,91,35,179,24,155,18,5,23
03/14/2021,Anchorage,7,LTACH,0,44,44,34,10,6,4,2,23,2,21,0,0,0,44,44,34,10,6,4,2,23,2,21,0,0,0
03/14/2021,Anchorage,7,Psych,0,,,,,,,,,,,,,,200,196,119,77,0,0,0,0,0,0,0,0,0
03/14/2021,Gulf Coast,4,CAH,1,80,69,25,44,4,3,1,18,0,18,1,0,1,80,69,25,44,4,3,1,18,0,18,1,0,1
03/14/2021,Gulf Coast,4,GACH,1,115,61,36,25,9,4,5,8,0,8,0,0,0,115,61,36,25,9,4,5,8,0,8,0,0,0
03/14/2021,Interior,6,GACH,1,101,81,52,29,20,7,13,16,0,16,3,0,3,101,81,52,29,20,7,13,16,0,16,3,0,3
03/14/2021,Matanuska-Susitna,3,GACH,1,184,160,67,93,14,10,4,33,4,29,7,0,7,184,160,67,93,14,10,4,33,4,29,7,0,7
03/14/2021,Northern,2,CAH,1,139,67,14,53,8,8,0,38,0,38,1,0,1,139,67,14,53,8,8,0,38,0,38,1,0,1
03/14/2021,Southeast,5,CAH,1,70,70,26,44,8,1,7,33,0,33,0,0,0,70,70,26,44,8,1,7,33,0,33,0,0,0
03/14/2021,Southeast,5,GACH,1,161,133,40,93,9,3,6,20,0,20,1,0,1,161,133,40,93,9,3,6,20,0,20,1,0,1
03/14/2021,Southwest,1,CAH,1,22,12,1,11,0,0,0,4,0,4,0,0,0,22,12,1,11,0,0,0,4,0,4,0,0,0
03/14/2021,Southwest,1,GACH,1,53,45,23,22,0,0,0,4,0,4,0,0,0,53,45,23,22,0,0,0,4,0,4,0,0,0
03/15/2021,Anchorage,7,GACH,1,725,701,509,192,124,97,27,179,22,157,22,0,22,725,701,509,192,124,97,27,179,22,157,22,0,22
03/15/2021,Anchorage,7,LTACH,0,44,44,34,10,6,4,2,23,2,21,0,0,0,44,44,34,10,6,4,2,23,2,21,0,0,0
03/15/2021,Anchorage,7,Psych,0,,,,,,,,,,,,,,200,196,119,77,0,0,0,0,0,0,0,0,0
03/15/2021,Gulf Coast,4,CAH,1,79,68,26,42,4,2,2,18,0,18,1,0,1,79,68,26,42,4,2,2,18,0,18,1,0,1
03/15/2021,Gulf Coast,4,GACH,1,115,61,38,23,9,5,4,8,0,8,0,0,0,115,61,38,23,9,5,4,8,0,8,0,0,0
03/15/2021,Interior,6,GACH,1,101,81,48,33,20,9,11,16,0,16,2,0,2,101,81,48,33,20,9,11,16,0,16,2,0,2
03/15/2021,Matanuska-Susitna,3,GACH,1,184,160,69,91,14,9,5,33,2,31,8,0,8,184,160,69,91,14,9,5,33,2,31,8,0,8
03/15/2021,Northern,2,CAH,1,139,110,12,98,8,0,8,38,0,38,0,0,0,139,110,12,98,8,0,8,38,0,38,0,0,0
03/15/2021,Southeast,5,CAH,1,70,70,29,41,8,3,5,33,0,33,0,0,0,70,70,29,41,8,3,5,33,0,33,0,0,0
03/15/2021,Southeast,5,GACH,1,161,133,37,96,9,1,8,20,0,20,1,0,1,161,133,37,96,9,1,8,20,0,20,1,0,1
03/15/2021,Southwest,1,CAH,1,22,12,0,12,0,0,0,4,0,4,0,0,0,22,12,0,12,0,0,0,4,0,4,0,0,0
03/15/2021,Southwest,1,GACH,1,53,45,23,22,0,0,0,4,0,4,0,0,0,53,45,23,22,0,0,0,4,0,4,0,0,0
03/16/2021,Anchorage,7,GACH,1,725,701,504,197,128,98,30,179,21,158,24,0,24,725,701,504,197,128,98,30,179,21,158,24,0,24
03/16/2021,Anchorage,7,LTACH,0,44,44,37,7,6,4,2,23,2,21,0,0,0,44,44,37,7,6,4,2,23,2,21,0,0,0
03/16/2021,Anchorage,7,Psych,0,,,,,,,,,,,,,,200,196,119,77,0,0,0,0,0,0,0,0,0
03/16/2021,Gulf Coast,4,CAH,1,79,68,27,41,4,2,2,18,0,18,0,0,0,79,68,27,41,4,2,2,18,0,18,0,0,0
03/16/2021,Gulf Coast,4,GACH,1,115,61,49,12,9,9,0,8,0,8,1,0,1,115,61,49,12,9,9,0,8,0,8,1,0,1
03/16/2021,Interior,6,GACH,1,101,81,56,25,20,10,10,16,0,16,2,0,2,101,81,56,25,20,10,10,16,0,16,2,0,2
03/16/2021,Matanuska-Susitna,3,GACH,1,184,160,74,86,14,7,7,33,0,33,6,0,6,184,160,74,86,14,7,7,33,0,33,6,0,6
03/16/2021,Northern,2,CAH,1,139,110,14,96,0,0,0,38,0,38,1,0,1,139,110,14,96,0,0,0,38,0,38,1,0,1
03/16/2021,Southeast,5,CAH,1,70,70,32,38,8,3,5,33,0,33,0,0,0,70,70,32,38,8,3,5,33,0,33,0,0,0
03/16/2021,Southeast,5,GACH,1,161,133,37,96,9,3,6,20,0,20,1,0,1,161,133,37,96,9,3,6,20,0,20,1,0,1
03/16/2021,Southwest,1,CAH,1,22,12,0,12,0,0,0,4,0,4,0,0,0,22,12,0,12,0,0,0,4,0,4,0,0,0
03/16/2021,Southwest,1,GACH,1,53,45,18,27,0,0,0,4,0,4,0,0,0,53,45,18,27,0,0,0,4,0,4,0,0,0
03/17/2021,Anchorage,7,GACH,1,724,699,533,166,129,95,34,179,21,158,22,0,22,724,699,533,166,129,95,34,179,21,158,22,0,22
03/17/2021,Anchorage,7,LTACH,0,44,44,38,6,6,4,2,23,2,21,0,0,0,44,44,38,6,6,4,2,23,2,21,0,0,0
03/17/2021,Anchorage,7,Psych,0,200,193,118,75,0,0,0,0,0,0,0,0,0,200,193,118,75,0,0,0,0,0,0,0,0,0
03/17/2021,Gulf Coast,4,CAH,1,79,68,23,45,4,2,2,18,0,18,0,0,0,79,68,23,45,4,2,2,18,0,18,0,0,0
03/17/2021,Gulf Coast,4,GACH,1,115,61,44,17,9,7,2,8,0,8,1,0,1,115,61,44,17,9,7,2,8,0,8,1,0,1
03/17/2021,Interior,6,GACH,1,101,81,52,29,20,11,9,16,0,16,3,0,3,101,81,52,29,20,11,9,16,0,16,3,0,3
03/17/2021,Matanuska-Susitna,3,GACH,1,184,160,74,86,14,3,11,33,2,31,8,0,8,184,160,74,86,14,3,11,33,2,31,8,0,8
03/17/2021,Northern,2,CAH,1,139,67,14,53,8,8,0,38,0,38,1,0,1,139,67,14,53,8,8,0,38,0,38,1,0,1
03/17/2021,Southeast,5,CAH,1,70,70,29,41,8,2,6,33,0,33,0,0,0,70,70,29,41,8,2,6,33,0,33,0,0,0
03/17/2021,Southeast,5,GACH,1,161,133,32,101,9,3,6,20,0,20,1,0,1,161,133,32,101,9,3,6,20,0,20,1,0,1
03/17/2021,Southwest,1,CAH,1,22,12,1,11,0,0,0,4,0,4,0,0,0,22,12,1,11,0,0,0,4,0,4,0,0,0
03/17/2021,Southwest,1,GACH,1,53,45,17,28,0,0,0,4,0,4,0,0,0,53,45,17,28,0,0,0,4,0,4,0,0,0
03/18/2021,Anchorage,7,GACH,1,724,701,531,170,127,98,29,179,23,156,25,0,25,724,701,531,170,127,98,29,179,23,156,25,0,25
03/18/2021,Anchorage,7,LTACH,0,44,44,38,6,6,4,2,23,2,21,0,0,0,44,44,38,6,6,4,2,23,2,21,0,0,0
03/18/2021,Anchorage,7,Psych,0,,,,,,,,,,,,,,200,193,118,75,0,0,0,0,0,0,0,0,0
03/18/2021,Gulf Coast,4,CAH,1,79,68,29,39,4,1,3,18,0,18,0,0,0,79,68,29,39,4,1,3,18,0,18,0,0,0
03/18/2021,Gulf Coast,4,GACH,1,115,61,45,16,9,7,2,8,0,8,1,0,1,115,61,45,16,9,7,2,8,0,8,1,0,1
03/18/2021,Interior,6,GACH,1,101,81,51,30,20,10,10,16,0,16,5,0,5,101,81,51,30,20,10,10,16,0,16,5,0,5
03/18/2021,Matanuska-Susitna,3,GACH,1,184,160,88,72,14,10,4,33,2,31,7,0,7,184,160,88,72,14,10,4,33,2,31,7,0,7
03/18/2021,Northern,2,CAH,1,139,67,13,54,8,8,0,38,0,38,0,0,0,139,67,13,54,8,8,0,38,0,38,0,0,0
03/18/2021,Southeast,5,CAH,1,70,70,29,41,8,2,6,33,1,32,0,0,0,70,70,29,41,8,2,6,33,1,32,0,0,0
03/18/2021,Southeast,5,GACH,1,161,133,32,101,9,2,7,20,0,20,1,0,1,161,133,32,101,9,2,7,20,0,20,1,0,1
03/18/2021,Southwest,1,CAH,1,22,12,1,11,0,0,0,4,0,4,0,0,0,22,12,1,11,0,0,0,4,0,4,0,0,0
03/18/2021,Southwest,1,GACH,1,53,45,17,28,0,0,0,4,0,4,0,0,0,53,45,17,28,0,0,0,4,0,4,0,0,0
03/19/2021,Anchorage,7,GACH,1,721,696,541,155,126,100,26,179,23,156,23,0,23,721,696,541,155,126,100,26,179,23,156,23,0,23
03/19/2021,Anchorage,7,LTACH,0,44,44,40,4,6,4,2,23,2,21,0,0,0,44,44,40,4,6,4,2,23,2,21,0,0,0
03/19/2021,Anchorage,7,Psych,0,,,,,,,,,,,,,,200,193,118,75,0,0,0,0,0,0,0,0,0
03/19/2021,Gulf Coast,4,CAH,1,79,68,26,42,4,0,4,18,0,18,0,0,0,79,68,26,42,4,0,4,18,0,18,0,0,0
03/19/2021,Gulf Coast,4,GACH,1,115,61,44,17,9,7,2,8,0,8,1,0,1,115,61,44,17,9,7,2,8,0,8,1,0,1
03/19/2021,Interior,6,GACH,1,101,81,47,34,20,10,10,16,0,16,4,0,4,101,81,47,34,20,10,10,16,0,16,4,0,4
03/19/2021,Matanuska-Susitna,3,GACH,1,184,160,74,86,14,12,2,33,1,32,7,0,7,184,160,74,86,14,12,2,33,1,32,7,0,7
03/19/2021,Northern,2,CAH,1,139,67,13,54,8,8,0,38,0,38,0,0,0,139,67,13,54,8,8,0,38,0,38,0,0,0
03/19/2021,Southeast,5,CAH,1,70,70,27,43,8,1,7,33,0,33,0,0,0,70,70,27,43,8,1,7,33,0,33,0,0,0
03/19/2021,Southeast,5,GACH,1,161,133,34,99,9,5,4,20,0,20,1,0,1,161,133,34,99,9,5,4,20,0,20,1,0,1
03/19/2021,Southwest,1,CAH,1,22,12,1,11,0,0,0,4,0,4,0,0,0,22,12,1,11,0,0,0,4,0,4,0,0,0
03/19/2021,Southwest,1,GACH,1,53,45,16,29,0,0,0,4,0,4,0,0,0,53,45,16,29,0,0,0,4,0,4,0,0,0
03/20/2021,Anchorage,7,GACH,1,721,697,504,193,126,97,29,179,23,156,21,1,22,721,697,504,193,126,97,29,179,23,156,21,1,22
03/20/2021,Anchorage,7,LTACH,0,44,44,39,5,6,4,2,23,2,21,0,0,0,44,44,39,5,6,4,2,23,2,21,0,0,0
03/20/2021,Anchorage,7,Psych,0,,,,,,,,,,,,,,200,193,118,75,0,0,0,0,0,0,0,0,0
03/20/2021,Gulf Coast,4,CAH,1,79,68,26,42,4,0,4,18,0,18,0,0,0,79,68,26,42,4,0,4,18,0,18,0,0,0
03/20/2021,Gulf Coast,4,GACH,1,115,61,49,12,9,9,0,8,0,8,1,0,1,115,61,49,12,9,9,0,8,0,8,1,0,1
03/20/2021,Interior,6,GACH,1,101,81,57,24,20,12,8,16,0,16,5,0,5,101,81,57,24,20,12,8,16,0,16,5,0,5
03/20/2021,Matanuska-Susitna,3,GACH,1,184,160,80,80,14,10,4,33,2,31,8,0,8,184,160,80,80,14,10,4,33,2,31,8,0,8
03/20/2021,Northern,2,CAH,1,139,67,12,55,8,8,0,38,0,38,0,0,0,139,67,12,55,8,8,0,38,0,38,0,0,0
03/20/2021,Southeast,5,CAH,1,70,70,27,43,8,0,8,33,0,33,0,0,0,70,70,27,43,8,0,8,33,0,33,0,0,0
03/20/2021,Southeast,5,GACH,1,161,133,30,103,9,5,4,20,0,20,1,0,1,161,133,30,103,9,5,4,20,0,20,1,0,1
03/20/2021,Southwest,1,CAH,1,22,12,1,11,0,0,0,4,0,4,0,0,0,22,12,1,11,0,0,0,4,0,4,0,0,0
03/20/2021,Southwest,1,GACH,1,53,45,21,24,0,0,0,4,0,4,0,0,0,53,45,21,24,0,0,0,4,0,4,0,0,0
03/21/2021,Anchorage,7,GACH,1,724,701,515,186,126,95,31,179,24,155,24,1,25,724,701,515,186,126,95,31,179,24,155,24,1,25
03/21/2021,Anchorage,7,LTACH,0,44,44,39,5,6,4,2,23,2,21,0,0,0,44,44,39,5,6,4,2,23,2,21,0,0,0
03/21/2021,Anchorage,7,Psych,0,,,,,,,,,,,,,,200,193,118,75,0,0,0,0,0,0,0,0,0
03/21/2021,Gulf Coast,4,CAH,1,78,68,25,43,4,0,4,18,0,18,0,0,0,78,68,25,43,4,0,4,18,0,18,0,0,0
03/21/2021,Gulf Coast,4,GACH,1,115,61,47,14,9,8,1,8,0,8,0,0,0,115,61,47,14,9,8,1,8,0,8,0,0,0
03/21/2021,Interior,6,GACH,1,101,81,41,40,20,7,13,16,0,16,4,0,4,101,81,41,40,20,7,13,16,0,16,4,0,4
03/21/2021,Matanuska-Susitna,3,GACH,1,184,160,81,79,14,10,4,33,1,32,11,0,11,184,160,81,79,14,10,4,33,1,32,11,0,11
03/21/2021,Northern,2,CAH,1,139,67,17,50,8,8,0,38,0,38,0,0,0,139,67,17,50,8,8,0,38,0,38,0,0,0
03/21/2021,Southeast,5,CAH,1,70,70,27,43,8,0,8,33,0,33,0,0,0,70,70,27,43,8,0,8,33,0,33,0,0,0
03/21/2021,Southeast,5,GACH,1,161,133,31,102,9,6,3,20,0,20,1,0,1,161,133,31,102,9,6,3,20,0,20,1,0,1
03/21/2021,Southwest,1,CAH,1,22,12,0,12,0,0,0,4,0,4,0,0,0,22,12,0,12,0,0,0,4,0,4,0,0,0
03/21/2021,Southwest,1,GACH,1,53,45,20,25,0,0,0,4,0,4,0,0,0,53,45,20,25,0,0,0,4,0,4,0,0,0
03/22/2021,Anchorage,7,GACH,1,724,700,520,180,125,98,27,179,24,155,21,1,22,724,700,520,180,125,98,27,179,24,155,21,1,22
03/22/2021,Anchorage,7,LTACH,0,44,44,39,5,6,4,2,23,2,21,0,0,0,44,44,39,5,6,4,2,23,2,21,0,0,0
03/22/2021,Anchorage,7,Psych,0,,,,,,,,,,,,,,200,193,118,75,0,0,0,0,0,0,0,0,0
03/22/2021,Gulf Coast,4,CAH,1,78,68,26,42,4,0,4,18,0,18,0,0,0,78,68,26,42,4,0,4,18,0,18,0,0,0
03/22/2021,Gulf Coast,4,GACH,1,115,61,42,19,9,8,1,8,0,8,0,0,0,115,61,42,19,9,8,1,8,0,8,0,0,0
03/22/2021,Interior,6,GACH,1,101,81,46,35,20,5,15,16,0,16,6,0,6,101,81,46,35,20,5,15,16,0,16,6,0,6
03/22/2021,Matanuska-Susitna,3,GACH,1,184,160,77,83,14,9,5,33,2,31,9,0,9,184,160,77,83,14,9,5,33,2,31,9,0,9
03/22/2021,Northern,2,CAH,1,139,67,20,47,8,8,0,36,0,36,0,0,0,139,67,20,47,8,8,0,36,0,36,0,0,0
03/22/2021,Southeast,5,CAH,1,70,70,36,34,8,0,8,33,0,33,0,0,0,70,70,36,34,8,0,8,33,0,33,0,0,0
03/22/2021,Southeast,5,GACH,1,161,133,36,97,9,6,3,20,0,20,1,0,1,161,133,36,97,9,6,3,20,0,20,1,0,1
03/22/2021,Southwest,1,CAH,1,22,12,2,10,0,0,0,4,0,4,0,0,0,22,12,2,10,0,0,0,4,0,4,0,0,0
03/22/2021,Southwest,1,GACH,1,53,45,20,25,0,0,0,4,0,4,0,0,0,53,45,20,25,0,0,0,4,0,4,0,0,0
03/23/2021,Anchorage,7,GACH,1,717,693,520,173,122,97,25,179,24,155,21,0,21,717,693,520,173,122,97,25,179,24,155,21,0,21
03/23/2021,Anchorage,7,LTACH,0,44,44,38,6,6,4,2,23,2,21,0,0,0,44,44,38,6,6,4,2,23,2,21,0,0,0
03/23/2021,Anchorage,7,Psych,0,,,,,,,,,,,,,,200,193,118,75,0,0,0,0,0,0,0,0,0
03/23/2021,Gulf Coast,4,CAH,1,78,68,28,40,4,1,3,18,0,18,0,0,0,78,68,28,40,4,1,3,18,0,18,0,0,0
03/23/2021,Gulf Coast,4,GACH,1,115,61,44,17,9,8,1,8,0,8,0,0,0,115,61,44,17,9,8,1,8,0,8,0,0,0
03/23/2021,Interior,6,GACH,1,101,81,55,26,20,6,14,16,0,16,5,0,5,101,81,55,26,20,6,14,16,0,16,5,0,5
03/23/2021,Matanuska-Susitna,3,GACH,1,184,160,89,71,14,9,5,33,3,30,9,0,9,184,160,89,71,14,9,5,33,3,30,9,0,9
03/23/2021,Northern,2,CAH,1,139,67,19,48,8,8,0,36,0,36,0,0,0,139,67,19,48,8,8,0,36,0,36,0,0,0
03/23/2021,Southeast,5,CAH,1,70,70,36,34,8,3,5,33,0,33,0,0,0,70,70,36,34,8,3,5,33,0,33,0,0,0
03/23/2021,Southeast,5,GACH,1,161,133,34,99,9,3,6,20,0,20,1,0,1,161,133,34,99,9,3,6,20,0,20,1,0,1
03/23/2021,Southwest,1,CAH,1,22,12,2,10,0,0,0,4,0,4,0,0,0,22,12,2,10,0,0,0,4,0,4,0,0,0
03/23/2021,Southwest,1,GACH,1,53,45,19,26,0,0,0,4,0,4,0,0,0,53,45,19,26,0,0,0,4,0,4,0,0,0
03/24/2021,Anchorage,7,GACH,1,725,702,536,166,123,99,24,179,27,152,16,0,16,725,702,536,166,123,99,24,179,27,152,16,0,16
03/24/2021,Anchorage,7,LTACH,0,44,44,37,7,6,4,2,23,2,21,0,0,0,44,44,37,7,6,4,2,23,2,21,0,0,0
03/24/2021,Anchorage,7,Psych,0,200,189,116,73,0,0,0,0,0,0,0,0,0,200,189,116,73,0,0,0,0,0,0,0,0,0
03/24/2021,Gulf Coast,4,CAH,1,78,68,25,43,4,2,2,18,0,18,0,0,0,78,68,25,43,4,2,2,18,0,18,0,0,0
03/24/2021,Gulf Coast,4,GACH,1,115,61,50,11,9,8,1,8,0,8,0,0,0,115,61,50,11,9,8,1,8,0,8,0,0,0
03/24/2021,Interior,6,GACH,1,101,81,56,25,20,10,10,16,0,16,1,0,1,101,81,56,25,20,10,10,16,0,16,1,0,1
03/24/2021,Matanuska-Susitna,3,GACH,1,184,160,90,70,14,9,5,33,2,31,11,0,11,184,160,90,70,14,9,5,33,2,31,11,0,11
03/24/2021,Northern,2,CAH,1,139,110,16,94,0,0,0,36,0,36,0,0,0,139,110,16,94,0,0,0,36,0,36,0,0,0
03/24/2021,Southeast,5,CAH,1,70,70,31,39,8,3,5,33,0,33,0,0,0,70,70,31,39,8,3,5,33,0,33,0,0,0
03/24/2021,Southeast,5,GACH,1,161,133,32,101,9,4,5,20,0,20,1,0,1,161,133,32,101,9,4,5,20,0,20,1,0,1
03/24/2021,Southwest,1,CAH,1,22,12,2,10,0,0,0,4,0,4,0,0,0,22,12,2,10,0,0,0,4,0,4,0,0,0
03/24/2021,Southwest,1,GACH,1,53,45,23,22,0,0,0,4,0,4,0,0,0,53,45,23,22,0,0,0,4,0,4,0,0,0
03/25/2021,Anchorage,7,GACH,1,726,700,510,190,125,98,27,179,23,156,11,0,11,726,700,510,190,125,98,27,179,23,156,11,0,11
03/25/2021,Anchorage,7,LTACH,0,44,44,38,6,6,4,2,23,2,21,0,0,0,44,44,38,6,6,4,2,23,2,21,0,0,0
03/25/2021,Anchorage,7,Psych,0,,,,,,,,,,,,,,200,189,116,73,0,0,0,0,0,0,0,0,0
03/25/2021,Gulf Coast,4,CAH,1,78,68,30,38,4,2,2,18,0,18,0,0,0,78,68,30,38,4,2,2,18,0,18,0,0,0
03/25/2021,Gulf Coast,4,GACH,1,115,61,44,17,9,7,2,8,0,8,1,0,1,115,61,44,17,9,7,2,8,0,8,1,0,1
03/25/2021,Interior,6,GACH,1,101,81,56,25,20,12,8,16,0,16,1,0,1,101,81,56,25,20,12,8,16,0,16,1,0,1
03/25/2021,Matanuska-Susitna,3,GACH,1,184,160,104,56,14,9,5,33,3,30,10,0,10,184,160,104,56,14,9,5,33,3,30,10,0,10
03/25/2021,Northern,2,CAH,1,139,110,20,90,0,0,0,36,0,36,0,0,0,139,110,20,90,0,0,0,36,0,36,0,0,0
03/25/2021,Southeast,5,CAH,1,70,70,35,35,8,3,5,33,0,33,0,0,0,70,70,35,35,8,3,5,33,0,33,0,0,0
03/25/2021,Southeast,5,GACH,1,161,133,35,98,9,3,6,20,0,20,0,0,0,161,133,35,98,9,3,6,20,0,20,0,0,0
03/25/2021,Southwest,1,CAH,1,22,12,3,9,0,0,0,4,0,4,0,0,0,22,12,3,9,0,0,0,4,0,4,0,0,0
03/25/2021,Southwest,1,GACH,1,53,45,14,31,0,0,0,4,0,4,0,0,0,53,45,14,31,0,0,0,4,0,4,0,0,0
03/26/2021,Anchorage,7,GACH,1,723,694,501,193,125,91,34,179,23,156,14,4,18,723,694,501,193,125,91,34,179,23,156,14,4,18
03/26/2021,Anchorage,7,LTACH,0,44,44,38,6,6,4,2,23,1,22,0,0,0,44,44,38,6,6,4,2,23,1,22,0,0,0
03/26/2021,Anchorage,7,Psych,0,,,,,,,,,,,,,,200,189,116,73,0,0,0,0,0,0,0,0,0
03/26/2021,Gulf Coast,4,CAH,1,78,68,26,42,4,2,2,18,2,16,0,0,0,78,68,26,42,4,2,2,18,2,16,0,0,0
03/26/2021,Gulf Coast,4,GACH,1,115,61,43,18,9,7,2,8,0,8,1,0,1,115,61,43,18,9,7,2,8,0,8,1,0,1
03/26/2021,Interior,6,GACH,1,101,81,52,29,20,11,9,16,0,16,1,0,1,101,81,52,29,20,11,9,16,0,16,1,0,1
03/26/2021,Matanuska-Susitna,3,GACH,1,184,160,98,62,14,12,2,33,3,30,8,0,8,184,160,98,62,14,12,2,33,3,30,8,0,8
03/26/2021,Northern,2,CAH,1,139,110,16,94,0,0,0,36,0,36,1,0,1,139,110,16,94,0,0,0,36,0,36,1,0,1
03/26/2021,Southeast,5,CAH,1,70,70,23,47,8,3,5,33,0,33,0,0,0,70,70,23,47,8,3,5,33,0,33,0,0,0
03/26/2021,Southeast,5,GACH,1,161,133,43,90,9,6,3,20,0,20,0,0,0,161,133,43,90,9,6,3,20,0,20,0,0,0
03/26/2021,Southwest,1,CAH,1,22,12,2,10,0,0,0,4,0,4,0,0,0,22,12,2,10,0,0,0,4,0,4,0,0,0
03/26/2021,Southwest,1,GACH,1,53,45,23,22,0,0,0,4,0,4,0,0,0,53,45,23,22,0,0,0,4,0,4,0,0,0
03/27/2021,Anchorage,7,GACH,1,715,689,490,199,121,84,37,179,24,155,12,0,12,715,689,490,199,121,84,37,179,24,155,12,0,12
03/27/2021,Anchorage,7,LTACH,0,44,44,39,5,6,4,2,23,1,22,0,0,0,44,44,39,5,6,4,2,23,1,22,0,0,0
03/27/2021,Anchorage,7,Psych,0,,,,,,,,,,,,,,200,189,116,73,0,0,0,0,0,0,0,0,0
03/27/2021,Gulf Coast,4,CAH,1,78,69,27,42,4,2,2,18,1,17,0,0,0,78,69,27,42,4,2,2,18,1,17,0,0,0
03/27/2021,Gulf Coast,4,GACH,1,115,61,43,18,9,7,2,8,2,6,1,0,1,115,61,43,18,9,7,2,8,2,6,1,0,1
03/27/2021,Interior,6,GACH,1,101,81,61,20,20,11,9,16,0,16,1,0,1,101,81,61,20,20,11,9,16,0,16,1,0,1
03/27/2021,Matanuska-Susitna,3,GACH,1,184,160,80,80,14,9,5,33,2,31,8,0,8,184,160,80,80,14,9,5,33,2,31,8,0,8
03/27/2021,Northern,2,CAH,1,139,110,14,96,0,0,0,36,0,36,1,0,1,139,110,14,96,0,0,0,36,0,36,1,0,1
03/27/2021,Southeast,5,CAH,1,70,70,23,47,8,3,5,33,0,33,0,0,0,70,70,23,47,8,3,5,33,0,33,0,0,0
03/27/2021,Southeast,5,GACH,1,161,133,37,96,9,5,4,20,0,20,0,0,0,161,133,37,96,9,5,4,20,0,20,0,0,0
03/27/2021,Southwest,1,CAH,1,22,12,2,10,0,0,0,4,0,4,0,0,0,22,12,2,10,0,0,0,4,0,4,0,0,0
03/27/2021,Southwest,1,GACH,1,53,45,22,23,0,0,0,4,0,4,0,0,0,53,45,22,23,0,0,0,4,0,4,0,0,0
03/28/2021,Anchorage,7,GACH,1,718,692,480,212,121,87,34,179,23,156,20,0,20,718,692,480,212,121,87,34,179,23,156,20,0,20
03/28/2021,Anchorage,7,LTACH,0,44,44,40,4,6,4,2,23,1,22,0,0,0,44,44,40,4,6,4,2,23,1,22,0,0,0
03/28/2021,Anchorage,7,Psych,0,,,,,,,,,,,,,,200,189,116,73,0,0,0,0,0,0,0,0,0
03/28/2021,Gulf Coast,4,CAH,1,78,69,27,42,4,1,3,18,1,17,0,0,0,78,69,27,42,4,1,3,18,1,17,0,0,0
03/28/2021,Gulf Coast,4,GACH,1,115,61,43,18,9,7,2,8,2,6,1,0,1,115,61,43,18,9,7,2,8,2,6,1,0,1
03/28/2021,Interior,6,GACH,1,101,81,44,37,20,10,10,16,0,16,3,0,3,101,81,44,37,20,10,10,16,0,16,3,0,3
03/28/2021,Matanuska-Susitna,3,GACH,1,184,160,82,78,14,8,6,33,2,31,8,0,8,184,160,82,78,14,8,6,33,2,31,8,0,8
03/28/2021,Northern,2,CAH,1,139,110,16,94,0,0,0,36,0,36,1,0,1,139,110,16,94,0,0,0,36,0,36,1,0,1
03/28/2021,Southeast,5,CAH,1,70,70,22,48,8,3,5,33,0,33,0,0,0,70,70,22,48,8,3,5,33,0,33,0,0,0
03/28/2021,Southeast,5,GACH,1,161,133,37,96,9,5,4,20,0,20,0,0,0,161,133,37,96,9,5,4,20,0,20,0,0,0
03/28/2021,Southwest,1,CAH,1,22,12,1,11,0,0,0,4,0,4,0,0,0,22,12,1,11,0,0,0,4,0,4,0,0,0
03/28/2021,Southwest,1,GACH,1,53,45,19,26,0,0,0,4,0,4,0,0,0,53,45,19,26,0,0,0,4,0,4,0,0,0
03/29/2021,Anchorage,7,GACH,1,726,700,504,196,123,85,38,179,23,156,18,0,18,726,700,504,196,123,85,38,179,23,156,18,0,18
03/29/2021,Anchorage,7,LTACH,0,44,44,40,4,6,4,2,23,1,22,0,0,0,44,44,40,4,6,4,2,23,1,22,0,0,0
03/29/2021,Anchorage,7,Psych,0,,,,,,,,,,,,,,200,189,116,73,0,0,0,0,0,0,0,0,0
03/29/2021,Gulf Coast,4,CAH,1,78,69,28,41,4,1,3,18,0,18,0,0,0,78,69,28,41,4,1,3,18,0,18,0,0,0
03/29/2021,Gulf Coast,4,GACH,1,115,61,40,21,9,5,4,8,2,6,1,0,1,115,61,40,21,9,5,4,8,2,6,1,0,1
03/29/2021,Interior,6,GACH,1,101,81,52,29,20,8,12,16,0,16,3,0,3,101,81,52,29,20,8,12,16,0,16,3,0,3
03/29/2021,Matanuska-Susitna,3,GACH,1,184,160,77,83,14,9,5,33,4,29,8,0,8,184,160,77,83,14,9,5,33,4,29,8,0,8
03/29/2021,Northern,2,CAH,1,139,110,17,93,0,0,0,36,0,36,1,0,1,139,110,17,93,0,0,0,36,0,36,1,0,1
03/29/2021,Southeast,5,CAH,1,70,70,27,43,8,4,4,33,0,33,0,0,0,70,70,27,43,8,4,4,33,0,33,0,0,0
03/29/2021,Southeast,5,GACH,1,161,133,39,94,9,3,6,20,0,20,0,0,0,161,133,39,94,9,3,6,20,0,20,0,0,0
03/29/2021,Southwest,1,CAH,1,22,12,2,10,0,0,0,4,0,4,0,0,0,22,12,2,10,0,0,0,4,0,4,0,0,0
03/29/2021,Southwest,1,GACH,1,53,45,10,35,0,0,0,4,0,4,0,0,0,53,45,10,35,0,0,0,4,0,4,0,0,0
03/30/2021,Anchorage,7,GACH,1,723,698,513,185,125,91,34,179,22,157,19,0,19,723,698,513,185,125,91,34,179,22,157,19,0,19
03/30/2021,Anchorage,7,LTACH,0,44,44,40,4,6,4,2,23,1,22,0,0,0,44,44,40,4,6,4,2,23,1,22,0,0,0
03/30/2021,Anchorage,7,Psych,0,,,,,,,,,,,,,,200,189,116,73,0,0,0,0,0,0,0,0,0
03/30/2021,Gulf Coast,4,CAH,1,78,69,31,38,4,1,3,18,0,18,0,0,0,78,69,31,38,4,1,3,18,0,18,0,0,0
03/30/2021,Gulf Coast,4,GACH,1,115,61,44,17,9,6,3,8,1,7,1,0,1,115,61,44,17,9,6,3,8,1,7,1,0,1
03/30/2021,Interior,6,GACH,1,101,81,53,28,20,8,12,16,0,16,4,0,4,101,81,53,28,20,8,12,16,0,16,4,0,4
03/30/2021,Matanuska-Susitna,3,GACH,1,194,160,87,73,14,12,2,33,4,29,10,0,10,194,160,87,73,14,12,2,33,4,29,10,0,10
03/30/2021,Northern,2,CAH,1,139,110,21,89,8,8,0,36,0,36,1,0,1,139,110,21,89,8,8,0,36,0,36,1,0,1
03/30/2021,Southeast,5,CAH,1,70,70,32,38,8,4,4,33,0,33,0,0,0,70,70,32,38,8,4,4,33,0,33,0,0,0
03/30/2021,Southeast,5,GACH,1,161,133,35,98,9,4,5,20,0,20,0,0,0,161,133,35,98,9,4,5,20,0,20,0,0,0
03/30/2021,Southwest,1,CAH,1,22,12,1,11,0,0,0,4,0,4,0,0,0,22,12,1,11,0,0,0,4,0,4,0,0,0
03/30/2021,Southwest,1,GACH,1,53,45,18,27,0,0,0,4,0,4,0,0,0,53,45,18,27,0,0,0,4,0,4,0,0,0
03/31/2021,Anchorage,7,GACH,1,728,704,519,185,136,89,47,179,21,158,20,0,20,728,704,519,185,136,89,47,179,21,158,20,0,20
03/31/2021,Anchorage,7,LTACH,0,44,44,42,2,6,4,2,23,2,21,0,0,0,44,44,42,2,6,4,2,23,2,21,0,0,0
03/31/2021,Anchorage,7,Psych,0,200,194,122,72,0,0,0,0,0,0,0,0,0,200,194,122,72,0,0,0,0,0,0,0,0,0
03/31/2021,Gulf Coast,4,CAH,1,78,69,31,38,4,2,2,18,0,18,0,0,0,78,69,31,38,4,2,2,18,0,18,0,0,0
03/31/2021,Gulf Coast,4,GACH,1,115,61,47,14,9,8,1,8,0,8,1,0,1,115,61,47,14,9,8,1,8,0,8,1,0,1
03/31/2021,Interior,6,GACH,1,101,81,59,22,20,5,15,16,0,16,3,0,3,101,81,59,22,20,5,15,16,0,16,3,0,3
03/31/2021,Matanuska-Susitna,3,GACH,1,184,160,78,82,14,14,0,33,5,28,10,0,10,184,160,78,82,14,14,0,33,5,28,10,0,10
03/31/2021,Northern,2,CAH,1,139,110,18,92,8,0,8,36,0,36,1,0,1,139,110,18,92,8,0,8,36,0,36,1,0,1
03/31/2021,Southeast,5,CAH,1,70,70,31,39,8,4,4,33,0,33,0,0,0,70,70,31,39,8,4,4,33,0,33,0,0,0
03/31/2021,Southeast,5,GACH,1,161,133,39,94,9,5,4,20,0,20,0,0,0,161,133,39,94,9,5,4,20,0,20,0,0,0
03/31/2021,Southwest,1,CAH,1,22,12,1,11,0,0,0,4,0,4,0,0,0,22,12,1,11,0,0,0,4,0,4,0,0,0
03/31/2021,Southwest,1,GACH,1,53,45,14,31,0,0,0,4,0,4,0,0,0,53,45,14,31,0,0,0,4,0,4,0,0,0
04/01/2021,Anchorage,7,GACH,1,728,705,533,172,139,95,44,179,23,156,24,0,24,728,705,533,172,139,95,44,179,23,156,24,0,24
04/01/2021,Anchorage,7,LTACH,0,44,44,42,2,6,4,2,23,2,21,0,0,0,44,44,42,2,6,4,2,23,2,21,0,0,0
04/01/2021,Anchorage,7,Psych,0,,,,,,,,,,,,,,200,194,122,72,0,0,0,0,0,0,0,0,0
04/01/2021,Gulf Coast,4,CAH,1,83,70,34,36,4,2,2,18,0,18,0,0,0,83,70,34,36,4,2,2,18,0,18,0,0,0
04/01/2021,Gulf Coast,4,GACH,1,115,61,44,17,9,9,0,8,0,8,1,0,1,115,61,44,17,9,9,0,8,0,8,1,0,1
04/01/2021,Interior,6,GACH,1,101,81,65,16,20,9,11,16,1,15,2,0,2,101,81,65,16,20,9,11,16,1,15,2,0,2
04/01/2021,Matanuska-Susitna,3,GACH,1,184,160,74,86,14,12,2,33,6,27,12,0,12,184,160,74,86,14,12,2,33,6,27,12,0,12
04/01/2021,Northern,2,CAH,1,139,110,19,91,0,0,0,36,0,36,1,0,1,139,110,19,91,0,0,0,36,0,36,1,0,1
04/01/2021,Southeast,5,CAH,1,70,70,30,40,8,5,3,33,0,33,0,0,0,70,70,30,40,8,5,3,33,0,33,0,0,0
04/01/2021,Southeast,5,GACH,1,161,133,37,96,9,5,4,20,0,20,0,0,0,161,133,37,96,9,5,4,20,0,20,0,0,0
04/01/2021,Southwest,1,CAH,1,22,12,1,11,0,0,0,4,0,4,0,0,0,22,12,1,11,0,0,0,4,0,4,0,0,0
04/01/2021,Southwest,1,GACH,1,53,45,17,28,0,0,0,4,0,4,0,0,0,53,45,17,28,0,0,0,4,0,4,0,0,0
04/02/2021,Anchorage,7,GACH,1,729,704,535,169,142,98,44,179,26,153,24,0,24,729,704,535,169,142,98,44,179,26,153,24,0,24
04/02/2021,Anchorage,7,LTACH,0,44,44,39,5,6,4,2,23,2,21,0,0,0,44,44,39,5,6,4,2,23,2,21,0,0,0
04/02/2021,Anchorage,7,Psych,0,,,,,,,,,,,,,,200,194,122,72,0,0,0,0,0,0,0,0,0
04/02/2021,Gulf Coast,4,CAH,1,83,70,23,47,4,1,3,18,0,18,0,0,0,83,70,23,47,4,1,3,18,0,18,0,0,0
04/02/2021,Gulf Coast,4,GACH,1,115,61,36,25,9,9,0,8,0,8,1,0,1,115,61,36,25,9,9,0,8,0,8,1,0,1
04/02/2021,Interior,6,GACH,1,101,81,55,26,20,10,10,16,1,15,3,0,3,101,81,55,26,20,10,10,16,1,15,3,0,3
04/02/2021,Matanuska-Susitna,3,GACH,1,184,160,85,75,14,14,0,33,7,26,17,0,17,184,160,85,75,14,14,0,33,7,26,17,0,17
04/02/2021,Northern,2,CAH,1,139,110,18,92,8,0,8,36,0,36,1,0,1,139,110,18,92,8,0,8,36,0,36,1,0,1
04/02/2021,Southeast,5,CAH,1,70,70,30,40,8,2,6,33,0,33,0,0,0,70,70,30,40,8,2,6,33,0,33,0,0,0
04/02/2021,Southeast,5,GACH,1,161,133,38,95,9,5,4,20,0,20,0,0,0,161,133,38,95,9,5,4,20,0,20,0,0,0
04/02/2021,Southwest,1,CAH,1,22,12,1,11,0,0,0,4,0,4,0,0,0,22,12,1,11,0,0,0,4,0,4,0,0,0
04/02/2021,Southwest,1,GACH,1,53,45,25,20,0,0,0,4,0,4,1,0,1,53,45,25,20,0,0,0,4,0,4,1,0,1
04/03/2021,Anchorage,7,GACH,1,715,689,539,150,132,94,38,179,26,153,16,0,16,715,689,539,150,132,94,38,179,26,153,16,0,16
04/03/2021,Anchorage,7,LTACH,0,44,44,37,7,6,4,2,23,1,22,0,0,0,44,44,37,7,6,4,2,23,1,22,0,0,0
04/03/2021,Anchorage,7,Psych,0,,,,,,,,,,,,,,200,194,122,72,0,0,0,0,0,0,0,0,0
04/03/2021,Gulf Coast,4,CAH,1,83,70,27,43,4,1,3,18,0,18,1,0,1,83,70,27,43,4,1,3,18,0,18,1,0,1
04/03/2021,Gulf Coast,4,GACH,1,115,61,41,20,9,9,0,8,0,8,1,0,1,115,61,41,20,9,9,0,8,0,8,1,0,1
04/03/2021,Interior,6,GACH,1,101,81,54,27,20,7,13,16,2,14,2,0,2,101,81,54,27,20,7,13,16,2,14,2,0,2
04/03/2021,Matanuska-Susitna,3,GACH,1,184,160,73,87,14,13,1,33,7,26,15,0,15,184,160,73,87,14,13,1,33,7,26,15,0,15
04/03/2021,Northern,2,CAH,1,139,110,19,91,0,0,0,36,0,36,1,0,1,139,110,19,91,0,0,0,36,0,36,1,0,1
04/03/2021,Southeast,5,CAH,1,70,70,30,40,8,2,6,33,0,33,0,0,0,70,70,30,40,8,2,6,33,0,33,0,0,0
04/03/2021,Southeast,5,GACH,1,161,133,36,97,9,2,7,20,0,20,0,0,0,161,133,36,97,9,2,7,20,0,20,0,0,0
04/03/2021,Southwest,1,CAH,1,22,12,3,9,0,0,0,4,0,4,0,0,0,22,12,3,9,0,0,0,4,0,4,0,0,0
04/03/2021,Southwest,1,GACH,1,53,45,21,24,0,0,0,4,0,4,1,0,1,53,45,21,24,0,0,0,4,0,4,1,0,1
04/04/2021,Anchorage,7,GACH,1,717,690,514,176,133,96,37,179,27,152,18,0,18,717,690,514,176,133,96,37,179,27,152,18,0,18
04/04/2021,Anchorage,7,LTACH,0,44,44,37,7,6,4,2,23,1,22,1,0,1,44,44,37,7,6,4,2,23,1,22,1,0,1
04/04/2021,Anchorage,7,Psych,0,,,,,,,,,,,,,,200,194,122,72,0,0,0,0,0,0,0,0,0
04/04/2021,Gulf Coast,4,CAH,1,83,70,26,44,4,1,3,18,0,18,1,0,1,83,70,26,44,4,1,3,18,0,18,1,0,1
04/04/2021,Gulf Coast,4,GACH,1,115,61,41,20,9,6,3,8,0,8,0,0,0,115,61,41,20,9,6,3,8,0,8,0,0,0
04/04/2021,Interior,6,GACH,1,101,81,49,32,20,9,11,16,1,15,2,0,2,101,81,49,32,20,9,11,16,1,15,2,0,2
04/04/2021,Matanuska-Susitna,3,GACH,1,184,160,79,81,14,13,1,33,6,27,11,0,11,184,160,79,81,14,13,1,33,6,27,11,0,11
04/04/2021,Northern,2,CAH,1,139,110,15,95,8,8,0,36,0,36,1,0,1,139,110,15,95,8,8,0,36,0,36,1,0,1
04/04/2021,Southeast,5,CAH,1,70,70,29,41,8,2,6,33,0,33,0,0,0,70,70,29,41,8,2,6,33,0,33,0,0,0
04/04/2021,Southeast,5,GACH,1,161,133,37,96,9,2,7,20,0,20,0,0,0,161,133,37,96,9,2,7,20,0,20,0,0,0
04/04/2021,Southwest,1,CAH,1,22,12,1,11,0,0,0,4,0,4,0,0,0,22,12,1,11,0,0,0,4,0,4,0,0,0
04/04/2021,Southwest,1,GACH,1,53,45,23,22,0,0,0,4,0,4,1,0,1,53,45,23,22,0,0,0,4,0,4,1,0,1
04/05/2021,Anchorage,7,GACH,1,728,701,513,188,135,93,42,179,26,153,22,4,26,728,701,513,188,135,93,42,179,26,153,22,4,26
04/05/2021,Anchorage,7,LTACH,0,44,44,37,7,6,4,2,23,1,22,1,0,1,44,44,37,7,6,4,2,23,1,22,1,0,1
04/05/2021,Anchorage,7,Psych,0,,,,,,,,,,,,,,200,194,122,72,0,0,0,0,0,0,0,0,0
04/05/2021,Gulf Coast,4,CAH,1,83,70,26,44,4,1,3,18,0,18,1,0,1,83,70,26,44,4,1,3,18,0,18,1,0,1
04/05/2021,Gulf Coast,4,GACH,1,115,61,41,20,9,5,4,8,0,8,0,0,0,115,61,41,20,9,5,4,8,0,8,0,0,0
04/05/2021,Interior,6,GACH,1,101,81,43,38,20,8,12,16,0,16,2,0,2,101,81,43,38,20,8,12,16,0,16,2,0,2
04/05/2021,Matanuska-Susitna,3,GACH,1,184,160,89,71,14,14,0,33,6,27,12,0,12,184,160,89,71,14,14,0,33,6,27,12,0,12
04/05/2021,Northern,2,CAH,1,139,110,14,96,0,0,0,36,0,36,1,0,1,139,110,14,96,0,0,0,36,0,36,1,0,1
04/05/2021,Southeast,5,CAH,1,70,70,38,32,8,4,4,33,0,33,0,0,0,70,70,38,32,8,4,4,33,0,33,0,0,0
04/05/2021,Southeast,5,GACH,1,161,133,34,99,9,4,5,20,0,20,0,0,0,161,133,34,99,9,4,5,20,0,20,0,0,0
04/05/2021,Southwest,1,CAH,1,22,12,1,11,0,0,0,4,0,4,0,0,0,22,12,1,11,0,0,0,4,0,4,0,0,0
04/05/2021,Southwest,1,GACH,1,53,45,13,32,0,0,0,4,0,4,1,0,1,53,45,13,32,0,0,0,4,0,4,1,0,1
04/06/2021,Anchorage,7,GACH,1,732,705,511,194,138,102,36,179,28,151,20,4,24,732,705,511,194,138,102,36,179,28,151,20,4,24
04/06/2021,Anchorage,7,LTACH,0,44,44,38,6,6,4,2,23,1,22,1,0,1,44,44,38,6,6,4,2,23,1,22,1,0,1
04/06/2021,Anchorage,7,Psych,0,,,,,,,,,,,,,,200,194,122,72,0,0,0,0,0,0,0,0,0
04/06/2021,Gulf Coast,4,CAH,1,83,69,29,40,4,1,3,18,0,18,1,0,1,83,69,29,40,4,1,3,18,0,18,1,0,1
04/06/2021,Gulf Coast,4,GACH,1,115,61,37,24,9,4,5,8,0,8,2,0,2,115,61,37,24,9,4,5,8,0,8,2,0,2
04/06/2021,Interior,6,GACH,1,101,81,48,33,20,6,14,16,0,16,1,0,1,101,81,48,33,20,6,14,16,0,16,1,0,1
04/06/2021,Matanuska-Susitna,3,GACH,1,184,160,96,64,14,14,0,33,5,28,13,0,13,184,160,96,64,14,14,0,33,5,28,13,0,13
04/06/2021,Northern,2,CAH,1,139,110,14,96,0,0,0,36,0,36,1,0,1,139,110,14,96,0,0,0,36,0,36,1,0,1
04/06/2021,Southeast,5,CAH,1,70,70,35,35,8,1,7,33,0,33,0,0,0,70,70,35,35,8,1,7,33,0,33,0,0,0
04/06/2021,Southeast,5,GACH,1,161,133,37,96,9,5,4,20,0,20,0,0,0,161,133,37,96,9,5,4,20,0,20,0,0,0
04/06/2021,Southwest,1,CAH,1,22,12,3,9,0,0,0,4,0,4,0,0,0,22,12,3,9,0,0,0,4,0,4,0,0,0
04/06/2021,Southwest,1,GACH,1,53,45,11,34,0,0,0,4,0,4,1,0,1,53,45,11,34,0,0,0,4,0,4,1,0,1
04/07/2021,Anchorage,7,GACH,1,736,703,517,186,137,97,40,179,28,151,21,4,25,736,703,517,186,137,97,40,179,28,151,21,4,25
04/07/2021,Anchorage,7,LTACH,0,44,44,37,7,6,4,2,23,1,22,1,0,1,44,44,37,7,6,4,2,23,1,22,1,0,1
04/07/2021,Anchorage,7,Psych,0,200,189,120,69,0,0,0,0,0,0,0,0,0,200,189,120,69,0,0,0,0,0,0,0,0,0
04/07/2021,Gulf Coast,4,CAH,1,83,69,26,43,4,1,3,18,0,18,1,0,1,83,69,26,43,4,1,3,18,0,18,1,0,1
04/07/2021,Gulf Coast,4,GACH,1,115,61,41,20,9,5,4,8,0,8,2,0,2,115,61,41,20,9,5,4,8,0,8,2,0,2
04/07/2021,Interior,6,GACH,1,101,81,60,21,20,5,15,16,0,16,1,0,1,101,81,60,21,20,5,15,16,0,16,1,0,1
04/07/2021,Matanuska-Susitna,3,GACH,1,184,160,99,61,14,14,0,33,4,29,10,0,10,184,160,99,61,14,14,0,33,4,29,10,0,10
04/07/2021,Northern,2,CAH,1,139,110,14,96,8,0,8,36,0,36,0,0,0,139,110,14,96,8,0,8,36,0,36,0,0,0
04/07/2021,Southeast,5,CAH,1,70,70,31,39,8,0,8,33,0,33,0,0,0,70,70,31,39,8,0,8,33,0,33,0,0,0
04/07/2021,Southeast,5,GACH,1,161,133,41,92,9,3,6,20,0,20,0,0,0,161,133,41,92,9,3,6,20,0,20,0,0,0
04/07/2021,Southwest,1,CAH,1,22,12,1,11,0,0,0,4,0,4,0,0,0,22,12,1,11,0,0,0,4,0,4,0,0,0
04/07/2021,Southwest,1,GACH,1,53,45,19,26,0,0,0,4,0,4,1,0,1,53,45,19,26,0,0,0,4,0,4,1,0,1
04/08/2021,Anchorage,7,GACH,1,735,699,501,198,136,100,36,179,29,150,27,4,31,735,699,501,198,136,100,36,179,29,150,27,4,31
04/08/2021,Anchorage,7,LTACH,0,44,44,38,6,6,4,2,23,1,22,1,0,1,44,44,38,6,6,4,2,23,1,22,1,0,1
04/08/2021,Anchorage,7,Psych,0,,,,,,,,,,,,,,200,189,120,69,0,0,0,0,0,0,0,0,0
04/08/2021,Gulf Coast,4,CAH,1,83,69,23,46,4,1,3,18,0,18,1,0,1,83,69,23,46,4,1,3,18,0,18,1,0,1
04/08/2021,Gulf Coast,4,GACH,1,115,61,38,23,9,5,4,8,0,8,1,0,1,115,61,38,23,9,5,4,8,0,8,1,0,1
04/08/2021,Interior,6,GACH,1,101,81,51,30,20,7,13,16,0,16,2,0,2,101,81,51,30,20,7,13,16,0,16,2,0,2
04/08/2021,Matanuska-Susitna,3,GACH,1,184,160,98,62,14,13,1,33,5,28,12,0,12,184,160,98,62,14,13,1,33,5,28,12,0,12
04/08/2021,Northern,2,CAH,1,139,110,18,92,8,0,8,36,0,36,0,0,0,139,110,18,92,8,0,8,36,0,36,0,0,0
04/08/2021,Southeast,5,CAH,1,70,70,34,36,8,3,5,25,0,25,0,0,0,70,70,34,36,8,3,5,25,0,25,0,0,0
04/08/2021,Southeast,5,GACH,1,161,133,36,97,9,6,3,20,0,20,0,0,0,161,133,36,97,9,6,3,20,0,20,0,0,0
04/08/2021,Southwest,1,CAH,1,22,12,1,11,0,0,0,4,0,4,0,0,0,22,12,1,11,0,0,0,4,0,4,0,0,0
04/08/2021,Southwest,1,GACH,1,53,45,22,23,0,0,0,4,0,4,1,0,1,53,45,22,23,0,0,0,4,0,4,1,0,1
04/09/2021,Anchorage,7,GACH,1,730,698,494,204,131,95,36,179,26,153,24,0,24,730,698,494,204,131,95,36,179,26,153,24,0,24
04/09/2021,Anchorage,7,LTACH,0,44,44,39,5,6,4,2,23,2,21,1,0,1,44,44,39,5,6,4,2,23,2,21,1,0,1
04/09/2021,Anchorage,7,Psych,0,,,,,,,,,,,,,,200,189,120,69,0,0,0,0,0,0,0,0,0
04/09/2021,Gulf Coast,4,CAH,1,78,68,24,44,4,1,3,18,0,18,1,0,1,78,68,24,44,4,1,3,18,0,18,1,0,1
04/09/2021,Gulf Coast,4,GACH,1,115,61,34,27,9,4,5,8,0,8,1,0,1,115,61,34,27,9,4,5,8,0,8,1,0,1
04/09/2021,Interior,6,GACH,1,101,81,46,35,20,6,14,16,0,16,1,0,1,101,81,46,35,20,6,14,16,0,16,1,0,1
04/09/2021,Matanuska-Susitna,3,GACH,1,184,160,87,73,14,10,4,33,4,29,12,0,12,184,160,87,73,14,10,4,33,4,29,12,0,12
04/09/2021,Northern,2,CAH,1,139,110,17,93,8,0,8,36,0,36,0,0,0,139,110,17,93,8,0,8,36,0,36,0,0,0
04/09/2021,Southeast,5,CAH,1,70,70,29,41,8,2,6,27,2,25,0,0,0,70,70,29,41,8,2,6,27,2,25,0,0,0
04/09/2021,Southeast,5,GACH,1,161,133,44,89,9,4,5,20,0,20,0,0,0,161,133,44,89,9,4,5,20,0,20,0,0,0
04/09/2021,Southwest,1,CAH,1,22,12,1,11,0,0,0,4,0,4,0,0,0,22,12,1,11,0,0,0,4,0,4,0,0,0
04/09/2021,Southwest,1,GACH,1,53,45,9,36,0,0,0,4,0,4,1,0,1,53,45,9,36,0,0,0,4,0,4,1,0,1
04/10/2021,Anchorage,7,GACH,1,719,695,496,199,131,90,41,179,23,156,21,5,26,719,695,496,199,131,90,41,179,23,156,21,5,26
04/10/2021,Anchorage,7,LTACH,0,44,44,40,4,6,4,2,23,2,21,1,0,1,44,44,40,4,6,4,2,23,2,21,1,0,1
04/10/2021,Anchorage,7,Psych,0,,,,,,,,,,,,,,200,189,120,69,0,0,0,0,0,0,0,0,0
04/10/2021,Gulf Coast,4,CAH,1,78,68,26,42,4,1,3,18,0,18,1,0,1,78,68,26,42,4,1,3,18,0,18,1,0,1
04/10/2021,Gulf Coast,4,GACH,1,115,61,33,28,9,4,5,8,0,8,2,0,2,115,61,33,28,9,4,5,8,0,8,2,0,2
04/10/2021,Interior,6,GACH,1,101,81,55,26,20,5,15,16,0,16,1,0,1,101,81,55,26,20,5,15,16,0,16,1,0,1
04/10/2021,Matanuska-Susitna,3,GACH,1,184,160,75,85,14,12,2,33,4,29,13,0,13,184,160,75,85,14,12,2,33,4,29,13,0,13
04/10/2021,Northern,2,CAH,1,139,110,13,97,8,0,8,36,0,36,0,0,0,139,110,13,97,8,0,8,36,0,36,0,0,0
04/10/2021,Southeast,5,CAH,1,70,70,28,42,8,2,6,33,0,33,1,0,1,70,70,28,42,8,2,6,33,0,33,1,0,1
04/10/2021,Southeast,5,GACH,1,161,133,41,92,9,6,3,20,0,20,0,0,0,161,133,41,92,9,6,3,20,0,20,0,0,0
04/10/2021,Southwest,1,CAH,1,22,12,0,12,0,0,0,4,0,4,0,0,0,22,12,0,12,0,0,0,4,0,4,0,0,0
04/10/2021,Southwest,1,GACH,1,53,45,22,23,0,0,0,4,0,4,1,0,1,53,45,22,23,0,0,0,4,0,4,1,0,1
04/11/2021,Anchorage,7,GACH,1,719,695,474,221,130,95,35,179,23,156,20,5,25,719,695,474,221,130,95,35,179,23,156,20,5,25
04/11/2021,Anchorage,7,LTACH,0,44,44,41,3,6,4,2,23,2,21,1,0,1,44,44,41,3,6,4,2,23,2,21,1,0,1
04/11/2021,Anchorage,7,Psych,0,,,,,,,,,,,,,,200,189,120,69,0,0,0,0,0,0,0,0,0
04/11/2021,Gulf Coast,4,CAH,1,78,68,24,44,4,1,3,18,0,18,1,0,1,78,68,24,44,4,1,3,18,0,18,1,0,1
04/11/2021,Gulf Coast,4,GACH,1,115,61,31,30,9,2,7,8,1,7,2,0,2,115,61,31,30,9,2,7,8,1,7,2,0,2
04/11/2021,Interior,6,GACH,1,101,81,55,26,20,9,11,16,0,16,1,0,1,101,81,55,26,20,9,11,16,0,16,1,0,1
04/11/2021,Matanuska-Susitna,3,GACH,1,184,160,72,88,14,12,2,33,4,29,8,0,8,184,160,72,88,14,12,2,33,4,29,8,0,8
04/11/2021,Northern,2,CAH,1,139,110,13,97,8,8,0,36,0,36,0,0,0,139,110,13,97,8,8,0,36,0,36,0,0,0
04/11/2021,Southeast,5,CAH,1,70,70,29,41,8,3,5,33,0,33,1,0,1,70,70,29,41,8,3,5,33,0,33,1,0,1
04/11/2021,Southeast,5,GACH,1,161,133,34,99,9,4,5,20,1,19,0,0,0,161,133,34,99,9,4,5,20,1,19,0,0,0
04/11/2021,Southwest,1,CAH,1,22,12,1,11,0,0,0,4,0,4,0,0,0,22,12,1,11,0,0,0,4,0,4,0,0,0
04/11/2021,Southwest,1,GACH,1,53,45,23,22,0,0,0,4,0,4,2,0,2,53,45,23,22,0,0,0,4,0,4,2,0,2
04/12/2021,Anchorage,7,GACH,1,725,700,497,203,132,98,34,179,21,158,19,6,25,725,700,497,203,132,98,34,179,21,158,19,6,25
04/12/2021,Anchorage,7,LTACH,0,44,44,41,3,6,4,2,23,2,21,1,0,1,44,44,41,3,6,4,2,23,2,21,1,0,1
04/12/2021,Anchorage,7,Psych,0,,,,,,,,,,,,,,200,189,120,69,0,0,0,0,0,0,0,0,0
04/12/2021,Gulf Coast,4,CAH,1,78,68,20,48,4,1,3,18,0,18,1,0,1,78,68,20,48,4,1,3,18,0,18,1,0,1
04/12/2021,Gulf Coast,4,GACH,1,115,61,36,25,9,4,5,8,1,7,3,0,3,115,61,36,25,9,4,5,8,1,7,3,0,3
04/12/2021,Interior,6,GACH,1,101,81,56,25,20,9,11,16,0,16,2,0,2,101,81,56,25,20,9,11,16,0,16,2,0,2
04/12/2021,Matanuska-Susitna,3,GACH,1,184,160,75,85,14,11,3,33,5,28,13,0,13,184,160,75,85,14,11,3,33,5,28,13,0,13
04/12/2021,Northern,2,CAH,1,139,110,14,96,8,0,8,36,0,36,0,0,0,139,110,14,96,8,0,8,36,0,36,0,0,0
04/12/2021,Southeast,5,CAH,1,70,70,31,39,8,2,6,33,0,33,1,0,1,70,70,31,39,8,2,6,33,0,33,1,0,1
04/12/2021,Southeast,5,GACH,1,161,133,37,96,9,5,4,20,1,19,0,0,0,161,133,37,96,9,5,4,20,1,19,0,0,0
04/12/2021,Southwest,1,CAH,1,22,12,2,10,0,0,0,4,0,4,1,0,1,22,12,2,10,0,0,0,4,0,4,1,0,1
04/12/2021,Southwest,1,GACH,1,53,45,15,30,0,0,0,4,0,4,2,0,2,53,45,15,30,0,0,0,4,0,4,2,0,2
04/13/2021,Anchorage,7,GACH,1,726,702,519,183,135,101,34,179,25,154,21,0,21,726,702,519,183,135,101,34,179,25,154,21,0,21
04/13/2021,Anchorage,7,LTACH,0,44,44,40,4,6,4,2,23,2,21,0,0,0,44,44,40,4,6,4,2,23,2,21,0,0,0
04/13/2021,Anchorage,7,Psych,0,,,,,,,,,,,,,,200,189,120,69,0,0,0,0,0,0,0,0,0
04/13/2021,Gulf Coast,4,CAH,1,78,68,19,49,4,1,3,18,0,18,1,0,1,78,68,19,49,4,1,3,18,0,18,1,0,1
04/13/2021,Gulf Coast,4,GACH,1,115,61,42,19,9,8,1,8,0,8,4,0,4,115,61,42,19,9,8,1,8,0,8,4,0,4
04/13/2021,Interior,6,GACH,1,101,81,60,21,20,8,12,16,0,16,1,0,1,101,81,60,21,20,8,12,16,0,16,1,0,1
04/13/2021,Matanuska-Susitna,3,GACH,1,184,160,77,83,14,13,1,33,6,27,12,0,12,184,160,77,83,14,13,1,33,6,27,12,0,12
04/13/2021,Northern,2,CAH,1,139,110,14,96,8,0,8,36,0,36,0,0,0,139,110,14,96,8,0,8,36,0,36,0,0,0
04/13/2021,Southeast,5,CAH,1,70,70,29,41,8,4,4,33,0,33,1,0,1,70,70,29,41,8,4,4,33,0,33,1,0,1
04/13/2021,Southeast,5,GACH,1,161,133,48,85,9,6,3,20,0,20,0,0,0,161,133,48,85,9,6,3,20,0,20,0,0,0
04/13/2021,Southwest,1,CAH,1,22,12,2,10,0,0,0,4,0,4,1,0,1,22,12,2,10,0,0,0,4,0,4,1,0,1
04/13/2021,Southwest,1,GACH,1,53,45,14,31,0,0,0,4,0,4,2,0,2,53,45,14,31,0,0,0,4,0,4,2,0,2
04/14/2021,Anchorage,7,GACH,1,721,695,534,161,133,103,30,179,23,156,19,0,19,721,695,534,161,133,103,30,179,23,156,19,0,19
04/14/2021,Anchorage,7,LTACH,0,44,44,39,5,6,5,1,23,3,20,0,0,0,44,44,39,5,6,5,1,23,3,20,0,0,0
04/14/2021,Anchorage,7,Psych,0,200,194,129,65,0,0,0,0,0,0,0,0,0,200,194,129,65,0,0,0,0,0,0,0,0,0
04/14/2021,Gulf Coast,4,CAH,1,78,69,29,40,4,1,3,18,0,18,1,0,1,78,69,29,40,4,1,3,18,0,18,1,0,1
04/14/2021,Gulf Coast,4,GACH,1,115,61,46,15,9,8,1,8,0,8,5,0,5,115,61,46,15,9,8,1,8,0,8,5,0,5
04/14/2021,Interior,6,GACH,1,101,81,67,14,20,9,11,16,1,15,1,0,1,101,81,67,14,20,9,11,16,1,15,1,0,1
04/14/2021,Matanuska-Susitna,3,GACH,1,184,160,93,67,14,11,3,33,5,28,9,0,9,184,160,93,67,14,11,3,33,5,28,9,0,9
04/14/2021,Northern,2,CAH,1,139,110,16,94,8,0,8,36,0,36,0,0,0,139,110,16,94,8,0,8,36,0,36,0,0,0
04/14/2021,Southeast,5,CAH,1,70,70,31,39,8,4,4,33,0,33,0,0,0,70,70,31,39,8,4,4,33,0,33,0,0,0
04/14/2021,Southeast,5,GACH,1,161,133,50,83,9,4,5,20,0,20,0,0,0,161,133,50,83,9,4,5,20,0,20,0,0,0
04/14/2021,Southwest,1,CAH,1,22,12,1,11,0,0,0,4,0,4,0,0,0,22,12,1,11,0,0,0,4,0,4,0,0,0
04/14/2021,Southwest,1,GACH,1,53,45,18,27,0,0,0,4,0,4,2,0,2,53,45,18,27,0,0,0,4,0,4,2,0,2
04/15/2021,Anchorage,7,GACH,1,722,692,529,163,130,99,31,179,22,157,16,0,16,722,692,529,163,130,99,31,179,22,157,16,0,16
04/15/2021,Anchorage,7,LTACH,0,44,44,39,5,6,5,1,23,3,20,0,0,0,44,44,39,5,6,5,1,23,3,20,0,0,0
04/15/2021,Anchorage,7,Psych,0,,,,,,,,,,,,,,200,194,129,65,0,0,0,0,0,0,0,0,0
04/15/2021,Gulf Coast,4,CAH,1,78,69,25,44,4,1,3,18,0,18,2,0,2,78,69,25,44,4,1,3,18,0,18,2,0,2
04/15/2021,Gulf Coast,4,GACH,1,115,61,46,15,9,9,0,8,0,8,6,0,6,115,61,46,15,9,9,0,8,0,8,6,0,6
04/15/2021,Interior,6,GACH,1,101,81,63,18,20,7,13,16,1,15,2,0,2,101,81,63,18,20,7,13,16,1,15,2,0,2
04/15/2021,Matanuska-Susitna,3,GACH,1,184,160,98,62,14,10,4,33,5,28,7,0,7,184,160,98,62,14,10,4,33,5,28,7,0,7
04/15/2021,Northern,2,CAH,1,139,110,18,92,8,0,8,36,0,36,0,0,0,139,110,18,92,8,0,8,36,0,36,0,0,0
04/15/2021,Southeast,5,CAH,1,70,70,35,35,8,3,5,33,0,33,0,0,0,70,70,35,35,8,3,5,33,0,33,0,0,0
04/15/2021,Southeast,5,GACH,1,161,133,46,87,9,5,4,20,0,20,0,0,0,161,133,46,87,9,5,4,20,0,20,0,0,0
04/15/2021,Southwest,1,CAH,1,22,12,1,11,0,0,0,4,0,4,3,0,3,22,12,1,11,0,0,0,4,0,4,3,0,3
04/15/2021,Southwest,1,GACH,1,53,45,21,24,0,0,0,4,0,4,2,0,2,53,45,21,24,0,0,0,4,0,4,2,0,2
04/16/2021,Anchorage,7,GACH,1,716,687,504,183,131,89,42,179,22,157,16,5,21,716,687,504,183,131,89,42,179,22,157,16,5,21
04/16/2021,Anchorage,7,LTACH,0,44,44,42,2,6,5,1,23,3,20,0,0,0,44,44,42,2,6,5,1,23,3,20,0,0,0
04/16/2021,Anchorage,7,Psych,0,,,,,,,,,,,,,,200,194,129,65,0,0,0,0,0,0,0,0,0
04/16/2021,Gulf Coast,4,CAH,1,78,68,25,43,4,2,2,18,0,18,2,0,2,78,68,25,43,4,2,2,18,0,18,2,0,2
04/16/2021,Gulf Coast,4,GACH,1,115,61,49,12,9,9,0,8,0,8,5,0,5,115,61,49,12,9,9,0,8,0,8,5,0,5
04/16/2021,Interior,6,GACH,1,101,81,65,16,20,9,11,16,1,15,5,0,5,101,81,65,16,20,9,11,16,1,15,5,0,5
04/16/2021,Matanuska-Susitna,3,GACH,1,184,160,98,62,14,13,1,33,3,30,6,0,6,184,160,98,62,14,13,1,33,3,30,6,0,6
04/16/2021,Northern,2,CAH,1,139,110,13,97,8,0,8,36,0,36,0,0,0,139,110,13,97,8,0,8,36,0,36,0,0,0
04/16/2021,Southeast,5,CAH,1,70,70,31,39,8,1,7,33,0,33,1,0,1,70,70,31,39,8,1,7,33,0,33,1,0,1
04/16/2021,Southeast,5,GACH,1,161,133,37,96,9,4,5,20,0,20,0,0,0,161,133,37,96,9,4,5,20,0,20,0,0,0
04/16/2021,Southwest,1,CAH,1,22,12,4,8,0,0,0,4,0,4,0,0,0,22,12,4,8,0,0,0,4,0,4,0,0,0
04/16/2021,Southwest,1,GACH,1,53,45,18,27,0,0,0,4,0,4,2,0,2,53,45,18,27,0,0,0,4,0,4,2,0,2
04/17/2021,Anchorage,7,GACH,1,712,686,482,204,132,90,42,179,24,155,13,0,13,712,686,482,204,132,90,42,179,24,155,13,0,13
04/17/2021,Anchorage,7,LTACH,0,44,44,41,3,6,5,1,23,3,20,0,0,0,44,44,41,3,6,5,1,23,3,20,0,0,0
04/17/2021,Anchorage,7,Psych,0,,,,,,,,,,,,,,200,194,129,65,0,0,0,0,0,0,0,0,0
04/17/2021,Gulf Coast,4,CAH,1,78,68,24,44,4,3,1,18,0,18,1,0,1,78,68,24,44,4,3,1,18,0,18,1,0,1
04/17/2021,Gulf Coast,4,GACH,1,115,61,40,21,9,9,0,8,0,8,4,0,4,115,61,40,21,9,9,0,8,0,8,4,0,4
04/17/2021,Interior,6,GACH,1,101,81,64,17,20,11,9,16,1,15,5,0,5,101,81,64,17,20,11,9,16,1,15,5,0,5
04/17/2021,Matanuska-Susitna,3,GACH,1,184,160,84,76,14,14,0,33,4,29,4,0,4,184,160,84,76,14,14,0,33,4,29,4,0,4
04/17/2021,Northern,2,CAH,1,139,110,12,98,8,0,8,36,0,36,0,0,0,139,110,12,98,8,0,8,36,0,36,0,0,0
04/17/2021,Southeast,5,CAH,1,70,70,33,37,8,0,8,33,0,33,2,0,2,70,70,33,37,8,0,8,33,0,33,2,0,2
04/17/2021,Southeast,5,GACH,1,161,133,38,95,9,2,7,20,0,20,0,0,0,161,133,38,95,9,2,7,20,0,20,0,0,0
04/17/2021,Southwest,1,CAH,1,22,12,4,8,0,0,0,4,0,4,0,0,0,22,12,4,8,0,0,0,4,0,4,0,0,0
04/17/2021,Southwest,1,GACH,1,53,45,23,22,0,0,0,4,0,4,2,0,2,53,45,23,22,0,0,0,4,0,4,2,0,2
04/18/2021,Anchorage,7,GACH,1,704,678,493,185,131,92,39,179,27,152,15,0,15,704,678,493,185,131,92,39,179,27,152,15,0,15
04/18/2021,Anchorage,7,LTACH,0,44,44,41,3,6,5,1,23,4,19,0,0,0,44,44,41,3,6,5,1,23,4,19,0,0,0
04/18/2021,Anchorage,7,Psych,0,,,,,,,,,,,,,,200,194,129,65,0,0,0,0,0,0,0,0,0
04/18/2021,Gulf Coast,4,CAH,1,78,68,22,46,4,1,3,18,0,18,1,0,1,78,68,22,46,4,1,3,18,0,18,1,0,1
04/18/2021,Gulf Coast,4,GACH,1,115,61,37,24,9,9,0,8,0,8,4,0,4,115,61,37,24,9,9,0,8,0,8,4,0,4
04/18/2021,Interior,6,GACH,1,101,81,37,44,20,10,10,16,1,15,4,0,4,101,81,37,44,20,10,10,16,1,15,4,0,4
04/18/2021,Matanuska-Susitna,3,GACH,1,184,160,73,87,14,8,6,33,3,30,5,0,5,184,160,73,87,14,8,6,33,3,30,5,0,5
04/18/2021,Northern,2,CAH,1,139,110,8,102,8,0,8,36,0,36,0,0,0,139,110,8,102,8,0,8,36,0,36,0,0,0
04/18/2021,Southeast,5,CAH,1,70,70,35,35,8,1,7,33,0,33,2,0,2,70,70,35,35,8,1,7,33,0,33,2,0,2
04/18/2021,Southeast,5,GACH,1,161,133,39,94,9,2,7,20,0,20,0,0,0,161,133,39,94,9,2,7,20,0,20,0,0,0
04/18/2021,Southwest,1,CAH,1,22,12,3,9,0,0,0,4,0,4,0,0,0,22,12,3,9,0,0,0,4,0,4,0,0,0
04/18/2021,Southwest,1,GACH,1,53,45,26,19,0,0,0,4,0,4,2,0,2,53,45,26,19,0,0,0,4,0,4,2,0,2
04/19/2021,Anchorage,7,GACH,1,721,696,506,190,135,95,40,179,24,155,15,0,15,721,696,506,190,135,95,40,179,24,155,15,0,15
04/19/2021,Anchorage,7,LTACH,0,44,44,41,3,6,5,1,23,4,19,0,0,0,44,44,41,3,6,5,1,23,4,19,0,0,0
04/19/2021,Anchorage,7,Psych,0,,,,,,,,,,,,,,200,194,129,65,0,0,0,0,0,0,0,0,0
04/19/2021,Gulf Coast,4,CAH,1,78,68,22,46,4,0,4,18,0,18,2,0,2,78,68,22,46,4,0,4,18,0,18,2,0,2
04/19/2021,Gulf Coast,4,GACH,1,115,61,39,22,9,8,1,8,0,8,5,0,5,115,61,39,22,9,8,1,8,0,8,5,0,5
04/19/2021,Interior,6,GACH,1,101,81,39,42,20,11,9,16,1,15,4,0,4,101,81,39,42,20,11,9,16,1,15,4,0,4
04/19/2021,Matanuska-Susitna,3,GACH,1,184,160,63,97,14,10,4,33,2,31,8,0,8,184,160,63,97,14,10,4,33,2,31,8,0,8
04/19/2021,Northern,2,CAH,1,139,110,10,100,8,0,8,36,0,36,0,0,0,139,110,10,100,8,0,8,36,0,36,0,0,0
04/19/2021,Southeast,5,CAH,1,70,70,35,35,8,2,6,33,0,33,2,0,2,70,70,35,35,8,2,6,33,0,33,2,0,2
04/19/2021,Southeast,5,GACH,1,161,133,36,97,9,1,8,20,0,20,0,0,0,161,133,36,97,9,1,8,20,0,20,0,0,0
04/19/2021,Southwest,1,CAH,1,22,12,3,9,0,0,0,4,0,4,0,0,0,22,12,3,9,0,0,0,4,0,4,0,0,0
04/19/2021,Southwest,1,GACH,1,53,45,24,21,0,0,0,4,0,4,2,0,2,53,45,24,21,0,0,0,4,0,4,2,0,2
04/20/2021,Anchorage,7,GACH,1,722,698,515,183,136,102,34,179,24,155,18,0,18,722,698,515,183,136,102,34,179,24,155,18,0,18
04/20/2021,Anchorage,7,LTACH,0,44,44,41,3,6,5,1,23,3,20,0,0,0,44,44,41,3,6,5,1,23,3,20,0,0,0
04/20/2021,Anchorage,7,Psych,0,,,,,,,,,,,,,,200,194,129,65,0,0,0,0,0,0,0,0,0
04/20/2021,Gulf Coast,4,CAH,1,78,68,22,46,4,0,4,18,0,18,1,0,1,78,68,22,46,4,0,4,18,0,18,1,0,1
04/20/2021,Gulf Coast,4,GACH,1,115,61,42,19,9,9,0,8,0,8,5,0,5,115,61,42,19,9,9,0,8,0,8,5,0,5
04/20/2021,Interior,6,GACH,1,101,81,59,22,20,10,10,16,1,15,7,0,7,101,81,59,22,20,10,10,16,1,15,7,0,7
04/20/2021,Matanuska-Susitna,3,GACH,1,184,160,83,77,14,11,3,33,3,30,11,0,11,184,160,83,77,14,11,3,33,3,30,11,0,11
04/20/2021,Northern,2,CAH,1,139,110,12,98,8,0,8,36,0,36,0,0,0,139,110,12,98,8,0,8,36,0,36,0,0,0
04/20/2021,Southeast,5,CAH,1,70,70,36,34,8,0,8,33,0,33,2,0,2,70,70,36,34,8,0,8,33,0,33,2,0,2
04/20/2021,Southeast,5,GACH,1,161,133,39,94,9,3,6,20,0,20,0,0,0,161,133,39,94,9,3,6,20,0,20,0,0,0
04/20/2021,Southwest,1,CAH,1,22,12,2,10,0,0,0,4,0,4,0,0,0,22,12,2,10,0,0,0,4,0,4,0,0,0
04/20/2021,Southwest,1,GACH,1,53,45,22,23,0,0,0,4,0,4,1,0,1,53,45,22,23,0,0,0,4,0,4,1,0,1
04/21/2021,Anchorage,7,GACH,1,725,696,499,197,136,94,42,179,26,153,16,0,16,725,696,499,197,136,94,42,179,26,153,16,0,16
04/21/2021,Anchorage,7,LTACH,0,44,44,38,6,6,5,1,23,3,20,0,0,0,44,44,38,6,6,5,1,23,3,20,0,0,0
04/21/2021,Anchorage,7,Psych,0,200,191,127,64,0,0,0,0,0,0,0,0,0,200,191,127,64,0,0,0,0,0,0,0,0,0
04/21/2021,Gulf Coast,4,CAH,1,78,68,20,48,4,0,4,18,0,18,0,0,0,78,68,20,48,4,0,4,18,0,18,0,0,0
04/21/2021,Gulf Coast,4,GACH,1,115,61,40,21,9,9,0,8,0,8,5,0,5,115,61,40,21,9,9,0,8,0,8,5,0,5
04/21/2021,Interior,6,GACH,1,101,81,66,15,20,9,11,16,1,15,9,0,9,101,81,66,15,20,9,11,16,1,15,9,0,9
04/21/2021,Matanuska-Susitna,3,GACH,1,184,160,94,66,14,10,4,33,4,29,11,0,11,184,160,94,66,14,10,4,33,4,29,11,0,11
04/21/2021,Northern,2,CAH,1,139,110,16,94,8,0,8,36,0,36,0,0,0,139,110,16,94,8,0,8,36,0,36,0,0,0
04/21/2021,Southeast,5,CAH,1,70,70,38,32,8,2,6,33,0,33,1,0,1,70,70,38,32,8,2,6,33,0,33,1,0,1
04/21/2021,Southeast,5,GACH,1,161,133,29,104,9,2,7,20,0,20,0,0,0,161,133,29,104,9,2,7,20,0,20,0,0,0
04/21/2021,Southwest,1,CAH,1,22,12,2,10,0,0,0,4,0,4,0,0,0,22,12,2,10,0,0,0,4,0,4,0,0,0
04/21/2021,Southwest,1,GACH,1,53,45,24,21,0,0,0,4,0,4,1,0,1,53,45,24,21,0,0,0,4,0,4,1,0,1
04/22/2021,Anchorage,7,GACH,1,721,697,587,110,116,94,22,179,26,153,13,0,13,721,697,587,110,116,94,22,179,26,153,13,0,13
04/22/2021,Anchorage,7,LTACH,0,44,44,38,6,6,5,1,23,3,20,0,0,0,44,44,38,6,6,5,1,23,3,20,0,0,0
04/22/2021,Anchorage,7,Psych,0,,,,,,,,,,,,,,200,191,127,64,0,0,0,0,0,0,0,0,0
04/22/2021,Gulf Coast,4,CAH,1,78,69,15,54,4,0,4,18,0,18,0,0,0,78,69,15,54,4,0,4,18,0,18,0,0,0
04/22/2021,Gulf Coast,4,GACH,1,115,61,43,18,9,9,0,8,0,8,4,0,4,115,61,43,18,9,9,0,8,0,8,4,0,4
04/22/2021,Interior,6,GACH,1,101,81,60,21,20,10,10,16,1,15,9,0,9,101,81,60,21,20,10,10,16,1,15,9,0,9
04/22/2021,Matanuska-Susitna,3,GACH,1,184,160,96,64,14,12,2,33,6,27,11,0,11,184,160,96,64,14,12,2,33,6,27,11,0,11
04/22/2021,Northern,2,CAH,1,139,110,16,94,8,0,8,36,0,36,0,0,0,139,110,16,94,8,0,8,36,0,36,0,0,0
04/22/2021,Southeast,5,CAH,1,70,70,32,38,8,0,8,33,0,33,3,0,3,70,70,32,38,8,0,8,33,0,33,3,0,3
04/22/2021,Southeast,5,GACH,1,161,133,37,96,9,3,6,20,0,20,0,0,0,161,133,37,96,9,3,6,20,0,20,0,0,0
04/22/2021,Southwest,1,CAH,1,22,12,2,10,0,0,0,4,0,4,0,0,0,22,12,2,10,0,0,0,4,0,4,0,0,0
04/22/2021,Southwest,1,GACH,1,53,45,29,16,0,0,0,4,0,4,1,0,1,53,45,29,16,0,0,0,4,0,4,1,0,1
04/23/2021,Anchorage,7,GACH,1,721,693,524,169,135,100,35,179,27,152,13,0,13,721,693,524,169,135,100,35,179,27,152,13,0,13
04/23/2021,Anchorage,7,LTACH,0,44,44,36,8,6,5,1,23,3,20,0,0,0,44,44,36,8,6,5,1,23,3,20,0,0,0
04/23/2021,Anchorage,7,Psych,0,,,,,,,,,,,,,,200,191,127,64,0,0,0,0,0,0,0,0,0
04/23/2021,Gulf Coast,4,CAH,1,84,74,20,54,4,2,2,18,0,18,0,0,0,84,74,20,54,4,2,2,18,0,18,0,0,0
04/23/2021,Gulf Coast,4,GACH,1,115,61,42,19,9,9,0,8,0,8,5,0,5,115,61,42,19,9,9,0,8,0,8,5,0,5
04/23/2021,Interior,6,GACH,1,101,81,49,32,20,13,7,16,1,15,7,0,7,101,81,49,32,20,13,7,16,1,15,7,0,7
04/23/2021,Matanuska-Susitna,3,GACH,1,184,160,73,87,14,9,5,33,8,25,11,0,11,184,160,73,87,14,9,5,33,8,25,11,0,11
04/23/2021,Northern,2,CAH,1,139,110,11,99,8,0,8,36,0,36,0,0,0,139,110,11,99,8,0,8,36,0,36,0,0,0
04/23/2021,Southeast,5,CAH,1,70,70,32,38,8,0,8,33,0,33,2,0,2,70,70,32,38,8,0,8,33,0,33,2,0,2
04/23/2021,Southeast,5,GACH,1,161,133,38,95,9,2,7,20,0,20,0,0,0,161,133,38,95,9,2,7,20,0,20,0,0,0
04/23/2021,Southwest,1,CAH,1,22,12,3,9,0,0,0,4,0,4,0,0,0,22,12,3,9,0,0,0,4,0,4,0,0,0
04/23/2021,Southwest,1,GACH,1,53,45,23,22,0,0,0,4,0,4,1,0,1,53,45,23,22,0,0,0,4,0,4,1,0,1
04/24/2021,Anchorage,7,GACH,1,722,696,534,162,135,104,31,179,28,151,13,0,13,722,696,534,162,135,104,31,179,28,151,13,0,13
04/24/2021,Anchorage,7,LTACH,0,44,44,34,10,6,5,1,23,3,20,0,0,0,44,44,34,10,6,5,1,23,3,20,0,0,0
04/24/2021,Anchorage,7,Psych,0,,,,,,,,,,,,,,200,191,127,64,0,0,0,0,0,0,0,0,0
04/24/2021,Gulf Coast,4,CAH,1,84,74,22,52,4,2,2,18,0,18,0,0,0,84,74,22,52,4,2,2,18,0,18,0,0,0
04/24/2021,Gulf Coast,4,GACH,1,115,61,39,22,9,6,3,8,0,8,2,0,2,115,61,39,22,9,6,3,8,0,8,2,0,2
04/24/2021,Interior,6,GACH,1,101,81,49,32,20,12,8,16,0,16,10,0,10,101,81,49,32,20,12,8,16,0,16,10,0,10
04/24/2021,Matanuska-Susitna,3,GACH,1,184,160,80,80,14,11,3,33,8,25,12,0,12,184,160,80,80,14,11,3,33,8,25,12,0,12
04/24/2021,Northern,2,CAH,1,139,110,16,94,8,0,8,36,0,36,0,0,0,139,110,16,94,8,0,8,36,0,36,0,0,0
04/24/2021,Southeast,5,CAH,1,70,70,30,40,8,0,8,33,0,33,2,0,2,70,70,30,40,8,0,8,33,0,33,2,0,2
04/24/2021,Southeast,5,GACH,1,161,133,28,105,9,4,5,20,0,20,0,0,0,161,133,28,105,9,4,5,20,0,20,0,0,0
04/24/2021,Southwest,1,CAH,1,22,12,2,10,0,0,0,4,0,4,0,0,0,22,12,2,10,0,0,0,4,0,4,0,0,0
04/24/2021,Southwest,1,GACH,1,53,45,23,22,0,0,0,4,0,4,0,0,0,53,45,23,22,0,0,0,4,0,4,0,0,0
04/25/2021,Anchorage,7,GACH,1,727,701,538,163,140,108,32,179,27,152,16,0,16,727,701,538,163,140,108,32,179,27,152,16,0,16
04/25/2021,Anchorage,7,LTACH,0,44,44,34,10,6,5,1,23,3,20,0,0,0,44,44,34,10,6,5,1,23,3,20,0,0,0
04/25/2021,Anchorage,7,Psych,0,,,,,,,,,,,,,,200,191,127,64,0,0,0,0,0,0,0,0,0
04/25/2021,Gulf Coast,4,CAH,1,84,74,14,60,4,1,3,18,0,18,0,0,0,84,74,14,60,4,1,3,18,0,18,0,0,0
04/25/2021,Gulf Coast,4,GACH,1,115,61,34,27,9,5,4,8,0,8,2,0,2,115,61,34,27,9,5,4,8,0,8,2,0,2
04/25/2021,Interior,6,GACH,1,101,81,55,26,20,10,10,16,0,16,10,0,10,101,81,55,26,20,10,10,16,0,16,10,0,10
04/25/2021,Matanuska-Susitna,3,GACH,1,184,160,71,89,14,12,2,33,7,26,9,0,9,184,160,71,89,14,12,2,33,7,26,9,0,9
04/25/2021,Northern,2,CAH,1,139,110,17,93,8,0,8,36,0,36,0,0,0,139,110,17,93,8,0,8,36,0,36,0,0,0
04/25/2021,Southeast,5,CAH,1,70,70,30,40,8,0,8,33,0,33,2,0,2,70,70,30,40,8,0,8,33,0,33,2,0,2
04/25/2021,Southeast,5,GACH,1,161,133,32,101,9,4,5,20,0,20,0,0,0,161,133,32,101,9,4,5,20,0,20,0,0,0
04/25/2021,Southwest,1,CAH,1,22,12,1,11,0,0,0,4,0,4,0,0,0,22,12,1,11,0,0,0,4,0,4,0,0,0
04/25/2021,Southwest,1,GACH,1,53,45,22,23,0,0,0,4,0,4,0,0,0,53,45,22,23,0,0,0,4,0,4,0,0,0
04/26/2021,Anchorage,7,GACH,1,738,704,550,154,140,113,27,179,22,157,19,0,19,738,704,550,154,140,113,27,179,22,157,19,0,19
04/26/2021,Anchorage,7,LTACH,0,44,44,34,10,6,5,1,23,3,20,0,0,0,44,44,34,10,6,5,1,23,3,20,0,0,0
04/26/2021,Anchorage,7,Psych,0,,,,,,,,,,,,,,200,191,127,64,0,0,0,0,0,0,0,0,0
04/26/2021,Gulf Coast,4,CAH,1,83,73,21,52,4,0,4,18,0,18,0,0,0,83,73,21,52,4,0,4,18,0,18,0,0,0
04/26/2021,Gulf Coast,4,GACH,1,115,61,33,28,9,8,1,8,0,8,3,0,3,115,61,33,28,9,8,1,8,0,8,3,0,3
04/26/2021,Interior,6,GACH,1,101,81,49,32,20,12,8,16,0,16,10,0,10,101,81,49,32,20,12,8,16,0,16,10,0,10
04/26/2021,Matanuska-Susitna,3,GACH,1,184,160,82,78,14,14,0,33,8,25,10,0,10,184,160,82,78,14,14,0,33,8,25,10,0,10
04/26/2021,Northern,2,CAH,1,139,110,16,94,8,0,8,36,0,36,0,0,0,139,110,16,94,8,0,8,36,0,36,0,0,0
04/26/2021,Southeast,5,CAH,1,70,70,35,35,8,0,8,33,0,33,1,0,1,70,70,35,35,8,0,8,33,0,33,1,0,1
04/26/2021,Southeast,5,GACH,1,161,133,28,105,9,5,4,20,0,20,0,0,0,161,133,28,105,9,5,4,20,0,20,0,0,0
04/26/2021,Southwest,1,CAH,1,22,12,1,11,0,0,0,4,0,4,0,0,0,22,12,1,11,0,0,0,4,0,4,0,0,0
04/26/2021,Southwest,1,GACH,1,53,45,24,21,0,0,0,4,0,4,0,0,0,53,45,24,21,0,0,0,4,0,4,0,0,0
04/27/2021,Anchorage,7,GACH,1,739,706,544,162,138,109,29,179,24,155,18,6,24,739,706,544,162,138,109,29,179,24,155,18,6,24
04/27/2021,Anchorage,7,LTACH,0,44,44,33,11,6,5,1,23,5,18,0,0,0,44,44,33,11,6,5,1,23,5,18,0,0,0
04/27/2021,Anchorage,7,Psych,0,,,,,,,,,,,,,,200,191,127,64,0,0,0,0,0,0,0,0,0
04/27/2021,Gulf Coast,4,CAH,1,83,73,24,49,4,1,3,18,0,18,0,0,0,83,73,24,49,4,1,3,18,0,18,0,0,0
04/27/2021,Gulf Coast,4,GACH,1,115,61,43,18,9,7,2,8,0,8,3,0,3,115,61,43,18,9,7,2,8,0,8,3,0,3
04/27/2021,Interior,6,GACH,1,101,81,70,11,20,12,8,16,0,16,10,0,10,101,81,70,11,20,12,8,16,0,16,10,0,10
04/27/2021,Matanuska-Susitna,3,GACH,1,184,160,81,79,14,14,0,33,8,25,10,0,10,184,160,81,79,14,14,0,33,8,25,10,0,10
04/27/2021,Northern,2,CAH,1,139,110,16,94,8,0,8,36,0,36,0,0,0,139,110,16,94,8,0,8,36,0,36,0,0,0
04/27/2021,Southeast,5,CAH,1,70,70,33,37,8,0,8,33,0,33,1,0,1,70,70,33,37,8,0,8,33,0,33,1,0,1
04/27/2021,Southeast,5,GACH,1,161,133,31,102,9,5,4,20,0,20,1,0,1,161,133,31,102,9,5,4,20,0,20,1,0,1
04/27/2021,Southwest,1,CAH,1,22,12,1,11,0,0,0,4,0,4,0,0,0,22,12,1,11,0,0,0,4,0,4,0,0,0
04/27/2021,Southwest,1,GACH,1,53,45,22,23,0,0,0,4,0,4,0,0,0,53,45,22,23,0,0,0,4,0,4,0,0,0
04/28/2021,Anchorage,7,GACH,1,757,728,632,96,129,111,18,179,27,152,20,0,20,757,728,632,96,129,111,18,179,27,152,20,0,20
04/28/2021,Anchorage,7,LTACH,0,44,44,33,11,6,5,1,23,5,18,0,0,0,44,44,33,11,6,5,1,23,5,18,0,0,0
04/28/2021,Anchorage,7,Psych,0,200,185,124,61,0,0,0,0,0,0,1,0,1,200,185,124,61,0,0,0,0,0,0,1,0,1
04/28/2021,Gulf Coast,4,CAH,1,83,73,23,50,4,1,3,18,0,18,0,0,0,83,73,23,50,4,1,3,18,0,18,0,0,0
04/28/2021,Gulf Coast,4,GACH,1,115,61,46,15,9,6,3,8,0,8,4,0,4,115,61,46,15,9,6,3,8,0,8,4,0,4
04/28/2021,Interior,6,GACH,1,101,81,61,20,20,12,8,16,0,16,11,0,11,101,81,61,20,20,12,8,16,0,16,11,0,11
04/28/2021,Matanuska-Susitna,3,GACH,1,184,160,86,74,14,14,0,33,8,25,9,0,9,184,160,86,74,14,14,0,33,8,25,9,0,9
04/28/2021,Northern,2,CAH,1,139,110,18,92,0,0,0,44,0,44,0,0,0,139,110,18,92,0,0,0,44,0,44,0,0,0
04/28/2021,Southeast,5,CAH,1,70,70,41,29,8,0,8,33,0,33,1,0,1,70,70,41,29,8,0,8,33,0,33,1,0,1
04/28/2021,Southeast,5,GACH,1,161,133,33,100,9,2,7,20,0,20,1,0,1,161,133,33,100,9,2,7,20,0,20,1,0,1
04/28/2021,Southwest,1,CAH,1,22,12,3,9,0,0,0,4,0,4,0,0,0,22,12,3,9,0,0,0,4,0,4,0,0,0
04/28/2021,Southwest,1,GACH,1,53,45,18,27,0,0,0,4,0,4,0,0,0,53,45,18,27,0,0,0,4,0,4,0,0,0
04/29/2021,Anchorage,7,GACH,1,749,720,624,96,129,111,18,179,26,153,20,9,29,749,720,624,96,129,111,18,179,26,153,20,9,29
04/29/2021,Anchorage,7,LTACH,0,44,44,34,10,6,5,1,23,5,18,0,0,0,44,44,34,10,6,5,1,23,5,18,0,0,0
04/29/2021,Anchorage,7,Psych,0,,,,,,,,,,,,,,200,185,124,61,0,0,0,0,0,0,1,0,1
04/29/2021,Gulf Coast,4,CAH,1,83,73,16,57,4,1,3,18,0,18,0,0,0,83,73,16,57,4,1,3,18,0,18,0,0,0
04/29/2021,Gulf Coast,4,GACH,1,115,61,45,16,9,6,3,8,0,8,2,0,2,115,61,45,16,9,6,3,8,0,8,2,0,2
04/29/2021,Interior,6,GACH,1,101,81,56,25,20,13,7,16,0,16,10,0,10,101,81,56,25,20,13,7,16,0,16,10,0,10
04/29/2021,Matanuska-Susitna,3,GACH,1,184,160,74,86,14,11,3,33,7,26,13,0,13,184,160,74,86,14,11,3,33,7,26,13,0,13
04/29/2021,Northern,2,CAH,1,139,110,26,84,0,0,0,44,0,44,0,0,0,139,110,26,84,0,0,0,44,0,44,0,0,0
04/29/2021,Southeast,5,CAH,1,70,70,42,28,8,2,6,33,0,33,1,0,1,70,70,42,28,8,2,6,33,0,33,1,0,1
04/29/2021,Southeast,5,GACH,1,161,133,30,103,9,3,6,20,0,20,1,0,1,161,133,30,103,9,3,6,20,0,20,1,0,1
04/29/2021,Southwest,1,CAH,1,22,12,0,12,0,0,0,4,0,4,0,0,0,22,12,0,12,0,0,0,4,0,4,0,0,0
04/29/2021,Southwest,1,GACH,1,53,45,22,23,0,0,0,4,0,4,0,0,0,53,45,22,23,0,0,0,4,0,4,0,0,0
04/30/2021,Anchorage,7,GACH,1,733,708,627,81,125,107,18,179,22,157,22,0,22,733,708,627,81,125,107,18,179,22,157,22,0,22
04/30/2021,Anchorage,7,LTACH,0,44,44,36,8,6,6,0,23,6,17,0,0,0,44,44,36,8,6,6,0,23,6,17,0,0,0
04/30/2021,Anchorage,7,Psych,0,,,,,,,,,,,,,,200,185,124,61,0,0,0,0,0,0,1,0,1
04/30/2021,Gulf Coast,4,CAH,1,81,71,30,41,4,3,1,18,0,18,0,0,0,81,71,30,41,4,3,1,18,0,18,0,0,0
04/30/2021,Gulf Coast,4,GACH,1,115,61,46,15,9,5,4,8,0,8,2,0,2,115,61,46,15,9,5,4,8,0,8,2,0,2
04/30/2021,Interior,6,GACH,1,101,81,61,20,20,11,9,16,2,14,12,0,12,101,81,61,20,20,11,9,16,2,14,12,0,12
04/30/2021,Matanuska-Susitna,3,GACH,1,184,160,85,75,14,11,3,33,5,28,13,0,13,184,160,85,75,14,11,3,33,5,28,13,0,13
04/30/2021,Northern,2,CAH,1,139,110,27,83,0,0,0,44,0,44,0,0,0,139,110,27,83,0,0,0,44,0,44,0,0,0
04/30/2021,Southeast,5,CAH,1,70,70,34,36,8,4,4,33,0,33,2,0,2,70,70,34,36,8,4,4,33,0,33,2,0,2
04/30/2021,Southeast,5,GACH,1,161,133,33,100,9,4,5,20,0,20,1,0,1,161,133,33,100,9,4,5,20,0,20,1,0,1
04/30/2021,Southwest,1,CAH,1,22,12,1,11,0,0,0,4,0,4,0,0,0,22,12,1,11,0,0,0,4,0,4,0,0,0
04/30/2021,Southwest,1,GACH,1,53,45,21,24,0,0,0,4,0,4,0,0,0,53,45,21,24,0,0,0,4,0,4,0,0,0
05/01/2021,Anchorage,7,GACH,1,721,691,607,84,123,101,22,179,27,152,21,0,21,721,691,607,84,123,101,22,179,27,152,21,0,21
05/01/2021,Anchorage,7,LTACH,0,44,44,36,8,6,6,0,23,8,15,0,0,0,44,44,36,8,6,6,0,23,8,15,0,0,0
05/01/2021,Anchorage,7,Psych,0,,,,,,,,,,,,,,200,185,124,61,0,0,0,0,0,0,1,0,1
05/01/2021,Gulf Coast,4,CAH,1,81,71,22,49,4,1,3,18,0,18,0,0,0,81,71,22,49,4,1,3,18,0,18,0,0,0
05/01/2021,Gulf Coast,4,GACH,1,115,61,44,17,9,7,2,8,0,8,3,0,3,115,61,44,17,9,7,2,8,0,8,3,0,3
05/01/2021,Interior,6,GACH,1,101,81,64,17,20,11,9,16,1,15,13,0,13,101,81,64,17,20,11,9,16,1,15,13,0,13
05/01/2021,Matanuska-Susitna,3,GACH,1,184,160,84,76,14,13,1,33,5,28,14,0,14,184,160,84,76,14,13,1,33,5,28,14,0,14
05/01/2021,Northern,2,CAH,1,139,110,25,85,8,0,8,44,0,44,0,0,0,139,110,25,85,8,0,8,44,0,44,0,0,0
05/01/2021,Southeast,5,CAH,1,70,70,33,37,8,4,4,33,0,33,2,0,2,70,70,33,37,8,4,4,33,0,33,2,0,2
05/01/2021,Southeast,5,GACH,1,161,133,33,100,9,6,3,20,0,20,1,0,1,161,133,33,100,9,6,3,20,0,20,1,0,1
05/01/2021,Southwest,1,CAH,1,22,12,2,10,0,0,0,4,0,4,0,0,0,22,12,2,10,0,0,0,4,0,4,0,0,0
05/01/2021,Southwest,1,GACH,1,53,45,21,24,0,0,0,4,0,4,0,0,0,53,45,21,24,0,0,0,4,0,4,0,0,0
05/02/2021,Anchorage,7,GACH,1,746,701,590,111,124,99,25,179,24,155,17,0,17,746,701,590,111,124,99,25,179,24,155,17,0,17
05/02/2021,Anchorage,7,LTACH,0,44,44,37,7,6,6,0,23,8,15,0,0,0,44,44,37,7,6,6,0,23,8,15,0,0,0
05/02/2021,Anchorage,7,Psych,0,,,,,,,,,,,,,,200,185,124,61,0,0,0,0,0,0,1,0,1
05/02/2021,Gulf Coast,4,CAH,1,81,71,23,48,4,2,2,18,0,18,0,0,0,81,71,23,48,4,2,2,18,0,18,0,0,0
05/02/2021,Gulf Coast,4,GACH,1,115,61,35,26,9,7,2,8,0,8,4,0,4,115,61,35,26,9,7,2,8,0,8,4,0,4
05/02/2021,Interior,6,GACH,1,101,81,55,26,20,12,8,16,1,15,15,0,15,101,81,55,26,20,12,8,16,1,15,15,0,15
05/02/2021,Matanuska-Susitna,3,GACH,1,184,160,76,84,14,9,5,33,5,28,16,0,16,184,160,76,84,14,9,5,33,5,28,16,0,16
05/02/2021,Northern,2,CAH,1,139,110,19,91,8,0,8,44,0,44,0,0,0,139,110,19,91,8,0,8,44,0,44,0,0,0
05/02/2021,Southeast,5,CAH,1,70,70,31,39,8,3,5,33,0,33,2,0,2,70,70,31,39,8,3,5,33,0,33,2,0,2
05/02/2021,Southeast,5,GACH,1,161,133,41,92,9,6,3,20,0,20,1,0,1,161,133,41,92,9,6,3,20,0,20,1,0,1
05/02/2021,Southwest,1,CAH,1,22,12,1,11,0,0,0,4,0,4,0,0,0,22,12,1,11,0,0,0,4,0,4,0,0,0
05/02/2021,Southwest,1,GACH,1,53,45,19,26,0,0,0,4,0,4,0,0,0,53,45,19,26,0,0,0,4,0,4,0,0,0
05/03/2021,Anchorage,7,GACH,1,805,777,613,164,162,109,53,179,26,153,16,0,16,805,777,613,164,162,109,53,179,26,153,16,0,16
05/03/2021,Anchorage,7,LTACH,0,44,44,37,7,6,6,0,23,8,15,0,0,0,44,44,37,7,6,6,0,23,8,15,0,0,0
05/03/2021,Anchorage,7,Psych,0,,,,,,,,,,,,,,200,185,124,61,0,0,0,0,0,0,1,0,1
05/03/2021,Gulf Coast,4,CAH,1,81,71,24,47,4,1,3,18,0,18,0,0,0,81,71,24,47,4,1,3,18,0,18,0,0,0
05/03/2021,Gulf Coast,4,GACH,1,115,61,36,25,9,8,1,8,0,8,4,0,4,115,61,36,25,9,8,1,8,0,8,4,0,4
05/03/2021,Interior,6,GACH,1,101,81,53,28,20,8,12,16,1,15,14,0,14,101,81,53,28,20,8,12,16,1,15,14,0,14
05/03/2021,Matanuska-Susitna,3,GACH,1,184,160,77,83,14,12,2,33,10,23,15,0,15,184,160,77,83,14,12,2,33,10,23,15,0,15
05/03/2021,Northern,2,CAH,1,139,110,22,88,8,0,8,44,0,44,0,0,0,139,110,22,88,8,0,8,44,0,44,0,0,0
05/03/2021,Southeast,5,CAH,1,70,70,29,41,8,3,5,33,0,33,2,0,2,70,70,29,41,8,3,5,33,0,33,2,0,2
05/03/2021,Southeast,5,GACH,1,161,133,38,95,9,2,7,20,0,20,1,0,1,161,133,38,95,9,2,7,20,0,20,1,0,1
05/03/2021,Southwest,1,CAH,1,22,12,1,11,0,0,0,4,0,4,0,0,0,22,12,1,11,0,0,0,4,0,4,0,0,0
05/03/2021,Southwest,1,GACH,1,53,45,4,41,0,0,0,4,0,4,0,0,0,53,45,4,41,0,0,0,4,0,4,0,0,0
05/04/2021,Anchorage,7,GACH,1,805,776,615,161,158,108,50,179,26,153,22,0,22,805,776,615,161,158,108,50,179,26,153,22,0,22
05/04/2021,Anchorage,7,LTACH,0,44,44,37,7,6,6,0,23,8,15,0,0,0,44,44,37,7,6,6,0,23,8,15,0,0,0
05/04/2021,Anchorage,7,Psych,0,,,,,,,,,,,,,,200,185,124,61,0,0,0,0,0,0,1,0,1
05/04/2021,Gulf Coast,4,CAH,1,82,72,26,46,4,1,3,18,0,18,0,0,0,82,72,26,46,4,1,3,18,0,18,0,0,0
05/04/2021,Gulf Coast,4,GACH,1,115,61,41,20,9,7,2,8,0,8,2,0,2,115,61,41,20,9,7,2,8,0,8,2,0,2
05/04/2021,Interior,6,GACH,1,101,81,57,24,20,10,10,16,0,16,15,0,15,101,81,57,24,20,10,10,16,0,16,15,0,15
05/04/2021,Matanuska-Susitna,3,GACH,1,184,160,85,75,14,10,4,33,6,27,13,0,13,184,160,85,75,14,10,4,33,6,27,13,0,13
05/04/2021,Northern,2,CAH,1,139,110,25,85,8,0,8,44,0,44,0,0,0,139,110,25,85,8,0,8,44,0,44,0,0,0
05/04/2021,Southeast,5,CAH,1,70,70,31,39,8,0,8,33,0,33,1,0,1,70,70,31,39,8,0,8,33,0,33,1,0,1
05/04/2021,Southeast,5,GACH,1,161,133,46,87,9,5,4,20,0,20,1,0,1,161,133,46,87,9,5,4,20,0,20,1,0,1
05/04/2021,Southwest,1,CAH,1,22,12,2,10,0,0,0,4,0,4,0,0,0,22,12,2,10,0,0,0,4,0,4,0,0,0
05/04/2021,Southwest,1,GACH,1,53,45,8,37,0,0,0,4,0,4,0,0,0,53,45,8,37,0,0,0,4,0,4,0,0,0
05/05/2021,Anchorage,7,GACH,1,758,716,617,99,132,106,26,179,24,155,19,0,19,758,716,617,99,132,106,26,179,24,155,19,0,19
05/05/2021,Anchorage,7,LTACH,0,44,44,37,7,6,6,0,23,7,16,0,0,0,44,44,37,7,6,6,0,23,7,16,0,0,0
05/05/2021,Anchorage,7,Psych,0,60,51,51,0,0,0,0,0,0,0,0,0,0,200,191,130,61,0,0,0,0,0,0,1,0,1
05/05/2021,Gulf Coast,4,CAH,1,81,71,28,43,4,1,3,18,0,18,0,0,0,81,71,28,43,4,1,3,18,0,18,0,0,0
05/05/2021,Gulf Coast,4,GACH,1,115,61,47,14,9,9,0,8,0,8,2,0,2,115,61,47,14,9,9,0,8,0,8,2,0,2
05/05/2021,Interior,6,GACH,1,101,81,63,18,20,11,9,16,1,15,14,0,14,101,81,63,18,20,11,9,16,1,15,14,0,14
05/05/2021,Matanuska-Susitna,3,GACH,1,184,160,84,76,14,9,5,33,5,28,13,0,13,184,160,84,76,14,9,5,33,5,28,13,0,13
05/05/2021,Northern,2,CAH,1,139,110,21,89,8,0,8,36,0,36,0,0,0,139,110,21,89,8,0,8,36,0,36,0,0,0
05/05/2021,Southeast,5,CAH,1,70,70,34,36,8,0,8,33,0,33,0,0,0,70,70,34,36,8,0,8,33,0,33,0,0,0
05/05/2021,Southeast,5,GACH,1,161,133,46,87,9,2,7,20,0,20,1,0,1,161,133,46,87,9,2,7,20,0,20,1,0,1
05/05/2021,Southwest,1,CAH,1,22,12,1,11,0,0,0,4,0,4,0,0,0,22,12,1,11,0,0,0,4,0,4,0,0,0
05/05/2021,Southwest,1,GACH,1,53,45,9,36,0,0,0,4,0,4,0,0,0,53,45,9,36,0,0,0,4,0,4,0,0,0
05/06/2021,Anchorage,7,GACH,1,762,720,628,92,136,104,32,179,23,156,18,0,18,762,720,628,92,136,104,32,179,23,156,18,0,18
05/06/2021,Anchorage,7,LTACH,0,44,44,38,6,6,6,0,23,6,17,0,0,0,44,44,38,6,6,6,0,23,6,17,0,0,0
05/06/2021,Anchorage,7,Psych,0,140,140,85,55,0,0,0,0,0,0,1,0,1,200,191,136,55,0,0,0,0,0,0,1,0,1
05/06/2021,Gulf Coast,4,CAH,1,81,71,26,45,4,0,4,18,0,18,0,0,0,81,71,26,45,4,0,4,18,0,18,0,0,0
05/06/2021,Gulf Coast,4,GACH,1,115,61,44,17,9,8,1,8,0,8,2,0,2,115,61,44,17,9,8,1,8,0,8,2,0,2
05/06/2021,Interior,6,GACH,1,101,81,52,29,20,13,7,16,1,15,13,0,13,101,81,52,29,20,13,7,16,1,15,13,0,13
05/06/2021,Matanuska-Susitna,3,GACH,1,184,160,80,80,14,9,5,33,4,29,11,0,11,184,160,80,80,14,9,5,33,4,29,11,0,11
05/06/2021,Northern,2,CAH,1,139,110,24,86,8,0,8,36,0,36,0,0,0,139,110,24,86,8,0,8,36,0,36,0,0,0
05/06/2021,Southeast,5,CAH,1,70,70,32,38,8,1,7,33,0,33,0,0,0,70,70,32,38,8,1,7,33,0,33,0,0,0
05/06/2021,Southeast,5,GACH,1,161,133,47,86,9,3,6,20,1,19,1,0,1,161,133,47,86,9,3,6,20,1,19,1,0,1
05/06/2021,Southwest,1,CAH,1,22,12,1,11,0,0,0,4,0,4,0,0,0,22,12,1,11,0,0,0,4,0,4,0,0,0
05/06/2021,Southwest,1,GACH,1,53,45,16,29,0,0,0,4,0,4,0,0,0,53,45,16,29,0,0,0,4,0,4,0,0,0
05/07/2021,Anchorage,7,GACH,1,737,699,604,95,132,108,24,179,22,157,17,0,17,737,699,604,95,132,108,24,179,22,157,17,0,17
05/07/2021,Anchorage,7,LTACH,0,44,44,38,6,6,6,0,23,5,18,0,0,0,44,44,38,6,6,6,0,23,5,18,0,0,0
05/07/2021,Anchorage,7,Psych,0,,,,,,,,,,,,,,200,191,136,55,0,0,0,0,0,0,1,0,1
05/07/2021,Gulf Coast,4,CAH,1,81,71,23,48,4,0,4,18,0,18,0,0,0,81,71,23,48,4,0,4,18,0,18,0,0,0
05/07/2021,Gulf Coast,4,GACH,1,115,61,39,22,9,9,0,8,0,8,2,0,2,115,61,39,22,9,9,0,8,0,8,2,0,2
05/07/2021,Interior,6,GACH,1,101,81,50,31,20,11,9,16,0,16,11,0,11,101,81,50,31,20,11,9,16,0,16,11,0,11
05/07/2021,Matanuska-Susitna,3,GACH,1,184,160,77,83,14,8,6,33,4,29,11,0,11,184,160,77,83,14,8,6,33,4,29,11,0,11
05/07/2021,Northern,2,CAH,1,139,110,25,85,8,0,8,36,0,36,0,0,0,139,110,25,85,8,0,8,36,0,36,0,0,0
05/07/2021,Southeast,5,CAH,1,70,70,29,41,8,1,7,33,0,33,0,0,0,70,70,29,41,8,1,7,33,0,33,0,0,0
05/07/2021,Southeast,5,GACH,1,161,133,42,91,9,4,5,20,1,19,1,0,1,161,133,42,91,9,4,5,20,1,19,1,0,1
05/07/2021,Southwest,1,CAH,1,22,12,2,10,0,0,0,4,0,4,0,0,0,22,12,2,10,0,0,0,4,0,4,0,0,0
05/07/2021,Southwest,1,GACH,1,53,45,16,29,0,0,0,4,0,4,0,0,0,53,45,16,29,0,0,0,4,0,4,0,0,0
05/08/2021,Anchorage,7,GACH,1,745,705,590,115,132,111,21,179,21,158,21,0,21,745,705,590,115,132,111,21,179,21,158,21,0,21
05/08/2021,Anchorage,7,LTACH,0,44,44,41,3,6,6,0,23,5,18,0,0,0,44,44,41,3,6,6,0,23,5,18,0,0,0
05/08/2021,Anchorage,7,Psych,0,,,,,,,,,,,,,,200,191,136,55,0,0,0,0,0,0,1,0,1
05/08/2021,Gulf Coast,4,CAH,1,81,71,17,54,4,1,3,18,0,18,0,0,0,81,71,17,54,4,1,3,18,0,18,0,0,0
05/08/2021,Gulf Coast,4,GACH,1,115,61,32,29,9,6,3,8,0,8,2,0,2,115,61,32,29,9,6,3,8,0,8,2,0,2
05/08/2021,Interior,6,GACH,1,101,81,50,31,20,11,9,16,0,16,9,0,9,101,81,50,31,20,11,9,16,0,16,9,0,9
05/08/2021,Matanuska-Susitna,3,GACH,1,184,160,86,74,14,10,4,33,2,31,9,0,9,184,160,86,74,14,10,4,33,2,31,9,0,9
05/08/2021,Northern,2,CAH,1,139,110,21,89,8,0,8,36,0,36,0,0,0,139,110,21,89,8,0,8,36,0,36,0,0,0
05/08/2021,Southeast,5,CAH,1,70,70,25,45,8,1,7,33,0,33,0,0,0,70,70,25,45,8,1,7,33,0,33,0,0,0
05/08/2021,Southeast,5,GACH,1,161,133,50,83,9,6,3,20,1,19,0,0,0,161,133,50,83,9,6,3,20,1,19,0,0,0
05/08/2021,Southwest,1,CAH,1,22,12,1,11,0,0,0,4,0,4,0,0,0,22,12,1,11,0,0,0,4,0,4,0,0,0
05/08/2021,Southwest,1,GACH,1,53,45,17,28,0,0,0,4,0,4,0,0,0,53,45,17,28,0,0,0,4,0,4,0,0,0
05/09/2021,Anchorage,7,GACH,1,744,701,577,124,133,108,25,179,24,155,19,0,19,744,701,577,124,133,108,25,179,24,155,19,0,19
05/09/2021,Anchorage,7,LTACH,0,44,44,40,4,6,6,0,23,6,17,0,0,0,44,44,40,4,6,6,0,23,6,17,0,0,0
05/09/2021,Anchorage,7,Psych,0,,,,,,,,,,,,,,200,191,136,55,0,0,0,0,0,0,1,0,1
05/09/2021,Gulf Coast,4,CAH,1,81,71,17,54,4,1,3,18,0,18,0,0,0,81,71,17,54,4,1,3,18,0,18,0,0,0
05/09/2021,Gulf Coast,4,GACH,1,115,61,39,22,9,5,4,8,0,8,2,0,2,115,61,39,22,9,5,4,8,0,8,2,0,2
05/09/2021,Interior,6,GACH,1,101,81,44,37,20,12,8,16,0,16,8,0,8,101,81,44,37,20,12,8,16,0,16,8,0,8
05/09/2021,Matanuska-Susitna,3,GACH,1,184,160,85,75,14,10,4,33,4,29,9,0,9,184,160,85,75,14,10,4,33,4,29,9,0,9
05/09/2021,Northern,2,CAH,1,139,110,20,90,8,0,8,36,0,36,0,0,0,139,110,20,90,8,0,8,36,0,36,0,0,0
05/09/2021,Southeast,5,CAH,1,70,70,25,45,8,2,6,33,0,33,0,0,0,70,70,25,45,8,2,6,33,0,33,0,0,0
05/09/2021,Southeast,5,GACH,1,161,133,42,91,9,6,3,20,1,19,0,0,0,161,133,42,91,9,6,3,20,1,19,0,0,0
05/09/2021,Southwest,1,CAH,1,22,12,1,11,0,0,0,4,0,4,0,0,0,22,12,1,11,0,0,0,4,0,4,0,0,0
05/09/2021,Southwest,1,GACH,1,53,45,18,27,0,0,0,4,0,4,0,0,0,53,45,18,27,0,0,0,4,0,4,0,0,0
05/10/2021,Anchorage,7,GACH,1,748,706,560,146,132,107,25,179,21,158,21,0,21,748,706,560,146,132,107,25,179,21,158,21,0,21
05/10/2021,Anchorage,7,LTACH,0,44,44,40,4,6,6,0,23,6,17,0,0,0,44,44,40,4,6,6,0,23,6,17,0,0,0
05/10/2021,Anchorage,7,Psych,0,,,,,,,,,,,,,,200,191,136,55,0,0,0,0,0,0,1,0,1
05/10/2021,Gulf Coast,4,CAH,1,77,68,25,43,4,1,3,18,0,18,0,0,0,77,68,25,43,4,1,3,18,0,18,0,0,0
05/10/2021,Gulf Coast,4,GACH,1,115,61,42,19,9,6,3,8,0,8,2,0,2,115,61,42,19,9,6,3,8,0,8,2,0,2
05/10/2021,Interior,6,GACH,1,101,81,42,39,20,11,9,16,0,16,6,0,6,101,81,42,39,20,11,9,16,0,16,6,0,6
05/10/2021,Matanuska-Susitna,3,GACH,1,184,160,90,70,14,9,5,33,3,30,10,0,10,184,160,90,70,14,9,5,33,3,30,10,0,10
05/10/2021,Northern,2,CAH,1,139,110,16,94,8,0,8,36,0,36,0,0,0,139,110,16,94,8,0,8,36,0,36,0,0,0
05/10/2021,Southeast,5,CAH,1,70,70,25,45,8,1,7,33,0,33,0,0,0,70,70,25,45,8,1,7,33,0,33,0,0,0
05/10/2021,Southeast,5,GACH,1,161,133,37,96,9,3,6,20,0,20,0,0,0,161,133,37,96,9,3,6,20,0,20,0,0,0
05/10/2021,Southwest,1,CAH,1,22,12,0,12,0,0,0,4,0,4,0,0,0,22,12,0,12,0,0,0,4,0,4,0,0,0
05/10/2021,Southwest,1,GACH,1,53,45,19,26,0,0,0,4,0,4,0,0,0,53,45,19,26,0,0,0,4,0,4,0,0,0
05/11/2021,Anchorage,7,GACH,1,753,716,578,138,135,105,30,179,19,160,19,0,19,753,716,578,138,135,105,30,179,19,160,19,0,19
05/11/2021,Anchorage,7,LTACH,0,44,44,43,1,6,6,0,23,5,18,0,0,0,44,44,43,1,6,6,0,23,5,18,0,0,0
05/11/2021,Anchorage,7,Psych,0,,,,,,,,,,,,,,200,191,136,55,0,0,0,0,0,0,1,0,1
05/11/2021,Gulf Coast,4,CAH,1,77,68,24,44,4,0,4,18,0,18,0,0,0,77,68,24,44,4,0,4,18,0,18,0,0,0
05/11/2021,Gulf Coast,4,GACH,1,115,61,47,14,9,8,1,8,0,8,3,0,3,115,61,47,14,9,8,1,8,0,8,3,0,3
05/11/2021,Interior,6,GACH,1,101,81,41,40,20,11,9,16,0,16,7,0,7,101,81,41,40,20,11,9,16,0,16,7,0,7
05/11/2021,Matanuska-Susitna,3,GACH,1,184,160,86,74,14,8,6,33,3,30,9,0,9,184,160,86,74,14,8,6,33,3,30,9,0,9
05/11/2021,Northern,2,CAH,1,139,110,21,89,8,0,8,36,0,36,0,0,0,139,110,21,89,8,0,8,36,0,36,0,0,0
05/11/2021,Southeast,5,CAH,1,70,70,26,44,8,0,8,33,0,33,0,0,0,70,70,26,44,8,0,8,33,0,33,0,0,0
05/11/2021,Southeast,5,GACH,1,161,133,38,95,9,3,6,20,0,20,1,0,1,161,133,38,95,9,3,6,20,0,20,1,0,1
05/11/2021,Southwest,1,CAH,1,22,12,3,9,0,0,0,4,0,4,0,0,0,22,12,3,9,0,0,0,4,0,4,0,0,0
05/11/2021,Southwest,1,GACH,1,53,45,10,35,0,0,0,4,0,4,0,0,0,53,45,10,35,0,0,0,4,0,4,0,0,0
05/12/2021,Anchorage,7,GACH,1,749,708,587,121,131,105,26,179,26,153,17,0,17,749,708,587,121,131,105,26,179,26,153,17,0,17
05/12/2021,Anchorage,7,LTACH,0,44,44,43,1,6,6,0,23,6,17,0,0,0,44,44,43,1,6,6,0,23,6,17,0,0,0
05/12/2021,Anchorage,7,Psych,0,203,198,136,62,0,0,0,0,0,0,1,0,1,203,198,136,62,0,0,0,0,0,0,1,0,1
05/12/2021,Gulf Coast,4,CAH,1,77,67,26,41,4,0,4,18,0,18,1,0,1,77,67,26,41,4,0,4,18,0,18,1,0,1
05/12/2021,Gulf Coast,4,GACH,1,115,61,44,17,9,6,3,8,0,8,2,0,2,115,61,44,17,9,6,3,8,0,8,2,0,2
05/12/2021,Interior,6,GACH,1,101,81,47,34,20,12,8,16,0,16,6,0,6,101,81,47,34,20,12,8,16,0,16,6,0,6
05/12/2021,Matanuska-Susitna,3,GACH,1,184,160,87,73,14,11,3,33,4,29,7,0,7,184,160,87,73,14,11,3,33,4,29,7,0,7
05/12/2021,Northern,2,CAH,1,139,110,20,90,8,0,8,36,0,36,0,0,0,139,110,20,90,8,0,8,36,0,36,0,0,0
05/12/2021,Southeast,5,CAH,1,70,70,28,42,8,0,8,33,0,33,0,0,0,70,70,28,42,8,0,8,33,0,33,0,0,0
05/12/2021,Southeast,5,GACH,1,161,133,44,89,9,4,5,20,0,20,0,0,0,161,133,44,89,9,4,5,20,0,20,0,0,0
05/12/2021,Southwest,1,CAH,1,22,12,2,10,0,0,0,4,0,4,0,0,0,22,12,2,10,0,0,0,4,0,4,0,0,0
05/12/2021,Southwest,1,GACH,1,53,45,11,34,0,0,0,4,0,4,0,0,0,53,45,11,34,0,0,0,4,0,4,0,0,0
05/13/2021,Anchorage,7,GACH,1,740,705,599,106,132,116,16,179,30,149,16,0,16,740,705,599,106,132,116,16,179,30,149,16,0,16
05/13/2021,Anchorage,7,LTACH,0,44,44,43,1,6,6,0,23,5,18,0,0,0,44,44,43,1,6,6,0,23,5,18,0,0,0
05/13/2021,Anchorage,7,Psych,0,,,,,,,,,,,,,,203,198,136,62,0,0,0,0,0,0,1,0,1
05/13/2021,Gulf Coast,4,CAH,1,77,67,23,44,4,0,4,18,0,18,1,0,1,77,67,23,44,4,0,4,18,0,18,1,0,1
05/13/2021,Gulf Coast,4,GACH,1,115,61,51,10,9,9,0,8,0,8,2,0,2,115,61,51,10,9,9,0,8,0,8,2,0,2
05/13/2021,Interior,6,GACH,1,101,81,54,27,20,11,9,16,0,16,5,0,5,101,81,54,27,20,11,9,16,0,16,5,0,5
05/13/2021,Matanuska-Susitna,3,GACH,1,184,160,88,72,14,14,0,33,6,27,7,0,7,184,160,88,72,14,14,0,33,6,27,7,0,7
05/13/2021,Northern,2,CAH,1,139,110,20,90,8,0,8,36,0,36,0,0,0,139,110,20,90,8,0,8,36,0,36,0,0,0
05/13/2021,Southeast,5,CAH,1,70,70,24,46,8,0,8,33,0,33,0,0,0,70,70,24,46,8,0,8,33,0,33,0,0,0
05/13/2021,Southeast,5,GACH,1,161,133,38,95,9,2,7,20,0,20,0,0,0,161,133,38,95,9,2,7,20,0,20,0,0,0
05/13/2021,Southwest,1,CAH,1,22,12,1,11,0,0,0,4,0,4,0,0,0,22,12,1,11,0,0,0,4,0,4,0,0,0
05/13/2021,Southwest,1,GACH,1,53,45,11,34,0,0,0,4,0,4,0,0,0,53,45,11,34,0,0,0,4,0,4,0,0,0
05/14/2021,Anchorage,7,GACH,1,741,703,611,92,133,112,21,179,32,147,14,0,14,741,703,611,92,133,112,21,179,32,147,14,0,14
05/14/2021,Anchorage,7,LTACH,0,44,44,42,2,6,6,0,23,6,17,0,0,0,44,44,42,2,6,6,0,23,6,17,0,0,0
05/14/2021,Anchorage,7,Psych,0,,,,,,,,,,,,,,203,198,136,62,0,0,0,0,0,0,1,0,1
05/14/2021,Gulf Coast,4,CAH,1,78,69,22,47,4,0,4,18,0,18,1,0,1,78,69,22,47,4,0,4,18,0,18,1,0,1
05/14/2021,Gulf Coast,4,GACH,1,115,61,46,15,9,7,2,8,0,8,1,0,1,115,61,46,15,9,7,2,8,0,8,1,0,1
05/14/2021,Interior,6,GACH,1,101,81,53,28,20,13,7,16,1,15,4,0,4,101,81,53,28,20,13,7,16,1,15,4,0,4
05/14/2021,Matanuska-Susitna,3,GACH,1,184,160,78,82,14,9,5,33,5,28,8,0,8,184,160,78,82,14,9,5,33,5,28,8,0,8
05/14/2021,Northern,2,CAH,1,139,110,18,92,8,0,8,36,0,36,0,0,0,139,110,18,92,8,0,8,36,0,36,0,0,0
05/14/2021,Southeast,5,CAH,1,70,70,25,45,8,0,8,33,0,33,0,0,0,70,70,25,45,8,0,8,33,0,33,0,0,0
05/14/2021,Southeast,5,GACH,1,161,133,45,88,9,4,5,20,0,20,0,0,0,161,133,45,88,9,4,5,20,0,20,0,0,0
05/14/2021,Southwest,1,CAH,1,22,12,1,11,0,0,0,4,0,4,0,0,0,22,12,1,11,0,0,0,4,0,4,0,0,0
05/14/2021,Southwest,1,GACH,1,53,45,12,33,0,0,0,4,0,4,0,0,0,53,45,12,33,0,0,0,4,0,4,0,0,0
05/15/2021,Anchorage,7,GACH,1,734,708,619,89,139,116,23,179,36,143,12,0,12,734,708,619,89,139,116,23,179,36,143,12,0,12
05/15/2021,Anchorage,7,LTACH,0,44,44,42,2,6,6,0,23,7,16,0,0,0,44,44,42,2,6,6,0,23,7,16,0,0,0
05/15/2021,Anchorage,7,Psych,0,,,,,,,,,,,,,,203,198,136,62,0,0,0,0,0,0,1,0,1
05/15/2021,Gulf Coast,4,CAH,1,78,69,19,50,4,0,4,18,0,18,1,0,1,78,69,19,50,4,0,4,18,0,18,1,0,1
05/15/2021,Gulf Coast,4,GACH,1,115,61,37,24,9,4,5,8,0,8,1,0,1,115,61,37,24,9,4,5,8,0,8,1,0,1
05/15/2021,Interior,6,GACH,1,101,81,55,26,20,11,9,16,1,15,3,0,3,101,81,55,26,20,11,9,16,1,15,3,0,3
05/15/2021,Matanuska-Susitna,3,GACH,1,184,160,81,79,14,8,6,33,5,28,7,0,7,184,160,81,79,14,8,6,33,5,28,7,0,7
05/15/2021,Northern,2,CAH,1,96,67,22,45,0,0,0,36,0,36,0,0,0,96,67,22,45,0,0,0,36,0,36,0,0,0
05/15/2021,Southeast,5,CAH,1,70,70,26,44,8,1,7,33,0,33,0,0,0,70,70,26,44,8,1,7,33,0,33,0,0,0
05/15/2021,Southeast,5,GACH,1,161,133,41,92,9,2,7,20,0,20,0,0,0,161,133,41,92,9,2,7,20,0,20,0,0,0
05/15/2021,Southwest,1,CAH,1,22,12,2,10,0,0,0,4,0,4,0,0,0,22,12,2,10,0,0,0,4,0,4,0,0,0
05/15/2021,Southwest,1,GACH,1,53,45,24,21,0,0,0,4,0,4,0,0,0,53,45,24,21,0,0,0,4,0,4,0,0,0
05/16/2021,Anchorage,7,GACH,1,745,716,623,93,138,118,20,179,33,146,12,0,12,745,716,623,93,138,118,20,179,33,146,12,0,12
05/16/2021,Anchorage,7,LTACH,0,44,44,43,1,6,6,0,23,5,18,0,0,0,44,44,43,1,6,6,0,23,5,18,0,0,0
05/16/2021,Anchorage,7,Psych,0,,,,,,,,,,,,,,203,198,136,62,0,0,0,0,0,0,1,0,1
05/16/2021,Gulf Coast,4,CAH,1,77,67,15,52,4,0,4,18,0,18,0,0,0,77,67,15,52,4,0,4,18,0,18,0,0,0
05/16/2021,Gulf Coast,4,GACH,1,115,61,39,22,9,6,3,8,0,8,1,0,1,115,61,39,22,9,6,3,8,0,8,1,0,1
05/16/2021,Interior,6,GACH,1,101,81,50,31,20,12,8,16,1,15,3,0,3,101,81,50,31,20,12,8,16,1,15,3,0,3
05/16/2021,Matanuska-Susitna,3,GACH,1,184,160,81,79,14,8,6,33,2,31,5,0,5,184,160,81,79,14,8,6,33,2,31,5,0,5
05/16/2021,Northern,2,CAH,1,96,67,22,45,0,0,0,36,0,36,0,0,0,96,67,22,45,0,0,0,36,0,36,0,0,0
05/16/2021,Southeast,5,CAH,1,70,70,27,43,8,1,7,33,0,33,0,0,0,70,70,27,43,8,1,7,33,0,33,0,0,0
05/16/2021,Southeast,5,GACH,1,161,133,41,92,9,3,6,20,0,20,1,0,1,161,133,41,92,9,3,6,20,0,20,1,0,1
05/16/2021,Southwest,1,CAH,1,22,12,3,9,0,0,0,4,0,4,0,0,0,22,12,3,9,0,0,0,4,0,4,0,0,0
05/16/2021,Southwest,1,GACH,1,53,45,22,23,0,0,0,4,0,4,0,0,0,53,45,22,23,0,0,0,4,0,4,0,0,0
05/17/2021,Anchorage,7,GACH,1,747,720,627,93,135,117,18,179,32,147,14,0,14,747,720,627,93,135,117,18,179,32,147,14,0,14
05/17/2021,Anchorage,7,LTACH,0,44,44,42,2,6,6,0,23,5,18,0,0,0,44,44,42,2,6,6,0,23,5,18,0,0,0
05/17/2021,Anchorage,7,Psych,0,,,,,,,,,,,,,,203,198,136,62,0,0,0,0,0,0,1,0,1
05/17/2021,Gulf Coast,4,CAH,1,77,67,17,50,4,0,4,18,0,18,1,0,1,77,67,17,50,4,0,4,18,0,18,1,0,1
05/17/2021,Gulf Coast,4,GACH,1,115,61,40,21,9,5,4,8,1,7,1,0,1,115,61,40,21,9,5,4,8,1,7,1,0,1
05/17/2021,Interior,6,GACH,1,101,81,45,36,20,11,9,16,0,16,3,0,3,101,81,45,36,20,11,9,16,0,16,3,0,3
05/17/2021,Matanuska-Susitna,3,GACH,1,184,160,72,88,14,9,5,33,1,32,5,0,5,184,160,72,88,14,9,5,33,1,32,5,0,5
05/17/2021,Northern,2,CAH,1,94,65,23,42,0,0,0,36,0,36,0,0,0,94,65,23,42,0,0,0,36,0,36,0,0,0
05/17/2021,Southeast,5,CAH,1,70,70,24,46,8,1,7,33,0,33,2,0,2,70,70,24,46,8,1,7,33,0,33,2,0,2
05/17/2021,Southeast,5,GACH,1,161,133,45,88,9,6,3,20,0,20,1,0,1,161,133,45,88,9,6,3,20,0,20,1,0,1
05/17/2021,Southwest,1,CAH,1,22,12,2,10,0,0,0,4,0,4,0,0,0,22,12,2,10,0,0,0,4,0,4,0,0,0
05/17/2021,Southwest,1,GACH,1,53,45,7,38,0,0,0,4,0,4,0,0,0,53,45,7,38,0,0,0,4,0,4,0,0,0
05/18/2021,Anchorage,7,GACH,1,750,707,594,113,133,107,26,179,28,151,11,0,11,750,707,594,113,133,107,26,179,28,151,11,0,11
05/18/2021,Anchorage,7,LTACH,0,44,44,42,2,6,6,0,23,7,16,0,0,0,44,44,42,2,6,6,0,23,7,16,0,0,0
05/18/2021,Anchorage,7,Psych,0,,,,,,,,,,,,,,203,198,136,62,0,0,0,0,0,0,1,0,1
05/18/2021,Gulf Coast,4,CAH,1,77,67,22,45,4,1,3,18,1,17,1,0,1,77,67,22,45,4,1,3,18,1,17,1,0,1
05/18/2021,Gulf Coast,4,GACH,1,115,61,39,22,9,6,3,8,1,7,0,0,0,115,61,39,22,9,6,3,8,1,7,0,0,0
05/18/2021,Interior,6,GACH,1,101,81,57,24,20,13,7,16,0,16,3,0,3,101,81,57,24,20,13,7,16,0,16,3,0,3
05/18/2021,Matanuska-Susitna,3,GACH,1,184,160,80,80,14,8,6,33,5,28,2,0,2,184,160,80,80,14,8,6,33,5,28,2,0,2
05/18/2021,Northern,2,CAH,1,96,67,21,46,0,0,0,36,0,36,0,0,0,96,67,21,46,0,0,0,36,0,36,0,0,0
05/18/2021,Southeast,5,CAH,1,70,70,27,43,8,1,7,33,0,33,2,0,2,70,70,27,43,8,1,7,33,0,33,2,0,2
05/18/2021,Southeast,5,GACH,1,161,133,37,96,9,3,6,20,0,20,1,0,1,161,133,37,96,9,3,6,20,0,20,1,0,1
05/18/2021,Southwest,1,CAH,1,22,12,3,9,0,0,0,4,0,4,0,0,0,22,12,3,9,0,0,0,4,0,4,0,0,0
05/18/2021,Southwest,1,GACH,1,53,45,6,39,0,0,0,4,0,4,0,0,0,53,45,6,39,0,0,0,4,0,4,0,0,0
05/19/2021,Anchorage,7,GACH,1,753,717,602,115,131,106,25,179,26,153,10,0,10,753,717,602,115,131,106,25,179,26,153,10,0,10
05/19/2021,Anchorage,7,LTACH,0,44,44,44,0,6,6,0,23,6,17,0,0,0,44,44,44,0,6,6,0,23,6,17,0,0,0
05/19/2021,Anchorage,7,Psych,0,204,198,136,62,0,0,0,0,0,0,0,0,0,204,198,136,62,0,0,0,0,0,0,0,0,0
05/19/2021,Gulf Coast,4,CAH,1,77,67,20,47,4,0,4,18,0,18,0,0,0,77,67,20,47,4,0,4,18,0,18,0,0,0
05/19/2021,Gulf Coast,4,GACH,1,115,61,49,12,9,7,2,8,2,6,1,0,1,115,61,49,12,9,7,2,8,2,6,1,0,1
05/19/2021,Interior,6,GACH,1,101,81,64,17,20,12,8,16,0,16,3,0,3,101,81,64,17,20,12,8,16,0,16,3,0,3
05/19/2021,Matanuska-Susitna,3,GACH,1,184,160,93,67,14,10,4,33,3,30,2,0,2,184,160,93,67,14,10,4,33,3,30,2,0,2
05/19/2021,Northern,2,CAH,1,94,65,17,48,0,0,0,36,0,36,0,0,0,94,65,17,48,0,0,0,36,0,36,0,0,0
05/19/2021,Southeast,5,CAH,1,70,70,37,33,8,3,5,33,0,33,3,0,3,70,70,37,33,8,3,5,33,0,33,3,0,3
05/19/2021,Southeast,5,GACH,1,161,133,30,103,9,3,6,20,0,20,1,0,1,161,133,30,103,9,3,6,20,0,20,1,0,1
05/19/2021,Southwest,1,CAH,1,22,12,2,10,0,0,0,4,0,4,0,0,0,22,12,2,10,0,0,0,4,0,4,0,0,0
05/19/2021,Southwest,1,GACH,1,53,45,5,40,0,0,0,4,0,4,0,0,0,53,45,5,40,0,0,0,4,0,4,0,0,0
05/20/2021,Anchorage,7,GACH,1,749,724,598,126,133,113,20,179,23,156,9,0,9,749,724,598,126,133,113,20,179,23,156,9,0,9
05/20/2021,Anchorage,7,LTACH,0,44,44,44,0,6,6,0,23,6,17,0,0,0,44,44,44,0,6,6,0,23,6,17,0,0,0
05/20/2021,Anchorage,7,Psych,0,,,,,,,,,,,,,,204,198,136,62,0,0,0,0,0,0,0,0,0
05/20/2021,Gulf Coast,4,CAH,1,77,67,22,45,4,1,3,18,0,18,0,0,0,77,67,22,45,4,1,3,18,0,18,0,0,0
05/20/2021,Gulf Coast,4,GACH,1,115,61,43,18,9,8,1,8,1,7,1,0,1,115,61,43,18,9,8,1,8,1,7,1,0,1
05/20/2021,Interior,6,GACH,1,101,81,58,23,20,13,7,16,0,16,3,0,3,101,81,58,23,20,13,7,16,0,16,3,0,3
05/20/2021,Matanuska-Susitna,3,GACH,1,184,160,87,73,14,7,7,33,3,30,3,0,3,184,160,87,73,14,7,7,33,3,30,3,0,3
05/20/2021,Northern,2,CAH,1,96,67,20,47,0,0,0,36,0,36,0,0,0,96,67,20,47,0,0,0,36,0,36,0,0,0
05/20/2021,Southeast,5,CAH,1,70,70,36,34,8,2,6,33,0,33,3,0,3,70,70,36,34,8,2,6,33,0,33,3,0,3
05/20/2021,Southeast,5,GACH,1,161,133,31,102,9,2,7,20,0,20,1,0,1,161,133,31,102,9,2,7,20,0,20,1,0,1
05/20/2021,Southwest,1,CAH,1,22,12,2,10,0,0,0,4,0,4,0,0,0,22,12,2,10,0,0,0,4,0,4,0,0,0
05/20/2021,Southwest,1,GACH,1,53,45,7,38,0,0,0,4,0,4,0,0,0,53,45,7,38,0,0,0,4,0,4,0,0,0
05/21/2021,Anchorage,7,GACH,1,744,705,599,106,133,112,21,179,21,158,9,0,9,744,705,599,106,133,112,21,179,21,158,9,0,9
05/21/2021,Anchorage,7,LTACH,0,44,44,43,1,6,6,0,23,7,16,0,0,0,44,44,43,1,6,6,0,23,7,16,0,0,0
05/21/2021,Anchorage,7,Psych,0,,,,,,,,,,,,,,204,198,136,62,0,0,0,0,0,0,0,0,0
05/21/2021,Gulf Coast,4,CAH,1,77,67,23,44,4,1,3,18,0,18,0,0,0,77,67,23,44,4,1,3,18,0,18,0,0,0
05/21/2021,Gulf Coast,4,GACH,1,115,61,43,18,9,6,3,8,0,8,1,0,1,115,61,43,18,9,6,3,8,0,8,1,0,1
05/21/2021,Interior,6,GACH,1,101,81,54,27,20,16,4,16,0,16,2,0,2,101,81,54,27,20,16,4,16,0,16,2,0,2
05/21/2021,Matanuska-Susitna,3,GACH,1,184,160,89,71,14,9,5,33,3,30,4,0,4,184,160,89,71,14,9,5,33,3,30,4,0,4
05/21/2021,Northern,2,CAH,1,96,67,24,43,0,0,0,36,0,36,0,0,0,96,67,24,43,0,0,0,36,0,36,0,0,0
05/21/2021,Southeast,5,CAH,1,70,70,35,35,8,2,6,33,0,33,3,0,3,70,70,35,35,8,2,6,33,0,33,3,0,3
05/21/2021,Southeast,5,GACH,1,161,133,32,101,9,2,7,20,0,20,0,0,0,161,133,32,101,9,2,7,20,0,20,0,0,0
05/21/2021,Southwest,1,CAH,1,22,12,1,11,0,0,0,4,0,4,0,0,0,22,12,1,11,0,0,0,4,0,4,0,0,0
05/21/2021,Southwest,1,GACH,1,53,45,11,34,0,0,0,4,0,4,0,0,0,53,45,11,34,0,0,0,4,0,4,0,0,0
05/22/2021,Anchorage,7,GACH,1,742,699,588,111,131,111,20,179,22,157,8,0,8,742,699,588,111,131,111,20,179,22,157,8,0,8
05/22/2021,Anchorage,7,LTACH,0,44,44,43,1,6,6,0,23,7,16,0,0,0,44,44,43,1,6,6,0,23,7,16,0,0,0
05/22/2021,Anchorage,7,Psych,0,,,,,,,,,,,,,,204,198,136,62,0,0,0,0,0,0,0,0,0
05/22/2021,Gulf Coast,4,CAH,1,78,68,17,51,4,0,4,18,0,18,0,0,0,78,68,17,51,4,0,4,18,0,18,0,0,0
05/22/2021,Gulf Coast,4,GACH,1,115,61,42,19,9,7,2,8,0,8,1,0,1,115,61,42,19,9,7,2,8,0,8,1,0,1
05/22/2021,Interior,6,GACH,1,101,81,49,32,20,14,6,16,1,15,2,0,2,101,81,49,32,20,14,6,16,1,15,2,0,2
05/22/2021,Matanuska-Susitna,3,GACH,1,184,160,91,69,14,9,5,33,1,32,3,0,3,184,160,91,69,14,9,5,33,1,32,3,0,3
05/22/2021,Northern,2,CAH,1,96,67,19,48,0,0,0,36,0,36,0,0,0,96,67,19,48,0,0,0,36,0,36,0,0,0
05/22/2021,Southeast,5,CAH,1,70,70,34,36,8,2,6,33,0,33,3,0,3,70,70,34,36,8,2,6,33,0,33,3,0,3
05/22/2021,Southeast,5,GACH,1,161,133,35,98,9,2,7,20,0,20,0,0,0,161,133,35,98,9,2,7,20,0,20,0,0,0
05/22/2021,Southwest,1,CAH,1,22,12,1,11,0,0,0,4,0,4,0,0,0,22,12,1,11,0,0,0,4,0,4,0,0,0
05/22/2021,Southwest,1,GACH,1,53,45,10,35,0,0,0,4,0,4,0,0,0,53,45,10,35,0,0,0,4,0,4,0,0,0
05/23/2021,Anchorage,7,GACH,1,748,705,576,129,131,101,30,179,23,156,7,0,7,748,705,576,129,131,101,30,179,23,156,7,0,7
05/23/2021,Anchorage,7,LTACH,0,44,44,43,1,6,6,0,23,8,15,0,0,0,44,44,43,1,6,6,0,23,8,15,0,0,0
05/23/2021,Anchorage,7,Psych,0,,,,,,,,,,,,,,204,198,136,62,0,0,0,0,0,0,0,0,0
05/23/2021,Gulf Coast,4,CAH,1,77,68,16,52,4,0,4,18,0,18,0,0,0,77,68,16,52,4,0,4,18,0,18,0,0,0
05/23/2021,Gulf Coast,4,GACH,1,115,61,40,21,9,6,3,8,0,8,1,0,1,115,61,40,21,9,6,3,8,0,8,1,0,1
05/23/2021,Interior,6,GACH,1,101,81,49,32,20,14,6,16,1,15,2,0,2,101,81,49,32,20,14,6,16,1,15,2,0,2
05/23/2021,Matanuska-Susitna,3,GACH,1,184,160,83,77,14,8,6,33,1,32,3,0,3,184,160,83,77,14,8,6,33,1,32,3,0,3
05/23/2021,Northern,2,CAH,1,96,67,16,51,0,0,0,36,0,36,0,0,0,96,67,16,51,0,0,0,36,0,36,0,0,0
05/23/2021,Southeast,5,CAH,1,70,70,36,34,8,2,6,33,0,33,3,0,3,70,70,36,34,8,2,6,33,0,33,3,0,3
05/23/2021,Southeast,5,GACH,1,161,133,34,99,9,2,7,20,0,20,0,0,0,161,133,34,99,9,2,7,20,0,20,0,0,0
05/23/2021,Southwest,1,CAH,1,22,12,1,11,0,0,0,4,0,4,0,0,0,22,12,1,11,0,0,0,4,0,4,0,0,0
05/23/2021,Southwest,1,GACH,1,53,45,13,32,0,0,0,4,0,4,0,0,0,53,45,13,32,0,0,0,4,0,4,0,0,0
05/24/2021,Anchorage,7,GACH,1,744,701,586,115,129,103,26,179,25,154,10,0,10,744,701,586,115,129,103,26,179,25,154,10,0,10
05/24/2021,Anchorage,7,LTACH,0,44,44,43,1,6,6,0,23,8,15,0,0,0,44,44,43,1,6,6,0,23,8,15,0,0,0
05/24/2021,Anchorage,7,Psych,0,,,,,,,,,,,,,,204,198,136,62,0,0,0,0,0,0,0,0,0
05/24/2021,Gulf Coast,4,CAH,1,78,69,17,52,4,1,3,18,0,18,0,0,0,78,69,17,52,4,1,3,18,0,18,0,0,0
05/24/2021,Gulf Coast,4,GACH,1,115,61,41,20,9,6,3,8,0,8,1,0,1,115,61,41,20,9,6,3,8,0,8,1,0,1
05/24/2021,Interior,6,GACH,1,101,81,38,43,20,16,4,16,0,16,1,0,1,101,81,38,43,20,16,4,16,0,16,1,0,1
05/24/2021,Matanuska-Susitna,3,GACH,1,184,160,78,82,14,6,8,33,2,31,4,0,4,184,160,78,82,14,6,8,33,2,31,4,0,4
05/24/2021,Northern,2,CAH,1,96,65,19,46,0,0,0,36,0,36,0,0,0,96,65,19,46,0,0,0,36,0,36,0,0,0
05/24/2021,Southeast,5,CAH,1,70,70,27,43,8,0,8,33,0,33,0,0,0,70,70,27,43,8,0,8,33,0,33,0,0,0
05/24/2021,Southeast,5,GACH,1,161,133,33,100,9,4,5,20,0,20,0,0,0,161,133,33,100,9,4,5,20,0,20,0,0,0
05/24/2021,Southwest,1,CAH,1,22,12,1,11,0,0,0,4,0,4,0,0,0,22,12,1,11,0,0,0,4,0,4,0,0,0
05/24/2021,Southwest,1,GACH,1,53,45,10,35,0,0,0,4,0,4,0,0,0,53,45,10,35,0,0,0,4,0,4,0,0,0
05/25/2021,Anchorage,7,GACH,1,749,708,607,101,128,113,15,179,26,153,11,0,11,749,708,607,101,128,113,15,179,26,153,11,0,11
05/25/2021,Anchorage,7,LTACH,0,44,44,44,0,6,6,0,23,8,15,0,0,0,44,44,44,0,6,6,0,23,8,15,0,0,0
05/25/2021,Anchorage,7,Psych,0,,,,,,,,,,,,,,204,198,136,62,0,0,0,0,0,0,0,0,0
05/25/2021,Gulf Coast,4,CAH,1,78,69,17,52,4,0,4,18,0,18,2,0,2,78,69,17,52,4,0,4,18,0,18,2,0,2
05/25/2021,Gulf Coast,4,GACH,1,115,61,48,13,9,7,2,8,0,8,1,0,1,115,61,48,13,9,7,2,8,0,8,1,0,1
05/25/2021,Interior,6,GACH,1,101,81,48,33,20,16,4,16,0,16,2,0,2,101,81,48,33,20,16,4,16,0,16,2,0,2
05/25/2021,Matanuska-Susitna,3,GACH,1,184,160,93,67,14,9,5,33,2,31,4,0,4,184,160,93,67,14,9,5,33,2,31,4,0,4
05/25/2021,Northern,2,CAH,1,96,65,25,40,0,0,0,36,0,36,0,0,0,96,65,25,40,0,0,0,36,0,36,0,0,0
05/25/2021,Southeast,5,CAH,1,70,70,40,30,8,0,8,33,0,33,0,0,0,70,70,40,30,8,0,8,33,0,33,0,0,0
05/25/2021,Southeast,5,GACH,1,161,133,35,98,9,4,5,20,0,20,0,0,0,161,133,35,98,9,4,5,20,0,20,0,0,0
05/25/2021,Southwest,1,CAH,1,22,12,0,12,0,0,0,4,0,4,0,0,0,22,12,0,12,0,0,0,4,0,4,0,0,0
05/25/2021,Southwest,1,GACH,1,53,45,11,34,0,0,0,4,0,4,0,0,0,53,45,11,34,0,0,0,4,0,4,0,0,0
05/26/2021,Anchorage,7,GACH,1,761,714,634,80,132,114,18,179,30,149,12,0,12,761,714,634,80,132,114,18,179,30,149,12,0,12
05/26/2021,Anchorage,7,LTACH,0,44,44,44,0,6,6,0,23,7,16,0,0,0,44,44,44,0,6,6,0,23,7,16,0,0,0
05/26/2021,Anchorage,7,Psych,0,205,194,130,64,0,0,0,0,0,0,0,0,0,205,194,130,64,0,0,0,0,0,0,0,0,0
05/26/2021,Gulf Coast,4,CAH,1,78,69,20,49,4,0,4,18,0,18,1,0,1,78,69,20,49,4,0,4,18,0,18,1,0,1
05/26/2021,Gulf Coast,4,GACH,1,115,61,52,9,9,9,0,8,1,7,1,0,1,115,61,52,9,9,9,0,8,1,7,1,0,1
05/26/2021,Interior,6,GACH,1,101,81,44,37,20,19,1,16,0,16,2,0,2,101,81,44,37,20,19,1,16,0,16,2,0,2
05/26/2021,Matanuska-Susitna,3,GACH,1,184,160,89,71,14,8,6,33,0,33,3,0,3,184,160,89,71,14,8,6,33,0,33,3,0,3
05/26/2021,Northern,2,CAH,1,96,65,23,42,0,0,0,36,0,36,0,0,0,96,65,23,42,0,0,0,36,0,36,0,0,0
05/26/2021,Southeast,5,CAH,1,70,70,40,30,8,0,8,33,0,33,0,0,0,70,70,40,30,8,0,8,33,0,33,0,0,0
05/26/2021,Southeast,5,GACH,1,161,133,31,102,9,4,5,20,0,20,0,0,0,161,133,31,102,9,4,5,20,0,20,0,0,0
05/26/2021,Southwest,1,CAH,1,22,12,2,10,0,0,0,4,0,4,0,0,0,22,12,2,10,0,0,0,4,0,4,0,0,0
05/26/2021,Southwest,1,GACH,1,53,45,12,33,0,0,0,4,0,4,1,0,1,53,45,12,33,0,0,0,4,0,4,1,0,1
05/27/2021,Anchorage,7,GACH,1,754,728,625,103,132,115,17,179,29,150,11,0,11,754,728,625,103,132,115,17,179,29,150,11,0,11
05/27/2021,Anchorage,7,LTACH,0,44,44,43,1,6,6,0,23,8,15,0,0,0,44,44,43,1,6,6,0,23,8,15,0,0,0
05/27/2021,Anchorage,7,Psych,0,,,,,,,,,,,,,,205,194,130,64,0,0,0,0,0,0,0,0,0
05/27/2021,Gulf Coast,4,CAH,1,78,69,26,43,4,0,4,18,0,18,1,0,1,78,69,26,43,4,0,4,18,0,18,1,0,1
05/27/2021,Gulf Coast,4,GACH,1,115,61,44,17,9,7,2,8,0,8,0,0,0,115,61,44,17,9,7,2,8,0,8,0,0,0
05/27/2021,Interior,6,GACH,1,101,81,48,33,20,14,6,16,0,16,2,0,2,101,81,48,33,20,14,6,16,0,16,2,0,2
05/27/2021,Matanuska-Susitna,3,GACH,1,184,160,93,67,14,8,6,33,0,33,0,0,0,184,160,93,67,14,8,6,33,0,33,0,0,0
05/27/2021,Northern,2,CAH,1,96,65,20,45,0,0,0,36,0,36,0,0,0,96,65,20,45,0,0,0,36,0,36,0,0,0
05/27/2021,Southeast,5,CAH,1,70,70,33,37,8,0,8,33,0,33,1,0,1,70,70,33,37,8,0,8,33,0,33,1,0,1
05/27/2021,Southeast,5,GACH,1,161,133,36,97,9,5,4,20,0,20,0,0,0,161,133,36,97,9,5,4,20,0,20,0,0,0
05/27/2021,Southwest,1,CAH,1,22,12,1,11,0,0,0,4,0,4,0,0,0,22,12,1,11,0,0,0,4,0,4,0,0,0
05/27/2021,Southwest,1,GACH,1,53,45,10,35,0,0,0,4,0,4,1,0,1,53,45,10,35,0,0,0,4,0,4,1,0,1
05/28/2021,Anchorage,7,GACH,1,754,730,622,108,134,114,20,179,31,148,12,0,12,754,730,622,108,134,114,20,179,31,148,12,0,12
05/28/2021,Anchorage,7,LTACH,0,44,44,43,1,6,6,0,23,7,16,0,0,0,44,44,43,1,6,6,0,23,7,16,0,0,0
05/28/2021,Anchorage,7,Psych,0,,,,,,,,,,,,,,205,194,130,64,0,0,0,0,0,0,0,0,0
05/28/2021,Gulf Coast,4,CAH,1,78,69,27,42,4,0,4,18,0,18,1,0,1,78,69,27,42,4,0,4,18,0,18,1,0,1
05/28/2021,Gulf Coast,4,GACH,1,115,61,43,18,9,6,3,8,2,6,0,0,0,115,61,43,18,9,6,3,8,2,6,0,0,0
05/28/2021,Interior,6,GACH,1,101,81,54,27,20,15,5,16,0,16,2,0,2,101,81,54,27,20,15,5,16,0,16,2,0,2
05/28/2021,Matanuska-Susitna,3,GACH,1,184,160,88,72,14,10,4,33,0,33,0,0,0,184,160,88,72,14,10,4,33,0,33,0,0,0
05/28/2021,Northern,2,CAH,1,96,65,17,48,0,0,0,36,0,36,0,0,0,96,65,17,48,0,0,0,36,0,36,0,0,0
05/28/2021,Southeast,5,CAH,1,70,70,29,41,8,2,6,33,0,33,1,0,1,70,70,29,41,8,2,6,33,0,33,1,0,1
05/28/2021,Southeast,5,GACH,1,161,133,39,94,9,7,2,20,0,20,0,0,0,161,133,39,94,9,7,2,20,0,20,0,0,0
05/28/2021,Southwest,1,CAH,1,22,12,0,12,0,0,0,4,0,4,0,0,0,22,12,0,12,0,0,0,4,0,4,0,0,0
05/28/2021,Southwest,1,GACH,1,53,45,8,37,0,0,0,4,0,4,1,0,1,53,45,8,37,0,0,0,4,0,4,1,0,1
05/29/2021,Anchorage,7,GACH,1,752,728,588,140,134,107,27,179,30,149,10,0,10,752,728,588,140,134,107,27,179,30,149,10,0,10
05/29/2021,Anchorage,7,LTACH,0,44,44,41,3,6,6,0,23,8,15,0,0,0,44,44,41,3,6,6,0,23,8,15,0,0,0
05/29/2021,Anchorage,7,Psych,0,,,,,,,,,,,,,,205,194,130,64,0,0,0,0,0,0,0,0,0
05/29/2021,Gulf Coast,4,CAH,1,78,69,25,44,4,1,3,18,0,18,1,0,1,78,69,25,44,4,1,3,18,0,18,1,0,1
05/29/2021,Gulf Coast,4,GACH,1,115,61,43,18,9,7,2,8,0,8,0,0,0,115,61,43,18,9,7,2,8,0,8,0,0,0
05/29/2021,Interior,6,GACH,1,101,81,45,36,20,14,6,16,0,16,2,0,2,101,81,45,36,20,14,6,16,0,16,2,0,2
05/29/2021,Matanuska-Susitna,3,GACH,1,184,160,65,95,14,9,5,33,1,32,0,0,0,184,160,65,95,14,9,5,33,1,32,0,0,0
05/29/2021,Northern,2,CAH,1,96,65,15,50,0,0,0,36,0,36,0,0,0,96,65,15,50,0,0,0,36,0,36,0,0,0
05/29/2021,Southeast,5,CAH,1,70,70,25,45,8,2,6,33,0,33,0,0,0,70,70,25,45,8,2,6,33,0,33,0,0,0
05/29/2021,Southeast,5,GACH,1,161,133,30,103,9,4,5,20,0,20,0,0,0,161,133,30,103,9,4,5,20,0,20,0,0,0
05/29/2021,Southwest,1,CAH,1,22,12,0,12,0,0,0,4,0,4,0,0,0,22,12,0,12,0,0,0,4,0,4,0,0,0
05/29/2021,Southwest,1,GACH,1,53,45,10,35,0,0,0,4,0,4,1,0,1,53,45,10,35,0,0,0,4,0,4,1,0,1
05/30/2021,Anchorage,7,GACH,1,749,724,602,122,131,110,21,179,34,145,11,0,11,749,724,602,122,131,110,21,179,34,145,11,0,11
05/30/2021,Anchorage,7,LTACH,0,44,44,39,5,6,6,0,23,6,17,0,0,0,44,44,39,5,6,6,0,23,6,17,0,0,0
05/30/2021,Anchorage,7,Psych,0,,,,,,,,,,,,,,205,194,130,64,0,0,0,0,0,0,0,0,0
05/30/2021,Gulf Coast,4,CAH,1,79,70,26,44,4,0,4,18,0,18,1,0,1,79,70,26,44,4,0,4,18,0,18,1,0,1
05/30/2021,Gulf Coast,4,GACH,1,115,61,40,21,9,5,4,8,0,8,1,0,1,115,61,40,21,9,5,4,8,0,8,1,0,1
05/30/2021,Interior,6,GACH,1,101,81,48,33,20,12,8,16,1,15,3,0,3,101,81,48,33,20,12,8,16,1,15,3,0,3
05/30/2021,Matanuska-Susitna,3,GACH,1,184,160,54,106,14,2,12,33,1,32,0,0,0,184,160,54,106,14,2,12,33,1,32,0,0,0
05/30/2021,Northern,2,CAH,1,96,65,16,49,0,0,0,36,0,36,0,0,0,96,65,16,49,0,0,0,36,0,36,0,0,0
05/30/2021,Southeast,5,CAH,1,70,70,24,46,8,2,6,33,0,33,0,0,0,70,70,24,46,8,2,6,33,0,33,0,0,0
05/30/2021,Southeast,5,GACH,1,161,133,37,96,9,3,6,20,1,19,0,0,0,161,133,37,96,9,3,6,20,1,19,0,0,0
05/30/2021,Southwest,1,CAH,1,22,12,0,12,0,0,0,4,0,4,0,0,0,22,12,0,12,0,0,0,4,0,4,0,0,0
05/30/2021,Southwest,1,GACH,1,53,45,12,33,0,0,0,4,0,4,1,0,1,53,45,12,33,0,0,0,4,0,4,1,0,1
05/31/2021,Anchorage,7,GACH,1,756,729,602,127,134,108,26,179,35,144,14,0,14,756,729,602,127,134,108,26,179,35,144,14,0,14
05/31/2021,Anchorage,7,LTACH,0,44,44,39,5,6,6,0,23,6,17,0,0,0,44,44,39,5,6,6,0,23,6,17,0,0,0
05/31/2021,Anchorage,7,Psych,0,,,,,,,,,,,,,,205,194,130,64,0,0,0,0,0,0,0,0,0
05/31/2021,Gulf Coast,4,CAH,1,78,69,27,42,4,1,3,18,0,18,1,0,1,78,69,27,42,4,1,3,18,0,18,1,0,1
05/31/2021,Gulf Coast,4,GACH,1,115,61,37,24,9,4,5,8,0,8,2,0,2,115,61,37,24,9,4,5,8,0,8,2,0,2
05/31/2021,Interior,6,GACH,1,101,81,41,40,20,10,10,16,1,15,2,0,2,101,81,41,40,20,10,10,16,1,15,2,0,2
05/31/2021,Matanuska-Susitna,3,GACH,1,184,160,57,103,14,8,6,33,3,30,1,0,1,184,160,57,103,14,8,6,33,3,30,1,0,1
05/31/2021,Northern,2,CAH,1,96,65,17,48,0,0,0,36,0,36,0,0,0,96,65,17,48,0,0,0,36,0,36,0,0,0
05/31/2021,Southeast,5,CAH,1,70,70,26,44,8,0,8,33,0,33,0,0,0,70,70,26,44,8,0,8,33,0,33,0,0,0
05/31/2021,Southeast,5,GACH,1,161,133,33,100,9,2,7,20,1,19,0,0,0,161,133,33,100,9,2,7,20,1,19,0,0,0
05/31/2021,Southwest,1,CAH,1,22,12,0,12,0,0,0,4,0,4,0,0,0,22,12,0,12,0,0,0,4,0,4,0,0,0
05/31/2021,Southwest,1,GACH,1,53,45,14,31,0,0,0,4,0,4,1,0,1,53,45,14,31,0,0,0,4,0,4,1,0,1
06/01/2021,Anchorage,7,GACH,1,757,731,601,130,133,111,22,179,36,143,15,0,15,757,731,601,130,133,111,22,179,36,143,15,0,15
06/01/2021,Anchorage,7,LTACH,0,44,44,37,7,6,6,0,23,6,17,0,0,0,44,44,37,7,6,6,0,23,6,17,0,0,0
06/01/2021,Anchorage,7,Psych,0,,,,,,,,,,,,,,205,194,130,64,0,0,0,0,0,0,0,0,0
06/01/2021,Gulf Coast,4,CAH,1,80,71,29,42,4,1,3,18,0,18,0,0,0,80,71,29,42,4,1,3,18,0,18,0,0,0
06/01/2021,Gulf Coast,4,GACH,1,115,61,35,26,9,6,3,8,0,8,2,0,2,115,61,35,26,9,6,3,8,0,8,2,0,2
06/01/2021,Interior,6,GACH,1,101,81,34,47,20,11,9,16,1,15,3,0,3,101,81,34,47,20,11,9,16,1,15,3,0,3
06/01/2021,Matanuska-Susitna,3,GACH,1,184,160,64,96,14,6,8,33,1,32,1,0,1,184,160,64,96,14,6,8,33,1,32,1,0,1
06/01/2021,Northern,2,CAH,1,96,65,19,46,0,0,0,36,0,36,0,0,0,96,65,19,46,0,0,0,36,0,36,0,0,0
06/01/2021,Southeast,5,CAH,1,70,70,31,39,8,3,5,33,0,33,0,0,0,70,70,31,39,8,3,5,33,0,33,0,0,0
06/01/2021,Southeast,5,GACH,1,161,133,28,105,9,0,9,20,0,20,0,0,0,161,133,28,105,9,0,9,20,0,20,0,0,0
06/01/2021,Southwest,1,CAH,1,22,12,0,12,0,0,0,4,0,4,0,0,0,22,12,0,12,0,0,0,4,0,4,0,0,0
06/01/2021,Southwest,1,GACH,1,53,45,10,35,0,0,0,4,0,4,0,0,0,53,45,10,35,0,0,0,4,0,4,0,0,0
06/02/2021,Anchorage,7,GACH,1,756,724,625,99,127,112,15,179,38,141,14,0,14,756,724,625,99,127,112,15,179,38,141,14,0,14
06/02/2021,Anchorage,7,LTACH,0,44,44,37,7,6,6,0,23,6,17,0,0,0,44,44,37,7,6,6,0,23,6,17,0,0,0
06/02/2021,Anchorage,7,Psych,0,205,203,140,63,0,0,0,0,0,0,0,0,0,205,203,140,63,0,0,0,0,0,0,0,0,0
06/02/2021,Gulf Coast,4,CAH,1,80,71,29,42,4,0,4,18,0,18,0,0,0,80,71,29,42,4,0,4,18,0,18,0,0,0
06/02/2021,Gulf Coast,4,GACH,1,115,61,41,20,9,4,5,8,0,8,2,0,2,115,61,41,20,9,4,5,8,0,8,2,0,2
06/02/2021,Interior,6,GACH,1,101,81,37,44,20,16,4,16,1,15,3,0,3,101,81,37,44,20,16,4,16,1,15,3,0,3
06/02/2021,Matanuska-Susitna,3,GACH,1,184,160,86,74,14,13,1,33,2,31,1,0,1,184,160,86,74,14,13,1,33,2,31,1,0,1
06/02/2021,Northern,2,CAH,1,96,65,17,48,0,0,0,36,0,36,0,0,0,96,65,17,48,0,0,0,36,0,36,0,0,0
06/02/2021,Southeast,5,CAH,1,70,70,33,37,8,4,4,33,0,33,0,0,0,70,70,33,37,8,4,4,33,0,33,0,0,0
06/02/2021,Southeast,5,GACH,1,161,133,28,105,9,2,7,20,0,20,0,0,0,161,133,28,105,9,2,7,20,0,20,0,0,0
06/02/2021,Southwest,1,CAH,1,22,12,1,11,0,0,0,4,0,4,0,0,0,22,12,1,11,0,0,0,4,0,4,0,0,0
06/02/2021,Southwest,1,GACH,1,53,45,11,34,0,0,0,4,0,4,0,0,0,53,45,11,34,0,0,0,4,0,4,0,0,0
06/03/2021,Anchorage,7,GACH,1,763,727,645,82,135,115,20,179,37,142,13,0,13,763,727,645,82,135,115,20,179,37,142,13,0,13
06/03/2021,Anchorage,7,LTACH,0,44,44,38,6,6,6,0,23,6,17,0,0,0,44,44,38,6,6,6,0,23,6,17,0,0,0
06/03/2021,Anchorage,7,Psych,0,,,,,,,,,,,,,,205,203,140,63,0,0,0,0,0,0,0,0,0
06/03/2021,Gulf Coast,4,CAH,1,80,71,26,45,4,0,4,18,0,18,0,0,0,80,71,26,45,4,0,4,18,0,18,0,0,0
06/03/2021,Gulf Coast,4,GACH,1,115,61,46,15,9,8,1,8,0,8,3,0,3,115,61,46,15,9,8,1,8,0,8,3,0,3
06/03/2021,Interior,6,GACH,1,101,81,45,36,20,10,10,16,1,15,3,0,3,101,81,45,36,20,10,10,16,1,15,3,0,3
06/03/2021,Matanuska-Susitna,3,GACH,1,184,160,72,88,14,10,4,33,1,32,0,0,0,184,160,72,88,14,10,4,33,1,32,0,0,0
06/03/2021,Northern,2,CAH,1,96,67,15,52,0,0,0,36,0,36,0,0,0,96,67,15,52,0,0,0,36,0,36,0,0,0
06/03/2021,Southeast,5,CAH,1,70,70,34,36,8,4,4,33,0,33,0,0,0,70,70,34,36,8,4,4,33,0,33,0,0,0
06/03/2021,Southeast,5,GACH,1,161,133,32,101,9,3,6,20,0,20,0,0,0,161,133,32,101,9,3,6,20,0,20,0,0,0
06/03/2021,Southwest,1,CAH,1,22,12,1,11,0,0,0,4,0,4,0,0,0,22,12,1,11,0,0,0,4,0,4,0,0,0
06/03/2021,Southwest,1,GACH,1,53,45,8,37,0,0,0,4,0,4,0,0,0,53,45,8,37,0,0,0,4,0,4,0,0,0
06/04/2021,Anchorage,7,GACH,1,758,733,632,101,131,113,18,179,39,140,11,0,11,758,733,632,101,131,113,18,179,39,140,11,0,11
06/04/2021,Anchorage,7,LTACH,0,44,44,40,4,6,6,0,23,7,16,0,0,0,44,44,40,4,6,6,0,23,7,16,0,0,0
06/04/2021,Anchorage,7,Psych,0,,,,,,,,,,,,,,205,203,140,63,0,0,0,0,0,0,0,0,0
06/04/2021,Gulf Coast,4,CAH,1,80,71,30,41,4,0,4,18,0,18,0,0,0,80,71,30,41,4,0,4,18,0,18,0,0,0
06/04/2021,Gulf Coast,4,GACH,1,115,61,43,18,9,9,0,8,0,8,2,0,2,115,61,43,18,9,9,0,8,0,8,2,0,2
06/04/2021,Interior,6,GACH,1,101,81,49,32,20,12,8,16,3,13,4,0,4,101,81,49,32,20,12,8,16,3,13,4,0,4
06/04/2021,Matanuska-Susitna,3,GACH,1,184,160,70,90,14,12,2,33,2,31,2,0,2,184,160,70,90,14,12,2,33,2,31,2,0,2
06/04/2021,Northern,2,CAH,1,96,65,16,49,0,0,0,36,0,36,1,0,1,96,65,16,49,0,0,0,36,0,36,1,0,1
06/04/2021,Southeast,5,CAH,1,70,70,37,33,8,3,5,33,0,33,1,0,1,70,70,37,33,8,3,5,33,0,33,1,0,1
06/04/2021,Southeast,5,GACH,1,161,133,30,103,9,2,7,20,0,20,0,0,0,161,133,30,103,9,2,7,20,0,20,0,0,0
06/04/2021,Southwest,1,CAH,1,22,12,0,12,0,0,0,4,0,4,0,0,0,22,12,0,12,0,0,0,4,0,4,0,0,0
06/04/2021,Southwest,1,GACH,1,53,45,9,36,0,0,0,4,0,4,0,0,0,53,45,9,36,0,0,0,4,0,4,0,0,0
06/05/2021,Anchorage,7,GACH,1,761,735,644,91,130,115,15,179,37,142,12,0,12,761,735,644,91,130,115,15,179,37,142,12,0,12
06/05/2021,Anchorage,7,LTACH,0,44,44,39,5,6,6,0,23,8,15,0,0,0,44,44,39,5,6,6,0,23,8,15,0,0,0
06/05/2021,Anchorage,7,Psych,0,,,,,,,,,,,,,,205,203,140,63,0,0,0,0,0,0,0,0,0
06/05/2021,Gulf Coast,4,CAH,1,80,71,23,48,4,0,4,18,0,18,0,0,0,80,71,23,48,4,0,4,18,0,18,0,0,0
06/05/2021,Gulf Coast,4,GACH,1,115,61,42,19,9,7,2,8,0,8,1,0,1,115,61,42,19,9,7,2,8,0,8,1,0,1
06/05/2021,Interior,6,GACH,1,101,81,46,35,20,11,9,16,2,14,4,0,4,101,81,46,35,20,11,9,16,2,14,4,0,4
06/05/2021,Matanuska-Susitna,3,GACH,1,184,160,73,87,14,11,3,33,3,30,0,0,0,184,160,73,87,14,11,3,33,3,30,0,0,0
06/05/2021,Northern,2,CAH,1,96,65,22,43,0,0,0,36,0,36,1,0,1,96,65,22,43,0,0,0,36,0,36,1,0,1
06/05/2021,Southeast,5,CAH,1,70,70,38,32,8,3,5,33,0,33,1,0,1,70,70,38,32,8,3,5,33,0,33,1,0,1
06/05/2021,Southeast,5,GACH,1,161,133,32,101,9,4,5,20,0,20,1,0,1,161,133,32,101,9,4,5,20,0,20,1,0,1
06/05/2021,Southwest,1,CAH,1,22,12,1,11,0,0,0,4,0,4,0,0,0,22,12,1,11,0,0,0,4,0,4,0,0,0
06/05/2021,Southwest,1,GACH,1,53,45,7,38,0,0,0,4,0,4,0,0,0,53,45,7,38,0,0,0,4,0,4,0,0,0
06/06/2021,Anchorage,7,GACH,1,752,727,627,100,129,106,23,179,37,142,13,0,13,752,727,627,100,129,106,23,179,37,142,13,0,13
06/06/2021,Anchorage,7,LTACH,0,44,44,39,5,6,6,0,23,8,15,0,0,0,44,44,39,5,6,6,0,23,8,15,0,0,0
06/06/2021,Anchorage,7,Psych,0,,,,,,,,,,,,,,205,203,140,63,0,0,0,0,0,0,0,0,0
06/06/2021,Gulf Coast,4,CAH,1,80,71,22,49,4,0,4,18,0,18,0,0,0,80,71,22,49,4,0,4,18,0,18,0,0,0
06/06/2021,Gulf Coast,4,GACH,1,115,61,36,25,9,3,6,8,0,8,1,0,1,115,61,36,25,9,3,6,8,0,8,1,0,1
06/06/2021,Interior,6,GACH,1,101,81,40,41,20,13,7,16,2,14,4,0,4,101,81,40,41,20,13,7,16,2,14,4,0,4
06/06/2021,Matanuska-Susitna,3,GACH,1,184,160,68,92,14,10,4,33,0,33,2,0,2,184,160,68,92,14,10,4,33,0,33,2,0,2
06/06/2021,Northern,2,CAH,1,96,65,22,43,0,0,0,36,0,36,1,0,1,96,65,22,43,0,0,0,36,0,36,1,0,1
06/06/2021,Southeast,5,CAH,1,70,70,33,37,8,3,5,33,0,33,1,0,1,70,70,33,37,8,3,5,33,0,33,1,0,1
06/06/2021,Southeast,5,GACH,1,161,133,35,98,9,2,7,20,0,20,1,0,1,161,133,35,98,9,2,7,20,0,20,1,0,1
06/06/2021,Southwest,1,CAH,1,22,12,2,10,0,0,0,4,0,4,0,0,0,22,12,2,10,0,0,0,4,0,4,0,0,0
06/06/2021,Southwest,1,GACH,1,53,45,7,38,0,0,0,4,0,4,0,0,0,53,45,7,38,0,0,0,4,0,4,0,0,0
06/07/2021,Anchorage,7,GACH,1,758,730,604,126,129,112,17,179,39,140,11,0,11,758,730,604,126,129,112,17,179,39,140,11,0,11
06/07/2021,Anchorage,7,LTACH,0,44,44,39,5,6,6,0,23,8,15,0,0,0,44,44,39,5,6,6,0,23,8,15,0,0,0
06/07/2021,Anchorage,7,Psych,0,,,,,,,,,,,,,,205,203,140,63,0,0,0,0,0,0,0,0,0
06/07/2021,Gulf Coast,4,CAH,1,80,71,25,46,4,0,4,18,0,18,0,0,0,80,71,25,46,4,0,4,18,0,18,0,0,0
06/07/2021,Gulf Coast,4,GACH,1,115,61,45,16,9,8,1,8,0,8,1,0,1,115,61,45,16,9,8,1,8,0,8,1,0,1
06/07/2021,Interior,6,GACH,1,101,81,37,44,20,8,12,16,2,14,3,0,3,101,81,37,44,20,8,12,16,2,14,3,0,3
06/07/2021,Matanuska-Susitna,3,GACH,1,184,160,69,91,14,7,7,33,1,32,3,0,3,184,160,69,91,14,7,7,33,1,32,3,0,3
06/07/2021,Northern,2,CAH,1,96,65,19,46,0,0,0,36,0,36,1,0,1,96,65,19,46,0,0,0,36,0,36,1,0,1
06/07/2021,Southeast,5,CAH,1,70,70,32,38,8,1,7,33,0,33,0,0,0,70,70,32,38,8,1,7,33,0,33,0,0,0
06/07/2021,Southeast,5,GACH,1,161,133,34,99,9,2,7,20,0,20,1,0,1,161,133,34,99,9,2,7,20,0,20,1,0,1
06/07/2021,Southwest,1,CAH,1,22,12,2,10,0,0,0,4,0,4,0,0,0,22,12,2,10,0,0,0,4,0,4,0,0,0
06/07/2021,Southwest,1,GACH,1,53,45,8,37,0,0,0,4,0,4,0,0,0,53,45,8,37,0,0,0,4,0,4,0,0,0
06/08/2021,Anchorage,7,GACH,1,759,731,570,161,128,111,17,179,37,142,9,0,9,759,731,570,161,128,111,17,179,37,142,9,0,9
06/08/2021,Anchorage,7,LTACH,0,44,44,41,3,6,6,0,23,5,18,0,0,0,44,44,41,3,6,6,0,23,5,18,0,0,0
06/08/2021,Anchorage,7,Psych,0,,,,,,,,,,,,,,205,203,140,63,0,0,0,0,0,0,0,0,0
06/08/2021,Gulf Coast,4,CAH,1,84,74,25,49,4,0,4,18,0,18,0,0,0,84,74,25,49,4,0,4,18,0,18,0,0,0
06/08/2021,Gulf Coast,4,GACH,1,115,61,42,19,9,6,3,8,0,8,1,0,1,115,61,42,19,9,6,3,8,0,8,1,0,1
06/08/2021,Interior,6,GACH,1,101,81,47,34,20,8,12,16,2,14,2,0,2,101,81,47,34,20,8,12,16,2,14,2,0,2
06/08/2021,Matanuska-Susitna,3,GACH,1,184,160,81,79,14,5,9,33,1,32,2,0,2,184,160,81,79,14,5,9,33,1,32,2,0,2
06/08/2021,Northern,2,CAH,1,96,65,19,46,0,0,0,36,0,36,1,0,1,96,65,19,46,0,0,0,36,0,36,1,0,1
06/08/2021,Southeast,5,CAH,1,70,70,32,38,8,3,5,33,0,33,0,0,0,70,70,32,38,8,3,5,33,0,33,0,0,0
06/08/2021,Southeast,5,GACH,1,161,133,38,95,9,3,6,20,0,20,1,0,1,161,133,38,95,9,3,6,20,0,20,1,0,1
06/08/2021,Southwest,1,CAH,1,22,12,2,10,0,0,0,4,0,4,0,0,0,22,12,2,10,0,0,0,4,0,4,0,0,0
06/08/2021,Southwest,1,GACH,1,53,45,6,39,0,0,0,4,0,4,0,0,0,53,45,6,39,0,0,0,4,0,4,0,0,0
06/09/2021,Anchorage,7,GACH,1,758,733,569,164,131,105,26,179,37,142,9,0,9,758,733,569,164,131,105,26,179,37,142,9,0,9
06/09/2021,Anchorage,7,LTACH,0,44,44,41,3,6,6,0,23,5,18,0,0,0,44,44,41,3,6,6,0,23,5,18,0,0,0
06/09/2021,Anchorage,7,Psych,0,205,200,137,63,0,0,0,0,0,0,0,0,0,205,200,137,63,0,0,0,0,0,0,0,0,0
06/09/2021,Gulf Coast,4,CAH,1,84,74,26,48,4,1,3,18,0,18,0,0,0,84,74,26,48,4,1,3,18,0,18,0,0,0
06/09/2021,Gulf Coast,4,GACH,1,115,61,43,18,9,8,1,8,0,8,1,0,1,115,61,43,18,9,8,1,8,0,8,1,0,1
06/09/2021,Interior,6,GACH,1,101,81,43,38,20,10,10,16,3,13,1,0,1,101,81,43,38,20,10,10,16,3,13,1,0,1
06/09/2021,Matanuska-Susitna,3,GACH,1,184,160,74,86,14,4,10,33,0,33,2,0,2,184,160,74,86,14,4,10,33,0,33,2,0,2
06/09/2021,Northern,2,CAH,1,96,65,15,50,0,0,0,36,0,36,1,0,1,96,65,15,50,0,0,0,36,0,36,1,0,1
06/09/2021,Southeast,5,CAH,1,70,70,27,43,8,2,6,33,0,33,0,0,0,70,70,27,43,8,2,6,33,0,33,0,0,0
06/09/2021,Southeast,5,GACH,1,161,133,45,88,9,5,4,20,0,20,1,0,1,161,133,45,88,9,5,4,20,0,20,1,0,1
06/09/2021,Southwest,1,CAH,1,22,12,0,12,0,0,0,4,0,4,0,0,0,22,12,0,12,0,0,0,4,0,4,0,0,0
06/09/2021,Southwest,1,GACH,1,53,45,7,38,0,0,0,4,0,4,0,0,0,53,45,7,38,0,0,0,4,0,4,0,0,0
06/10/2021,Anchorage,7,GACH,1,747,724,577,147,130,103,27,179,35,144,10,0,10,747,724,577,147,130,103,27,179,35,144,10,0,10
06/10/2021,Anchorage,7,LTACH,0,44,44,40,4,6,6,0,23,5,18,0,0,0,44,44,40,4,6,6,0,23,5,18,0,0,0
06/10/2021,Anchorage,7,Psych,0,,,,,,,,,,,,,,205,200,137,63,0,0,0,0,0,0,0,0,0
06/10/2021,Gulf Coast,4,CAH,1,84,74,28,46,4,1,3,18,0,18,3,0,3,84,74,28,46,4,1,3,18,0,18,3,0,3
06/10/2021,Gulf Coast,4,GACH,1,115,61,42,19,9,8,1,8,0,8,1,0,1,115,61,42,19,9,8,1,8,0,8,1,0,1
06/10/2021,Interior,6,GACH,1,101,81,43,38,20,10,10,16,3,13,1,0,1,101,81,43,38,20,10,10,16,3,13,1,0,1
06/10/2021,Matanuska-Susitna,3,GACH,1,184,160,64,96,14,7,7,33,0,33,1,0,1,184,160,64,96,14,7,7,33,0,33,1,0,1
06/10/2021,Northern,2,CAH,1,96,65,11,54,0,0,0,36,0,36,2,0,2,96,65,11,54,0,0,0,36,0,36,2,0,2
06/10/2021,Southeast,5,CAH,1,70,70,31,39,8,3,5,33,0,33,0,0,0,70,70,31,39,8,3,5,33,0,33,0,0,0
06/10/2021,Southeast,5,GACH,1,161,133,37,96,9,4,5,20,0,20,1,0,1,161,133,37,96,9,4,5,20,0,20,1,0,1
06/10/2021,Southwest,1,CAH,1,22,12,1,11,0,0,0,4,0,4,0,0,0,22,12,1,11,0,0,0,4,0,4,0,0,0
06/10/2021,Southwest,1,GACH,1,53,45,10,35,0,0,0,4,0,4,0,0,0,53,45,10,35,0,0,0,4,0,4,0,0,0
06/11/2021,Anchorage,7,GACH,1,751,726,596,130,131,104,27,179,33,146,9,0,9,751,726,596,130,131,104,27,179,33,146,9,0,9
06/11/2021,Anchorage,7,LTACH,0,44,44,43,1,6,6,0,23,6,17,0,0,0,44,44,43,1,6,6,0,23,6,17,0,0,0
06/11/2021,Anchorage,7,Psych,0,,,,,,,,,,,,,,205,200,137,63,0,0,0,0,0,0,0,0,0
06/11/2021,Gulf Coast,4,CAH,1,84,74,23,51,4,0,4,18,0,18,2,0,2,84,74,23,51,4,0,4,18,0,18,2,0,2
06/11/2021,Gulf Coast,4,GACH,1,115,61,42,19,9,8,1,8,0,8,0,0,0,115,61,42,19,9,8,1,8,0,8,0,0,0
06/11/2021,Interior,6,GACH,1,101,81,40,41,20,10,10,16,3,13,2,0,2,101,81,40,41,20,10,10,16,3,13,2,0,2
06/11/2021,Matanuska-Susitna,3,GACH,1,184,160,67,93,14,6,8,33,0,33,0,0,0,184,160,67,93,14,6,8,33,0,33,0,0,0
06/11/2021,Northern,2,CAH,1,96,65,11,54,0,0,0,36,0,36,2,0,2,96,65,11,54,0,0,0,36,0,36,2,0,2
06/11/2021,Southeast,5,CAH,1,70,70,26,44,8,2,6,33,0,33,0,0,0,70,70,26,44,8,2,6,33,0,33,0,0,0
06/11/2021,Southeast,5,GACH,1,161,133,38,95,9,4,5,20,0,20,2,0,2,161,133,38,95,9,4,5,20,0,20,2,0,2
06/11/2021,Southwest,1,CAH,1,22,12,0,12,0,0,0,4,0,4,0,0,0,22,12,0,12,0,0,0,4,0,4,0,0,0
06/11/2021,Southwest,1,GACH,1,53,45,11,34,0,0,0,4,0,4,0,0,0,53,45,11,34,0,0,0,4,0,4,0,0,0
06/12/2021,Anchorage,7,GACH,1,752,726,588,138,131,108,23,179,36,143,10,0,10,752,726,588,138,131,108,23,179,36,143,10,0,10
06/12/2021,Anchorage,7,LTACH,0,44,44,40,4,6,6,0,23,7,16,0,0,0,44,44,40,4,6,6,0,23,7,16,0,0,0
06/12/2021,Anchorage,7,Psych,0,,,,,,,,,,,,,,205,200,137,63,0,0,0,0,0,0,0,0,0
06/12/2021,Gulf Coast,4,CAH,1,84,74,25,49,4,0,4,18,0,18,0,0,0,84,74,25,49,4,0,4,18,0,18,0,0,0
06/12/2021,Gulf Coast,4,GACH,1,115,61,47,14,9,8,1,8,0,8,0,0,0,115,61,47,14,9,8,1,8,0,8,0,0,0
06/12/2021,Interior,6,GACH,1,101,81,54,27,20,9,11,16,2,14,3,0,3,101,81,54,27,20,9,11,16,2,14,3,0,3
06/12/2021,Matanuska-Susitna,3,GACH,1,184,160,68,92,14,7,7,33,0,33,1,0,1,184,160,68,92,14,7,7,33,0,33,1,0,1
06/12/2021,Northern,2,CAH,1,96,65,22,43,0,0,0,36,0,36,3,0,3,96,65,22,43,0,0,0,36,0,36,3,0,3
06/12/2021,Southeast,5,CAH,1,70,70,23,47,8,2,6,33,0,33,0,0,0,70,70,23,47,8,2,6,33,0,33,0,0,0
06/12/2021,Southeast,5,GACH,1,161,133,41,92,9,4,5,20,0,20,2,0,2,161,133,41,92,9,4,5,20,0,20,2,0,2
06/12/2021,Southwest,1,CAH,1,22,12,1,11,0,0,0,4,0,4,0,0,0,22,12,1,11,0,0,0,4,0,4,0,0,0
06/12/2021,Southwest,1,GACH,1,53,45,14,31,0,0,0,4,0,4,0,0,0,53,45,14,31,0,0,0,4,0,4,0,0,0
06/13/2021,Anchorage,7,GACH,1,754,724,582,142,129,103,26,179,37,142,10,0,10,754,724,582,142,129,103,26,179,37,142,10,0,10
06/13/2021,Anchorage,7,LTACH,0,44,44,41,3,6,6,0,23,7,16,0,0,0,44,44,41,3,6,6,0,23,7,16,0,0,0
06/13/2021,Anchorage,7,Psych,0,,,,,,,,,,,,,,205,200,137,63,0,0,0,0,0,0,0,0,0
06/13/2021,Gulf Coast,4,CAH,1,84,74,25,49,4,0,4,18,0,18,0,0,0,84,74,25,49,4,0,4,18,0,18,0,0,0
06/13/2021,Gulf Coast,4,GACH,1,115,61,46,15,9,9,0,8,0,8,0,0,0,115,61,46,15,9,9,0,8,0,8,0,0,0
06/13/2021,Interior,6,GACH,1,101,81,50,31,20,9,11,16,1,15,4,0,4,101,81,50,31,20,9,11,16,1,15,4,0,4
06/13/2021,Matanuska-Susitna,3,GACH,1,184,160,52,108,14,5,9,33,0,33,1,0,1,184,160,52,108,14,5,9,33,0,33,1,0,1
06/13/2021,Northern,2,CAH,1,96,65,19,46,0,0,0,36,0,36,3,0,3,96,65,19,46,0,0,0,36,0,36,3,0,3
06/13/2021,Southeast,5,CAH,1,70,70,22,48,8,2,6,33,0,33,0,0,0,70,70,22,48,8,2,6,33,0,33,0,0,0
06/13/2021,Southeast,5,GACH,1,161,133,38,95,9,5,4,20,0,20,1,0,1,161,133,38,95,9,5,4,20,0,20,1,0,1
06/13/2021,Southwest,1,CAH,1,22,12,1,11,0,0,0,4,0,4,0,0,0,22,12,1,11,0,0,0,4,0,4,0,0,0
06/13/2021,Southwest,1,GACH,1,53,45,10,35,0,0,0,4,0,4,0,0,0,53,45,10,35,0,0,0,4,0,4,0,0,0
06/14/2021,Anchorage,7,GACH,1,752,726,578,148,131,98,33,179,34,145,9,0,9,752,726,578,148,131,98,33,179,34,145,9,0,9
06/14/2021,Anchorage,7,LTACH,0,44,44,41,3,6,6,0,23,7,16,0,0,0,44,44,41,3,6,6,0,23,7,16,0,0,0
06/14/2021,Anchorage,7,Psych,0,,,,,,,,,,,,,,205,200,137,63,0,0,0,0,0,0,0,0,0
06/14/2021,Gulf Coast,4,CAH,1,84,74,23,51,4,1,3,18,0,18,0,0,0,84,74,23,51,4,1,3,18,0,18,0,0,0
06/14/2021,Gulf Coast,4,GACH,1,115,61,39,22,9,7,2,8,0,8,0,0,0,115,61,39,22,9,7,2,8,0,8,0,0,0
06/14/2021,Interior,6,GACH,1,101,81,54,27,20,11,9,16,1,15,3,0,3,101,81,54,27,20,11,9,16,1,15,3,0,3
06/14/2021,Matanuska-Susitna,3,GACH,1,184,160,64,96,14,6,8,33,1,32,1,0,1,184,160,64,96,14,6,8,33,1,32,1,0,1
06/14/2021,Northern,2,CAH,1,96,65,15,50,0,0,0,36,0,36,3,0,3,96,65,15,50,0,0,0,36,0,36,3,0,3
06/14/2021,Southeast,5,CAH,1,70,70,27,43,8,3,5,33,0,33,0,0,0,70,70,27,43,8,3,5,33,0,33,0,0,0
06/14/2021,Southeast,5,GACH,1,161,133,30,103,9,5,4,20,2,18,1,0,1,161,133,30,103,9,5,4,20,2,18,1,0,1
06/14/2021,Southwest,1,CAH,1,22,12,1,11,0,0,0,4,0,4,0,0,0,22,12,1,11,0,0,0,4,0,4,0,0,0
06/14/2021,Southwest,1,GACH,1,53,45,10,35,0,0,0,4,0,4,0,0,0,53,45,10,35,0,0,0,4,0,4,0,0,0
06/15/2021,Anchorage,7,GACH,1,752,727,602,125,132,108,24,179,36,143,11,0,11,752,727,602,125,132,108,24,179,36,143,11,0,11
06/15/2021,Anchorage,7,LTACH,0,44,44,41,3,6,6,0,23,7,16,0,0,0,44,44,41,3,6,6,0,23,7,16,0,0,0
06/15/2021,Anchorage,7,Psych,0,,,,,,,,,,,,,,205,200,137,63,0,0,0,0,0,0,0,0,0
06/15/2021,Gulf Coast,4,CAH,1,84,74,29,45,4,1,3,18,0,18,0,0,0,84,74,29,45,4,1,3,18,0,18,0,0,0
06/15/2021,Gulf Coast,4,GACH,1,115,61,43,18,9,7,2,8,1,7,0,0,0,115,61,43,18,9,7,2,8,1,7,0,0,0
06/15/2021,Interior,6,GACH,1,101,81,60,21,20,9,11,16,1,15,2,1,3,101,81,60,21,20,9,11,16,1,15,2,1,3
06/15/2021,Matanuska-Susitna,3,GACH,1,184,160,80,80,14,9,5,33,1,32,2,0,2,184,160,80,80,14,9,5,33,1,32,2,0,2
06/15/2021,Northern,2,CAH,1,96,65,18,47,0,0,0,36,0,36,1,0,1,96,65,18,47,0,0,0,36,0,36,1,0,1
06/15/2021,Southeast,5,CAH,1,70,70,29,41,8,3,5,33,0,33,0,0,0,70,70,29,41,8,3,5,33,0,33,0,0,0
06/15/2021,Southeast,5,GACH,1,161,133,33,100,9,6,3,20,0,20,1,0,1,161,133,33,100,9,6,3,20,0,20,1,0,1
06/15/2021,Southwest,1,CAH,1,22,12,1,11,0,0,0,4,0,4,0,0,0,22,12,1,11,0,0,0,4,0,4,0,0,0
06/15/2021,Southwest,1,GACH,1,53,45,11,34,0,0,0,4,0,4,0,0,0,53,45,11,34,0,0,0,4,0,4,0,0,0
06/16/2021,Anchorage,7,GACH,1,733,704,596,108,120,100,20,179,33,146,9,0,9,733,704,596,108,120,100,20,179,33,146,9,0,9
06/16/2021,Anchorage,7,LTACH,0,44,44,39,5,6,6,0,23,7,16,0,0,0,44,44,39,5,6,6,0,23,7,16,0,0,0
06/16/2021,Anchorage,7,Psych,0,208,199,130,69,0,0,0,0,0,0,0,0,0,208,199,130,69,0,0,0,0,0,0,0,0,0
06/16/2021,Gulf Coast,4,CAH,1,84,74,29,45,4,0,4,18,0,18,0,0,0,84,74,29,45,4,0,4,18,0,18,0,0,0
06/16/2021,Gulf Coast,4,GACH,1,115,61,45,16,9,7,2,8,1,7,0,0,0,115,61,45,16,9,7,2,8,1,7,0,0,0
06/16/2021,Interior,6,GACH,1,101,81,68,13,20,8,12,16,0,16,2,1,3,101,81,68,13,20,8,12,16,0,16,2,1,3
06/16/2021,Matanuska-Susitna,3,GACH,1,184,160,77,83,14,10,4,33,2,31,1,0,1,184,160,77,83,14,10,4,33,2,31,1,0,1
06/16/2021,Northern,2,CAH,1,96,65,14,51,0,0,0,36,0,36,0,0,0,96,65,14,51,0,0,0,36,0,36,0,0,0
06/16/2021,Southeast,5,CAH,1,70,70,32,38,8,4,4,33,0,33,1,0,1,70,70,32,38,8,4,4,33,0,33,1,0,1
06/16/2021,Southeast,5,GACH,1,161,133,31,102,9,3,6,20,0,20,0,0,0,161,133,31,102,9,3,6,20,0,20,0,0,0
06/16/2021,Southwest,1,CAH,1,22,12,1,11,0,0,0,4,0,4,0,0,0,22,12,1,11,0,0,0,4,0,4,0,0,0
06/16/2021,Southwest,1,GACH,1,53,45,10,35,0,0,0,4,0,4,0,0,0,53,45,10,35,0,0,0,4,0,4,0,0,0
06/17/2021,Anchorage,7,GACH,1,721,693,600,93,118,99,19,179,32,147,9,0,9,721,693,600,93,118,99,19,179,32,147,9,0,9
06/17/2021,Anchorage,7,LTACH,0,44,44,38,6,6,6,0,23,7,16,0,0,0,44,44,38,6,6,6,0,23,7,16,0,0,0
06/17/2021,Anchorage,7,Psych,0,,,,,,,,,,,,,,208,199,130,69,0,0,0,0,0,0,0,0,0
06/17/2021,Gulf Coast,4,CAH,1,84,74,26,48,4,1,3,18,0,18,0,0,0,84,74,26,48,4,1,3,18,0,18,0,0,0
06/17/2021,Gulf Coast,4,GACH,1,115,61,35,26,9,3,6,8,1,7,0,0,0,115,61,35,26,9,3,6,8,1,7,0,0,0
06/17/2021,Interior,6,GACH,1,101,81,64,17,20,6,14,16,0,16,2,0,2,101,81,64,17,20,6,14,16,0,16,2,0,2
06/17/2021,Matanuska-Susitna,3,GACH,1,184,160,73,87,14,10,4,33,2,31,1,0,1,184,160,73,87,14,10,4,33,2,31,1,0,1
06/17/2021,Northern,2,CAH,1,96,65,7,58,0,0,0,36,0,36,0,0,0,96,65,7,58,0,0,0,36,0,36,0,0,0
06/17/2021,Southeast,5,CAH,1,70,70,26,44,8,4,4,33,0,33,1,0,1,70,70,26,44,8,4,4,33,0,33,1,0,1
06/17/2021,Southeast,5,GACH,1,161,133,32,101,9,4,5,20,0,20,0,0,0,161,133,32,101,9,4,5,20,0,20,0,0,0
06/17/2021,Southwest,1,CAH,1,22,12,3,9,0,0,0,4,0,4,0,0,0,22,12,3,9,0,0,0,4,0,4,0,0,0
06/17/2021,Southwest,1,GACH,1,53,45,12,33,0,0,0,4,0,4,0,0,0,53,45,12,33,0,0,0,4,0,4,0,0,0
06/18/2021,Anchorage,7,GACH,1,716,691,608,83,107,90,17,179,30,149,8,0,8,716,691,608,83,107,90,17,179,30,149,8,0,8
06/18/2021,Anchorage,7,LTACH,0,44,44,38,6,6,6,0,23,6,17,0,0,0,44,44,38,6,6,6,0,23,6,17,0,0,0
06/18/2021,Anchorage,7,Psych,0,,,,,,,,,,,,,,208,199,130,69,0,0,0,0,0,0,0,0,0
06/18/2021,Gulf Coast,4,CAH,1,84,74,23,51,4,1,3,18,0,18,0,0,0,84,74,23,51,4,1,3,18,0,18,0,0,0
06/18/2021,Gulf Coast,4,GACH,1,115,61,32,29,9,4,5,8,1,7,0,0,0,115,61,32,29,9,4,5,8,1,7,0,0,0
06/18/2021,Interior,6,GACH,1,101,81,61,20,20,11,9,16,0,16,2,0,2,101,81,61,20,20,11,9,16,0,16,2,0,2
06/18/2021,Matanuska-Susitna,3,GACH,1,184,160,73,87,14,2,12,33,0,33,0,0,0,184,160,73,87,14,2,12,33,0,33,0,0,0
06/18/2021,Northern,2,CAH,1,96,65,11,54,0,0,0,36,0,36,0,0,0,96,65,11,54,0,0,0,36,0,36,0,0,0
06/18/2021,Southeast,5,CAH,1,70,70,23,47,8,4,4,33,0,33,1,0,1,70,70,23,47,8,4,4,33,0,33,1,0,1
06/18/2021,Southeast,5,GACH,1,161,133,34,99,9,4,5,20,0,20,0,0,0,161,133,34,99,9,4,5,20,0,20,0,0,0
06/18/2021,Southwest,1,CAH,1,22,12,1,11,0,0,0,4,0,4,0,0,0,22,12,1,11,0,0,0,4,0,4,0,0,0
06/18/2021,Southwest,1,GACH,1,53,45,10,35,0,0,0,4,0,4,0,0,0,53,45,10,35,0,0,0,4,0,4,0,0,0
06/19/2021,Anchorage,7,GACH,1,708,683,583,100,114,93,21,179,27,152,9,0,9,708,683,583,100,114,93,21,179,27,152,9,0,9
06/19/2021,Anchorage,7,LTACH,0,44,44,37,7,6,6,0,23,5,18,0,0,0,44,44,37,7,6,6,0,23,5,18,0,0,0
06/19/2021,Anchorage,7,Psych,0,,,,,,,,,,,,,,208,199,130,69,0,0,0,0,0,0,0,0,0
06/19/2021,Gulf Coast,4,CAH,1,84,74,17,57,4,1,3,18,0,18,0,0,0,84,74,17,57,4,1,3,18,0,18,0,0,0
06/19/2021,Gulf Coast,4,GACH,1,115,61,35,26,9,6,3,8,2,6,0,0,0,115,61,35,26,9,6,3,8,2,6,0,0,0
06/19/2021,Interior,6,GACH,1,101,81,68,13,20,9,11,16,0,16,2,0,2,101,81,68,13,20,9,11,16,0,16,2,0,2
06/19/2021,Matanuska-Susitna,3,GACH,1,184,160,68,92,14,6,8,33,1,32,0,0,0,184,160,68,92,14,6,8,33,1,32,0,0,0
06/19/2021,Northern,2,CAH,1,96,65,18,47,0,0,0,36,0,36,0,0,0,96,65,18,47,0,0,0,36,0,36,0,0,0
06/19/2021,Southeast,5,CAH,1,70,70,24,46,8,4,4,33,0,33,1,0,1,70,70,24,46,8,4,4,33,0,33,1,0,1
06/19/2021,Southeast,5,GACH,1,161,133,30,103,9,4,5,20,0,20,0,0,0,161,133,30,103,9,4,5,20,0,20,0,0,0
06/19/2021,Southwest,1,CAH,1,22,12,2,10,0,0,0,4,0,4,0,0,0,22,12,2,10,0,0,0,4,0,4,0,0,0
06/19/2021,Southwest,1,GACH,1,53,45,11,34,0,0,0,4,0,4,0,0,0,53,45,11,34,0,0,0,4,0,4,0,0,0
06/20/2021,Anchorage,7,GACH,1,710,685,579,106,109,90,19,179,31,148,8,0,8,710,685,579,106,109,90,19,179,31,148,8,0,8
06/20/2021,Anchorage,7,LTACH,0,44,44,37,7,6,6,0,23,5,18,0,0,0,44,44,37,7,6,6,0,23,5,18,0,0,0
06/20/2021,Anchorage,7,Psych,0,,,,,,,,,,,,,,208,199,130,69,0,0,0,0,0,0,0,0,0
06/20/2021,Gulf Coast,4,CAH,1,84,74,20,54,4,0,4,18,0,18,0,0,0,84,74,20,54,4,0,4,18,0,18,0,0,0
06/20/2021,Gulf Coast,4,GACH,1,115,61,37,24,9,3,6,8,1,7,0,0,0,115,61,37,24,9,3,6,8,1,7,0,0,0
06/20/2021,Interior,6,GACH,1,101,81,68,13,20,8,12,16,0,16,2,0,2,101,81,68,13,20,8,12,16,0,16,2,0,2
06/20/2021,Matanuska-Susitna,3,GACH,1,184,160,57,103,14,3,11,33,1,32,0,0,0,184,160,57,103,14,3,11,33,1,32,0,0,0
06/20/2021,Northern,2,CAH,1,96,65,18,47,0,0,0,36,0,36,0,0,0,96,65,18,47,0,0,0,36,0,36,0,0,0
06/20/2021,Southeast,5,CAH,1,70,70,22,48,8,4,4,33,0,33,1,0,1,70,70,22,48,8,4,4,33,0,33,1,0,1
06/20/2021,Southeast,5,GACH,1,161,133,26,107,9,3,6,20,0,20,0,0,0,161,133,26,107,9,3,6,20,0,20,0,0,0
06/20/2021,Southwest,1,CAH,1,22,12,2,10,0,0,0,4,0,4,0,0,0,22,12,2,10,0,0,0,4,0,4,0,0,0
06/20/2021,Southwest,1,GACH,1,53,45,9,36,0,0,0,4,0,4,0,0,0,53,45,9,36,0,0,0,4,0,4,0,0,0
06/21/2021,Anchorage,7,GACH,1,723,696,601,95,113,94,19,179,31,148,9,0,9,723,696,601,95,113,94,19,179,31,148,9,0,9
06/21/2021,Anchorage,7,LTACH,0,44,44,38,6,6,6,0,23,5,18,0,0,0,44,44,38,6,6,6,0,23,5,18,0,0,0
06/21/2021,Anchorage,7,Psych,0,,,,,,,,,,,,,,208,199,130,69,0,0,0,0,0,0,0,0,0
06/21/2021,Gulf Coast,4,CAH,1,84,74,26,48,4,0,4,18,0,18,0,0,0,84,74,26,48,4,0,4,18,0,18,0,0,0
06/21/2021,Gulf Coast,4,GACH,1,115,61,34,27,9,4,5,8,0,8,0,0,0,115,61,34,27,9,4,5,8,0,8,0,0,0
06/21/2021,Interior,6,GACH,1,101,81,57,24,20,4,16,16,0,16,1,0,1,101,81,57,24,20,4,16,16,0,16,1,0,1
06/21/2021,Matanuska-Susitna,3,GACH,1,184,160,64,96,14,7,7,33,0,33,0,0,0,184,160,64,96,14,7,7,33,0,33,0,0,0
06/21/2021,Northern,2,CAH,1,96,65,21,44,0,0,0,36,0,36,0,0,0,96,65,21,44,0,0,0,36,0,36,0,0,0
06/21/2021,Southeast,5,CAH,1,70,70,23,47,8,0,8,33,0,33,1,0,1,70,70,23,47,8,0,8,33,0,33,1,0,1
06/21/2021,Southeast,5,GACH,1,161,133,29,104,9,4,5,20,0,20,0,0,0,161,133,29,104,9,4,5,20,0,20,0,0,0
06/21/2021,Southwest,1,CAH,1,22,12,3,9,0,0,0,4,0,4,0,0,0,22,12,3,9,0,0,0,4,0,4,0,0,0
06/21/2021,Southwest,1,GACH,1,53,45,4,41,0,0,0,4,0,4,0,0,0,53,45,4,41,0,0,0,4,0,4,0,0,0
06/22/2021,Anchorage,7,GACH,1,728,701,609,92,114,97,17,179,30,149,11,0,11,728,701,609,92,114,97,17,179,30,149,11,0,11
06/22/2021,Anchorage,7,LTACH,0,44,44,38,6,6,6,0,23,4,19,0,0,0,44,44,38,6,6,6,0,23,4,19,0,0,0
06/22/2021,Anchorage,7,Psych,0,,,,,,,,,,,,,,208,199,130,69,0,0,0,0,0,0,0,0,0
06/22/2021,Gulf Coast,4,CAH,1,84,74,25,49,4,0,4,18,0,18,2,0,2,84,74,25,49,4,0,4,18,0,18,2,0,2
06/22/2021,Gulf Coast,4,GACH,1,115,61,43,18,9,6,3,8,0,8,0,0,0,115,61,43,18,9,6,3,8,0,8,0,0,0
06/22/2021,Interior,6,GACH,1,101,81,60,21,20,10,10,16,1,15,1,0,1,101,81,60,21,20,10,10,16,1,15,1,0,1
06/22/2021,Matanuska-Susitna,3,GACH,1,184,160,71,89,14,7,7,33,0,33,1,0,1,184,160,71,89,14,7,7,33,0,33,1,0,1
06/22/2021,Northern,2,CAH,1,96,65,21,44,0,0,0,36,0,36,0,0,0,96,65,21,44,0,0,0,36,0,36,0,0,0
06/22/2021,Southeast,5,CAH,1,70,70,23,47,8,1,7,33,0,33,1,0,1,70,70,23,47,8,1,7,33,0,33,1,0,1
06/22/2021,Southeast,5,GACH,1,161,133,34,99,9,5,4,20,0,20,0,0,0,161,133,34,99,9,5,4,20,0,20,0,0,0
06/22/2021,Southwest,1,CAH,1,22,12,2,10,0,0,0,4,0,4,0,0,0,22,12,2,10,0,0,0,4,0,4,0,0,0
06/22/2021,Southwest,1,GACH,1,53,45,6,39,0,0,0,4,0,4,0,0,0,53,45,6,39,0,0,0,4,0,4,0,0,0
06/23/2021,Anchorage,7,GACH,1,734,708,623,85,118,102,16,179,32,147,10,0,10,734,708,623,85,118,102,16,179,32,147,10,0,10
06/23/2021,Anchorage,7,LTACH,0,44,44,36,8,6,6,0,23,4,19,0,0,0,44,44,36,8,6,6,0,23,4,19,0,0,0
06/23/2021,Anchorage,7,Psych,0,140,140,73,67,0,0,0,0,0,0,0,0,0,208,199,132,67,0,0,0,0,0,0,0,0,0
06/23/2021,Gulf Coast,4,CAH,1,84,74,28,46,4,0,4,18,0,18,2,0,2,84,74,28,46,4,0,4,18,0,18,2,0,2
06/23/2021,Gulf Coast,4,GACH,1,115,61,40,21,9,5,4,8,0,8,0,0,0,115,61,40,21,9,5,4,8,0,8,0,0,0
06/23/2021,Interior,6,GACH,1,101,81,64,17,20,8,12,16,0,16,1,0,1,101,81,64,17,20,8,12,16,0,16,1,0,1
06/23/2021,Matanuska-Susitna,3,GACH,1,184,160,70,90,14,3,11,33,0,33,2,0,2,184,160,70,90,14,3,11,33,0,33,2,0,2
06/23/2021,Northern,2,CAH,1,96,65,15,50,0,0,0,36,0,36,0,0,0,96,65,15,50,0,0,0,36,0,36,0,0,0
06/23/2021,Southeast,5,CAH,1,70,70,31,39,8,2,6,33,0,33,1,0,1,70,70,31,39,8,2,6,33,0,33,1,0,1
06/23/2021,Southeast,5,GACH,1,161,133,38,95,9,4,5,20,0,20,0,0,0,161,133,38,95,9,4,5,20,0,20,0,0,0
06/23/2021,Southwest,1,CAH,1,22,12,2,10,0,0,0,4,0,4,0,0,0,22,12,2,10,0,0,0,4,0,4,0,0,0
06/23/2021,Southwest,1,GACH,1,53,45,5,40,0,0,0,4,0,4,0,0,0,53,45,5,40,0,0,0,4,0,4,0,0,0
06/24/2021,Anchorage,7,GACH,1,747,719,643,76,122,107,15,179,26,153,10,0,10,747,719,643,76,122,107,15,179,26,153,10,0,10
06/24/2021,Anchorage,7,LTACH,0,44,44,35,9,6,6,0,23,4,19,0,0,0,44,44,35,9,6,6,0,23,4,19,0,0,0
06/24/2021,Anchorage,7,Psych,0,,,,,,,,,,,,,,208,199,132,67,0,0,0,0,0,0,0,0,0
06/24/2021,Gulf Coast,4,CAH,1,84,74,25,49,4,0,4,18,0,18,1,0,1,84,74,25,49,4,0,4,18,0,18,1,0,1
06/24/2021,Gulf Coast,4,GACH,1,115,61,35,26,9,4,5,8,0,8,0,0,0,115,61,35,26,9,4,5,8,0,8,0,0,0
06/24/2021,Interior,6,GACH,1,101,81,63,18,20,7,13,16,0,16,1,0,1,101,81,63,18,20,7,13,16,0,16,1,0,1
06/24/2021,Matanuska-Susitna,3,GACH,1,184,160,74,86,14,8,6,33,0,33,3,0,3,184,160,74,86,14,8,6,33,0,33,3,0,3
06/24/2021,Northern,2,CAH,1,96,65,12,53,0,0,0,36,0,36,0,0,0,96,65,12,53,0,0,0,36,0,36,0,0,0
06/24/2021,Southeast,5,CAH,1,70,70,43,27,8,3,5,33,0,33,1,0,1,70,70,43,27,8,3,5,33,0,33,1,0,1
06/24/2021,Southeast,5,GACH,1,161,133,41,92,9,1,8,20,0,20,0,0,0,161,133,41,92,9,1,8,20,0,20,0,0,0
06/24/2021,Southwest,1,CAH,1,22,12,2,10,0,0,0,4,0,4,0,0,0,22,12,2,10,0,0,0,4,0,4,0,0,0
06/24/2021,Southwest,1,GACH,1,53,45,7,38,0,0,0,4,0,4,0,0,0,53,45,7,38,0,0,0,4,0,4,0,0,0
06/25/2021,Anchorage,7,GACH,1,733,700,609,91,123,106,17,179,32,147,6,0,6,733,700,609,91,123,106,17,179,32,147,6,0,6
06/25/2021,Anchorage,7,LTACH,0,44,44,36,8,6,6,0,23,5,18,0,0,0,44,44,36,8,6,6,0,23,5,18,0,0,0
06/25/2021,Anchorage,7,Psych,0,,,,,,,,,,,,,,208,199,132,67,0,0,0,0,0,0,0,0,0
06/25/2021,Gulf Coast,4,CAH,1,84,74,27,47,4,0,4,18,0,18,1,0,1,84,74,27,47,4,0,4,18,0,18,1,0,1
06/25/2021,Gulf Coast,4,GACH,1,115,61,33,28,9,4,5,8,0,8,0,0,0,115,61,33,28,9,4,5,8,0,8,0,0,0
06/25/2021,Interior,6,GACH,1,101,81,66,15,20,6,14,16,0,16,0,0,0,101,81,66,15,20,6,14,16,0,16,0,0,0
06/25/2021,Matanuska-Susitna,3,GACH,1,184,160,72,88,14,14,0,33,2,31,4,0,4,184,160,72,88,14,14,0,33,2,31,4,0,4
06/25/2021,Northern,2,CAH,1,96,65,16,49,0,0,0,36,0,36,0,0,0,96,65,16,49,0,0,0,36,0,36,0,0,0
06/25/2021,Southeast,5,CAH,1,70,70,33,37,8,3,5,33,0,33,1,0,1,70,70,33,37,8,3,5,33,0,33,1,0,1
06/25/2021,Southeast,5,GACH,1,161,133,38,95,9,2,7,20,0,20,0,0,0,161,133,38,95,9,2,7,20,0,20,0,0,0
06/25/2021,Southwest,1,CAH,1,22,12,4,8,0,0,0,4,0,4,0,0,0,22,12,4,8,0,0,0,4,0,4,0,0,0
06/25/2021,Southwest,1,GACH,1,53,45,12,33,0,0,0,4,0,4,0,0,0,53,45,12,33,0,0,0,4,0,4,0,0,0
06/26/2021,Anchorage,7,GACH,1,728,697,604,93,116,98,18,179,34,145,6,0,6,728,697,604,93,116,98,18,179,34,145,6,0,6
06/26/2021,Anchorage,7,LTACH,0,44,44,36,8,6,6,0,23,5,18,0,0,0,44,44,36,8,6,6,0,23,5,18,0,0,0
06/26/2021,Anchorage,7,Psych,0,,,,,,,,,,,,,,208,199,132,67,0,0,0,0,0,0,0,0,0
06/26/2021,Gulf Coast,4,CAH,1,84,74,20,54,4,0,4,18,0,18,0,0,0,84,74,20,54,4,0,4,18,0,18,0,0,0
06/26/2021,Gulf Coast,4,GACH,1,115,61,34,27,9,2,7,8,0,8,0,0,0,115,61,34,27,9,2,7,8,0,8,0,0,0
06/26/2021,Interior,6,GACH,1,101,81,51,30,20,11,9,16,0,16,0,0,0,101,81,51,30,20,11,9,16,0,16,0,0,0
06/26/2021,Matanuska-Susitna,3,GACH,1,184,160,67,93,14,9,5,33,1,32,4,0,4,184,160,67,93,14,9,5,33,1,32,4,0,4
06/26/2021,Northern,2,CAH,1,96,65,23,42,0,0,0,36,0,36,0,0,0,96,65,23,42,0,0,0,36,0,36,0,0,0
06/26/2021,Southeast,5,CAH,1,70,70,28,42,8,3,5,33,0,33,0,0,0,70,70,28,42,8,3,5,33,0,33,0,0,0
06/26/2021,Southeast,5,GACH,1,161,133,35,98,9,3,6,20,0,20,0,0,0,161,133,35,98,9,3,6,20,0,20,0,0,0
06/26/2021,Southwest,1,CAH,1,22,12,3,9,0,0,0,4,0,4,0,0,0,22,12,3,9,0,0,0,4,0,4,0,0,0
06/26/2021,Southwest,1,GACH,1,53,45,14,31,0,0,0,4,0,4,0,0,0,53,45,14,31,0,0,0,4,0,4,0,0,0
06/27/2021,Anchorage,7,GACH,1,723,695,564,131,119,96,23,179,32,147,6,0,6,723,695,564,131,119,96,23,179,32,147,6,0,6
06/27/2021,Anchorage,7,LTACH,0,44,44,36,8,6,6,0,23,5,18,0,0,0,44,44,36,8,6,6,0,23,5,18,0,0,0
06/27/2021,Anchorage,7,Psych,0,,,,,,,,,,,,,,208,199,132,67,0,0,0,0,0,0,0,0,0
06/27/2021,Gulf Coast,4,CAH,1,84,74,20,54,4,0,4,18,0,18,0,0,0,84,74,20,54,4,0,4,18,0,18,0,0,0
06/27/2021,Gulf Coast,4,GACH,1,115,61,39,22,9,5,4,8,1,7,0,0,0,115,61,39,22,9,5,4,8,1,7,0,0,0
06/27/2021,Interior,6,GACH,1,101,81,43,38,20,8,12,16,0,16,0,0,0,101,81,43,38,20,8,12,16,0,16,0,0,0
06/27/2021,Matanuska-Susitna,3,GACH,1,184,160,70,90,14,4,10,33,0,33,3,0,3,184,160,70,90,14,4,10,33,0,33,3,0,3
06/27/2021,Northern,2,CAH,1,96,65,21,44,0,0,0,36,0,36,0,0,0,96,65,21,44,0,0,0,36,0,36,0,0,0
06/27/2021,Southeast,5,CAH,1,70,70,30,40,8,3,5,33,0,33,0,0,0,70,70,30,40,8,3,5,33,0,33,0,0,0
06/27/2021,Southeast,5,GACH,1,161,133,34,99,9,5,4,20,0,20,0,0,0,161,133,34,99,9,5,4,20,0,20,0,0,0
06/27/2021,Southwest,1,CAH,1,22,12,3,9,0,0,0,4,0,4,0,0,0,22,12,3,9,0,0,0,4,0,4,0,0,0
06/27/2021,Southwest,1,GACH,1,53,45,14,31,0,0,0,4,0,4,0,0,0,53,45,14,31,0,0,0,4,0,4,0,0,0
06/28/2021,Anchorage,7,GACH,1,637,608,335,273,85,35,50,179,20,159,13,0,13,637,608,335,273,85,35,50,179,20,159,13,0,13
06/28/2021,Anchorage,7,LTACH,0,44,44,36,8,6,6,0,23,5,18,0,0,0,44,44,36,8,6,6,0,23,5,18,0,0,0
06/28/2021,Anchorage,7,Psych,0,,,,,,,,,,,,,,208,199,132,67,0,0,0,0,0,0,0,0,0
06/28/2021,Gulf Coast,4,CAH,1,84,74,22,52,4,0,4,18,0,18,0,0,0,84,74,22,52,4,0,4,18,0,18,0,0,0
06/28/2021,Gulf Coast,4,GACH,1,115,61,37,24,9,5,4,8,1,7,0,0,0,115,61,37,24,9,5,4,8,1,7,0,0,0
06/28/2021,Interior,6,GACH,1,101,81,50,31,20,10,10,16,0,16,0,0,0,101,81,50,31,20,10,10,16,0,16,0,0,0
06/28/2021,Matanuska-Susitna,3,GACH,1,184,160,69,91,14,6,8,33,2,31,2,0,2,184,160,69,91,14,6,8,33,2,31,2,0,2
06/28/2021,Northern,2,CAH,1,96,65,25,40,0,0,0,36,0,36,0,0,0,96,65,25,40,0,0,0,36,0,36,0,0,0
06/28/2021,Southeast,5,CAH,1,70,70,32,38,8,4,4,33,0,33,0,0,0,70,70,32,38,8,4,4,33,0,33,0,0,0
06/28/2021,Southeast,5,GACH,1,161,133,35,98,9,4,5,20,2,18,0,0,0,161,133,35,98,9,4,5,20,2,18,0,0,0
06/28/2021,Southwest,1,CAH,1,22,12,3,9,0,0,0,4,0,4,0,0,0,22,12,3,9,0,0,0,4,0,4,0,0,0
06/28/2021,Southwest,1,GACH,1,53,45,11,34,0,0,0,4,0,4,0,0,0,53,45,11,34,0,0,0,4,0,4,0,0,0
06/29/2021,Anchorage,7,GACH,1,733,705,589,116,120,97,23,179,28,151,13,0,13,733,705,589,116,120,97,23,179,28,151,13,0,13
06/29/2021,Anchorage,7,LTACH,0,44,44,36,8,6,6,0,23,6,17,0,0,0,44,44,36,8,6,6,0,23,6,17,0,0,0
06/29/2021,Anchorage,7,Psych,0,,,,,,,,,,,,,,208,199,132,67,0,0,0,0,0,0,0,0,0
06/29/2021,Gulf Coast,4,CAH,1,84,74,25,49,4,0,4,18,0,18,0,0,0,84,74,25,49,4,0,4,18,0,18,0,0,0
06/29/2021,Gulf Coast,4,GACH,1,115,61,43,18,9,6,3,8,0,8,0,0,0,115,61,43,18,9,6,3,8,0,8,0,0,0
06/29/2021,Interior,6,GACH,1,101,81,62,19,20,9,11,16,0,16,0,0,0,101,81,62,19,20,9,11,16,0,16,0,0,0
06/29/2021,Matanuska-Susitna,3,GACH,1,184,160,73,87,14,9,5,33,2,31,1,0,1,184,160,73,87,14,9,5,33,2,31,1,0,1
06/29/2021,Northern,2,CAH,1,96,65,24,41,0,0,0,36,0,36,0,0,0,96,65,24,41,0,0,0,36,0,36,0,0,0
06/29/2021,Southeast,5,CAH,1,70,70,36,34,8,4,4,33,0,33,0,0,0,70,70,36,34,8,4,4,33,0,33,0,0,0
06/29/2021,Southeast,5,GACH,1,161,133,36,97,9,6,3,20,1,19,0,0,0,161,133,36,97,9,6,3,20,1,19,0,0,0
06/29/2021,Southwest,1,CAH,1,22,12,3,9,0,0,0,4,0,4,0,0,0,22,12,3,9,0,0,0,4,0,4,0,0,0
06/29/2021,Southwest,1,GACH,1,53,45,9,36,0,0,0,4,0,4,0,0,0,53,45,9,36,0,0,0,4,0,4,0,0,0
06/30/2021,Anchorage,7,GACH,1,730,703,595,108,119,98,21,179,35,144,13,0,13,730,703,595,108,119,98,21,179,35,144,13,0,13
06/30/2021,Anchorage,7,LTACH,0,44,44,33,11,6,6,0,23,4,19,0,0,0,44,44,33,11,6,6,0,23,4,19,0,0,0
06/30/2021,Anchorage,7,Psych,0,208,197,130,67,0,0,0,0,0,0,1,0,1,208,197,130,67,0,0,0,0,0,0,1,0,1
06/30/2021,Gulf Coast,4,CAH,1,84,74,25,49,4,1,3,18,0,18,0,0,0,84,74,25,49,4,1,3,18,0,18,0,0,0
06/30/2021,Gulf Coast,4,GACH,1,115,61,46,15,9,9,0,8,0,8,3,0,3,115,61,46,15,9,9,0,8,0,8,3,0,3
06/30/2021,Interior,6,GACH,1,101,81,48,33,20,6,14,16,0,16,0,0,0,101,81,48,33,20,6,14,16,0,16,0,0,0
06/30/2021,Matanuska-Susitna,3,GACH,1,184,160,67,93,14,7,7,33,2,31,1,0,1,184,160,67,93,14,7,7,33,2,31,1,0,1
06/30/2021,Northern,2,CAH,1,96,65,24,41,0,0,0,36,0,36,0,0,0,96,65,24,41,0,0,0,36,0,36,0,0,0
06/30/2021,Southeast,5,CAH,1,70,70,34,36,8,3,5,33,0,33,0,0,0,70,70,34,36,8,3,5,33,0,33,0,0,0
06/30/2021,Southeast,5,GACH,1,161,133,39,94,9,3,6,20,1,19,0,0,0,161,133,39,94,9,3,6,20,1,19,0,0,0
06/30/2021,Southwest,1,CAH,1,22,12,5,7,0,0,0,4,0,4,0,0,0,22,12,5,7,0,0,0,4,0,4,0,0,0
06/30/2021,Southwest,1,GACH,1,53,45,11,34,0,0,0,4,0,4,0,0,0,53,45,11,34,0,0,0,4,0,4,0,0,0
07/01/2021,Anchorage,7,GACH,1,726,695,597,98,118,94,24,179,34,145,12,0,12,726,695,597,98,118,94,24,179,34,145,12,0,12
07/01/2021,Anchorage,7,LTACH,0,44,44,33,11,6,6,0,23,4,19,0,0,0,44,44,33,11,6,6,0,23,4,19,0,0,0
07/01/2021,Anchorage,7,Psych,0,,,,,,,,,,,,,,208,197,130,67,0,0,0,0,0,0,1,0,1
07/01/2021,Gulf Coast,4,CAH,1,84,74,26,48,4,0,4,18,0,18,0,0,0,84,74,26,48,4,0,4,18,0,18,0,0,0
07/01/2021,Gulf Coast,4,GACH,1,115,61,44,17,9,7,2,8,1,7,2,0,2,115,61,44,17,9,7,2,8,1,7,2,0,2
07/01/2021,Interior,6,GACH,1,101,81,44,37,20,9,11,16,0,16,0,0,0,101,81,44,37,20,9,11,16,0,16,0,0,0
07/01/2021,Matanuska-Susitna,3,GACH,1,184,160,72,88,14,5,9,33,2,31,1,0,1,184,160,72,88,14,5,9,33,2,31,1,0,1
07/01/2021,Northern,2,CAH,1,96,65,21,44,0,0,0,36,0,36,0,0,0,96,65,21,44,0,0,0,36,0,36,0,0,0
07/01/2021,Southeast,5,CAH,1,70,70,25,45,8,2,6,33,0,33,3,0,3,70,70,25,45,8,2,6,33,0,33,3,0,3
07/01/2021,Southeast,5,GACH,1,161,133,37,96,9,3,6,20,1,19,0,0,0,161,133,37,96,9,3,6,20,1,19,0,0,0
07/01/2021,Southwest,1,CAH,1,22,12,5,7,0,0,0,4,0,4,0,0,0,22,12,5,7,0,0,0,4,0,4,0,0,0
07/01/2021,Southwest,1,GACH,1,53,45,9,36,0,0,0,4,0,4,0,0,0,53,45,9,36,0,0,0,4,0,4,0,0,0
07/02/2021,Anchorage,7,GACH,1,716,691,599,92,122,99,23,179,33,146,15,0,15,716,691,599,92,122,99,23,179,33,146,15,0,15
07/02/2021,Anchorage,7,LTACH,0,44,44,34,10,6,6,0,23,5,18,0,0,0,44,44,34,10,6,6,0,23,5,18,0,0,0
07/02/2021,Anchorage,7,Psych,0,,,,,,,,,,,,,,208,197,130,67,0,0,0,0,0,0,1,0,1
07/02/2021,Gulf Coast,4,CAH,1,80,69,24,45,4,0,4,18,0,18,0,0,0,80,69,24,45,4,0,4,18,0,18,0,0,0
07/02/2021,Gulf Coast,4,GACH,1,115,61,37,24,9,6,3,8,1,7,2,0,2,115,61,37,24,9,6,3,8,1,7,2,0,2
07/02/2021,Interior,6,GACH,1,101,81,52,29,20,14,6,16,0,16,0,0,0,101,81,52,29,20,14,6,16,0,16,0,0,0
07/02/2021,Matanuska-Susitna,3,GACH,1,184,160,72,88,14,5,9,33,2,31,1,0,1,184,160,72,88,14,5,9,33,2,31,1,0,1
07/02/2021,Northern,2,CAH,1,96,65,24,41,0,0,0,36,0,36,0,0,0,96,65,24,41,0,0,0,36,0,36,0,0,0
07/02/2021,Southeast,5,CAH,1,70,70,29,41,8,2,6,33,0,33,3,0,3,70,70,29,41,8,2,6,33,0,33,3,0,3
07/02/2021,Southeast,5,GACH,1,161,133,36,97,9,4,5,20,0,20,1,0,1,161,133,36,97,9,4,5,20,0,20,1,0,1
07/02/2021,Southwest,1,CAH,1,22,12,3,9,0,0,0,4,0,4,0,0,0,22,12,3,9,0,0,0,4,0,4,0,0,0
07/02/2021,Southwest,1,GACH,1,53,45,8,37,0,0,0,4,0,4,0,0,0,53,45,8,37,0,0,0,4,0,4,0,0,0
07/03/2021,Anchorage,7,GACH,1,721,696,599,97,118,97,21,179,29,150,14,0,14,721,696,599,97,118,97,21,179,29,150,14,0,14
07/03/2021,Anchorage,7,LTACH,0,44,44,36,8,6,6,0,23,6,17,0,0,0,44,44,36,8,6,6,0,23,6,17,0,0,0
07/03/2021,Anchorage,7,Psych,0,,,,,,,,,,,,,,208,197,130,67,0,0,0,0,0,0,1,0,1
07/03/2021,Gulf Coast,4,CAH,1,80,69,23,46,4,0,4,18,0,18,0,0,0,80,69,23,46,4,0,4,18,0,18,0,0,0
07/03/2021,Gulf Coast,4,GACH,1,115,61,37,24,9,6,3,8,1,7,2,0,2,115,61,37,24,9,6,3,8,1,7,2,0,2
07/03/2021,Interior,6,GACH,1,101,81,46,35,20,12,8,16,0,16,0,0,0,101,81,46,35,20,12,8,16,0,16,0,0,0
07/03/2021,Matanuska-Susitna,3,GACH,1,184,160,72,88,14,5,9,33,2,31,1,0,1,184,160,72,88,14,5,9,33,2,31,1,0,1
07/03/2021,Northern,2,CAH,1,96,65,19,46,0,0,0,36,0,36,0,0,0,96,65,19,46,0,0,0,36,0,36,0,0,0
07/03/2021,Southeast,5,CAH,1,70,70,28,42,8,2,6,33,0,33,3,0,3,70,70,28,42,8,2,6,33,0,33,3,0,3
07/03/2021,Southeast,5,GACH,1,161,133,40,93,9,3,6,20,0,20,1,0,1,161,133,40,93,9,3,6,20,0,20,1,0,1
07/03/2021,Southwest,1,CAH,1,22,12,4,8,0,0,0,4,0,4,0,0,0,22,12,4,8,0,0,0,4,0,4,0,0,0
07/03/2021,Southwest,1,GACH,1,53,45,7,38,0,0,0,4,0,4,0,0,0,53,45,7,38,0,0,0,4,0,4,0,0,0
07/04/2021,Anchorage,7,GACH,1,726,699,591,108,120,100,20,179,30,149,16,0,16,726,699,591,108,120,100,20,179,30,149,16,0,16
07/04/2021,Anchorage,7,LTACH,0,44,44,36,8,6,6,0,23,6,17,0,0,0,44,44,36,8,6,6,0,23,6,17,0,0,0
07/04/2021,Anchorage,7,Psych,0,,,,,,,,,,,,,,208,197,130,67,0,0,0,0,0,0,1,0,1
07/04/2021,Gulf Coast,4,CAH,1,80,69,29,40,4,1,3,18,0,18,0,0,0,80,69,29,40,4,1,3,18,0,18,0,0,0
07/04/2021,Gulf Coast,4,GACH,1,115,61,39,22,9,5,4,8,0,8,1,0,1,115,61,39,22,9,5,4,8,0,8,1,0,1
07/04/2021,Interior,6,GACH,1,101,81,47,34,20,13,7,16,0,16,0,0,0,101,81,47,34,20,13,7,16,0,16,0,0,0
07/04/2021,Matanuska-Susitna,3,GACH,1,184,160,72,88,14,5,9,33,2,31,1,0,1,184,160,72,88,14,5,9,33,2,31,1,0,1
07/04/2021,Northern,2,CAH,1,96,65,18,47,0,0,0,36,0,36,0,0,0,96,65,18,47,0,0,0,36,0,36,0,0,0
07/04/2021,Southeast,5,CAH,1,70,70,22,48,8,2,6,33,0,33,3,0,3,70,70,22,48,8,2,6,33,0,33,3,0,3
07/04/2021,Southeast,5,GACH,1,161,133,37,96,9,2,7,20,0,20,1,0,1,161,133,37,96,9,2,7,20,0,20,1,0,1
07/04/2021,Southwest,1,CAH,1,22,12,1,11,0,0,0,4,0,4,0,0,0,22,12,1,11,0,0,0,4,0,4,0,0,0
07/04/2021,Southwest,1,GACH,1,53,45,7,38,0,0,0,4,0,4,0,0,0,53,45,7,38,0,0,0,4,0,4,0,0,0
07/05/2021,Anchorage,7,GACH,1,710,686,580,106,116,95,21,179,28,151,21,0,21,710,686,580,106,116,95,21,179,28,151,21,0,21
07/05/2021,Anchorage,7,LTACH,0,44,44,36,8,6,6,0,23,3,20,0,0,0,44,44,36,8,6,6,0,23,3,20,0,0,0
07/05/2021,Anchorage,7,Psych,0,,,,,,,,,,,,,,208,197,130,67,0,0,0,0,0,0,1,0,1
07/05/2021,Gulf Coast,4,CAH,1,80,69,28,41,4,2,2,18,0,18,0,0,0,80,69,28,41,4,2,2,18,0,18,0,0,0
07/05/2021,Gulf Coast,4,GACH,1,115,61,35,26,9,6,3,8,0,8,0,0,0,115,61,35,26,9,6,3,8,0,8,0,0,0
07/05/2021,Interior,6,GACH,1,101,81,38,43,20,11,9,16,0,16,0,0,0,101,81,38,43,20,11,9,16,0,16,0,0,0
07/05/2021,Matanuska-Susitna,3,GACH,1,184,160,72,88,14,5,9,33,2,31,1,0,1,184,160,72,88,14,5,9,33,2,31,1,0,1
07/05/2021,Northern,2,CAH,1,96,65,16,49,0,0,0,36,0,36,0,0,0,96,65,16,49,0,0,0,36,0,36,0,0,0
07/05/2021,Southeast,5,CAH,1,70,70,23,47,8,2,6,33,0,33,3,0,3,70,70,23,47,8,2,6,33,0,33,3,0,3
07/05/2021,Southeast,5,GACH,1,161,133,41,92,9,4,5,20,0,20,1,0,1,161,133,41,92,9,4,5,20,0,20,1,0,1
07/05/2021,Southwest,1,CAH,1,22,12,2,10,0,0,0,4,0,4,0,0,0,22,12,2,10,0,0,0,4,0,4,0,0,0
07/05/2021,Southwest,1,GACH,1,53,45,7,38,0,0,0,4,0,4,0,0,0,53,45,7,38,0,0,0,4,0,4,0,0,0
07/06/2021,Anchorage,7,GACH,1,693,669,552,117,109,85,24,179,29,150,18,0,18,693,669,552,117,109,85,24,179,29,150,18,0,18
07/06/2021,Anchorage,7,LTACH,0,44,44,36,8,6,6,0,23,3,20,0,0,0,44,44,36,8,6,6,0,23,3,20,0,0,0
07/06/2021,Anchorage,7,Psych,0,,,,,,,,,,,,,,208,197,130,67,0,0,0,0,0,0,1,0,1
07/06/2021,Gulf Coast,4,CAH,1,80,70,31,39,4,1,3,18,0,18,0,0,0,80,70,31,39,4,1,3,18,0,18,0,0,0
07/06/2021,Gulf Coast,4,GACH,1,115,61,34,27,9,7,2,8,0,8,0,0,0,115,61,34,27,9,7,2,8,0,8,0,0,0
07/06/2021,Interior,6,GACH,1,101,81,41,40,20,12,8,16,2,14,0,0,0,101,81,41,40,20,12,8,16,2,14,0,0,0
07/06/2021,Matanuska-Susitna,3,GACH,1,184,160,72,88,14,5,9,33,2,31,1,0,1,184,160,72,88,14,5,9,33,2,31,1,0,1
07/06/2021,Northern,2,CAH,1,96,65,16,49,0,0,0,36,0,36,0,0,0,96,65,16,49,0,0,0,36,0,36,0,0,0
07/06/2021,Southeast,5,CAH,1,70,70,23,47,8,1,7,33,0,33,0,0,0,70,70,23,47,8,1,7,33,0,33,0,0,0
07/06/2021,Southeast,5,GACH,1,161,133,45,88,9,2,7,20,0,20,2,0,2,161,133,45,88,9,2,7,20,0,20,2,0,2
07/06/2021,Southwest,1,CAH,1,22,12,4,8,0,0,0,4,0,4,0,0,0,22,12,4,8,0,0,0,4,0,4,0,0,0
07/06/2021,Southwest,1,GACH,1,53,45,9,36,0,0,0,4,0,4,0,0,0,53,45,9,36,0,0,0,4,0,4,0,0,0
07/07/2021,Anchorage,7,GACH,1,702,675,562,113,120,98,22,179,28,151,23,0,23,702,675,562,113,120,98,22,179,28,151,23,0,23
07/07/2021,Anchorage,7,LTACH,0,44,44,37,7,6,6,0,23,4,19,0,0,0,44,44,37,7,6,6,0,23,4,19,0,0,0
07/07/2021,Anchorage,7,Psych,0,208,199,128,71,0,0,0,0,0,0,1,0,1,208,199,128,71,0,0,0,0,0,0,1,0,1
07/07/2021,Gulf Coast,4,CAH,1,80,69,25,44,4,3,1,18,0,18,0,0,0,80,69,25,44,4,3,1,18,0,18,0,0,0
07/07/2021,Gulf Coast,4,GACH,1,115,61,35,26,9,5,4,8,0,8,0,0,0,115,61,35,26,9,5,4,8,0,8,0,0,0
07/07/2021,Interior,6,GACH,1,101,81,42,39,20,10,10,16,2,14,0,0,0,101,81,42,39,20,10,10,16,2,14,0,0,0
07/07/2021,Matanuska-Susitna,3,GACH,1,184,160,72,88,14,5,9,33,2,31,1,0,1,184,160,72,88,14,5,9,33,2,31,1,0,1
07/07/2021,Northern,2,CAH,1,96,65,20,45,0,0,0,36,0,36,0,0,0,96,65,20,45,0,0,0,36,0,36,0,0,0
07/07/2021,Southeast,5,CAH,1,70,70,26,44,8,0,8,33,0,33,2,0,2,70,70,26,44,8,0,8,33,0,33,2,0,2
07/07/2021,Southeast,5,GACH,1,161,133,41,92,9,3,6,20,0,20,1,0,1,161,133,41,92,9,3,6,20,0,20,1,0,1
07/07/2021,Southwest,1,CAH,1,22,12,4,8,0,0,0,4,0,4,0,0,0,22,12,4,8,0,0,0,4,0,4,0,0,0
07/07/2021,Southwest,1,GACH,1,53,45,9,36,0,0,0,4,0,4,1,0,1,53,45,9,36,0,0,0,4,0,4,1,0,1
07/08/2021,Anchorage,7,GACH,1,720,691,580,111,118,94,24,179,31,148,22,0,22,720,691,580,111,118,94,24,179,31,148,22,0,22
07/08/2021,Anchorage,7,LTACH,0,44,44,37,7,6,6,0,23,4,19,0,0,0,44,44,37,7,6,6,0,23,4,19,0,0,0
07/08/2021,Anchorage,7,Psych,0,,,,,,,,,,,,,,208,199,128,71,0,0,0,0,0,0,1,0,1
07/08/2021,Gulf Coast,4,CAH,1,80,70,28,42,4,2,2,18,0,18,0,0,0,80,70,28,42,4,2,2,18,0,18,0,0,0
07/08/2021,Gulf Coast,4,GACH,1,115,61,37,24,9,4,5,8,0,8,0,0,0,115,61,37,24,9,4,5,8,0,8,0,0,0
07/08/2021,Interior,6,GACH,1,101,81,42,39,20,10,10,16,2,14,0,0,0,101,81,42,39,20,10,10,16,2,14,0,0,0
07/08/2021,Matanuska-Susitna,3,GACH,1,184,160,72,88,14,5,9,33,2,31,1,0,1,184,160,72,88,14,5,9,33,2,31,1,0,1
07/08/2021,Northern,2,CAH,1,96,65,23,42,0,0,0,36,0,36,0,0,0,96,65,23,42,0,0,0,36,0,36,0,0,0
07/08/2021,Southeast,5,CAH,1,70,70,31,39,8,0,8,33,0,33,6,0,6,70,70,31,39,8,0,8,33,0,33,6,0,6
07/08/2021,Southeast,5,GACH,1,161,133,41,92,9,3,6,20,0,20,1,0,1,161,133,41,92,9,3,6,20,0,20,1,0,1
07/08/2021,Southwest,1,CAH,1,22,12,4,8,0,0,0,4,0,4,0,0,0,22,12,4,8,0,0,0,4,0,4,0,0,0
07/08/2021,Southwest,1,GACH,1,53,45,6,39,0,0,0,4,0,4,1,0,1,53,45,6,39,0,0,0,4,0,4,1,0,1
07/09/2021,Anchorage,7,GACH,1,722,686,593,93,123,100,23,179,32,147,23,0,23,722,686,593,93,123,100,23,179,32,147,23,0,23
07/09/2021,Anchorage,7,LTACH,0,44,44,33,11,6,4,2,23,4,19,0,0,0,44,44,33,11,6,4,2,23,4,19,0,0,0
07/09/2021,Anchorage,7,Psych,0,,,,,,,,,,,,,,208,199,128,71,0,0,0,0,0,0,1,0,1
07/09/2021,Gulf Coast,4,CAH,1,80,69,21,48,4,2,2,18,0,18,1,0,1,80,69,21,48,4,2,2,18,0,18,1,0,1
07/09/2021,Gulf Coast,4,GACH,1,115,61,37,24,9,5,4,8,0,8,1,0,1,115,61,37,24,9,5,4,8,0,8,1,0,1
07/09/2021,Interior,6,GACH,1,101,81,39,42,20,12,8,16,4,12,0,0,0,101,81,39,42,20,12,8,16,4,12,0,0,0
07/09/2021,Matanuska-Susitna,3,GACH,1,184,160,73,87,14,8,6,33,2,31,0,0,0,184,160,73,87,14,8,6,33,2,31,0,0,0
07/09/2021,Northern,2,CAH,1,96,65,25,40,0,0,0,36,0,36,0,0,0,96,65,25,40,0,0,0,36,0,36,0,0,0
07/09/2021,Southeast,5,CAH,1,70,70,30,40,8,0,8,33,0,33,7,0,7,70,70,30,40,8,0,8,33,0,33,7,0,7
07/09/2021,Southeast,5,GACH,1,161,133,35,98,9,5,4,20,0,20,0,0,0,161,133,35,98,9,5,4,20,0,20,0,0,0
07/09/2021,Southwest,1,CAH,1,22,12,4,8,0,0,0,4,0,4,0,0,0,22,12,4,8,0,0,0,4,0,4,0,0,0
07/09/2021,Southwest,1,GACH,1,53,45,6,39,0,0,0,4,0,4,1,0,1,53,45,6,39,0,0,0,4,0,4,1,0,1
07/10/2021,Anchorage,7,GACH,1,726,694,595,99,120,100,20,179,31,148,21,1,22,726,694,595,99,120,100,20,179,31,148,21,1,22
07/10/2021,Anchorage,7,LTACH,0,44,44,31,13,6,4,2,23,3,20,0,0,0,44,44,31,13,6,4,2,23,3,20,0,0,0
07/10/2021,Anchorage,7,Psych,0,,,,,,,,,,,,,,208,199,128,71,0,0,0,0,0,0,1,0,1
07/10/2021,Gulf Coast,4,CAH,1,81,72,29,43,4,2,2,18,0,18,3,0,3,81,72,29,43,4,2,2,18,0,18,3,0,3
07/10/2021,Gulf Coast,4,GACH,1,115,61,37,24,9,5,4,8,1,7,3,0,3,115,61,37,24,9,5,4,8,1,7,3,0,3
07/10/2021,Interior,6,GACH,1,101,81,47,34,20,13,7,16,3,13,2,0,2,101,81,47,34,20,13,7,16,3,13,2,0,2
07/10/2021,Matanuska-Susitna,3,GACH,1,184,160,73,87,14,10,4,33,1,32,0,0,0,184,160,73,87,14,10,4,33,1,32,0,0,0
07/10/2021,Northern,2,CAH,1,96,65,25,40,0,0,0,36,0,36,0,0,0,96,65,25,40,0,0,0,36,0,36,0,0,0
07/10/2021,Southeast,5,CAH,1,70,70,31,39,8,0,8,33,0,33,7,0,7,70,70,31,39,8,0,8,33,0,33,7,0,7
07/10/2021,Southeast,5,GACH,1,161,133,47,86,9,4,5,20,0,20,0,0,0,161,133,47,86,9,4,5,20,0,20,0,0,0
07/10/2021,Southwest,1,CAH,1,22,12,3,9,0,0,0,4,0,4,0,0,0,22,12,3,9,0,0,0,4,0,4,0,0,0
07/10/2021,Southwest,1,GACH,1,53,45,8,37,0,0,0,4,0,4,1,0,1,53,45,8,37,0,0,0,4,0,4,1,0,1
07/11/2021,Anchorage,7,GACH,1,718,682,592,90,124,106,18,179,32,147,29,1,30,718,682,592,90,124,106,18,179,32,147,29,1,30
07/11/2021,Anchorage,7,LTACH,0,44,44,31,13,6,4,2,23,3,20,0,0,0,44,44,31,13,6,4,2,23,3,20,0,0,0
07/11/2021,Anchorage,7,Psych,0,,,,,,,,,,,,,,208,199,128,71,0,0,0,0,0,0,1,0,1
07/11/2021,Gulf Coast,4,CAH,1,82,71,27,44,4,2,2,18,0,18,2,0,2,82,71,27,44,4,2,2,18,0,18,2,0,2
07/11/2021,Gulf Coast,4,GACH,1,115,61,35,26,9,6,3,8,1,7,4,0,4,115,61,35,26,9,6,3,8,1,7,4,0,4
07/11/2021,Interior,6,GACH,1,101,81,36,45,20,15,5,16,3,13,2,0,2,101,81,36,45,20,15,5,16,3,13,2,0,2
07/11/2021,Matanuska-Susitna,3,GACH,1,184,160,71,89,14,5,9,33,0,33,0,0,0,184,160,71,89,14,5,9,33,0,33,0,0,0
07/11/2021,Northern,2,CAH,1,96,65,26,39,0,0,0,36,0,36,0,0,0,96,65,26,39,0,0,0,36,0,36,0,0,0
07/11/2021,Southeast,5,CAH,1,70,70,29,41,8,0,8,33,0,33,6,0,6,70,70,29,41,8,0,8,33,0,33,6,0,6
07/11/2021,Southeast,5,GACH,1,161,133,49,84,9,2,7,20,0,20,0,0,0,161,133,49,84,9,2,7,20,0,20,0,0,0
07/11/2021,Southwest,1,CAH,1,22,12,3,9,0,0,0,4,0,4,0,0,0,22,12,3,9,0,0,0,4,0,4,0,0,0
07/11/2021,Southwest,1,GACH,1,53,45,6,39,0,0,0,4,0,4,1,0,1,53,45,6,39,0,0,0,4,0,4,1,0,1
07/12/2021,Anchorage,7,GACH,1,716,682,585,97,125,104,21,179,10,169,30,1,31,716,682,585,97,125,104,21,179,10,169,30,1,31
07/12/2021,Anchorage,7,LTACH,0,44,44,30,14,6,4,2,23,3,20,0,0,0,44,44,30,14,6,4,2,23,3,20,0,0,0
07/12/2021,Anchorage,7,Psych,0,,,,,,,,,,,,,,208,199,128,71,0,0,0,0,0,0,1,0,1
07/12/2021,Gulf Coast,4,CAH,1,82,73,28,45,4,2,2,18,0,18,2,0,2,82,73,28,45,4,2,2,18,0,18,2,0,2
07/12/2021,Gulf Coast,4,GACH,1,115,61,39,22,9,5,4,8,1,7,3,0,3,115,61,39,22,9,5,4,8,1,7,3,0,3
07/12/2021,Interior,6,GACH,1,101,81,43,38,20,11,9,16,3,13,2,0,2,101,81,43,38,20,11,9,16,3,13,2,0,2
07/12/2021,Matanuska-Susitna,3,GACH,1,184,160,74,86,14,4,10,33,0,33,0,0,0,184,160,74,86,14,4,10,33,0,33,0,0,0
07/12/2021,Northern,2,CAH,1,96,65,29,36,0,0,0,36,0,36,0,0,0,96,65,29,36,0,0,0,36,0,36,0,0,0
07/12/2021,Southeast,5,CAH,1,70,70,32,38,8,3,5,33,0,33,3,0,3,70,70,32,38,8,3,5,33,0,33,3,0,3
07/12/2021,Southeast,5,GACH,1,161,133,47,86,9,3,6,20,0,20,0,0,0,161,133,47,86,9,3,6,20,0,20,0,0,0
07/12/2021,Southwest,1,CAH,1,22,12,1,11,0,0,0,4,0,4,0,0,0,22,12,1,11,0,0,0,4,0,4,0,0,0
07/12/2021,Southwest,1,GACH,1,53,45,5,40,0,0,0,4,0,4,1,0,1,53,45,5,40,0,0,0,4,0,4,1,0,1
07/13/2021,Anchorage,7,GACH,1,754,725,621,104,126,105,21,179,33,146,40,0,40,754,725,621,104,126,105,21,179,33,146,40,0,40
07/13/2021,Anchorage,7,LTACH,0,44,44,33,11,6,4,2,23,3,20,0,0,0,44,44,33,11,6,4,2,23,3,20,0,0,0
07/13/2021,Anchorage,7,Psych,0,,,,,,,,,,,,,,208,199,128,71,0,0,0,0,0,0,1,0,1
07/13/2021,Gulf Coast,4,CAH,1,82,71,30,41,4,2,2,18,0,18,2,0,2,82,71,30,41,4,2,2,18,0,18,2,0,2
07/13/2021,Gulf Coast,4,GACH,1,115,61,40,21,9,7,2,8,1,7,3,0,3,115,61,40,21,9,7,2,8,1,7,3,0,3
07/13/2021,Interior,6,GACH,1,101,81,46,35,20,16,4,16,2,14,1,0,1,101,81,46,35,20,16,4,16,2,14,1,0,1
07/13/2021,Matanuska-Susitna,3,GACH,1,184,160,77,83,14,7,7,33,0,33,1,0,1,184,160,77,83,14,7,7,33,0,33,1,0,1
07/13/2021,Northern,2,CAH,1,96,65,28,37,0,0,0,36,0,36,0,0,0,96,65,28,37,0,0,0,36,0,36,0,0,0
07/13/2021,Southeast,5,CAH,1,70,70,34,36,8,2,6,33,0,33,6,0,6,70,70,34,36,8,2,6,33,0,33,6,0,6
07/13/2021,Southeast,5,GACH,1,161,133,48,85,9,4,5,20,0,20,0,0,0,161,133,48,85,9,4,5,20,0,20,0,0,0
07/13/2021,Southwest,1,CAH,1,22,12,1,11,0,0,0,4,0,4,0,0,0,22,12,1,11,0,0,0,4,0,4,0,0,0
07/13/2021,Southwest,1,GACH,1,53,45,9,36,0,0,0,4,0,4,2,0,2,53,45,9,36,0,0,0,4,0,4,2,0,2
07/14/2021,Anchorage,7,GACH,1,729,698,606,92,125,104,21,179,33,146,40,0,40,729,698,606,92,125,104,21,179,33,146,40,0,40
07/14/2021,Anchorage,7,LTACH,0,44,44,33,11,6,4,2,23,3,20,0,0,0,44,44,33,11,6,4,2,23,3,20,0,0,0
07/14/2021,Anchorage,7,Psych,0,208,196,124,72,0,0,0,0,0,0,0,0,0,208,196,124,72,0,0,0,0,0,0,0,0,0
07/14/2021,Gulf Coast,4,CAH,1,82,71,29,42,4,2,2,18,1,17,2,0,2,82,71,29,42,4,2,2,18,1,17,2,0,2
07/14/2021,Gulf Coast,4,GACH,1,115,61,39,22,9,6,3,8,1,7,2,0,2,115,61,39,22,9,6,3,8,1,7,2,0,2
07/14/2021,Interior,6,GACH,1,101,81,50,31,20,19,1,16,3,13,1,0,1,101,81,50,31,20,19,1,16,3,13,1,0,1
07/14/2021,Matanuska-Susitna,3,GACH,1,184,160,63,97,14,7,7,33,0,33,1,0,1,184,160,63,97,14,7,7,33,0,33,1,0,1
07/14/2021,Northern,2,CAH,1,96,65,21,44,0,0,0,36,0,36,0,0,0,96,65,21,44,0,0,0,36,0,36,0,0,0
07/14/2021,Southeast,5,CAH,1,70,70,35,35,8,1,7,33,0,33,6,0,6,70,70,35,35,8,1,7,33,0,33,6,0,6
07/14/2021,Southeast,5,GACH,1,161,133,48,85,9,4,5,20,0,20,1,0,1,161,133,48,85,9,4,5,20,0,20,1,0,1
07/14/2021,Southwest,1,CAH,1,22,12,2,10,0,0,0,4,0,4,0,0,0,22,12,2,10,0,0,0,4,0,4,0,0,0
07/14/2021,Southwest,1,GACH,1,53,45,12,33,0,0,0,4,0,4,2,0,2,53,45,12,33,0,0,0,4,0,4,2,0,2
07/15/2021,Anchorage,7,GACH,1,737,707,626,81,122,102,20,179,33,146,44,0,44,737,707,626,81,122,102,20,179,33,146,44,0,44
07/15/2021,Anchorage,7,LTACH,0,44,44,36,8,6,4,2,23,3,20,0,0,0,44,44,36,8,6,4,2,23,3,20,0,0,0
07/15/2021,Anchorage,7,Psych,0,,,,,,,,,,,,,,208,196,124,72,0,0,0,0,0,0,0,0,0
07/15/2021,Gulf Coast,4,CAH,1,82,71,28,43,4,1,3,18,0,18,1,0,1,82,71,28,43,4,1,3,18,0,18,1,0,1
07/15/2021,Gulf Coast,4,GACH,1,115,61,44,17,9,6,3,8,1,7,3,0,3,115,61,44,17,9,6,3,8,1,7,3,0,3
07/15/2021,Interior,6,GACH,1,101,81,55,26,20,12,8,16,2,14,0,0,0,101,81,55,26,20,12,8,16,2,14,0,0,0
07/15/2021,Matanuska-Susitna,3,GACH,1,184,160,65,95,14,7,7,33,2,31,3,0,3,184,160,65,95,14,7,7,33,2,31,3,0,3
07/15/2021,Northern,2,CAH,1,96,65,19,46,0,0,0,36,0,36,0,0,0,96,65,19,46,0,0,0,36,0,36,0,0,0
07/15/2021,Southeast,5,CAH,1,70,70,28,42,8,2,6,33,0,33,4,0,4,70,70,28,42,8,2,6,33,0,33,4,0,4
07/15/2021,Southeast,5,GACH,1,161,133,42,91,9,3,6,20,0,20,1,0,1,161,133,42,91,9,3,6,20,0,20,1,0,1
07/15/2021,Southwest,1,CAH,1,22,12,1,11,0,0,0,4,0,4,0,0,0,22,12,1,11,0,0,0,4,0,4,0,0,0
07/15/2021,Southwest,1,GACH,1,53,45,14,31,0,0,0,4,0,4,2,0,2,53,45,14,31,0,0,0,4,0,4,2,0,2
07/16/2021,Anchorage,7,GACH,1,732,703,634,69,121,102,19,179,31,148,47,1,48,732,703,634,69,121,102,19,179,31,148,47,1,48
07/16/2021,Anchorage,7,LTACH,0,44,44,34,10,6,4,2,23,3,20,0,0,0,44,44,34,10,6,4,2,23,3,20,0,0,0
07/16/2021,Anchorage,7,Psych,0,,,,,,,,,,,,,,208,196,124,72,0,0,0,0,0,0,0,0,0
07/16/2021,Gulf Coast,4,CAH,1,82,71,27,44,4,1,3,18,0,18,1,0,1,82,71,27,44,4,1,3,18,0,18,1,0,1
07/16/2021,Gulf Coast,4,GACH,1,115,61,44,17,9,4,5,8,1,7,3,0,3,115,61,44,17,9,4,5,8,1,7,3,0,3
07/16/2021,Interior,6,GACH,1,101,81,62,19,20,12,8,16,1,15,0,0,0,101,81,62,19,20,12,8,16,1,15,0,0,0
07/16/2021,Matanuska-Susitna,3,GACH,1,184,160,67,93,14,7,7,33,3,30,2,0,2,184,160,67,93,14,7,7,33,3,30,2,0,2
07/16/2021,Northern,2,CAH,1,96,65,21,44,0,0,0,36,0,36,0,0,0,96,65,21,44,0,0,0,36,0,36,0,0,0
07/16/2021,Southeast,5,CAH,1,70,70,30,40,8,2,6,33,0,33,7,0,7,70,70,30,40,8,2,6,33,0,33,7,0,7
07/16/2021,Southeast,5,GACH,1,161,133,46,87,9,3,6,20,0,20,1,0,1,161,133,46,87,9,3,6,20,0,20,1,0,1
07/16/2021,Southwest,1,CAH,1,22,12,1,11,0,0,0,4,0,4,0,0,0,22,12,1,11,0,0,0,4,0,4,0,0,0
07/16/2021,Southwest,1,GACH,1,53,45,13,32,0,0,0,4,0,4,1,0,1,53,45,13,32,0,0,0,4,0,4,1,0,1
07/17/2021,Anchorage,7,GACH,1,728,701,627,74,121,101,20,179,32,147,46,1,47,728,701,627,74,121,101,20,179,32,147,46,1,47
07/17/2021,Anchorage,7,LTACH,0,44,44,35,9,6,4,2,23,3,20,0,0,0,44,44,35,9,6,4,2,23,3,20,0,0,0
07/17/2021,Anchorage,7,Psych,0,,,,,,,,,,,,,,208,196,124,72,0,0,0,0,0,0,0,0,0
07/17/2021,Gulf Coast,4,CAH,1,82,72,31,41,4,0,4,18,0,18,1,0,1,82,72,31,41,4,0,4,18,0,18,1,0,1
07/17/2021,Gulf Coast,4,GACH,1,115,61,39,22,9,7,2,8,1,7,4,0,4,115,61,39,22,9,7,2,8,1,7,4,0,4
07/17/2021,Interior,6,GACH,1,101,81,39,42,20,13,7,16,1,15,1,0,1,101,81,39,42,20,13,7,16,1,15,1,0,1
07/17/2021,Matanuska-Susitna,3,GACH,1,184,160,63,97,14,6,8,33,0,33,2,0,2,184,160,63,97,14,6,8,33,0,33,2,0,2
07/17/2021,Northern,2,CAH,1,96,65,29,36,0,0,0,36,0,36,0,0,0,96,65,29,36,0,0,0,36,0,36,0,0,0
07/17/2021,Southeast,5,CAH,1,70,70,24,46,8,2,6,33,0,33,3,0,3,70,70,24,46,8,2,6,33,0,33,3,0,3
07/17/2021,Southeast,5,GACH,1,161,133,44,89,9,4,5,20,0,20,1,0,1,161,133,44,89,9,4,5,20,0,20,1,0,1
07/17/2021,Southwest,1,CAH,1,22,12,2,10,0,0,0,4,0,4,0,0,0,22,12,2,10,0,0,0,4,0,4,0,0,0
07/17/2021,Southwest,1,GACH,1,53,45,9,36,0,0,0,4,0,4,1,0,1,53,45,9,36,0,0,0,4,0,4,1,0,1
07/18/2021,Anchorage,7,GACH,1,736,711,622,89,121,103,18,179,44,135,46,1,47,736,711,622,89,121,103,18,179,44,135,46,1,47
07/18/2021,Anchorage,7,LTACH,0,44,44,33,11,6,4,2,23,3,20,0,0,0,44,44,33,11,6,4,2,23,3,20,0,0,0
07/18/2021,Anchorage,7,Psych,0,,,,,,,,,,,,,,208,196,124,72,0,0,0,0,0,0,0,0,0
07/18/2021,Gulf Coast,4,CAH,1,82,72,30,42,4,0,4,18,0,18,1,0,1,82,72,30,42,4,0,4,18,0,18,1,0,1
07/18/2021,Gulf Coast,4,GACH,1,115,61,42,19,9,8,1,8,1,7,4,0,4,115,61,42,19,9,8,1,8,1,7,4,0,4
07/18/2021,Interior,6,GACH,1,101,81,43,38,20,14,6,16,2,14,1,0,1,101,81,43,38,20,14,6,16,2,14,1,0,1
07/18/2021,Matanuska-Susitna,3,GACH,1,184,160,64,96,14,6,8,33,1,32,2,0,2,184,160,64,96,14,6,8,33,1,32,2,0,2
07/18/2021,Northern,2,CAH,1,96,65,28,37,0,0,0,36,0,36,0,0,0,96,65,28,37,0,0,0,36,0,36,0,0,0
07/18/2021,Southeast,5,CAH,1,70,70,23,47,8,2,6,33,0,33,2,0,2,70,70,23,47,8,2,6,33,0,33,2,0,2
07/18/2021,Southeast,5,GACH,1,161,133,46,87,9,3,6,20,0,20,2,0,2,161,133,46,87,9,3,6,20,0,20,2,0,2
07/18/2021,Southwest,1,CAH,1,22,12,4,8,0,0,0,4,0,4,0,0,0,22,12,4,8,0,0,0,4,0,4,0,0,0
07/18/2021,Southwest,1,GACH,1,53,45,13,32,0,0,0,4,0,4,2,0,2,53,45,13,32,0,0,0,4,0,4,2,0,2
07/19/2021,Anchorage,7,GACH,1,756,730,641,89,129,108,21,179,51,128,49,0,49,756,730,641,89,129,108,21,179,51,128,49,0,49
07/19/2021,Anchorage,7,LTACH,0,44,44,34,10,6,4,2,23,1,22,0,0,0,44,44,34,10,6,4,2,23,1,22,0,0,0
07/19/2021,Anchorage,7,Psych,0,,,,,,,,,,,,,,208,196,124,72,0,0,0,0,0,0,0,0,0
07/19/2021,Gulf Coast,4,CAH,1,82,70,28,42,4,0,4,18,0,18,2,0,2,82,70,28,42,4,0,4,18,0,18,2,0,2
07/19/2021,Gulf Coast,4,GACH,1,115,61,40,21,9,7,2,8,1,7,3,0,3,115,61,40,21,9,7,2,8,1,7,3,0,3
07/19/2021,Interior,6,GACH,1,101,81,37,44,20,18,2,16,0,16,1,0,1,101,81,37,44,20,18,2,16,0,16,1,0,1
07/19/2021,Matanuska-Susitna,3,GACH,1,184,160,62,98,14,6,8,33,1,32,3,0,3,184,160,62,98,14,6,8,33,1,32,3,0,3
07/19/2021,Northern,2,CAH,1,96,65,23,42,0,0,0,36,0,36,0,0,0,96,65,23,42,0,0,0,36,0,36,0,0,0
07/19/2021,Southeast,5,CAH,1,70,70,26,44,8,2,6,33,0,33,3,0,3,70,70,26,44,8,2,6,33,0,33,3,0,3
07/19/2021,Southeast,5,GACH,1,161,133,46,87,9,3,6,20,0,20,1,0,1,161,133,46,87,9,3,6,20,0,20,1,0,1
07/19/2021,Southwest,1,CAH,1,22,12,2,10,0,0,0,4,0,4,0,0,0,22,12,2,10,0,0,0,4,0,4,0,0,0
07/19/2021,Southwest,1,GACH,1,53,45,14,31,0,0,0,4,0,4,2,0,2,53,45,14,31,0,0,0,4,0,4,2,0,2
07/20/2021,Anchorage,7,GACH,1,758,729,663,66,125,111,14,178,51,127,56,0,56,758,729,663,66,125,111,14,178,51,127,56,0,56
07/20/2021,Anchorage,7,LTACH,0,44,44,33,11,6,4,2,23,1,22,0,0,0,44,44,33,11,6,4,2,23,1,22,0,0,0
07/20/2021,Anchorage,7,Psych,0,,,,,,,,,,,,,,208,196,124,72,0,0,0,0,0,0,0,0,0
07/20/2021,Gulf Coast,4,CAH,1,83,71,25,46,4,1,3,18,0,18,3,0,3,83,71,25,46,4,1,3,18,0,18,3,0,3
07/20/2021,Gulf Coast,4,GACH,1,115,61,57,4,9,9,0,8,1,7,4,0,4,115,61,57,4,9,9,0,8,1,7,4,0,4
07/20/2021,Interior,6,GACH,1,101,81,47,34,20,17,3,16,1,15,2,0,2,101,81,47,34,20,17,3,16,1,15,2,0,2
07/20/2021,Matanuska-Susitna,3,GACH,1,184,160,79,81,14,8,6,33,1,32,4,0,4,184,160,79,81,14,8,6,33,1,32,4,0,4
07/20/2021,Northern,2,CAH,1,96,65,19,46,0,0,0,36,0,36,0,0,0,96,65,19,46,0,0,0,36,0,36,0,0,0
07/20/2021,Southeast,5,CAH,1,70,70,26,44,8,3,5,33,0,33,3,0,3,70,70,26,44,8,3,5,33,0,33,3,0,3
07/20/2021,Southeast,5,GACH,1,161,133,42,91,9,2,7,20,0,20,0,0,0,161,133,42,91,9,2,7,20,0,20,0,0,0
07/20/2021,Southwest,1,CAH,1,22,12,2,10,0,0,0,4,0,4,0,0,0,22,12,2,10,0,0,0,4,0,4,0,0,0
07/20/2021,Southwest,1,GACH,1,53,45,13,32,0,0,0,4,0,4,2,0,2,53,45,13,32,0,0,0,4,0,4,2,0,2
07/21/2021,Anchorage,7,GACH,1,751,713,654,59,121,103,18,178,48,130,48,1,49,751,713,654,59,121,103,18,178,48,130,48,1,49
07/21/2021,Anchorage,7,LTACH,0,44,44,34,10,6,4,2,23,1,22,0,0,0,44,44,34,10,6,4,2,23,1,22,0,0,0
07/21/2021,Anchorage,7,Psych,0,220,206,144,62,0,0,0,0,0,0,0,0,0,220,206,144,62,0,0,0,0,0,0,0,0,0
07/21/2021,Gulf Coast,4,CAH,1,82,70,26,44,4,1,3,18,0,18,4,0,4,82,70,26,44,4,1,3,18,0,18,4,0,4
07/21/2021,Gulf Coast,4,GACH,1,115,61,54,7,9,9,0,8,1,7,5,0,5,115,61,54,7,9,9,0,8,1,7,5,0,5
07/21/2021,Interior,6,GACH,1,101,81,65,16,20,17,3,16,0,16,2,0,2,101,81,65,16,20,17,3,16,0,16,2,0,2
07/21/2021,Matanuska-Susitna,3,GACH,1,184,160,76,84,14,5,9,33,2,31,4,0,4,184,160,76,84,14,5,9,33,2,31,4,0,4
07/21/2021,Northern,2,CAH,1,96,65,24,41,0,0,0,36,0,36,0,0,0,96,65,24,41,0,0,0,36,0,36,0,0,0
07/21/2021,Southeast,5,CAH,1,70,70,31,39,8,4,4,33,0,33,4,0,4,70,70,31,39,8,4,4,33,0,33,4,0,4
07/21/2021,Southeast,5,GACH,1,161,133,41,92,9,5,4,20,0,20,0,0,0,161,133,41,92,9,5,4,20,0,20,0,0,0
07/21/2021,Southwest,1,CAH,1,22,12,3,9,0,0,0,4,0,4,0,0,0,22,12,3,9,0,0,0,4,0,4,0,0,0
07/21/2021,Southwest,1,GACH,1,53,45,13,32,0,0,0,4,0,4,2,0,2,53,45,13,32,0,0,0,4,0,4,2,0,2
07/22/2021,Anchorage,7,GACH,1,755,723,657,66,122,105,17,178,51,127,54,1,55,755,723,657,66,122,105,17,178,51,127,54,1,55
07/22/2021,Anchorage,7,LTACH,0,44,44,33,11,6,3,3,23,1,22,0,0,0,44,44,33,11,6,3,3,23,1,22,0,0,0
07/22/2021,Anchorage,7,Psych,0,,,,,,,,,,,,,,220,206,144,62,0,0,0,0,0,0,0,0,0
07/22/2021,Gulf Coast,4,CAH,1,82,70,25,45,4,2,2,18,0,18,4,0,4,82,70,25,45,4,2,2,18,0,18,4,0,4
07/22/2021,Gulf Coast,4,GACH,1,115,61,50,11,9,8,1,8,1,7,6,0,6,115,61,50,11,9,8,1,8,1,7,6,0,6
07/22/2021,Interior,6,GACH,1,101,81,55,26,20,17,3,16,0,16,3,0,3,101,81,55,26,20,17,3,16,0,16,3,0,3
07/22/2021,Matanuska-Susitna,3,GACH,1,184,160,70,90,14,8,6,33,3,30,8,0,8,184,160,70,90,14,8,6,33,3,30,8,0,8
07/22/2021,Northern,2,CAH,1,96,65,21,44,0,0,0,36,0,36,0,0,0,96,65,21,44,0,0,0,36,0,36,0,0,0
07/22/2021,Southeast,5,CAH,1,70,70,28,42,8,4,4,33,0,33,6,0,6,70,70,28,42,8,4,4,33,0,33,6,0,6
07/22/2021,Southeast,5,GACH,1,161,133,41,92,9,5,4,20,0,20,0,0,0,161,133,41,92,9,5,4,20,0,20,0,0,0
07/22/2021,Southwest,1,CAH,1,22,12,3,9,0,0,0,4,0,4,0,0,0,22,12,3,9,0,0,0,4,0,4,0,0,0
07/22/2021,Southwest,1,GACH,1,53,45,10,35,0,0,0,4,0,4,1,0,1,53,45,10,35,0,0,0,4,0,4,1,0,1
07/23/2021,Anchorage,7,GACH,1,754,721,654,67,129,110,19,178,53,125,62,0,62,754,721,654,67,129,110,19,178,53,125,62,0,62
07/23/2021,Anchorage,7,LTACH,0,44,44,33,11,6,3,3,23,1,22,0,0,0,44,44,33,11,6,3,3,23,1,22,0,0,0
07/23/2021,Anchorage,7,Psych,0,,,,,,,,,,,,,,220,206,144,62,0,0,0,0,0,0,0,0,0
07/23/2021,Gulf Coast,4,CAH,1,80,69,22,47,4,1,3,18,0,18,5,0,5,80,69,22,47,4,1,3,18,0,18,5,0,5
07/23/2021,Gulf Coast,4,GACH,1,115,61,43,18,9,7,2,8,3,5,8,0,8,115,61,43,18,9,7,2,8,3,5,8,0,8
07/23/2021,Interior,6,GACH,1,101,81,55,26,20,17,3,16,0,16,3,0,3,101,81,55,26,20,17,3,16,0,16,3,0,3
07/23/2021,Matanuska-Susitna,3,GACH,1,184,160,82,78,14,11,3,33,4,29,8,0,8,184,160,82,78,14,11,3,33,4,29,8,0,8
07/23/2021,Northern,2,CAH,1,96,65,15,50,0,0,0,36,0,36,0,0,0,96,65,15,50,0,0,0,36,0,36,0,0,0
07/23/2021,Southeast,5,CAH,1,70,70,25,45,8,4,4,33,0,33,5,0,5,70,70,25,45,8,4,4,33,0,33,5,0,5
07/23/2021,Southeast,5,GACH,1,161,133,47,86,9,6,3,20,0,20,1,0,1,161,133,47,86,9,6,3,20,0,20,1,0,1
07/23/2021,Southwest,1,CAH,1,22,12,3,9,0,0,0,4,0,4,0,0,0,22,12,3,9,0,0,0,4,0,4,0,0,0
07/23/2021,Southwest,1,GACH,1,53,45,11,34,0,0,0,4,0,4,1,0,1,53,45,11,34,0,0,0,4,0,4,1,0,1
07/24/2021,Anchorage,7,GACH,1,737,708,631,77,126,107,19,170,52,118,63,0,63,737,708,631,77,126,107,19,170,52,118,63,0,63
07/24/2021,Anchorage,7,LTACH,0,44,44,34,10,6,3,3,23,1,22,0,0,0,44,44,34,10,6,3,3,23,1,22,0,0,0
07/24/2021,Anchorage,7,Psych,0,,,,,,,,,,,,,,220,206,144,62,0,0,0,0,0,0,0,0,0
07/24/2021,Gulf Coast,4,CAH,1,80,69,21,48,4,0,4,18,0,18,4,0,4,80,69,21,48,4,0,4,18,0,18,4,0,4
07/24/2021,Gulf Coast,4,GACH,1,115,61,42,19,9,8,1,8,3,5,9,0,9,115,61,42,19,9,8,1,8,3,5,9,0,9
07/24/2021,Interior,6,GACH,1,101,81,44,37,20,14,6,16,1,15,3,0,3,101,81,44,37,20,14,6,16,1,15,3,0,3
07/24/2021,Matanuska-Susitna,3,GACH,1,184,160,84,76,14,11,3,33,5,28,9,0,9,184,160,84,76,14,11,3,33,5,28,9,0,9
07/24/2021,Northern,2,CAH,1,96,65,18,47,0,0,0,36,0,36,0,0,0,96,65,18,47,0,0,0,36,0,36,0,0,0
07/24/2021,Southeast,5,CAH,1,70,70,30,40,8,5,3,33,0,33,8,0,8,70,70,30,40,8,5,3,33,0,33,8,0,8
07/24/2021,Southeast,5,GACH,1,161,133,46,87,9,3,6,20,0,20,1,0,1,161,133,46,87,9,3,6,20,0,20,1,0,1
07/24/2021,Southwest,1,CAH,1,22,12,3,9,0,0,0,4,0,4,0,0,0,22,12,3,9,0,0,0,4,0,4,0,0,0
07/24/2021,Southwest,1,GACH,1,53,45,14,31,0,0,0,4,0,4,1,0,1,53,45,14,31,0,0,0,4,0,4,1,0,1
07/25/2021,Anchorage,7,GACH,1,706,679,593,86,117,96,21,171,47,124,59,1,60,706,679,593,86,117,96,21,171,47,124,59,1,60
07/25/2021,Anchorage,7,LTACH,0,44,44,33,11,6,3,3,23,1,22,0,0,0,44,44,33,11,6,3,3,23,1,22,0,0,0
07/25/2021,Anchorage,7,Psych,0,,,,,,,,,,,,,,220,206,144,62,0,0,0,0,0,0,0,0,0
07/25/2021,Gulf Coast,4,CAH,1,80,69,22,47,4,0,4,18,0,18,4,0,4,80,69,22,47,4,0,4,18,0,18,4,0,4
07/25/2021,Gulf Coast,4,GACH,1,115,61,46,15,9,9,0,8,2,6,11,0,11,115,61,46,15,9,9,0,8,2,6,11,0,11
07/25/2021,Interior,6,GACH,1,101,81,42,39,20,13,7,16,2,14,4,0,4,101,81,42,39,20,13,7,16,2,14,4,0,4
07/25/2021,Matanuska-Susitna,3,GACH,1,184,160,78,82,14,8,6,33,5,28,7,0,7,184,160,78,82,14,8,6,33,5,28,7,0,7
07/25/2021,Northern,2,CAH,1,96,65,23,42,0,0,0,36,0,36,0,0,0,96,65,23,42,0,0,0,36,0,36,0,0,0
07/25/2021,Southeast,5,CAH,1,70,70,32,38,8,6,2,33,0,33,9,0,9,70,70,32,38,8,6,2,33,0,33,9,0,9
07/25/2021,Southeast,5,GACH,1,161,133,43,90,9,4,5,20,0,20,1,0,1,161,133,43,90,9,4,5,20,0,20,1,0,1
07/25/2021,Southwest,1,CAH,1,22,12,3,9,0,0,0,4,0,4,0,0,0,22,12,3,9,0,0,0,4,0,4,0,0,0
07/25/2021,Southwest,1,GACH,1,53,45,12,33,0,0,0,4,0,4,1,0,1,53,45,12,33,0,0,0,4,0,4,1,0,1
07/26/2021,Anchorage,7,GACH,1,710,680,581,99,117,97,20,171,45,126,59,0,59,710,680,581,99,117,97,20,171,45,126,59,0,59
07/26/2021,Anchorage,7,LTACH,0,44,44,33,11,6,3,3,23,1,22,0,0,0,44,44,33,11,6,3,3,23,1,22,0,0,0
07/26/2021,Anchorage,7,Psych,0,,,,,,,,,,,,,,220,206,144,62,0,0,0,0,0,0,0,0,0
07/26/2021,Gulf Coast,4,CAH,1,84,71,26,45,4,1,3,18,0,18,5,0,5,84,71,26,45,4,1,3,18,0,18,5,0,5
07/26/2021,Gulf Coast,4,GACH,1,115,61,41,20,9,9,0,11,2,9,11,0,11,115,61,41,20,9,9,0,11,2,9,11,0,11
07/26/2021,Interior,6,GACH,1,101,81,40,41,20,15,5,16,3,13,4,0,4,101,81,40,41,20,15,5,16,3,13,4,0,4
07/26/2021,Matanuska-Susitna,3,GACH,1,184,160,83,77,14,12,2,33,4,29,6,0,6,184,160,83,77,14,12,2,33,4,29,6,0,6
07/26/2021,Northern,2,CAH,1,96,65,17,48,0,0,0,36,0,36,0,0,0,96,65,17,48,0,0,0,36,0,36,0,0,0
07/26/2021,Southeast,5,CAH,1,70,70,33,37,8,2,6,33,1,32,8,0,8,70,70,33,37,8,2,6,33,1,32,8,0,8
07/26/2021,Southeast,5,GACH,1,161,133,42,91,9,6,3,20,0,20,2,0,2,161,133,42,91,9,6,3,20,0,20,2,0,2
07/26/2021,Southwest,1,CAH,1,22,12,3,9,0,0,0,4,0,4,0,0,0,22,12,3,9,0,0,0,4,0,4,0,0,0
07/26/2021,Southwest,1,GACH,1,53,45,16,29,0,0,0,4,0,4,1,0,1,53,45,16,29,0,0,0,4,0,4,1,0,1
07/27/2021,Anchorage,7,GACH,1,719,692,595,97,111,90,21,171,46,125,60,0,60,719,692,595,97,111,90,21,171,46,125,60,0,60
07/27/2021,Anchorage,7,LTACH,0,44,44,34,10,6,3,3,23,1,22,1,0,1,44,44,34,10,6,3,3,23,1,22,1,0,1
07/27/2021,Anchorage,7,Psych,0,,,,,,,,,,,,,,220,206,144,62,0,0,0,0,0,0,0,0,0
07/27/2021,Gulf Coast,4,CAH,1,85,72,23,49,4,0,4,18,0,18,4,0,4,85,72,23,49,4,0,4,18,0,18,4,0,4
07/27/2021,Gulf Coast,4,GACH,1,115,61,44,17,9,8,1,11,1,10,12,0,12,115,61,44,17,9,8,1,11,1,10,12,0,12
07/27/2021,Interior,6,GACH,1,101,81,40,41,20,15,5,16,3,13,4,0,4,101,81,40,41,20,15,5,16,3,13,4,0,4
07/27/2021,Matanuska-Susitna,3,GACH,1,184,160,87,73,14,10,4,33,2,31,3,0,3,184,160,87,73,14,10,4,33,2,31,3,0,3
07/27/2021,Northern,2,CAH,1,96,65,18,47,0,0,0,36,0,36,0,0,0,96,65,18,47,0,0,0,36,0,36,0,0,0
07/27/2021,Southeast,5,CAH,1,70,70,31,39,8,1,7,33,0,33,9,0,9,70,70,31,39,8,1,7,33,0,33,9,0,9
07/27/2021,Southeast,5,GACH,1,161,133,42,91,9,6,3,20,0,20,2,0,2,161,133,42,91,9,6,3,20,0,20,2,0,2
07/27/2021,Southwest,1,CAH,1,22,12,4,8,0,0,0,4,0,4,0,0,0,22,12,4,8,0,0,0,4,0,4,0,0,0
07/27/2021,Southwest,1,GACH,1,53,45,14,31,0,0,0,4,0,4,1,0,1,53,45,14,31,0,0,0,4,0,4,1,0,1
07/28/2021,Anchorage,7,GACH,1,725,698,617,81,119,101,18,171,49,122,57,0,57,725,698,617,81,119,101,18,171,49,122,57,0,57
07/28/2021,Anchorage,7,LTACH,0,44,44,36,8,6,3,3,23,1,22,1,0,1,44,44,36,8,6,3,3,23,1,22,1,0,1
07/28/2021,Anchorage,7,Psych,0,140,140,75,65,0,0,0,0,0,0,1,0,1,220,206,141,65,0,0,0,0,0,0,1,0,1
07/28/2021,Gulf Coast,4,CAH,1,84,71,25,46,4,1,3,18,0,18,5,0,5,84,71,25,46,4,1,3,18,0,18,5,0,5
07/28/2021,Gulf Coast,4,GACH,1,115,61,47,14,9,9,0,11,1,10,12,0,12,115,61,47,14,9,9,0,11,1,10,12,0,12
07/28/2021,Interior,6,GACH,1,101,81,49,32,20,16,4,16,3,13,5,0,5,101,81,49,32,20,16,4,16,3,13,5,0,5
07/28/2021,Matanuska-Susitna,3,GACH,1,184,160,79,81,14,11,3,33,0,33,4,0,4,184,160,79,81,14,11,3,33,0,33,4,0,4
07/28/2021,Northern,2,CAH,1,96,71,31,40,0,0,0,36,0,36,0,0,0,96,71,31,40,0,0,0,36,0,36,0,0,0
07/28/2021,Southeast,5,CAH,1,70,70,34,36,8,0,8,33,0,33,13,0,13,70,70,34,36,8,0,8,33,0,33,13,0,13
07/28/2021,Southeast,5,GACH,1,161,133,42,91,9,6,3,20,0,20,2,0,2,161,133,42,91,9,6,3,20,0,20,2,0,2
07/28/2021,Southwest,1,CAH,1,22,12,5,7,0,0,0,4,0,4,0,0,0,22,12,5,7,0,0,0,4,0,4,0,0,0
07/28/2021,Southwest,1,GACH,1,53,45,15,30,0,0,0,4,0,4,2,0,2,53,45,15,30,0,0,0,4,0,4,2,0,2
07/29/2021,Anchorage,7,GACH,1,739,710,638,72,112,97,15,171,45,126,62,0,62,739,710,638,72,112,97,15,171,45,126,62,0,62
07/29/2021,Anchorage,7,LTACH,0,44,44,37,7,6,3,3,23,2,21,1,0,1,44,44,37,7,6,3,3,23,2,21,1,0,1
07/29/2021,Anchorage,7,Psych,0,,,,,,,,,,,,,,220,206,141,65,0,0,0,0,0,0,1,0,1
07/29/2021,Gulf Coast,4,CAH,1,84,71,24,47,4,1,3,18,0,18,7,0,7,84,71,24,47,4,1,3,18,0,18,7,0,7
07/29/2021,Gulf Coast,4,GACH,1,115,61,50,11,9,9,0,11,1,10,15,0,15,115,61,50,11,9,9,0,11,1,10,15,0,15
07/29/2021,Interior,6,GACH,1,101,81,62,19,20,14,6,16,3,13,6,0,6,101,81,62,19,20,14,6,16,3,13,6,0,6
07/29/2021,Matanuska-Susitna,3,GACH,1,184,160,82,78,14,11,3,33,1,32,2,0,2,184,160,82,78,14,11,3,33,1,32,2,0,2
07/29/2021,Northern,2,CAH,1,96,66,29,37,0,0,0,36,0,36,0,0,0,96,66,29,37,0,0,0,36,0,36,0,0,0
07/29/2021,Southeast,5,CAH,1,70,72,41,31,8,2,6,33,0,33,9,0,9,70,72,41,31,8,2,6,33,0,33,9,0,9
07/29/2021,Southeast,5,GACH,1,161,133,41,92,9,6,3,20,0,20,3,0,3,161,133,41,92,9,6,3,20,0,20,3,0,3
07/29/2021,Southwest,1,CAH,1,22,12,4,8,0,0,0,4,0,4,0,0,0,22,12,4,8,0,0,0,4,0,4,0,0,0
07/29/2021,Southwest,1,GACH,1,53,45,10,35,0,0,0,4,0,4,2,0,2,53,45,10,35,0,0,0,4,0,4,2,0,2
07/30/2021,Anchorage,7,GACH,1,711,683,625,58,120,108,12,178,60,118,62,2,64,711,683,625,58,120,108,12,178,60,118,62,2,64
07/30/2021,Anchorage,7,LTACH,0,44,44,39,5,6,3,3,23,2,21,0,0,0,44,44,39,5,6,3,3,23,2,21,0,0,0
07/30/2021,Anchorage,7,Psych,0,,,,,,,,,,,,,,220,206,141,65,0,0,0,0,0,0,1,0,1
07/30/2021,Gulf Coast,4,CAH,1,84,71,29,42,4,1,3,18,0,18,6,0,6,84,71,29,42,4,1,3,18,0,18,6,0,6
07/30/2021,Gulf Coast,4,GACH,1,115,61,48,13,9,9,0,11,1,10,14,1,15,115,61,48,13,9,9,0,11,1,10,14,1,15
07/30/2021,Interior,6,GACH,1,101,81,58,23,20,13,7,16,3,13,6,0,6,101,81,58,23,20,13,7,16,3,13,6,0,6
07/30/2021,Matanuska-Susitna,3,GACH,1,184,160,82,78,14,13,1,33,3,30,6,0,6,184,160,82,78,14,13,1,33,3,30,6,0,6
07/30/2021,Northern,2,CAH,1,96,65,25,40,0,0,0,36,0,36,0,0,0,96,65,25,40,0,0,0,36,0,36,0,0,0
07/30/2021,Southeast,5,CAH,1,70,70,36,34,8,0,8,33,0,33,6,0,6,70,70,36,34,8,0,8,33,0,33,6,0,6
07/30/2021,Southeast,5,GACH,1,161,133,40,93,9,5,4,20,0,20,3,0,3,161,133,40,93,9,5,4,20,0,20,3,0,3
07/30/2021,Southwest,1,CAH,1,22,12,2,10,0,0,0,4,0,4,0,0,0,22,12,2,10,0,0,0,4,0,4,0,0,0
07/30/2021,Southwest,1,GACH,1,53,45,11,34,0,0,0,4,0,4,3,0,3,53,45,11,34,0,0,0,4,0,4,3,0,3
07/31/2021,Anchorage,7,GACH,1,695,666,598,68,116,105,11,203,62,141,59,1,60,695,666,598,68,116,105,11,203,62,141,59,1,60
07/31/2021,Anchorage,7,LTACH,0,44,44,38,6,6,4,2,23,3,20,1,0,1,44,44,38,6,6,4,2,23,3,20,1,0,1
07/31/2021,Anchorage,7,Psych,0,,,,,,,,,,,,,,220,206,141,65,0,0,0,0,0,0,1,0,1
07/31/2021,Gulf Coast,4,CAH,1,85,72,22,50,4,0,4,18,0,18,6,1,7,85,72,22,50,4,0,4,18,0,18,6,1,7
07/31/2021,Gulf Coast,4,GACH,1,115,61,54,7,9,9,0,11,2,9,14,0,14,115,61,54,7,9,9,0,11,2,9,14,0,14
07/31/2021,Interior,6,GACH,1,101,81,50,31,20,9,11,16,0,16,5,0,5,101,81,50,31,20,9,11,16,0,16,5,0,5
07/31/2021,Matanuska-Susitna,3,GACH,1,184,160,63,97,14,8,6,33,2,31,5,0,5,184,160,63,97,14,8,6,33,2,31,5,0,5
07/31/2021,Northern,2,CAH,1,96,66,24,42,0,0,0,36,0,36,0,0,0,96,66,24,42,0,0,0,36,0,36,0,0,0
07/31/2021,Southeast,5,CAH,1,70,70,35,35,8,0,8,33,0,33,9,0,9,70,70,35,35,8,0,8,33,0,33,9,0,9
07/31/2021,Southeast,5,GACH,1,161,133,33,100,9,4,5,20,0,20,3,0,3,161,133,33,100,9,4,5,20,0,20,3,0,3
07/31/2021,Southwest,1,CAH,1,22,12,2,10,0,0,0,4,0,4,0,0,0,22,12,2,10,0,0,0,4,0,4,0,0,0
07/31/2021,Southwest,1,GACH,1,53,45,7,38,0,0,0,4,0,4,2,0,2,53,45,7,38,0,0,0,4,0,4,2,0,2
08/01/2021,Anchorage,7,GACH,1,695,666,597,69,117,104,13,204,59,145,62,1,63,695,666,597,69,117,104,13,204,59,145,62,1,63
08/01/2021,Anchorage,7,LTACH,0,44,44,38,6,6,4,2,23,4,19,1,0,1,44,44,38,6,6,4,2,23,4,19,1,0,1
08/01/2021,Anchorage,7,Psych,0,,,,,,,,,,,,,,220,206,141,65,0,0,0,0,0,0,1,0,1
08/01/2021,Gulf Coast,4,CAH,1,84,71,29,42,4,1,3,18,0,18,8,0,8,84,71,29,42,4,1,3,18,0,18,8,0,8
08/01/2021,Gulf Coast,4,GACH,1,93,60,43,17,9,8,1,11,2,9,12,0,12,93,60,43,17,9,8,1,11,2,9,12,0,12
08/01/2021,Interior,6,GACH,1,101,81,52,29,20,9,11,16,0,16,4,0,4,101,81,52,29,20,9,11,16,0,16,4,0,4
08/01/2021,Matanuska-Susitna,3,GACH,1,184,160,68,92,14,6,8,33,2,31,4,0,4,184,160,68,92,14,6,8,33,2,31,4,0,4
08/01/2021,Northern,2,CAH,1,96,65,24,41,0,0,0,36,0,36,0,0,0,96,65,24,41,0,0,0,36,0,36,0,0,0
08/01/2021,Southeast,5,CAH,1,70,70,34,36,8,0,8,33,0,33,9,0,9,70,70,34,36,8,0,8,33,0,33,9,0,9
08/01/2021,Southeast,5,GACH,1,161,133,35,98,9,4,5,20,0,20,3,0,3,161,133,35,98,9,4,5,20,0,20,3,0,3
08/01/2021,Southwest,1,CAH,1,22,12,3,9,0,0,0,4,0,4,0,0,0,22,12,3,9,0,0,0,4,0,4,0,0,0
08/01/2021,Southwest,1,GACH,1,53,45,6,39,0,0,0,4,0,4,2,0,2,53,45,6,39,0,0,0,4,0,4,2,0,2
08/02/2021,Anchorage,7,GACH,1,707,676,585,91,114,98,16,204,60,144,59,1,60,707,676,585,91,114,98,16,204,60,144,59,1,60
08/02/2021,Anchorage,7,LTACH,0,44,44,39,5,6,4,2,23,3,20,1,0,1,44,44,39,5,6,4,2,23,3,20,1,0,1
08/02/2021,Anchorage,7,Psych,0,,,,,,,,,,,,,,220,206,141,65,0,0,0,0,0,0,1,0,1
08/02/2021,Gulf Coast,4,CAH,1,84,71,27,44,4,1,3,18,0,18,8,0,8,84,71,27,44,4,1,3,18,0,18,8,0,8
08/02/2021,Gulf Coast,4,GACH,1,93,60,40,20,9,6,3,11,3,8,10,0,10,93,60,40,20,9,6,3,11,3,8,10,0,10
08/02/2021,Interior,6,GACH,1,101,81,56,25,20,8,12,16,0,16,4,0,4,101,81,56,25,20,8,12,16,0,16,4,0,4
08/02/2021,Matanuska-Susitna,3,GACH,1,184,160,59,101,14,5,9,33,2,31,3,0,3,184,160,59,101,14,5,9,33,2,31,3,0,3
08/02/2021,Northern,2,CAH,1,96,65,25,40,0,0,0,36,0,36,0,0,0,96,65,25,40,0,0,0,36,0,36,0,0,0
08/02/2021,Southeast,5,CAH,1,70,70,40,30,8,1,7,33,0,33,11,0,11,70,70,40,30,8,1,7,33,0,33,11,0,11
08/02/2021,Southeast,5,GACH,1,161,133,32,101,9,3,6,20,0,20,1,0,1,161,133,32,101,9,3,6,20,0,20,1,0,1
08/02/2021,Southwest,1,CAH,1,22,12,3,9,0,0,0,4,0,4,0,0,0,22,12,3,9,0,0,0,4,0,4,0,0,0
08/02/2021,Southwest,1,GACH,1,53,45,7,38,0,0,0,4,0,4,2,0,2,53,45,7,38,0,0,0,4,0,4,2,0,2
08/03/2021,Anchorage,7,GACH,1,724,693,589,104,121,110,11,204,61,143,59,0,59,724,693,589,104,121,110,11,204,61,143,59,0,59
08/03/2021,Anchorage,7,LTACH,0,44,44,39,5,6,6,0,23,3,20,1,0,1,44,44,39,5,6,6,0,23,3,20,1,0,1
08/03/2021,Anchorage,7,Psych,0,,,,,,,,,,,,,,220,206,141,65,0,0,0,0,0,0,1,0,1
08/03/2021,Gulf Coast,4,CAH,1,85,72,27,45,4,0,4,18,0,18,6,0,6,85,72,27,45,4,0,4,18,0,18,6,0,6
08/03/2021,Gulf Coast,4,GACH,1,93,60,47,13,9,6,3,11,3,8,11,0,11,93,60,47,13,9,6,3,11,3,8,11,0,11
08/03/2021,Interior,6,GACH,1,101,81,59,22,20,8,12,16,0,16,4,0,4,101,81,59,22,20,8,12,16,0,16,4,0,4
08/03/2021,Matanuska-Susitna,3,GACH,1,184,160,82,78,14,7,7,33,3,30,9,0,9,184,160,82,78,14,7,7,33,3,30,9,0,9
08/03/2021,Northern,2,CAH,1,96,65,24,41,0,0,0,36,0,36,0,0,0,96,65,24,41,0,0,0,36,0,36,0,0,0
08/03/2021,Southeast,5,CAH,1,70,70,35,35,8,0,8,33,0,33,10,0,10,70,70,35,35,8,0,8,33,0,33,10,0,10
08/03/2021,Southeast,5,GACH,1,161,133,43,90,9,4,5,20,0,20,2,0,2,161,133,43,90,9,4,5,20,0,20,2,0,2
08/03/2021,Southwest,1,CAH,1,22,12,3,9,0,0,0,4,0,4,0,0,0,22,12,3,9,0,0,0,4,0,4,0,0,0
08/03/2021,Southwest,1,GACH,1,53,45,11,34,0,0,0,4,0,4,1,0,1,53,45,11,34,0,0,0,4,0,4,1,0,1
08/04/2021,Anchorage,7,GACH,1,718,691,598,93,122,107,15,204,36,168,59,0,59,718,691,598,93,122,107,15,204,36,168,59,0,59
08/04/2021,Anchorage,7,LTACH,0,44,44,40,4,6,6,0,23,4,19,1,0,1,44,44,40,4,6,6,0,23,4,19,1,0,1
08/04/2021,Anchorage,7,Psych,0,220,201,138,63,0,0,0,0,0,0,1,0,1,220,201,138,63,0,0,0,0,0,0,1,0,1
08/04/2021,Gulf Coast,4,CAH,1,85,72,30,42,4,0,4,18,0,18,6,0,6,85,72,30,42,4,0,4,18,0,18,6,0,6
08/04/2021,Gulf Coast,4,GACH,1,93,60,45,15,9,7,2,11,2,9,10,0,10,93,60,45,15,9,7,2,11,2,9,10,0,10
08/04/2021,Interior,6,GACH,1,101,81,53,28,20,8,12,16,0,16,5,0,5,101,81,53,28,20,8,12,16,0,16,5,0,5
08/04/2021,Matanuska-Susitna,3,GACH,1,184,160,78,82,14,9,5,33,3,30,10,0,10,184,160,78,82,14,9,5,33,3,30,10,0,10
08/04/2021,Northern,2,CAH,1,96,65,25,40,0,0,0,36,0,36,0,0,0,96,65,25,40,0,0,0,36,0,36,0,0,0
08/04/2021,Southeast,5,CAH,1,70,70,30,40,8,0,8,33,0,33,5,0,5,70,70,30,40,8,0,8,33,0,33,5,0,5
08/04/2021,Southeast,5,GACH,1,161,133,48,85,9,3,6,20,0,20,4,0,4,161,133,48,85,9,3,6,20,0,20,4,0,4
08/04/2021,Southwest,1,CAH,1,22,12,4,8,0,0,0,4,0,4,0,0,0,22,12,4,8,0,0,0,4,0,4,0,0,0
08/04/2021,Southwest,1,GACH,1,53,45,9,36,0,0,0,4,0,4,1,0,1,53,45,9,36,0,0,0,4,0,4,1,0,1
08/05/2021,Anchorage,7,GACH,1,744,720,629,91,120,110,10,204,55,149,58,0,58,744,720,629,91,120,110,10,204,55,149,58,0,58
08/05/2021,Anchorage,7,LTACH,0,44,44,40,4,6,6,0,23,5,18,0,0,0,44,44,40,4,6,6,0,23,5,18,0,0,0
08/05/2021,Anchorage,7,Psych,0,,,,,,,,,,,,,,220,201,138,63,0,0,0,0,0,0,1,0,1
08/05/2021,Gulf Coast,4,CAH,1,84,71,28,43,4,2,2,18,0,18,4,0,4,84,71,28,43,4,2,2,18,0,18,4,0,4
08/05/2021,Gulf Coast,4,GACH,1,93,60,45,15,9,7,2,11,2,9,11,0,11,93,60,45,15,9,7,2,11,2,9,11,0,11
08/05/2021,Interior,6,GACH,1,101,81,66,15,20,13,7,16,1,15,7,0,7,101,81,66,15,20,13,7,16,1,15,7,0,7
08/05/2021,Matanuska-Susitna,3,GACH,1,184,160,92,68,14,12,2,33,6,27,12,0,12,184,160,92,68,14,12,2,33,6,27,12,0,12
08/05/2021,Northern,2,CAH,1,96,65,19,46,0,0,0,36,0,36,0,0,0,96,65,19,46,0,0,0,36,0,36,0,0,0
08/05/2021,Southeast,5,CAH,1,70,70,30,40,8,0,8,33,0,33,3,0,3,70,70,30,40,8,0,8,33,0,33,3,0,3
08/05/2021,Southeast,5,GACH,1,161,133,51,82,9,3,6,20,0,20,5,0,5,161,133,51,82,9,3,6,20,0,20,5,0,5
08/05/2021,Southwest,1,CAH,1,22,12,3,9,0,0,0,4,0,4,0,0,0,22,12,3,9,0,0,0,4,0,4,0,0,0
08/05/2021,Southwest,1,GACH,1,53,45,6,39,0,0,0,4,0,4,1,0,1,53,45,6,39,0,0,0,4,0,4,1,0,1
08/06/2021,Anchorage,7,GACH,1,715,686,609,77,119,107,12,199,53,146,56,0,56,715,686,609,77,119,107,12,199,53,146,56,0,56
08/06/2021,Anchorage,7,LTACH,0,44,44,39,5,6,6,0,23,5,18,0,0,0,44,44,39,5,6,6,0,23,5,18,0,0,0
08/06/2021,Anchorage,7,Psych,0,,,,,,,,,,,,,,220,201,138,63,0,0,0,0,0,0,1,0,1
08/06/2021,Gulf Coast,4,CAH,1,84,71,28,43,4,2,2,18,0,18,6,0,6,84,71,28,43,4,2,2,18,0,18,6,0,6
08/06/2021,Gulf Coast,4,GACH,1,93,60,47,13,9,9,0,11,2,9,11,0,11,93,60,47,13,9,9,0,11,2,9,11,0,11
08/06/2021,Interior,6,GACH,1,101,81,58,23,20,11,9,16,1,15,5,0,5,101,81,58,23,20,11,9,16,1,15,5,0,5
08/06/2021,Matanuska-Susitna,3,GACH,1,184,160,85,75,14,10,4,33,5,28,12,0,12,184,160,85,75,14,10,4,33,5,28,12,0,12
08/06/2021,Northern,2,CAH,1,96,65,21,44,0,0,0,36,0,36,0,0,0,96,65,21,44,0,0,0,36,0,36,0,0,0
08/06/2021,Southeast,5,CAH,1,70,70,33,37,8,0,8,33,0,33,3,0,3,70,70,33,37,8,0,8,33,0,33,3,0,3
08/06/2021,Southeast,5,GACH,1,161,133,46,87,9,4,5,20,0,20,4,0,4,161,133,46,87,9,4,5,20,0,20,4,0,4
08/06/2021,Southwest,1,CAH,1,22,12,3,9,0,0,0,4,0,4,0,0,0,22,12,3,9,0,0,0,4,0,4,0,0,0
08/06/2021,Southwest,1,GACH,1,53,45,5,40,0,0,0,4,0,4,0,0,0,53,45,5,40,0,0,0,4,0,4,0,0,0
08/07/2021,Anchorage,7,GACH,1,722,693,611,82,121,109,12,203,53,150,52,0,52,722,693,611,82,121,109,12,203,53,150,52,0,52
08/07/2021,Anchorage,7,LTACH,0,44,44,37,7,6,6,0,23,5,18,0,0,0,44,44,37,7,6,6,0,23,5,18,0,0,0
08/07/2021,Anchorage,7,Psych,0,,,,,,,,,,,,,,220,201,138,63,0,0,0,0,0,0,1,0,1
08/07/2021,Gulf Coast,4,CAH,1,84,71,30,41,4,2,2,18,0,18,8,0,8,84,71,30,41,4,2,2,18,0,18,8,0,8
08/07/2021,Gulf Coast,4,GACH,1,93,60,46,14,9,6,3,11,1,10,12,0,12,93,60,46,14,9,6,3,11,1,10,12,0,12
08/07/2021,Interior,6,GACH,1,101,81,59,22,20,13,7,16,1,15,8,1,9,101,81,59,22,20,13,7,16,1,15,8,1,9
08/07/2021,Matanuska-Susitna,3,GACH,1,184,160,85,75,14,13,1,33,4,29,12,0,12,184,160,85,75,14,13,1,33,4,29,12,0,12
08/07/2021,Northern,2,CAH,1,96,65,19,46,0,0,0,36,0,36,0,0,0,96,65,19,46,0,0,0,36,0,36,0,0,0
08/07/2021,Southeast,5,CAH,1,70,70,30,40,8,0,8,33,0,33,2,0,2,70,70,30,40,8,0,8,33,0,33,2,0,2
08/07/2021,Southeast,5,GACH,1,161,133,47,86,9,3,6,20,0,20,3,0,3,161,133,47,86,9,3,6,20,0,20,3,0,3
08/07/2021,Southwest,1,CAH,1,22,12,3,9,0,0,0,4,0,4,0,0,0,22,12,3,9,0,0,0,4,0,4,0,0,0
08/07/2021,Southwest,1,GACH,1,53,45,6,39,0,0,0,4,0,4,0,0,0,53,45,6,39,0,0,0,4,0,4,0,0,0
08/08/2021,Anchorage,7,GACH,1,721,692,597,95,114,104,10,203,52,151,56,0,56,721,692,597,95,114,104,10,203,52,151,56,0,56
08/08/2021,Anchorage,7,LTACH,0,44,44,37,7,6,6,0,23,5,18,0,0,0,44,44,37,7,6,6,0,23,5,18,0,0,0
08/08/2021,Anchorage,7,Psych,0,,,,,,,,,,,,,,220,201,138,63,0,0,0,0,0,0,1,0,1
08/08/2021,Gulf Coast,4,CAH,1,85,76,38,38,4,1,3,18,0,18,7,0,7,85,76,38,38,4,1,3,18,0,18,7,0,7
08/08/2021,Gulf Coast,4,GACH,1,93,60,44,16,9,9,0,11,0,11,12,0,12,93,60,44,16,9,9,0,11,0,11,12,0,12
08/08/2021,Interior,6,GACH,1,101,81,48,33,20,10,10,16,1,15,9,0,9,101,81,48,33,20,10,10,16,1,15,9,0,9
08/08/2021,Matanuska-Susitna,3,GACH,1,184,160,79,81,14,10,4,33,4,29,13,0,13,184,160,79,81,14,10,4,33,4,29,13,0,13
08/08/2021,Northern,2,CAH,1,96,65,22,43,0,0,0,36,0,36,0,0,0,96,65,22,43,0,0,0,36,0,36,0,0,0
08/08/2021,Southeast,5,CAH,1,70,70,32,38,8,0,8,33,0,33,2,0,2,70,70,32,38,8,0,8,33,0,33,2,0,2
08/08/2021,Southeast,5,GACH,1,161,133,43,90,9,3,6,20,0,20,3,0,3,161,133,43,90,9,3,6,20,0,20,3,0,3
08/08/2021,Southwest,1,CAH,1,22,12,3,9,0,0,0,4,0,4,0,0,0,22,12,3,9,0,0,0,4,0,4,0,0,0
08/08/2021,Southwest,1,GACH,1,53,45,7,38,0,0,0,4,0,4,0,0,0,53,45,7,38,0,0,0,4,0,4,0,0,0
08/09/2021,Anchorage,7,GACH,1,739,710,616,94,114,102,12,199,54,145,63,0,63,739,710,616,94,114,102,12,199,54,145,63,0,63
08/09/2021,Anchorage,7,LTACH,0,44,44,37,7,6,6,0,23,5,18,0,0,0,44,44,37,7,6,6,0,23,5,18,0,0,0
08/09/2021,Anchorage,7,Psych,0,,,,,,,,,,,,,,220,201,138,63,0,0,0,0,0,0,1,0,1
08/09/2021,Gulf Coast,4,CAH,1,84,73,27,46,4,1,3,18,0,18,6,0,6,84,73,27,46,4,1,3,18,0,18,6,0,6
08/09/2021,Gulf Coast,4,GACH,1,93,60,47,13,9,9,0,11,0,11,13,0,13,93,60,47,13,9,9,0,11,0,11,13,0,13
08/09/2021,Interior,6,GACH,1,101,81,50,31,20,14,6,16,1,15,10,0,10,101,81,50,31,20,14,6,16,1,15,10,0,10
08/09/2021,Matanuska-Susitna,3,GACH,1,184,160,95,65,14,6,8,33,2,31,11,0,11,184,160,95,65,14,6,8,33,2,31,11,0,11
08/09/2021,Northern,2,CAH,1,96,67,20,47,0,0,0,36,0,36,0,0,0,96,67,20,47,0,0,0,36,0,36,0,0,0
08/09/2021,Southeast,5,CAH,1,70,70,36,34,8,2,6,33,0,33,4,0,4,70,70,36,34,8,2,6,33,0,33,4,0,4
08/09/2021,Southeast,5,GACH,1,161,133,41,92,9,3,6,20,0,20,3,0,3,161,133,41,92,9,3,6,20,0,20,3,0,3
08/09/2021,Southwest,1,CAH,1,22,12,3,9,0,0,0,4,0,4,0,0,0,22,12,3,9,0,0,0,4,0,4,0,0,0
08/09/2021,Southwest,1,GACH,1,53,45,7,38,0,0,0,4,0,4,0,0,0,53,45,7,38,0,0,0,4,0,4,0,0,0
08/10/2021,Anchorage,7,GACH,1,747,720,628,92,122,109,13,199,54,145,65,1,66,747,720,628,92,122,109,13,199,54,145,65,1,66
08/10/2021,Anchorage,7,LTACH,0,44,44,37,7,6,6,0,23,4,19,0,0,0,44,44,37,7,6,6,0,23,4,19,0,0,0
08/10/2021,Anchorage,7,Psych,0,,,,,,,,,,,,,,220,201,138,63,0,0,0,0,0,0,1,0,1
08/10/2021,Gulf Coast,4,CAH,1,84,71,25,46,4,1,3,18,0,18,5,0,5,84,71,25,46,4,1,3,18,0,18,5,0,5
08/10/2021,Gulf Coast,4,GACH,1,93,60,50,10,9,9,0,11,0,11,12,0,12,93,60,50,10,9,9,0,11,0,11,12,0,12
08/10/2021,Interior,6,GACH,1,101,81,63,18,20,10,10,16,1,15,8,0,8,101,81,63,18,20,10,10,16,1,15,8,0,8
08/10/2021,Matanuska-Susitna,3,GACH,1,184,160,88,72,14,11,3,33,3,30,12,0,12,184,160,88,72,14,11,3,33,3,30,12,0,12
08/10/2021,Northern,2,CAH,1,96,65,28,37,0,0,0,36,0,36,2,0,2,96,65,28,37,0,0,0,36,0,36,2,0,2
08/10/2021,Southeast,5,CAH,1,70,70,42,28,8,2,6,33,0,33,4,0,4,70,70,42,28,8,2,6,33,0,33,4,0,4
08/10/2021,Southeast,5,GACH,1,161,133,41,92,9,3,6,20,0,20,2,0,2,161,133,41,92,9,3,6,20,0,20,2,0,2
08/10/2021,Southwest,1,CAH,1,22,12,3,9,0,0,0,4,0,4,0,0,0,22,12,3,9,0,0,0,4,0,4,0,0,0
08/10/2021,Southwest,1,GACH,1,53,45,7,38,0,0,0,4,0,4,0,0,0,53,45,7,38,0,0,0,4,0,4,0,0,0
08/11/2021,Anchorage,7,GACH,1,736,710,606,104,125,114,11,196,53,143,72,1,73,736,710,606,104,125,114,11,196,53,143,72,1,73
08/11/2021,Anchorage,7,LTACH,0,44,44,37,7,6,6,0,23,4,19,0,0,0,44,44,37,7,6,6,0,23,4,19,0,0,0
08/11/2021,Anchorage,7,Psych,0,220,200,138,62,0,0,0,0,0,0,0,0,0,220,200,138,62,0,0,0,0,0,0,0,0,0
08/11/2021,Gulf Coast,4,CAH,1,84,71,24,47,4,1,3,18,0,18,3,0,3,84,71,24,47,4,1,3,18,0,18,3,0,3
08/11/2021,Gulf Coast,4,GACH,1,93,60,52,8,9,9,0,11,1,10,9,0,9,93,60,52,8,9,9,0,11,1,10,9,0,9
08/11/2021,Interior,6,GACH,1,101,81,56,25,20,9,11,16,1,15,8,0,8,101,81,56,25,20,9,11,16,1,15,8,0,8
08/11/2021,Matanuska-Susitna,3,GACH,1,184,160,81,79,14,10,4,33,3,30,10,0,10,184,160,81,79,14,10,4,33,3,30,10,0,10
08/11/2021,Northern,2,CAH,1,96,65,29,36,0,0,0,36,0,36,5,0,5,96,65,29,36,0,0,0,36,0,36,5,0,5
08/11/2021,Southeast,5,CAH,1,70,70,26,44,8,3,5,33,0,33,5,0,5,70,70,26,44,8,3,5,33,0,33,5,0,5
08/11/2021,Southeast,5,GACH,1,161,133,43,90,9,3,6,20,0,20,4,0,4,161,133,43,90,9,3,6,20,0,20,4,0,4
08/11/2021,Southwest,1,CAH,1,22,12,3,9,0,0,0,4,0,4,0,0,0,22,12,3,9,0,0,0,4,0,4,0,0,0
08/11/2021,Southwest,1,GACH,1,53,45,6,39,0,0,0,4,0,4,0,0,0,53,45,6,39,0,0,0,4,0,4,0,0,0
08/12/2021,Anchorage,7,GACH,1,728,699,603,96,125,115,10,206,48,158,74,0,74,728,699,603,96,125,115,10,206,48,158,74,0,74
08/12/2021,Anchorage,7,LTACH,0,44,44,36,8,6,6,0,23,4,19,0,0,0,44,44,36,8,6,6,0,23,4,19,0,0,0
08/12/2021,Anchorage,7,Psych,0,,,,,,,,,,,,,,220,200,138,62,0,0,0,0,0,0,0,0,0
08/12/2021,Gulf Coast,4,CAH,1,84,71,28,43,4,1,3,18,0,18,4,0,4,84,71,28,43,4,1,3,18,0,18,4,0,4
08/12/2021,Gulf Coast,4,GACH,1,93,60,52,8,9,9,0,11,2,9,8,0,8,93,60,52,8,9,9,0,11,2,9,8,0,8
08/12/2021,Interior,6,GACH,1,101,81,53,28,20,13,7,16,1,15,7,0,7,101,81,53,28,20,13,7,16,1,15,7,0,7
08/12/2021,Matanuska-Susitna,3,GACH,1,184,160,73,87,14,8,6,33,2,31,10,0,10,184,160,73,87,14,8,6,33,2,31,10,0,10
08/12/2021,Northern,2,CAH,1,96,65,20,45,0,0,0,36,0,36,4,0,4,96,65,20,45,0,0,0,36,0,36,4,0,4
08/12/2021,Southeast,5,CAH,1,70,70,40,30,8,2,6,33,0,33,5,0,5,70,70,40,30,8,2,6,33,0,33,5,0,5
08/12/2021,Southeast,5,GACH,1,161,133,50,83,9,6,3,20,0,20,6,0,6,161,133,50,83,9,6,3,20,0,20,6,0,6
08/12/2021,Southwest,1,CAH,1,22,12,2,10,0,0,0,4,0,4,0,0,0,22,12,2,10,0,0,0,4,0,4,0,0,0
08/12/2021,Southwest,1,GACH,1,53,45,10,35,0,0,0,4,0,4,0,0,0,53,45,10,35,0,0,0,4,0,4,0,0,0
08/13/2021,Anchorage,7,GACH,1,736,709,624,85,126,113,13,206,44,162,72,0,72,736,709,624,85,126,113,13,206,44,162,72,0,72
08/13/2021,Anchorage,7,LTACH,0,44,44,35,9,6,6,0,23,4,19,0,0,0,44,44,35,9,6,6,0,23,4,19,0,0,0
08/13/2021,Anchorage,7,Psych,0,,,,,,,,,,,,,,220,200,138,62,0,0,0,0,0,0,0,0,0
08/13/2021,Gulf Coast,4,CAH,1,84,71,33,38,4,1,3,25,0,25,7,0,7,84,71,33,38,4,1,3,25,0,25,7,0,7
08/13/2021,Gulf Coast,4,GACH,1,93,60,48,12,9,7,2,11,2,9,7,0,7,93,60,48,12,9,7,2,11,2,9,7,0,7
08/13/2021,Interior,6,GACH,1,101,81,53,28,20,11,9,16,1,15,8,0,8,101,81,53,28,20,11,9,16,1,15,8,0,8
08/13/2021,Matanuska-Susitna,3,GACH,1,184,160,87,73,14,12,2,33,4,29,11,0,11,184,160,87,73,14,12,2,33,4,29,11,0,11
08/13/2021,Northern,2,CAH,1,96,65,17,48,0,0,0,36,0,36,1,0,1,96,65,17,48,0,0,0,36,0,36,1,0,1
08/13/2021,Southeast,5,CAH,1,70,70,37,33,8,0,8,33,0,33,2,0,2,70,70,37,33,8,0,8,33,0,33,2,0,2
08/13/2021,Southeast,5,GACH,1,161,133,45,88,9,5,4,20,0,20,6,0,6,161,133,45,88,9,5,4,20,0,20,6,0,6
08/13/2021,Southwest,1,CAH,1,22,12,2,10,0,0,0,4,0,4,0,0,0,22,12,2,10,0,0,0,4,0,4,0,0,0
08/13/2021,Southwest,1,GACH,1,53,45,13,32,0,0,0,4,0,4,0,0,0,53,45,13,32,0,0,0,4,0,4,0,0,0
08/14/2021,Anchorage,7,GACH,1,725,702,611,91,119,106,13,206,46,160,69,0,69,725,702,611,91,119,106,13,206,46,160,69,0,69
08/14/2021,Anchorage,7,LTACH,0,44,44,35,9,6,6,0,23,4,19,0,0,0,44,44,35,9,6,6,0,23,4,19,0,0,0
08/14/2021,Anchorage,7,Psych,0,,,,,,,,,,,,,,220,200,138,62,0,0,0,0,0,0,0,0,0
08/14/2021,Gulf Coast,4,CAH,1,85,72,29,43,4,1,3,25,0,25,8,0,8,85,72,29,43,4,1,3,25,0,25,8,0,8
08/14/2021,Gulf Coast,4,GACH,1,93,60,39,21,9,8,1,11,2,9,7,0,7,93,60,39,21,9,8,1,11,2,9,7,0,7
08/14/2021,Interior,6,GACH,1,101,81,62,19,20,11,9,16,1,15,9,0,9,101,81,62,19,20,11,9,16,1,15,9,0,9
08/14/2021,Matanuska-Susitna,3,GACH,1,184,160,83,77,14,8,6,33,8,25,15,0,15,184,160,83,77,14,8,6,33,8,25,15,0,15
08/14/2021,Northern,2,CAH,1,96,65,16,49,0,0,0,36,0,36,1,0,1,96,65,16,49,0,0,0,36,0,36,1,0,1
08/14/2021,Southeast,5,CAH,1,70,70,32,38,8,1,7,33,0,33,2,0,2,70,70,32,38,8,1,7,33,0,33,2,0,2
08/14/2021,Southeast,5,GACH,1,161,133,39,94,9,4,5,20,0,20,5,0,5,161,133,39,94,9,4,5,20,0,20,5,0,5
08/14/2021,Southwest,1,CAH,1,22,12,3,9,0,0,0,4,0,4,0,0,0,22,12,3,9,0,0,0,4,0,4,0,0,0
08/14/2021,Southwest,1,GACH,1,53,45,12,33,0,0,0,4,0,4,0,0,0,53,45,12,33,0,0,0,4,0,4,0,0,0
08/15/2021,Anchorage,7,GACH,1,732,703,632,71,120,105,15,200,45,155,83,0,83,732,703,632,71,120,105,15,200,45,155,83,0,83
08/15/2021,Anchorage,7,LTACH,0,44,44,35,9,6,6,0,23,4,19,0,0,0,44,44,35,9,6,6,0,23,4,19,0,0,0
08/15/2021,Anchorage,7,Psych,0,,,,,,,,,,,,,,220,200,138,62,0,0,0,0,0,0,0,0,0
08/15/2021,Gulf Coast,4,CAH,1,84,71,28,43,4,1,3,25,0,25,6,0,6,84,71,28,43,4,1,3,25,0,25,6,0,6
08/15/2021,Gulf Coast,4,GACH,1,93,60,36,24,9,7,2,11,2,9,7,0,7,93,60,36,24,9,7,2,11,2,9,7,0,7
08/15/2021,Interior,6,GACH,1,101,81,58,23,20,11,9,16,1,15,9,0,9,101,81,58,23,20,11,9,16,1,15,9,0,9
08/15/2021,Matanuska-Susitna,3,GACH,1,184,160,80,80,14,9,5,33,4,29,14,0,14,184,160,80,80,14,9,5,33,4,29,14,0,14
08/15/2021,Northern,2,CAH,1,96,65,21,44,0,0,0,36,0,36,3,0,3,96,65,21,44,0,0,0,36,0,36,3,0,3
08/15/2021,Southeast,5,CAH,1,70,70,29,41,8,0,8,33,0,33,2,0,2,70,70,29,41,8,0,8,33,0,33,2,0,2
08/15/2021,Southeast,5,GACH,1,161,133,38,95,9,4,5,20,0,20,4,0,4,161,133,38,95,9,4,5,20,0,20,4,0,4
08/15/2021,Southwest,1,CAH,1,22,12,4,8,0,0,0,4,0,4,0,0,0,22,12,4,8,0,0,0,4,0,4,0,0,0
08/15/2021,Southwest,1,GACH,1,53,45,12,33,0,0,0,4,0,4,1,0,1,53,45,12,33,0,0,0,4,0,4,1,0,1
08/16/2021,Anchorage,7,GACH,1,719,694,621,73,124,110,14,200,45,155,76,0,76,719,694,621,73,124,110,14,200,45,155,76,0,76
08/16/2021,Anchorage,7,LTACH,0,44,44,35,9,6,6,0,23,4,19,0,0,0,44,44,35,9,6,6,0,23,4,19,0,0,0
08/16/2021,Anchorage,7,Psych,0,,,,,,,,,,,,,,220,200,138,62,0,0,0,0,0,0,0,0,0
08/16/2021,Gulf Coast,4,CAH,1,84,71,28,43,4,1,3,25,0,25,8,0,8,84,71,28,43,4,1,3,25,0,25,8,0,8
08/16/2021,Gulf Coast,4,GACH,1,93,60,37,23,9,8,1,11,3,8,9,0,9,93,60,37,23,9,8,1,11,3,8,9,0,9
08/16/2021,Interior,6,GACH,1,101,81,42,39,20,12,8,16,1,15,8,0,8,101,81,42,39,20,12,8,16,1,15,8,0,8
08/16/2021,Matanuska-Susitna,3,GACH,1,184,160,86,74,14,10,4,33,5,28,17,0,17,184,160,86,74,14,10,4,33,5,28,17,0,17
08/16/2021,Northern,2,CAH,1,96,65,22,43,0,0,0,36,0,36,3,0,3,96,65,22,43,0,0,0,36,0,36,3,0,3
08/16/2021,Southeast,5,CAH,1,70,70,25,45,8,2,6,33,0,33,4,0,4,70,70,25,45,8,2,6,33,0,33,4,0,4
08/16/2021,Southeast,5,GACH,1,161,133,32,101,9,3,6,20,1,19,2,0,2,161,133,32,101,9,3,6,20,1,19,2,0,2
08/16/2021,Southwest,1,CAH,1,22,12,3,9,0,0,0,4,0,4,0,0,0,22,12,3,9,0,0,0,4,0,4,0,0,0
08/16/2021,Southwest,1,GACH,1,53,45,15,30,0,0,0,4,0,4,2,0,2,53,45,15,30,0,0,0,4,0,4,2,0,2
08/17/2021,Anchorage,7,GACH,1,717,684,609,75,120,106,14,205,48,157,71,0,71,717,684,609,75,120,106,14,205,48,157,71,0,71
08/17/2021,Anchorage,7,LTACH,0,44,44,37,7,6,6,0,23,2,21,0,0,0,44,44,37,7,6,6,0,23,2,21,0,0,0
08/17/2021,Anchorage,7,Psych,0,,,,,,,,,,,,,,220,200,138,62,0,0,0,0,0,0,0,0,0
08/17/2021,Gulf Coast,4,CAH,1,84,71,31,40,4,2,2,25,0,25,8,0,8,84,71,31,40,4,2,2,25,0,25,8,0,8
08/17/2021,Gulf Coast,4,GACH,1,93,60,48,12,9,8,1,11,5,6,14,0,14,93,60,48,12,9,8,1,11,5,6,14,0,14
08/17/2021,Interior,6,GACH,1,101,81,41,40,20,11,9,16,1,15,7,0,7,101,81,41,40,20,11,9,16,1,15,7,0,7
08/17/2021,Matanuska-Susitna,3,GACH,1,184,160,79,81,14,12,2,33,7,26,15,0,15,184,160,79,81,14,12,2,33,7,26,15,0,15
08/17/2021,Northern,2,CAH,1,96,65,19,46,0,0,0,36,0,36,4,0,4,96,65,19,46,0,0,0,36,0,36,4,0,4
08/17/2021,Southeast,5,CAH,1,70,70,34,36,8,2,6,33,0,33,2,0,2,70,70,34,36,8,2,6,33,0,33,2,0,2
08/17/2021,Southeast,5,GACH,1,161,133,33,100,9,2,7,20,0,20,1,0,1,161,133,33,100,9,2,7,20,0,20,1,0,1
08/17/2021,Southwest,1,CAH,1,22,12,3,9,0,0,0,4,0,4,0,0,0,22,12,3,9,0,0,0,4,0,4,0,0,0
08/17/2021,Southwest,1,GACH,1,53,45,19,26,0,0,0,4,0,4,2,0,2,53,45,19,26,0,0,0,4,0,4,2,0,2
08/18/2021,Anchorage,7,GACH,1,716,688,624,64,116,102,14,205,48,157,70,0,70,716,688,624,64,116,102,14,205,48,157,70,0,70
08/18/2021,Anchorage,7,LTACH,0,44,44,37,7,6,6,0,23,2,21,0,0,0,44,44,37,7,6,6,0,23,2,21,0,0,0
08/18/2021,Anchorage,7,Psych,0,220,203,129,74,0,0,0,0,0,0,0,0,0,220,203,129,74,0,0,0,0,0,0,0,0,0
08/18/2021,Gulf Coast,4,CAH,1,84,71,28,43,4,1,3,25,0,25,7,0,7,84,71,28,43,4,1,3,25,0,25,7,0,7
08/18/2021,Gulf Coast,4,GACH,1,93,60,41,19,9,8,1,11,5,6,12,0,12,93,60,41,19,9,8,1,11,5,6,12,0,12
08/18/2021,Interior,6,GACH,1,101,81,51,30,20,14,6,16,3,13,7,0,7,101,81,51,30,20,14,6,16,3,13,7,0,7
08/18/2021,Matanuska-Susitna,3,GACH,1,184,160,88,72,14,12,2,33,8,25,14,0,14,184,160,88,72,14,12,2,33,8,25,14,0,14
08/18/2021,Northern,2,CAH,1,96,65,22,43,0,0,0,36,0,36,5,0,5,96,65,22,43,0,0,0,36,0,36,5,0,5
08/18/2021,Southeast,5,CAH,1,70,70,31,39,8,4,4,33,0,33,3,0,3,70,70,31,39,8,4,4,33,0,33,3,0,3
08/18/2021,Southeast,5,GACH,1,161,133,34,99,9,5,4,20,1,19,3,0,3,161,133,34,99,9,5,4,20,1,19,3,0,3
08/18/2021,Southwest,1,CAH,1,22,12,1,11,0,0,0,4,0,4,0,0,0,22,12,1,11,0,0,0,4,0,4,0,0,0
08/18/2021,Southwest,1,GACH,1,53,45,17,28,0,0,0,4,0,4,1,0,1,53,45,17,28,0,0,0,4,0,4,1,0,1
08/19/2021,Anchorage,7,GACH,1,719,693,625,68,117,103,14,200,50,150,69,0,69,719,693,625,68,117,103,14,200,50,150,69,0,69
08/19/2021,Anchorage,7,LTACH,0,44,44,36,8,6,6,0,23,2,21,0,0,0,44,44,36,8,6,6,0,23,2,21,0,0,0
08/19/2021,Anchorage,7,Psych,0,140,140,70,70,0,0,0,0,0,0,0,0,0,220,203,133,70,0,0,0,0,0,0,0,0,0
08/19/2021,Gulf Coast,4,CAH,1,84,71,25,46,4,1,3,25,0,25,8,0,8,84,71,25,46,4,1,3,25,0,25,8,0,8
08/19/2021,Gulf Coast,4,GACH,1,93,60,43,17,9,8,1,11,5,6,10,0,10,93,60,43,17,9,8,1,11,5,6,10,0,10
08/19/2021,Interior,6,GACH,1,101,81,53,28,20,11,9,16,2,14,8,0,8,101,81,53,28,20,11,9,16,2,14,8,0,8
08/19/2021,Matanuska-Susitna,3,GACH,1,184,160,86,74,14,14,0,33,9,24,16,0,16,184,160,86,74,14,14,0,33,9,24,16,0,16
08/19/2021,Northern,2,CAH,1,96,65,27,38,0,0,0,36,0,36,4,0,4,96,65,27,38,0,0,0,36,0,36,4,0,4
08/19/2021,Southeast,5,CAH,1,70,70,34,36,8,3,5,33,0,33,4,0,4,70,70,34,36,8,3,5,33,0,33,4,0,4
08/19/2021,Southeast,5,GACH,1,161,133,41,92,9,6,3,20,0,20,3,0,3,161,133,41,92,9,6,3,20,0,20,3,0,3
08/19/2021,Southwest,1,CAH,1,22,12,1,11,0,0,0,4,0,4,0,0,0,22,12,1,11,0,0,0,4,0,4,0,0,0
08/19/2021,Southwest,1,GACH,1,53,45,12,33,0,0,0,4,0,4,3,0,3,53,45,12,33,0,0,0,4,0,4,3,0,3
08/20/2021,Anchorage,7,GACH,1,732,700,634,66,120,106,14,200,50,150,71,1,72,732,700,634,66,120,106,14,200,50,150,71,1,72
08/20/2021,Anchorage,7,LTACH,0,44,44,37,7,6,6,0,23,3,20,0,0,0,44,44,37,7,6,6,0,23,3,20,0,0,0
08/20/2021,Anchorage,7,Psych,0,,,,,,,,,,,,,,220,203,133,70,0,0,0,0,0,0,0,0,0
08/20/2021,Gulf Coast,4,CAH,1,84,71,28,43,4,0,4,25,0,25,5,0,5,84,71,28,43,4,0,4,25,0,25,5,0,5
08/20/2021,Gulf Coast,4,GACH,1,93,60,43,17,9,8,1,11,4,7,15,0,15,93,60,43,17,9,8,1,11,4,7,15,0,15
08/20/2021,Interior,6,GACH,1,101,81,58,23,20,13,7,16,1,15,14,0,14,101,81,58,23,20,13,7,16,1,15,14,0,14
08/20/2021,Matanuska-Susitna,3,GACH,1,184,160,79,81,14,12,2,33,9,24,14,0,14,184,160,79,81,14,12,2,33,9,24,14,0,14
08/20/2021,Northern,2,CAH,1,96,65,28,37,0,0,0,36,0,36,6,0,6,96,65,28,37,0,0,0,36,0,36,6,0,6
08/20/2021,Southeast,5,CAH,1,70,70,31,39,8,2,6,33,0,33,6,0,6,70,70,31,39,8,2,6,33,0,33,6,0,6
08/20/2021,Southeast,5,GACH,1,161,133,38,95,9,5,4,20,0,20,4,0,4,161,133,38,95,9,5,4,20,0,20,4,0,4
08/20/2021,Southwest,1,CAH,1,22,12,1,11,0,0,0,4,0,4,0,0,0,22,12,1,11,0,0,0,4,0,4,0,0,0
08/20/2021,Southwest,1,GACH,1,53,45,11,34,0,0,0,4,0,4,2,0,2,53,45,11,34,0,0,0,4,0,4,2,0,2
08/21/2021,Anchorage,7,GACH,1,737,710,629,81,116,107,9,211,46,165,71,1,72,737,710,629,81,116,107,9,211,46,165,71,1,72
08/21/2021,Anchorage,7,LTACH,0,44,44,36,8,6,6,0,23,3,20,0,0,0,44,44,36,8,6,6,0,23,3,20,0,0,0
08/21/2021,Anchorage,7,Psych,0,,,,,,,,,,,,,,220,203,133,70,0,0,0,0,0,0,0,0,0
08/21/2021,Gulf Coast,4,CAH,1,80,70,27,43,4,0,4,25,0,25,7,0,7,80,70,27,43,4,0,4,25,0,25,7,0,7
08/21/2021,Gulf Coast,4,GACH,1,93,60,46,14,9,7,2,11,7,4,17,0,17,93,60,46,14,9,7,2,11,7,4,17,0,17
08/21/2021,Interior,6,GACH,1,101,81,56,25,20,17,3,16,2,14,7,0,7,101,81,56,25,20,17,3,16,2,14,7,0,7
08/21/2021,Matanuska-Susitna,3,GACH,1,184,160,84,76,14,11,3,33,8,25,15,0,15,184,160,84,76,14,11,3,33,8,25,15,0,15
08/21/2021,Northern,2,CAH,1,96,65,25,40,0,0,0,36,0,36,4,0,4,96,65,25,40,0,0,0,36,0,36,4,0,4
08/21/2021,Southeast,5,CAH,1,70,70,32,38,8,2,6,33,0,33,6,0,6,70,70,32,38,8,2,6,33,0,33,6,0,6
08/21/2021,Southeast,5,GACH,1,161,133,33,100,9,5,4,20,0,20,3,0,3,161,133,33,100,9,5,4,20,0,20,3,0,3
08/21/2021,Southwest,1,CAH,1,22,12,3,9,0,0,0,4,0,4,0,0,0,22,12,3,9,0,0,0,4,0,4,0,0,0
08/21/2021,Southwest,1,GACH,1,53,45,10,35,0,0,0,4,0,4,2,0,2,53,45,10,35,0,0,0,4,0,4,2,0,2
08/22/2021,Anchorage,7,GACH,1,736,703,626,77,119,104,15,211,43,168,67,1,68,736,703,626,77,119,104,15,211,43,168,67,1,68
08/22/2021,Anchorage,7,LTACH,0,44,44,37,7,6,6,0,23,3,20,0,0,0,44,44,37,7,6,6,0,23,3,20,0,0,0
08/22/2021,Anchorage,7,Psych,0,,,,,,,,,,,,,,220,203,133,70,0,0,0,0,0,0,0,0,0
08/22/2021,Gulf Coast,4,CAH,1,80,70,26,44,4,0,4,24,0,24,4,0,4,80,70,26,44,4,0,4,24,0,24,4,0,4
08/22/2021,Gulf Coast,4,GACH,1,93,60,49,11,9,9,0,11,8,3,18,0,18,93,60,49,11,9,9,0,11,8,3,18,0,18
08/22/2021,Interior,6,GACH,1,101,81,45,36,20,11,9,16,2,14,7,0,7,101,81,45,36,20,11,9,16,2,14,7,0,7
08/22/2021,Matanuska-Susitna,3,GACH,1,184,160,80,80,14,13,1,33,11,22,14,0,14,184,160,80,80,14,13,1,33,11,22,14,0,14
08/22/2021,Northern,2,CAH,1,96,65,23,42,0,0,0,36,0,36,3,0,3,96,65,23,42,0,0,0,36,0,36,3,0,3
08/22/2021,Southeast,5,CAH,1,70,70,34,36,8,2,6,33,0,33,6,0,6,70,70,34,36,8,2,6,33,0,33,6,0,6
08/22/2021,Southeast,5,GACH,1,161,133,35,98,9,3,6,20,0,20,4,0,4,161,133,35,98,9,3,6,20,0,20,4,0,4
08/22/2021,Southwest,1,CAH,1,22,12,2,10,0,0,0,4,0,4,0,0,0,22,12,2,10,0,0,0,4,0,4,0,0,0
08/22/2021,Southwest,1,GACH,1,53,45,10,35,0,0,0,4,0,4,2,0,2,53,45,10,35,0,0,0,4,0,4,2,0,2
08/23/2021,Anchorage,7,GACH,1,745,715,633,82,120,105,15,214,48,166,71,2,73,745,715,633,82,120,105,15,214,48,166,71,2,73
08/23/2021,Anchorage,7,LTACH,0,44,44,36,8,6,6,0,23,3,20,0,0,0,44,44,36,8,6,6,0,23,3,20,0,0,0
08/23/2021,Anchorage,7,Psych,0,,,,,,,,,,,,,,220,203,133,70,0,0,0,0,0,0,0,0,0
08/23/2021,Gulf Coast,4,CAH,1,80,69,30,39,4,0,4,24,0,24,6,0,6,80,69,30,39,4,0,4,24,0,24,6,0,6
08/23/2021,Gulf Coast,4,GACH,1,93,60,48,12,9,9,0,11,8,3,18,0,18,93,60,48,12,9,9,0,11,8,3,18,0,18
08/23/2021,Interior,6,GACH,1,101,81,46,35,20,11,9,16,1,15,6,0,6,101,81,46,35,20,11,9,16,1,15,6,0,6
08/23/2021,Matanuska-Susitna,3,GACH,1,184,160,81,79,14,12,2,33,9,24,15,0,15,184,160,81,79,14,12,2,33,9,24,15,0,15
08/23/2021,Northern,2,CAH,1,96,65,21,44,0,0,0,36,0,36,3,0,3,96,65,21,44,0,0,0,36,0,36,3,0,3
08/23/2021,Southeast,5,CAH,1,70,70,33,37,8,2,6,33,0,33,3,0,3,70,70,33,37,8,2,6,33,0,33,3,0,3
08/23/2021,Southeast,5,GACH,1,161,133,29,104,9,1,8,20,0,20,4,0,4,161,133,29,104,9,1,8,20,0,20,4,0,4
08/23/2021,Southwest,1,CAH,1,22,12,1,11,0,0,0,4,0,4,0,0,0,22,12,1,11,0,0,0,4,0,4,0,0,0
08/23/2021,Southwest,1,GACH,1,53,45,10,35,0,0,0,4,0,4,0,0,0,53,45,10,35,0,0,0,4,0,4,0,0,0
08/24/2021,Anchorage,7,GACH,1,736,708,619,89,117,104,13,209,46,163,71,0,71,736,708,619,89,117,104,13,209,46,163,71,0,71
08/24/2021,Anchorage,7,LTACH,0,44,44,37,7,6,6,0,23,2,21,0,0,0,44,44,37,7,6,6,0,23,2,21,0,0,0
08/24/2021,Anchorage,7,Psych,0,,,,,,,,,,,,,,220,203,133,70,0,0,0,0,0,0,0,0,0
08/24/2021,Gulf Coast,4,CAH,1,80,71,31,40,4,2,2,24,0,24,7,0,7,80,71,31,40,4,2,2,24,0,24,7,0,7
08/24/2021,Gulf Coast,4,GACH,1,93,60,47,13,10,10,0,14,6,8,20,0,20,93,60,47,13,10,10,0,14,6,8,20,0,20
08/24/2021,Interior,6,GACH,1,101,81,48,33,20,14,6,16,1,15,6,0,6,101,81,48,33,20,14,6,16,1,15,6,0,6
08/24/2021,Matanuska-Susitna,3,GACH,1,184,160,85,75,14,14,0,33,10,23,16,0,16,184,160,85,75,14,14,0,33,10,23,16,0,16
08/24/2021,Northern,2,CAH,1,96,65,28,37,0,0,0,36,0,36,3,0,3,96,65,28,37,0,0,0,36,0,36,3,0,3
08/24/2021,Southeast,5,CAH,1,70,70,39,31,8,2,6,33,0,33,4,0,4,70,70,39,31,8,2,6,33,0,33,4,0,4
08/24/2021,Southeast,5,GACH,1,161,133,31,102,9,2,7,20,0,20,4,0,4,161,133,31,102,9,2,7,20,0,20,4,0,4
08/24/2021,Southwest,1,CAH,1,22,12,1,11,0,0,0,4,0,4,0,0,0,22,12,1,11,0,0,0,4,0,4,0,0,0
08/24/2021,Southwest,1,GACH,1,53,45,7,38,0,0,0,4,0,4,0,0,0,53,45,7,38,0,0,0,4,0,4,0,0,0
08/25/2021,Anchorage,7,GACH,1,731,697,621,76,116,107,9,211,53,158,72,1,73,731,697,621,76,116,107,9,211,53,158,72,1,73
08/25/2021,Anchorage,7,LTACH,0,44,44,37,7,6,6,0,23,3,20,0,0,0,44,44,37,7,6,6,0,23,3,20,0,0,0
08/25/2021,Anchorage,7,Psych,0,220,203,156,47,0,0,0,0,0,0,0,0,0,220,203,156,47,0,0,0,0,0,0,0,0,0
08/25/2021,Gulf Coast,4,CAH,1,81,71,30,41,4,1,3,24,0,24,4,0,4,81,71,30,41,4,1,3,24,0,24,4,0,4
08/25/2021,Gulf Coast,4,GACH,1,93,60,49,11,10,10,0,14,4,10,18,0,18,93,60,49,11,10,10,0,14,4,10,18,0,18
08/25/2021,Interior,6,GACH,1,101,81,48,33,20,14,6,16,1,15,8,0,8,101,81,48,33,20,14,6,16,1,15,8,0,8
08/25/2021,Matanuska-Susitna,3,GACH,1,184,160,83,77,14,14,0,33,10,23,16,0,16,184,160,83,77,14,14,0,33,10,23,16,0,16
08/25/2021,Northern,2,CAH,1,96,65,20,45,0,0,0,36,0,36,1,0,1,96,65,20,45,0,0,0,36,0,36,1,0,1
08/25/2021,Southeast,5,CAH,1,70,70,29,41,8,0,8,33,0,33,3,0,3,70,70,29,41,8,0,8,33,0,33,3,0,3
08/25/2021,Southeast,5,GACH,1,161,133,33,100,9,3,6,20,0,20,3,0,3,161,133,33,100,9,3,6,20,0,20,3,0,3
08/25/2021,Southwest,1,CAH,1,22,12,1,11,0,0,0,4,0,4,0,0,0,22,12,1,11,0,0,0,4,0,4,0,0,0
08/25/2021,Southwest,1,GACH,1,53,45,10,35,0,0,0,4,0,4,1,0,1,53,45,10,35,0,0,0,4,0,4,1,0,1
08/26/2021,Anchorage,7,GACH,1,732,701,619,82,118,106,12,210,48,162,74,2,76,732,701,619,82,118,106,12,210,48,162,74,2,76
08/26/2021,Anchorage,7,LTACH,0,44,44,40,4,6,6,0,23,3,20,0,0,0,44,44,40,4,6,6,0,23,3,20,0,0,0
08/26/2021,Anchorage,7,Psych,0,,,,,,,,,,,,,,220,203,156,47,0,0,0,0,0,0,0,0,0
08/26/2021,Gulf Coast,4,CAH,1,81,71,27,44,4,0,4,24,0,24,5,0,5,81,71,27,44,4,0,4,24,0,24,5,0,5
08/26/2021,Gulf Coast,4,GACH,1,93,56,53,3,9,9,0,14,4,10,25,0,25,93,56,53,3,9,9,0,14,4,10,25,0,25
08/26/2021,Interior,6,GACH,1,101,81,51,30,20,11,9,16,1,15,12,1,13,101,81,51,30,20,11,9,16,1,15,12,1,13
08/26/2021,Matanuska-Susitna,3,GACH,1,184,160,91,69,14,14,0,33,10,23,20,0,20,184,160,91,69,14,14,0,33,10,23,20,0,20
08/26/2021,Northern,2,CAH,1,96,65,26,39,0,0,0,36,0,36,2,0,2,96,65,26,39,0,0,0,36,0,36,2,0,2
08/26/2021,Southeast,5,CAH,1,70,70,31,39,8,0,8,33,0,33,3,0,3,70,70,31,39,8,0,8,33,0,33,3,0,3
08/26/2021,Southeast,5,GACH,1,161,133,37,96,9,2,7,20,0,20,4,0,4,161,133,37,96,9,2,7,20,0,20,4,0,4
08/26/2021,Southwest,1,CAH,1,22,12,2,10,0,0,0,4,0,4,0,0,0,22,12,2,10,0,0,0,4,0,4,0,0,0
08/26/2021,Southwest,1,GACH,1,53,45,13,32,0,0,0,4,0,4,1,0,1,53,45,13,32,0,0,0,4,0,4,1,0,1
08/27/2021,Anchorage,7,GACH,1,745,716,626,90,118,107,11,210,48,162,80,1,81,745,716,626,90,118,107,11,210,48,162,80,1,81
08/27/2021,Anchorage,7,LTACH,0,44,44,40,4,6,6,0,23,3,20,0,0,0,44,44,40,4,6,6,0,23,3,20,0,0,0
08/27/2021,Anchorage,7,Psych,0,,,,,,,,,,,,,,220,203,156,47,0,0,0,0,0,0,0,0,0
08/27/2021,Gulf Coast,4,CAH,1,81,71,25,46,4,0,4,24,0,24,5,0,5,81,71,25,46,4,0,4,24,0,24,5,0,5
08/27/2021,Gulf Coast,4,GACH,1,93,56,53,3,9,9,0,14,5,9,24,0,24,93,56,53,3,9,9,0,14,5,9,24,0,24
08/27/2021,Interior,6,GACH,1,101,81,47,34,20,11,9,16,2,14,13,1,14,101,81,47,34,20,11,9,16,2,14,13,1,14
08/27/2021,Matanuska-Susitna,3,GACH,1,184,160,88,72,14,11,3,33,6,27,19,0,19,184,160,88,72,14,11,3,33,6,27,19,0,19
08/27/2021,Northern,2,CAH,1,96,65,20,45,0,0,0,36,0,36,2,0,2,96,65,20,45,0,0,0,36,0,36,2,0,2
08/27/2021,Southeast,5,CAH,1,70,70,28,42,4,2,2,33,0,33,2,0,2,70,70,28,42,4,2,2,33,0,33,2,0,2
08/27/2021,Southeast,5,GACH,1,161,133,34,99,9,3,6,20,0,20,5,0,5,161,133,34,99,9,3,6,20,0,20,5,0,5
08/27/2021,Southwest,1,CAH,1,22,12,2,10,0,0,0,4,0,4,0,0,0,22,12,2,10,0,0,0,4,0,4,0,0,0
08/27/2021,Southwest,1,GACH,1,53,45,13,32,0,0,0,4,0,4,1,0,1,53,45,13,32,0,0,0,4,0,4,1,0,1
08/28/2021,Anchorage,7,GACH,1,722,697,610,87,122,113,9,210,48,162,81,2,83,722,697,610,87,122,113,9,210,48,162,81,2,83
08/28/2021,Anchorage,7,LTACH,0,44,44,38,6,6,6,0,23,3,20,0,0,0,44,44,38,6,6,6,0,23,3,20,0,0,0
08/28/2021,Anchorage,7,Psych,0,,,,,,,,,,,,,,220,203,156,47,0,0,0,0,0,0,0,0,0
08/28/2021,Gulf Coast,4,CAH,1,81,71,24,47,4,1,3,24,0,24,6,0,6,81,71,24,47,4,1,3,24,0,24,6,0,6
08/28/2021,Gulf Coast,4,GACH,1,93,57,57,0,9,9,0,14,4,10,25,0,25,93,57,57,0,9,9,0,14,4,10,25,0,25
08/28/2021,Interior,6,GACH,1,101,81,68,13,20,9,11,16,1,15,14,0,14,101,81,68,13,20,9,11,16,1,15,14,0,14
08/28/2021,Matanuska-Susitna,3,GACH,1,184,160,73,87,14,11,3,33,5,28,13,0,13,184,160,73,87,14,11,3,33,5,28,13,0,13
08/28/2021,Northern,2,CAH,1,96,65,23,42,0,0,0,36,0,36,3,0,3,96,65,23,42,0,0,0,36,0,36,3,0,3
08/28/2021,Southeast,5,CAH,1,70,70,25,45,4,3,1,33,0,33,3,0,3,70,70,25,45,4,3,1,33,0,33,3,0,3
08/28/2021,Southeast,5,GACH,1,161,133,35,98,9,6,3,20,0,20,5,0,5,161,133,35,98,9,6,3,20,0,20,5,0,5
08/28/2021,Southwest,1,CAH,1,22,12,3,9,0,0,0,4,0,4,0,0,0,22,12,3,9,0,0,0,4,0,4,0,0,0
08/28/2021,Southwest,1,GACH,1,53,45,13,32,0,0,0,4,0,4,1,0,1,53,45,13,32,0,0,0,4,0,4,1,0,1
08/29/2021,Anchorage,7,GACH,1,720,692,597,95,118,106,12,211,47,164,79,0,79,720,692,597,95,118,106,12,211,47,164,79,0,79
08/29/2021,Anchorage,7,LTACH,0,44,44,37,7,6,6,0,23,3,20,0,0,0,44,44,37,7,6,6,0,23,3,20,0,0,0
08/29/2021,Anchorage,7,Psych,0,,,,,,,,,,,,,,220,203,156,47,0,0,0,0,0,0,0,0,0
08/29/2021,Gulf Coast,4,CAH,1,81,71,29,42,4,1,3,24,0,24,6,0,6,81,71,29,42,4,1,3,24,0,24,6,0,6
08/29/2021,Gulf Coast,4,GACH,1,93,56,54,2,9,9,0,14,2,12,23,0,23,93,56,54,2,9,9,0,14,2,12,23,0,23
08/29/2021,Interior,6,GACH,1,101,81,52,29,20,12,8,16,1,15,13,0,13,101,81,52,29,20,12,8,16,1,15,13,0,13
08/29/2021,Matanuska-Susitna,3,GACH,1,184,160,69,91,14,11,3,33,4,29,19,2,21,184,160,69,91,14,11,3,33,4,29,19,2,21
08/29/2021,Northern,2,CAH,1,96,65,21,44,0,0,0,36,0,36,2,0,2,96,65,21,44,0,0,0,36,0,36,2,0,2
08/29/2021,Southeast,5,CAH,1,70,70,22,48,4,2,2,33,0,33,3,0,3,70,70,22,48,4,2,2,33,0,33,3,0,3
08/29/2021,Southeast,5,GACH,1,161,133,39,94,9,3,6,20,0,20,4,0,4,161,133,39,94,9,3,6,20,0,20,4,0,4
08/29/2021,Southwest,1,CAH,1,22,12,3,9,0,0,0,4,0,4,0,0,0,22,12,3,9,0,0,0,4,0,4,0,0,0
08/29/2021,Southwest,1,GACH,1,53,45,12,33,0,0,0,4,0,4,1,0,1,53,45,12,33,0,0,0,4,0,4,1,0,1
08/30/2021,Anchorage,7,GACH,1,722,693,615,78,113,105,8,216,37,179,82,0,82,722,693,615,78,113,105,8,216,37,179,82,0,82
08/30/2021,Anchorage,7,LTACH,0,44,44,37,7,6,6,0,23,3,20,0,0,0,44,44,37,7,6,6,0,23,3,20,0,0,0
08/30/2021,Anchorage,7,Psych,0,,,,,,,,,,,,,,220,203,156,47,0,0,0,0,0,0,0,0,0
08/30/2021,Gulf Coast,4,CAH,1,81,71,25,46,4,0,4,24,0,24,3,0,3,81,71,25,46,4,0,4,24,0,24,3,0,3
08/30/2021,Gulf Coast,4,GACH,1,93,56,54,2,9,8,1,14,1,13,21,0,21,93,56,54,2,9,8,1,14,1,13,21,0,21
08/30/2021,Interior,6,GACH,1,101,81,55,26,20,15,5,16,0,16,13,0,13,101,81,55,26,20,15,5,16,0,16,13,0,13
08/30/2021,Matanuska-Susitna,3,GACH,1,184,160,81,79,14,13,1,33,6,27,22,1,23,184,160,81,79,14,13,1,33,6,27,22,1,23
08/30/2021,Northern,2,CAH,1,96,65,20,45,0,0,0,36,0,36,2,0,2,96,65,20,45,0,0,0,36,0,36,2,0,2
08/30/2021,Southeast,5,CAH,1,70,70,22,48,4,2,2,33,0,33,2,0,2,70,70,22,48,4,2,2,33,0,33,2,0,2
08/30/2021,Southeast,5,GACH,1,161,133,43,90,9,4,5,20,0,20,4,0,4,161,133,43,90,9,4,5,20,0,20,4,0,4
08/30/2021,Southwest,1,CAH,1,22,12,2,10,0,0,0,4,0,4,0,0,0,22,12,2,10,0,0,0,4,0,4,0,0,0
08/30/2021,Southwest,1,GACH,1,53,45,13,32,0,0,0,4,0,4,1,0,1,53,45,13,32,0,0,0,4,0,4,1,0,1
08/31/2021,Anchorage,7,GACH,1,768,735,659,76,123,110,13,216,40,176,93,1,94,768,735,659,76,123,110,13,216,40,176,93,1,94
08/31/2021,Anchorage,7,LTACH,0,44,44,36,8,6,6,0,23,3,20,0,0,0,44,44,36,8,6,6,0,23,3,20,0,0,0
08/31/2021,Anchorage,7,Psych,0,,,,,,,,,,,,,,220,203,156,47,0,0,0,0,0,0,0,0,0
08/31/2021,Gulf Coast,4,CAH,1,81,71,26,45,4,0,4,24,0,24,4,0,4,81,71,26,45,4,0,4,24,0,24,4,0,4
08/31/2021,Gulf Coast,4,GACH,1,93,54,54,0,9,9,0,14,3,11,25,0,25,93,54,54,0,9,9,0,14,3,11,25,0,25
08/31/2021,Interior,6,GACH,1,101,81,57,24,20,13,7,16,1,15,12,0,12,101,81,57,24,20,13,7,16,1,15,12,0,12
08/31/2021,Matanuska-Susitna,3,GACH,1,184,160,86,74,14,13,1,33,6,27,23,0,23,184,160,86,74,14,13,1,33,6,27,23,0,23
08/31/2021,Northern,2,CAH,1,96,65,19,46,0,0,0,36,0,36,4,0,4,96,65,19,46,0,0,0,36,0,36,4,0,4
08/31/2021,Southeast,5,CAH,1,70,70,26,44,6,4,2,33,0,33,3,0,3,70,70,26,44,6,4,2,33,0,33,3,0,3
08/31/2021,Southeast,5,GACH,1,161,133,33,100,9,4,5,20,0,20,3,0,3,161,133,33,100,9,4,5,20,0,20,3,0,3
08/31/2021,Southwest,1,CAH,1,22,12,3,9,0,0,0,4,0,4,2,0,2,22,12,3,9,0,0,0,4,0,4,2,0,2
08/31/2021,Southwest,1,GACH,1,53,45,13,32,0,0,0,4,0,4,1,0,1,53,45,13,32,0,0,0,4,0,4,1,0,1
09/01/2021,Anchorage,7,GACH,1,751,719,647,72,124,112,12,216,40,176,96,1,97,751,719,647,72,124,112,12,216,40,176,96,1,97
09/01/2021,Anchorage,7,LTACH,0,44,44,39,5,6,6,0,23,4,19,0,0,0,44,44,39,5,6,6,0,23,4,19,0,0,0
09/01/2021,Anchorage,7,Psych,0,220,202,127,75,0,0,0,0,0,0,0,5,5,220,202,127,75,0,0,0,0,0,0,0,5,5
09/01/2021,Gulf Coast,4,CAH,1,81,71,25,46,4,1,3,24,0,24,4,0,4,81,71,25,46,4,1,3,24,0,24,4,0,4
09/01/2021,Gulf Coast,4,GACH,1,93,55,55,0,9,9,0,14,3,11,23,0,23,93,55,55,0,9,9,0,14,3,11,23,0,23
09/01/2021,Interior,6,GACH,1,101,81,63,18,20,13,7,16,2,14,13,0,13,101,81,63,18,20,13,7,16,2,14,13,0,13
09/01/2021,Matanuska-Susitna,3,GACH,1,184,160,93,67,14,14,0,33,6,27,25,0,25,184,160,93,67,14,14,0,33,6,27,25,0,25
09/01/2021,Northern,2,CAH,1,96,65,14,51,0,0,0,36,0,36,2,0,2,96,65,14,51,0,0,0,36,0,36,2,0,2
09/01/2021,Southeast,5,CAH,1,70,70,28,42,3,1,2,33,0,33,3,0,3,70,70,28,42,3,1,2,33,0,33,3,0,3
09/01/2021,Southeast,5,GACH,1,161,133,31,102,9,4,5,20,0,20,3,0,3,161,133,31,102,9,4,5,20,0,20,3,0,3
09/01/2021,Southwest,1,CAH,1,22,12,2,10,0,0,0,4,0,4,0,0,0,22,12,2,10,0,0,0,4,0,4,0,0,0
09/01/2021,Southwest,1,GACH,1,53,45,12,33,0,0,0,4,0,4,0,0,0,53,45,12,33,0,0,0,4,0,4,0,0,0
09/02/2021,Anchorage,7,GACH,1,760,733,664,69,117,107,10,216,39,177,99,0,99,760,733,664,69,117,107,10,216,39,177,99,0,99
09/02/2021,Anchorage,7,LTACH,0,44,44,37,7,6,6,0,23,4,19,0,0,0,44,44,37,7,6,6,0,23,4,19,0,0,0
09/02/2021,Anchorage,7,Psych,0,,,,,,,,,,,,,,220,202,127,75,0,0,0,0,0,0,0,5,5
09/02/2021,Gulf Coast,4,CAH,1,81,70,24,46,4,0,4,24,0,24,5,0,5,81,70,24,46,4,0,4,24,0,24,5,0,5
09/02/2021,Gulf Coast,4,GACH,1,93,55,55,0,9,8,1,14,3,11,21,0,21,93,55,55,0,9,8,1,14,3,11,21,0,21
09/02/2021,Interior,6,GACH,1,101,81,62,19,25,20,5,16,4,12,11,0,11,101,81,62,19,25,20,5,16,4,12,11,0,11
09/02/2021,Matanuska-Susitna,3,GACH,1,184,160,88,72,14,14,0,33,5,28,19,0,19,184,160,88,72,14,14,0,33,5,28,19,0,19
09/02/2021,Northern,2,CAH,1,96,65,16,49,0,0,0,36,0,36,2,0,2,96,65,16,49,0,0,0,36,0,36,2,0,2
09/02/2021,Southeast,5,CAH,1,70,70,28,42,3,1,2,33,0,33,1,0,1,70,70,28,42,3,1,2,33,0,33,1,0,1
09/02/2021,Southeast,5,GACH,1,161,133,33,100,9,4,5,20,0,20,5,0,5,161,133,33,100,9,4,5,20,0,20,5,0,5
09/02/2021,Southwest,1,CAH,1,22,12,2,10,0,0,0,4,0,4,1,0,1,22,12,2,10,0,0,0,4,0,4,1,0,1
09/02/2021,Southwest,1,GACH,1,53,45,13,32,0,0,0,4,0,4,1,0,1,53,45,13,32,0,0,0,4,0,4,1,0,1
09/03/2021,Anchorage,7,GACH,1,725,695,618,77,120,104,16,217,43,174,97,0,97,725,695,618,77,120,104,16,217,43,174,97,0,97
09/03/2021,Anchorage,7,LTACH,0,44,44,38,6,6,6,0,23,4,19,0,0,0,44,44,38,6,6,6,0,23,4,19,0,0,0
09/03/2021,Anchorage,7,Psych,0,,,,,,,,,,,,,,220,202,127,75,0,0,0,0,0,0,0,5,5
09/03/2021,Gulf Coast,4,CAH,1,81,70,26,44,4,0,4,24,0,24,3,0,3,81,70,26,44,4,0,4,24,0,24,3,0,3
09/03/2021,Gulf Coast,4,GACH,1,93,55,55,0,9,9,0,14,3,11,22,0,22,93,55,55,0,9,9,0,14,3,11,22,0,22
09/03/2021,Interior,6,GACH,1,101,81,62,19,25,20,5,16,4,12,11,0,11,101,81,62,19,25,20,5,16,4,12,11,0,11
09/03/2021,Matanuska-Susitna,3,GACH,1,184,160,88,72,14,14,0,33,6,27,23,0,23,184,160,88,72,14,14,0,33,6,27,23,0,23
09/03/2021,Northern,2,CAH,1,96,65,16,49,0,0,0,36,0,36,3,0,3,96,65,16,49,0,0,0,36,0,36,3,0,3
09/03/2021,Southeast,5,CAH,1,70,70,27,43,3,2,1,33,0,33,1,0,1,70,70,27,43,3,2,1,33,0,33,1,0,1
09/03/2021,Southeast,5,GACH,1,161,133,35,98,9,5,4,20,0,20,4,0,4,161,133,35,98,9,5,4,20,0,20,4,0,4
09/03/2021,Southwest,1,CAH,1,22,12,2,10,0,0,0,4,0,4,1,0,1,22,12,2,10,0,0,0,4,0,4,1,0,1
09/03/2021,Southwest,1,GACH,1,53,45,15,30,0,0,0,4,0,4,1,0,1,53,45,15,30,0,0,0,4,0,4,1,0,1
09/04/2021,Anchorage,7,GACH,1,722,693,609,84,122,110,12,215,40,175,96,1,97,722,693,609,84,122,110,12,215,40,175,96,1,97
09/04/2021,Anchorage,7,LTACH,0,44,44,38,6,6,6,0,23,5,18,0,0,0,44,44,38,6,6,6,0,23,5,18,0,0,0
09/04/2021,Anchorage,7,Psych,0,,,,,,,,,,,,,,220,202,127,75,0,0,0,0,0,0,0,5,5
09/04/2021,Gulf Coast,4,CAH,1,81,70,25,45,4,0,4,24,0,24,4,0,4,81,70,25,45,4,0,4,24,0,24,4,0,4
09/04/2021,Gulf Coast,4,GACH,1,93,53,49,4,9,8,1,14,3,11,22,0,22,93,53,49,4,9,8,1,14,3,11,22,0,22
09/04/2021,Interior,6,GACH,1,101,81,56,25,25,22,3,16,2,14,11,0,11,101,81,56,25,25,22,3,16,2,14,11,0,11
09/04/2021,Matanuska-Susitna,3,GACH,1,184,160,78,82,14,13,1,33,7,26,24,0,24,184,160,78,82,14,13,1,33,7,26,24,0,24
09/04/2021,Northern,2,CAH,1,81,43,22,21,0,0,0,36,0,36,4,0,4,81,43,22,21,0,0,0,36,0,36,4,0,4
09/04/2021,Southeast,5,CAH,1,70,70,25,45,3,2,1,33,0,33,2,0,2,70,70,25,45,3,2,1,33,0,33,2,0,2
09/04/2021,Southeast,5,GACH,1,161,133,37,96,9,5,4,20,0,20,4,0,4,161,133,37,96,9,5,4,20,0,20,4,0,4
09/04/2021,Southwest,1,CAH,1,22,12,3,9,0,0,0,4,0,4,1,1,2,22,12,3,9,0,0,0,4,0,4,1,1,2
09/04/2021,Southwest,1,GACH,1,53,45,13,32,0,0,0,4,0,4,1,0,1,53,45,13,32,0,0,0,4,0,4,1,0,1
09/05/2021,Anchorage,7,GACH,1,713,681,593,88,116,104,12,215,43,172,100,1,101,713,681,593,88,116,104,12,215,43,172,100,1,101
09/05/2021,Anchorage,7,LTACH,0,44,44,40,4,6,6,0,23,6,17,0,0,0,44,44,40,4,6,6,0,23,6,17,0,0,0
09/05/2021,Anchorage,7,Psych,0,,,,,,,,,,,,,,220,202,127,75,0,0,0,0,0,0,0,5,5
09/05/2021,Gulf Coast,4,CAH,1,81,70,23,47,4,0,4,24,0,24,5,0,5,81,70,23,47,4,0,4,24,0,24,5,0,5
09/05/2021,Gulf Coast,4,GACH,1,93,53,51,2,9,8,1,14,2,12,17,0,17,93,53,51,2,9,8,1,14,2,12,17,0,17
09/05/2021,Interior,6,GACH,1,101,81,54,27,25,21,4,16,0,16,12,1,13,101,81,54,27,25,21,4,16,0,16,12,1,13
09/05/2021,Matanuska-Susitna,3,GACH,1,184,160,75,85,14,13,1,33,7,26,30,0,30,184,160,75,85,14,13,1,33,7,26,30,0,30
09/05/2021,Northern,2,CAH,1,81,43,19,24,0,0,0,36,0,36,2,0,2,81,43,19,24,0,0,0,36,0,36,2,0,2
09/05/2021,Southeast,5,CAH,1,70,70,27,43,3,2,1,33,0,33,2,0,2,70,70,27,43,3,2,1,33,0,33,2,0,2
09/05/2021,Southeast,5,GACH,1,161,133,36,97,9,5,4,20,0,20,3,0,3,161,133,36,97,9,5,4,20,0,20,3,0,3
09/05/2021,Southwest,1,CAH,1,22,12,3,9,0,0,0,4,0,4,1,1,2,22,12,3,9,0,0,0,4,0,4,1,1,2
09/05/2021,Southwest,1,GACH,1,53,45,13,32,0,0,0,4,0,4,1,0,1,53,45,13,32,0,0,0,4,0,4,1,0,1
09/06/2021,Anchorage,7,GACH,1,706,676,592,84,118,106,12,215,48,167,98,0,98,706,676,592,84,118,106,12,215,48,167,98,0,98
09/06/2021,Anchorage,7,LTACH,0,44,44,42,2,6,6,0,23,6,17,0,0,0,44,44,42,2,6,6,0,23,6,17,0,0,0
09/06/2021,Anchorage,7,Psych,0,,,,,,,,,,,,,,220,202,127,75,0,0,0,0,0,0,0,5,5
09/06/2021,Gulf Coast,4,CAH,1,81,70,26,44,4,0,4,24,0,24,4,0,4,81,70,26,44,4,0,4,24,0,24,4,0,4
09/06/2021,Gulf Coast,4,GACH,1,93,53,50,3,9,7,2,14,2,12,18,0,18,93,53,50,3,9,7,2,14,2,12,18,0,18
09/06/2021,Interior,6,GACH,1,101,81,43,38,25,21,4,16,1,15,12,1,13,101,81,43,38,25,21,4,16,1,15,12,1,13
09/06/2021,Matanuska-Susitna,3,GACH,1,184,160,85,75,14,12,2,33,8,25,39,0,39,184,160,85,75,14,12,2,33,8,25,39,0,39
09/06/2021,Northern,2,CAH,1,81,43,21,22,0,0,0,36,0,36,3,0,3,81,43,21,22,0,0,0,36,0,36,3,0,3
09/06/2021,Southeast,5,CAH,1,70,70,31,39,3,2,1,33,0,33,2,0,2,70,70,31,39,3,2,1,33,0,33,2,0,2
09/06/2021,Southeast,5,GACH,1,161,133,39,94,9,3,6,20,0,20,3,0,3,161,133,39,94,9,3,6,20,0,20,3,0,3
09/06/2021,Southwest,1,CAH,1,22,12,2,10,0,0,0,4,0,4,1,1,2,22,12,2,10,0,0,0,4,0,4,1,1,2
09/06/2021,Southwest,1,GACH,1,53,45,16,29,0,0,0,4,0,4,2,0,2,53,45,16,29,0,0,0,4,0,4,2,0,2
09/07/2021,Anchorage,7,GACH,1,729,697,609,88,115,101,14,215,51,164,105,0,105,729,697,609,88,115,101,14,215,51,164,105,0,105
09/07/2021,Anchorage,7,LTACH,0,44,44,42,2,6,6,0,23,6,17,0,0,0,44,44,42,2,6,6,0,23,6,17,0,0,0
09/07/2021,Anchorage,7,Psych,0,,,,,,,,,,,,,,220,202,127,75,0,0,0,0,0,0,0,5,5
09/07/2021,Gulf Coast,4,CAH,1,81,69,29,40,4,0,4,24,0,24,4,0,4,81,69,29,40,4,0,4,24,0,24,4,0,4
09/07/2021,Gulf Coast,4,GACH,1,93,53,49,4,9,8,1,14,1,13,17,0,17,93,53,49,4,9,8,1,14,1,13,17,0,17
09/07/2021,Interior,6,GACH,1,101,81,58,23,25,18,7,16,1,15,19,1,20,101,81,58,23,25,18,7,16,1,15,19,1,20
09/07/2021,Matanuska-Susitna,3,GACH,1,184,160,95,65,14,9,5,33,7,26,40,0,40,184,160,95,65,14,9,5,33,7,26,40,0,40
09/07/2021,Northern,2,CAH,1,81,43,19,24,0,0,0,36,0,36,2,0,2,81,43,19,24,0,0,0,36,0,36,2,0,2
09/07/2021,Southeast,5,CAH,1,70,70,25,45,2,2,0,33,0,33,3,0,3,70,70,25,45,2,2,0,33,0,33,3,0,3
09/07/2021,Southeast,5,GACH,1,161,133,47,86,9,4,5,20,1,19,4,0,4,161,133,47,86,9,4,5,20,1,19,4,0,4
09/07/2021,Southwest,1,CAH,1,22,12,2,10,0,0,0,4,0,4,1,1,2,22,12,2,10,0,0,0,4,0,4,1,1,2
09/07/2021,Southwest,1,GACH,1,53,45,14,31,0,0,0,4,0,4,2,0,2,53,45,14,31,0,0,0,4,0,4,2,0,2
09/08/2021,Anchorage,7,GACH,1,746,715,629,86,124,115,9,215,52,163,111,0,111,746,715,629,86,124,115,9,215,52,163,111,0,111
09/08/2021,Anchorage,7,LTACH,0,44,44,42,2,6,6,0,23,7,16,0,0,0,44,44,42,2,6,6,0,23,7,16,0,0,0
09/08/2021,Anchorage,7,Psych,0,220,201,122,79,0,0,0,0,0,0,0,5,5,220,201,122,79,0,0,0,0,0,0,0,5,5
09/08/2021,Gulf Coast,4,CAH,1,81,69,28,41,4,0,4,24,0,24,5,0,5,81,69,28,41,4,0,4,24,0,24,5,0,5
09/08/2021,Gulf Coast,4,GACH,1,93,54,54,0,9,9,0,14,1,13,17,0,17,93,54,54,0,9,9,0,14,1,13,17,0,17
09/08/2021,Interior,6,GACH,1,101,81,60,21,25,16,9,16,1,15,21,1,22,101,81,60,21,25,16,9,16,1,15,21,1,22
09/08/2021,Matanuska-Susitna,3,GACH,1,184,160,92,68,14,13,1,33,10,23,43,0,43,184,160,92,68,14,13,1,33,10,23,43,0,43
09/08/2021,Northern,2,CAH,1,81,43,23,20,0,0,0,36,0,36,1,0,1,81,43,23,20,0,0,0,36,0,36,1,0,1
09/08/2021,Southeast,5,CAH,1,70,70,27,43,3,3,0,33,0,33,2,0,2,70,70,27,43,3,3,0,33,0,33,2,0,2
09/08/2021,Southeast,5,GACH,1,161,133,44,89,9,6,3,20,1,19,3,0,3,161,133,44,89,9,6,3,20,1,19,3,0,3
09/08/2021,Southwest,1,CAH,1,22,12,2,10,0,0,0,4,0,4,1,0,1,22,12,2,10,0,0,0,4,0,4,1,0,1
09/08/2021,Southwest,1,GACH,1,53,45,15,30,0,0,0,4,0,4,3,0,3,53,45,15,30,0,0,0,4,0,4,3,0,3
09/09/2021,Anchorage,7,GACH,1,745,710,638,72,124,113,11,213,30,183,113,0,113,745,710,638,72,124,113,11,213,30,183,113,0,113
09/09/2021,Anchorage,7,LTACH,0,44,44,41,3,6,6,0,23,5,18,0,0,0,44,44,41,3,6,6,0,23,5,18,0,0,0
09/09/2021,Anchorage,7,Psych,0,,,,,,,,,,,,,,220,201,122,79,0,0,0,0,0,0,0,5,5
09/09/2021,Gulf Coast,4,CAH,1,81,69,26,43,4,0,4,24,0,24,4,0,4,81,69,26,43,4,0,4,24,0,24,4,0,4
09/09/2021,Gulf Coast,4,GACH,1,93,53,49,4,9,9,0,14,1,13,16,0,16,93,53,49,4,9,9,0,14,1,13,16,0,16
09/09/2021,Interior,6,GACH,1,101,81,75,6,25,13,12,16,1,15,23,0,23,101,81,75,6,25,13,12,16,1,15,23,0,23
09/09/2021,Matanuska-Susitna,3,GACH,1,184,160,98,62,14,14,0,33,10,23,34,0,34,184,160,98,62,14,14,0,33,10,23,34,0,34
09/09/2021,Northern,2,CAH,1,81,43,25,18,0,0,0,36,0,36,2,0,2,81,43,25,18,0,0,0,36,0,36,2,0,2
09/09/2021,Southeast,5,CAH,1,70,70,34,36,4,3,1,33,0,33,2,0,2,70,70,34,36,4,3,1,33,0,33,2,0,2
09/09/2021,Southeast,5,GACH,1,161,133,44,89,9,6,3,20,1,19,3,0,3,161,133,44,89,9,6,3,20,1,19,3,0,3
09/09/2021,Southwest,1,CAH,1,22,12,5,7,0,0,0,4,0,4,4,0,4,22,12,5,7,0,0,0,4,0,4,4,0,4
09/09/2021,Southwest,1,GACH,1,53,45,14,31,0,0,0,4,0,4,3,0,3,53,45,14,31,0,0,0,4,0,4,3,0,3
09/10/2021,Anchorage,7,GACH,1,752,718,652,66,113,102,11,213,43,170,110,0,110,752,718,652,66,113,102,11,213,43,170,110,0,110
09/10/2021,Anchorage,7,LTACH,0,44,44,42,2,6,6,0,23,5,18,0,0,0,44,44,42,2,6,6,0,23,5,18,0,0,0
09/10/2021,Anchorage,7,Psych,0,,,,,,,,,,,,,,220,201,122,79,0,0,0,0,0,0,0,5,5
09/10/2021,Gulf Coast,4,CAH,1,81,70,28,42,4,2,2,24,0,24,6,0,6,81,70,28,42,4,2,2,24,0,24,6,0,6
09/10/2021,Gulf Coast,4,GACH,1,93,53,48,5,9,9,0,14,1,13,18,0,18,93,53,48,5,9,9,0,14,1,13,18,0,18
09/10/2021,Interior,6,GACH,1,101,81,61,20,25,11,14,16,1,15,15,0,15,101,81,61,20,25,11,14,16,1,15,15,0,15
09/10/2021,Matanuska-Susitna,3,GACH,1,184,160,92,68,14,14,0,33,9,24,33,1,34,184,160,92,68,14,14,0,33,9,24,33,1,34
09/10/2021,Northern,2,CAH,1,81,45,32,13,0,0,0,36,0,36,5,0,5,81,45,32,13,0,0,0,36,0,36,5,0,5
09/10/2021,Southeast,5,CAH,1,70,70,33,37,4,2,2,33,0,33,4,0,4,70,70,33,37,4,2,2,33,0,33,4,0,4
09/10/2021,Southeast,5,GACH,1,161,133,46,87,9,6,3,20,0,20,2,0,2,161,133,46,87,9,6,3,20,0,20,2,0,2
09/10/2021,Southwest,1,CAH,1,22,12,6,6,0,0,0,4,0,4,3,0,3,22,12,6,6,0,0,0,4,0,4,3,0,3
09/10/2021,Southwest,1,GACH,1,53,45,14,31,0,0,0,4,0,4,2,0,2,53,45,14,31,0,0,0,4,0,4,2,0,2
09/11/2021,Anchorage,7,GACH,1,730,694,625,69,122,110,12,213,52,161,123,0,123,730,694,625,69,122,110,12,213,52,161,123,0,123
09/11/2021,Anchorage,7,LTACH,0,44,44,42,2,6,6,0,23,4,19,0,0,0,44,44,42,2,6,6,0,23,4,19,0,0,0
09/11/2021,Anchorage,7,Psych,0,,,,,,,,,,,,,,220,201,122,79,0,0,0,0,0,0,0,5,5
09/11/2021,Gulf Coast,4,CAH,1,81,69,29,40,4,1,3,24,0,24,5,0,5,81,69,29,40,4,1,3,24,0,24,5,0,5
09/11/2021,Gulf Coast,4,GACH,1,93,53,43,10,9,9,0,14,2,12,15,0,15,93,53,43,10,9,9,0,14,2,12,15,0,15
09/11/2021,Interior,6,GACH,1,101,81,62,19,25,11,14,16,0,16,14,0,14,101,81,62,19,25,11,14,16,0,16,14,0,14
09/11/2021,Matanuska-Susitna,3,GACH,1,184,160,91,69,14,14,0,33,11,22,33,0,33,184,160,91,69,14,14,0,33,11,22,33,0,33
09/11/2021,Northern,2,CAH,1,81,47,30,17,0,0,0,36,0,36,5,0,5,81,47,30,17,0,0,0,36,0,36,5,0,5
09/11/2021,Southeast,5,CAH,1,70,70,34,36,2,2,0,33,0,33,4,0,4,70,70,34,36,2,2,0,33,0,33,4,0,4
09/11/2021,Southeast,5,GACH,1,161,133,47,86,9,6,3,20,1,19,3,0,3,161,133,47,86,9,6,3,20,1,19,3,0,3
09/11/2021,Southwest,1,CAH,1,22,12,7,5,0,0,0,4,0,4,3,0,3,22,12,7,5,0,0,0,4,0,4,3,0,3
09/11/2021,Southwest,1,GACH,1,53,45,16,29,0,0,0,4,0,4,2,0,2,53,45,16,29,0,0,0,4,0,4,2,0,2
09/12/2021,Anchorage,7,GACH,1,719,685,606,79,112,105,7,213,49,164,110,0,110,719,685,606,79,112,105,7,213,49,164,110,0,110
09/12/2021,Anchorage,7,LTACH,0,44,44,42,2,6,6,0,23,3,20,0,0,0,44,44,42,2,6,6,0,23,3,20,0,0,0
09/12/2021,Anchorage,7,Psych,0,,,,,,,,,,,,,,220,201,122,79,0,0,0,0,0,0,0,5,5
09/12/2021,Gulf Coast,4,CAH,1,81,70,33,37,4,1,3,24,0,24,7,0,7,81,70,33,37,4,1,3,24,0,24,7,0,7
09/12/2021,Gulf Coast,4,GACH,1,93,53,40,13,9,8,1,14,2,12,15,0,15,93,53,40,13,9,8,1,14,2,12,15,0,15
09/12/2021,Interior,6,GACH,1,101,81,67,14,25,8,17,16,0,16,16,0,16,101,81,67,14,25,8,17,16,0,16,16,0,16
09/12/2021,Matanuska-Susitna,3,GACH,1,184,160,90,70,14,14,0,33,11,22,36,0,36,184,160,90,70,14,14,0,33,11,22,36,0,36
09/12/2021,Northern,2,CAH,1,81,48,31,17,0,0,0,36,0,36,7,0,7,81,48,31,17,0,0,0,36,0,36,7,0,7
09/12/2021,Southeast,5,CAH,1,70,70,32,38,4,2,2,33,0,33,3,0,3,70,70,32,38,4,2,2,33,0,33,3,0,3
09/12/2021,Southeast,5,GACH,1,161,133,46,87,9,2,7,20,1,19,2,0,2,161,133,46,87,9,2,7,20,1,19,2,0,2
09/12/2021,Southwest,1,CAH,1,22,12,5,7,0,0,0,4,0,4,1,0,1,22,12,5,7,0,0,0,4,0,4,1,0,1
09/12/2021,Southwest,1,GACH,1,53,45,16,29,0,0,0,4,0,4,1,0,1,53,45,16,29,0,0,0,4,0,4,1,0,1
09/13/2021,Anchorage,7,GACH,1,715,687,605,82,121,110,11,216,52,164,102,0,102,715,687,605,82,121,110,11,216,52,164,102,0,102
09/13/2021,Anchorage,7,LTACH,0,44,44,42,2,6,6,0,23,3,20,0,0,0,44,44,42,2,6,6,0,23,3,20,0,0,0
09/13/2021,Anchorage,7,Psych,0,,,,,,,,,,,,,,220,201,122,79,0,0,0,0,0,0,0,5,5
09/13/2021,Gulf Coast,4,CAH,1,81,69,25,44,4,1,3,24,0,24,6,0,6,81,69,25,44,4,1,3,24,0,24,6,0,6
09/13/2021,Gulf Coast,4,GACH,1,93,53,44,9,9,8,1,14,2,12,16,0,16,93,53,44,9,9,8,1,14,2,12,16,0,16
09/13/2021,Interior,6,GACH,1,101,81,79,2,25,12,13,16,1,15,16,0,16,101,81,79,2,25,12,13,16,1,15,16,0,16
09/13/2021,Matanuska-Susitna,3,GACH,1,184,160,102,58,14,14,0,33,14,19,41,0,41,184,160,102,58,14,14,0,33,14,19,41,0,41
09/13/2021,Northern,2,CAH,1,81,45,30,15,0,0,0,36,0,36,6,0,6,81,45,30,15,0,0,0,36,0,36,6,0,6
09/13/2021,Southeast,5,CAH,1,70,70,34,36,4,2,2,33,0,33,2,0,2,70,70,34,36,4,2,2,33,0,33,2,0,2
09/13/2021,Southeast,5,GACH,1,161,133,48,85,9,2,7,20,1,19,4,0,4,161,133,48,85,9,2,7,20,1,19,4,0,4
09/13/2021,Southwest,1,CAH,1,22,12,3,9,0,0,0,4,0,4,1,0,1,22,12,3,9,0,0,0,4,0,4,1,0,1
09/13/2021,Southwest,1,GACH,1,53,45,15,30,0,0,0,4,0,4,0,0,0,53,45,15,30,0,0,0,4,0,4,0,0,0
09/14/2021,Anchorage,7,GACH,1,730,696,627,69,130,121,9,216,58,158,107,1,108,730,696,627,69,130,121,9,216,58,158,107,1,108
09/14/2021,Anchorage,7,LTACH,0,44,44,43,1,6,6,0,23,3,20,0,0,0,44,44,43,1,6,6,0,23,3,20,0,0,0
09/14/2021,Anchorage,7,Psych,0,,,,,,,,,,,,,,220,201,122,79,0,0,0,0,0,0,0,5,5
09/14/2021,Gulf Coast,4,CAH,1,81,69,26,43,4,1,3,24,0,24,7,0,7,81,69,26,43,4,1,3,24,0,24,7,0,7
09/14/2021,Gulf Coast,4,GACH,1,93,53,48,5,9,8,1,14,2,12,14,0,14,93,53,48,5,9,8,1,14,2,12,14,0,14
09/14/2021,Interior,6,GACH,1,101,81,72,9,25,11,14,16,1,15,16,0,16,101,81,72,9,25,11,14,16,1,15,16,0,16
09/14/2021,Matanuska-Susitna,3,GACH,1,184,160,114,46,14,14,0,33,13,20,43,0,43,184,160,114,46,14,14,0,33,13,20,43,0,43
09/14/2021,Northern,2,CAH,1,81,43,25,18,0,0,0,36,0,36,5,0,5,81,43,25,18,0,0,0,36,0,36,5,0,5
09/14/2021,Southeast,5,CAH,1,70,70,28,42,3,1,2,33,0,33,3,0,3,70,70,28,42,3,1,2,33,0,33,3,0,3
09/14/2021,Southeast,5,GACH,1,161,133,47,86,9,4,5,20,1,19,4,0,4,161,133,47,86,9,4,5,20,1,19,4,0,4
09/14/2021,Southwest,1,CAH,1,22,12,3,9,0,0,0,4,0,4,1,0,1,22,12,3,9,0,0,0,4,0,4,1,0,1
09/14/2021,Southwest,1,GACH,1,53,45,17,28,0,0,0,4,0,4,1,0,1,53,45,17,28,0,0,0,4,0,4,1,0,1
09/15/2021,Anchorage,7,GACH,1,732,697,644,53,124,116,8,216,58,158,110,1,111,732,697,644,53,124,116,8,216,58,158,110,1,111
09/15/2021,Anchorage,7,LTACH,0,44,44,40,4,6,6,0,23,1,22,0,0,0,44,44,40,4,6,6,0,23,1,22,0,0,0
09/15/2021,Anchorage,7,Psych,0,220,191,112,79,0,0,0,0,0,0,0,5,5,220,191,112,79,0,0,0,0,0,0,0,5,5
09/15/2021,Gulf Coast,4,CAH,1,83,72,30,42,4,2,2,24,0,24,6,0,6,83,72,30,42,4,2,2,24,0,24,6,0,6
09/15/2021,Gulf Coast,4,GACH,1,93,55,55,0,9,9,0,14,1,13,16,0,16,93,55,55,0,9,9,0,14,1,13,16,0,16
09/15/2021,Interior,6,GACH,1,101,81,66,15,25,12,13,16,1,15,15,0,15,101,81,66,15,25,12,13,16,1,15,15,0,15
09/15/2021,Matanuska-Susitna,3,GACH,1,184,160,104,56,14,14,0,33,14,19,43,0,43,184,160,104,56,14,14,0,33,14,19,43,0,43
09/15/2021,Northern,2,CAH,1,81,43,29,14,0,0,0,36,0,36,6,0,6,81,43,29,14,0,0,0,36,0,36,6,0,6
09/15/2021,Southeast,5,CAH,1,70,70,28,42,4,2,2,33,0,33,2,0,2,70,70,28,42,4,2,2,33,0,33,2,0,2
09/15/2021,Southeast,5,GACH,1,161,133,46,87,9,5,4,20,1,19,6,0,6,161,133,46,87,9,5,4,20,1,19,6,0,6
09/15/2021,Southwest,1,CAH,1,22,12,2,10,0,0,0,4,0,4,1,0,1,22,12,2,10,0,0,0,4,0,4,1,0,1
09/15/2021,Southwest,1,GACH,1,44,35,21,14,0,0,0,4,0,4,2,0,2,44,35,21,14,0,0,0,4,0,4,2,0,2
09/16/2021,Anchorage,7,GACH,1,706,681,629,52,112,105,7,213,58,155,114,1,115,706,681,629,52,112,105,7,213,58,155,114,1,115
09/16/2021,Anchorage,7,LTACH,0,44,44,41,3,6,6,0,23,2,21,0,0,0,44,44,41,3,6,6,0,23,2,21,0,0,0
09/16/2021,Anchorage,7,Psych,0,,,,,,,,,,,,,,220,191,112,79,0,0,0,0,0,0,0,5,5
09/16/2021,Gulf Coast,4,CAH,1,81,70,30,40,4,1,3,24,0,24,8,0,8,81,70,30,40,4,1,3,24,0,24,8,0,8
09/16/2021,Gulf Coast,4,GACH,1,93,55,55,0,9,9,0,14,1,13,15,0,15,93,55,55,0,9,9,0,14,1,13,15,0,15
09/16/2021,Interior,6,GACH,1,101,81,75,6,25,9,16,16,0,16,16,0,16,101,81,75,6,25,9,16,16,0,16,16,0,16
09/16/2021,Matanuska-Susitna,3,GACH,1,184,160,103,57,14,14,0,33,11,22,39,0,39,184,160,103,57,14,14,0,33,11,22,39,0,39
09/16/2021,Northern,2,CAH,1,81,43,26,17,0,0,0,36,0,36,6,0,6,81,43,26,17,0,0,0,36,0,36,6,0,6
09/16/2021,Southeast,5,CAH,1,70,70,25,45,4,2,2,33,0,33,3,0,3,70,70,25,45,4,2,2,33,0,33,3,0,3
09/16/2021,Southeast,5,GACH,1,161,133,45,88,9,6,3,20,0,20,8,0,8,161,133,45,88,9,6,3,20,0,20,8,0,8
09/16/2021,Southwest,1,CAH,1,22,12,3,9,0,0,0,4,0,4,1,0,1,22,12,3,9,0,0,0,4,0,4,1,0,1
09/16/2021,Southwest,1,GACH,1,44,35,19,16,0,0,0,4,0,4,1,0,1,44,35,19,16,0,0,0,4,0,4,1,0,1
09/17/2021,Anchorage,7,GACH,1,700,672,607,65,118,110,8,215,61,154,112,0,112,700,672,607,65,118,110,8,215,61,154,112,0,112
09/17/2021,Anchorage,7,LTACH,0,44,44,43,1,6,6,0,23,3,20,0,0,0,44,44,43,1,6,6,0,23,3,20,0,0,0
09/17/2021,Anchorage,7,Psych,0,,,,,,,,,,,,,,220,191,112,79,0,0,0,0,0,0,0,5,5
09/17/2021,Gulf Coast,4,CAH,1,82,71,25,46,4,3,1,24,0,24,6,0,6,82,71,25,46,4,3,1,24,0,24,6,0,6
09/17/2021,Gulf Coast,4,GACH,1,93,51,51,0,9,8,1,14,2,12,18,0,18,93,51,51,0,9,8,1,14,2,12,18,0,18
09/17/2021,Interior,6,GACH,1,101,81,62,19,25,8,17,16,1,15,17,0,17,101,81,62,19,25,8,17,16,1,15,17,0,17
09/17/2021,Matanuska-Susitna,3,GACH,1,184,160,92,68,14,14,0,33,9,24,41,0,41,184,160,92,68,14,14,0,33,9,24,41,0,41
09/17/2021,Northern,2,CAH,1,81,43,24,19,0,0,0,36,0,36,5,0,5,81,43,24,19,0,0,0,36,0,36,5,0,5
09/17/2021,Southeast,5,CAH,1,70,70,34,36,5,3,2,33,0,33,4,0,4,70,70,34,36,5,3,2,33,0,33,4,0,4
09/17/2021,Southeast,5,GACH,1,161,133,41,92,9,4,5,20,0,20,7,0,7,161,133,41,92,9,4,5,20,0,20,7,0,7
09/17/2021,Southwest,1,CAH,1,22,12,4,8,0,0,0,4,0,4,2,0,2,22,12,4,8,0,0,0,4,0,4,2,0,2
09/17/2021,Southwest,1,GACH,1,44,35,21,14,0,0,0,4,0,4,2,0,2,44,35,21,14,0,0,0,4,0,4,2,0,2
09/18/2021,Anchorage,7,GACH,1,708,678,600,78,117,108,9,224,62,162,104,0,104,708,678,600,78,117,108,9,224,62,162,104,0,104
09/18/2021,Anchorage,7,LTACH,0,44,44,41,3,6,6,0,23,2,21,0,0,0,44,44,41,3,6,6,0,23,2,21,0,0,0
09/18/2021,Anchorage,7,Psych,0,,,,,,,,,,,,,,220,191,112,79,0,0,0,0,0,0,0,5,5
09/18/2021,Gulf Coast,4,CAH,1,81,70,21,49,4,1,3,24,0,24,5,0,5,81,70,21,49,4,1,3,24,0,24,5,0,5
09/18/2021,Gulf Coast,4,GACH,1,93,51,51,0,9,8,1,14,2,12,18,0,18,93,51,51,0,9,8,1,14,2,12,18,0,18
09/18/2021,Interior,6,GACH,1,101,81,65,16,25,12,13,16,1,15,18,0,18,101,81,65,16,25,12,13,16,1,15,18,0,18
09/18/2021,Matanuska-Susitna,3,GACH,1,184,160,92,68,14,14,0,33,8,25,37,0,37,184,160,92,68,14,14,0,33,8,25,37,0,37
09/18/2021,Northern,2,CAH,1,81,43,23,20,0,0,0,36,0,36,3,0,3,81,43,23,20,0,0,0,36,0,36,3,0,3
09/18/2021,Southeast,5,CAH,1,70,70,38,32,5,3,2,33,0,33,5,0,5,70,70,38,32,5,3,2,33,0,33,5,0,5
09/18/2021,Southeast,5,GACH,1,161,133,49,84,9,5,4,20,1,19,8,0,8,161,133,49,84,9,5,4,20,1,19,8,0,8
09/18/2021,Southwest,1,CAH,1,22,12,5,7,0,0,0,4,0,4,2,0,2,22,12,5,7,0,0,0,4,0,4,2,0,2
09/18/2021,Southwest,1,GACH,1,44,35,17,18,0,0,0,4,0,4,2,0,2,44,35,17,18,0,0,0,4,0,4,2,0,2
09/19/2021,Anchorage,7,GACH,1,703,676,579,97,122,113,9,224,65,159,107,0,107,703,676,579,97,122,113,9,224,65,159,107,0,107
09/19/2021,Anchorage,7,LTACH,0,44,44,40,4,6,6,0,23,2,21,0,0,0,44,44,40,4,6,6,0,23,2,21,0,0,0
09/19/2021,Anchorage,7,Psych,0,,,,,,,,,,,,,,220,191,112,79,0,0,0,0,0,0,0,5,5
09/19/2021,Gulf Coast,4,CAH,1,81,70,25,45,4,0,4,24,0,24,8,0,8,81,70,25,45,4,0,4,24,0,24,8,0,8
09/19/2021,Gulf Coast,4,GACH,1,93,49,46,3,9,8,1,14,2,12,17,0,17,93,49,46,3,9,8,1,14,2,12,17,0,17
09/19/2021,Interior,6,GACH,1,101,81,79,2,25,9,16,16,0,16,19,0,19,101,81,79,2,25,9,16,16,0,16,19,0,19
09/19/2021,Matanuska-Susitna,3,GACH,1,184,160,95,65,14,14,0,33,9,24,41,0,41,184,160,95,65,14,14,0,33,9,24,41,0,41
09/19/2021,Northern,2,CAH,1,81,43,23,20,0,0,0,36,0,36,3,0,3,81,43,23,20,0,0,0,36,0,36,3,0,3
09/19/2021,Southeast,5,CAH,1,70,70,34,36,5,3,2,33,0,33,5,0,5,70,70,34,36,5,3,2,33,0,33,5,0,5
09/19/2021,Southeast,5,GACH,1,161,133,48,85,9,6,3,20,0,20,6,0,6,161,133,48,85,9,6,3,20,0,20,6,0,6
09/19/2021,Southwest,1,CAH,1,22,12,4,8,0,0,0,4,0,4,1,0,1,22,12,4,8,0,0,0,4,0,4,1,0,1
09/19/2021,Southwest,1,GACH,1,44,35,20,15,0,0,0,4,0,4,2,0,2,44,35,20,15,0,0,0,4,0,4,2,0,2
09/20/2021,Anchorage,7,GACH,1,706,679,573,106,125,113,12,224,61,163,97,0,97,706,679,573,106,125,113,12,224,61,163,97,0,97
09/20/2021,Anchorage,7,LTACH,0,44,44,40,4,6,6,0,23,2,21,0,0,0,44,44,40,4,6,6,0,23,2,21,0,0,0
09/20/2021,Anchorage,7,Psych,0,,,,,,,,,,,,,,220,191,112,79,0,0,0,0,0,0,0,5,5
09/20/2021,Gulf Coast,4,CAH,1,81,69,32,37,4,0,4,24,0,24,7,0,7,81,69,32,37,4,0,4,24,0,24,7,0,7
09/20/2021,Gulf Coast,4,GACH,1,93,52,52,0,9,9,0,14,2,12,19,0,19,93,52,52,0,9,9,0,14,2,12,19,0,19
09/20/2021,Interior,6,GACH,1,101,81,65,16,25,12,13,16,0,16,18,0,18,101,81,65,16,25,12,13,16,0,16,18,0,18
09/20/2021,Matanuska-Susitna,3,GACH,1,184,160,93,67,14,14,0,33,10,23,34,0,34,184,160,93,67,14,14,0,33,10,23,34,0,34
09/20/2021,Northern,2,CAH,1,81,43,21,22,0,0,0,36,0,36,2,0,2,81,43,21,22,0,0,0,36,0,36,2,0,2
09/20/2021,Southeast,5,CAH,1,70,70,39,31,6,4,2,33,0,33,7,0,7,70,70,39,31,6,4,2,33,0,33,7,0,7
09/20/2021,Southeast,5,GACH,1,161,133,46,87,9,6,3,20,0,20,5,0,5,161,133,46,87,9,6,3,20,0,20,5,0,5
09/20/2021,Southwest,1,CAH,1,22,12,4,8,0,0,0,4,0,4,1,0,1,22,12,4,8,0,0,0,4,0,4,1,0,1
09/20/2021,Southwest,1,GACH,1,44,35,20,15,0,0,0,4,0,4,2,0,2,44,35,20,15,0,0,0,4,0,4,2,0,2
09/21/2021,Anchorage,7,GACH,1,707,679,588,91,117,105,12,222,51,171,110,0,110,707,679,588,91,117,105,12,222,51,171,110,0,110
09/21/2021,Anchorage,7,LTACH,0,44,44,40,4,6,6,0,23,2,21,0,0,0,44,44,40,4,6,6,0,23,2,21,0,0,0
09/21/2021,Anchorage,7,Psych,0,,,,,,,,,,,,,,220,191,112,79,0,0,0,0,0,0,0,5,5
09/21/2021,Gulf Coast,4,CAH,1,81,70,30,40,4,0,4,24,0,24,8,0,8,81,70,30,40,4,0,4,24,0,24,8,0,8
09/21/2021,Gulf Coast,4,GACH,1,93,65,65,0,9,9,0,14,2,12,25,0,25,93,65,65,0,9,9,0,14,2,12,25,0,25
09/21/2021,Interior,6,GACH,1,101,81,66,15,25,8,17,16,1,15,16,1,17,101,81,66,15,25,8,17,16,1,15,16,1,17
09/21/2021,Matanuska-Susitna,3,GACH,1,184,160,90,70,14,13,1,33,9,24,33,0,33,184,160,90,70,14,13,1,33,9,24,33,0,33
09/21/2021,Northern,2,CAH,1,81,43,20,23,0,0,0,36,0,36,1,0,1,81,43,20,23,0,0,0,36,0,36,1,0,1
09/21/2021,Southeast,5,CAH,1,70,70,35,35,6,4,2,33,0,33,5,0,5,70,70,35,35,6,4,2,33,0,33,5,0,5
09/21/2021,Southeast,5,GACH,1,161,133,51,82,9,5,4,20,0,20,5,0,5,161,133,51,82,9,5,4,20,0,20,5,0,5
09/21/2021,Southwest,1,CAH,1,22,12,1,11,0,0,0,4,0,4,1,0,1,22,12,1,11,0,0,0,4,0,4,1,0,1
09/21/2021,Southwest,1,GACH,1,44,35,23,12,0,0,0,4,0,4,3,0,3,44,35,23,12,0,0,0,4,0,4,3,0,3
09/22/2021,Anchorage,7,GACH,1,726,691,630,61,121,112,9,222,57,165,112,1,113,726,691,630,61,121,112,9,222,57,165,112,1,113
09/22/2021,Anchorage,7,LTACH,0,44,44,42,2,6,6,0,23,2,21,0,0,0,44,44,42,2,6,6,0,23,2,21,0,0,0
09/22/2021,Anchorage,7,Psych,0,220,199,129,70,0,0,0,0,0,0,0,1,1,220,199,129,70,0,0,0,0,0,0,0,1,1
09/22/2021,Gulf Coast,4,CAH,1,81,70,35,35,4,0,4,24,0,24,9,0,9,81,70,35,35,4,0,4,24,0,24,9,0,9
09/22/2021,Gulf Coast,4,GACH,1,93,60,60,0,9,9,0,14,2,12,21,0,21,93,60,60,0,9,9,0,14,2,12,21,0,21
09/22/2021,Interior,6,GACH,1,101,81,64,17,25,11,14,16,2,14,14,0,14,101,81,64,17,25,11,14,16,2,14,14,0,14
09/22/2021,Matanuska-Susitna,3,GACH,1,184,160,102,58,14,14,0,33,11,22,33,0,33,184,160,102,58,14,14,0,33,11,22,33,0,33
09/22/2021,Northern,2,CAH,1,81,43,18,25,0,0,0,36,0,36,1,0,1,81,43,18,25,0,0,0,36,0,36,1,0,1
09/22/2021,Southeast,5,CAH,1,70,70,38,32,5,3,2,33,0,33,7,0,7,70,70,38,32,5,3,2,33,0,33,7,0,7
09/22/2021,Southeast,5,GACH,1,161,133,53,80,9,7,2,20,1,19,7,0,7,161,133,53,80,9,7,2,20,1,19,7,0,7
09/22/2021,Southwest,1,CAH,1,22,12,3,9,0,0,0,4,0,4,1,0,1,22,12,3,9,0,0,0,4,0,4,1,0,1
09/22/2021,Southwest,1,GACH,1,44,35,19,16,0,0,0,4,0,4,3,0,3,44,35,19,16,0,0,0,4,0,4,3,0,3
09/23/2021,Anchorage,7,GACH,1,738,704,643,61,123,111,12,224,56,168,119,1,120,738,704,643,61,123,111,12,224,56,168,119,1,120
09/23/2021,Anchorage,7,LTACH,0,44,44,42,2,6,6,0,23,2,21,0,0,0,44,44,42,2,6,6,0,23,2,21,0,0,0
09/23/2021,Anchorage,7,Psych,0,,,,,,,,,,,,,,220,199,129,70,0,0,0,0,0,0,0,1,1
09/23/2021,Gulf Coast,4,CAH,1,81,71,36,35,4,1,3,24,0,24,7,0,7,81,71,36,35,4,1,3,24,0,24,7,0,7
09/23/2021,Gulf Coast,4,GACH,1,93,61,61,0,9,9,0,14,4,10,23,0,23,93,61,61,0,9,9,0,14,4,10,23,0,23
09/23/2021,Interior,6,GACH,1,101,81,67,14,25,12,13,16,2,14,17,0,17,101,81,67,14,25,12,13,16,2,14,17,0,17
09/23/2021,Matanuska-Susitna,3,GACH,1,184,160,112,48,14,14,0,33,14,19,38,0,38,184,160,112,48,14,14,0,33,14,19,38,0,38
09/23/2021,Northern,2,CAH,1,81,43,16,27,0,0,0,36,0,36,0,0,0,81,43,16,27,0,0,0,36,0,36,0,0,0
09/23/2021,Southeast,5,CAH,1,70,70,40,30,5,3,2,33,0,33,4,0,4,70,70,40,30,5,3,2,33,0,33,4,0,4
09/23/2021,Southeast,5,GACH,1,161,133,53,80,9,6,3,20,0,20,8,0,8,161,133,53,80,9,6,3,20,0,20,8,0,8
09/23/2021,Southwest,1,CAH,1,22,12,4,8,0,0,0,4,0,4,1,0,1,22,12,4,8,0,0,0,4,0,4,1,0,1
09/23/2021,Southwest,1,GACH,1,44,35,20,15,0,0,0,4,0,4,4,0,4,44,35,20,15,0,0,0,4,0,4,4,0,4
09/24/2021,Anchorage,7,GACH,1,736,705,639,66,123,111,12,221,58,163,114,0,114,736,705,639,66,123,111,12,221,58,163,114,0,114
09/24/2021,Anchorage,7,LTACH,0,44,44,43,1,6,6,0,23,5,18,0,0,0,44,44,43,1,6,6,0,23,5,18,0,0,0
09/24/2021,Anchorage,7,Psych,0,,,,,,,,,,,,,,220,199,129,70,0,0,0,0,0,0,0,1,1
09/24/2021,Gulf Coast,4,CAH,1,81,72,27,45,4,0,4,24,0,24,5,0,5,81,72,27,45,4,0,4,24,0,24,5,0,5
09/24/2021,Gulf Coast,4,GACH,1,93,54,52,2,9,9,0,14,4,10,22,0,22,93,54,52,2,9,9,0,14,4,10,22,0,22
09/24/2021,Interior,6,GACH,1,101,81,69,12,25,12,13,16,1,15,16,0,16,101,81,69,12,25,12,13,16,1,15,16,0,16
09/24/2021,Matanuska-Susitna,3,GACH,1,184,160,99,61,14,14,0,33,13,20,40,0,40,184,160,99,61,14,14,0,33,13,20,40,0,40
09/24/2021,Northern,2,CAH,1,81,43,16,27,0,0,0,36,0,36,0,0,0,81,43,16,27,0,0,0,36,0,36,0,0,0
09/24/2021,Southeast,5,CAH,1,70,70,39,31,5,3,2,33,0,33,5,0,5,70,70,39,31,5,3,2,33,0,33,5,0,5
09/24/2021,Southeast,5,GACH,1,161,133,59,74,10,10,0,20,0,20,11,0,11,161,133,59,74,10,10,0,20,0,20,11,0,11
09/24/2021,Southwest,1,CAH,1,22,12,5,7,0,0,0,4,0,4,2,0,2,22,12,5,7,0,0,0,4,0,4,2,0,2
09/24/2021,Southwest,1,GACH,1,44,35,17,18,0,0,0,4,0,4,3,0,3,44,35,17,18,0,0,0,4,0,4,3,0,3
09/25/2021,Anchorage,7,GACH,1,707,677,617,60,122,110,12,221,53,168,112,0,112,707,677,617,60,122,110,12,221,53,168,112,0,112
09/25/2021,Anchorage,7,LTACH,0,44,44,43,1,6,6,0,23,3,20,0,0,0,44,44,43,1,6,6,0,23,3,20,0,0,0
09/25/2021,Anchorage,7,Psych,0,,,,,,,,,,,,,,220,199,129,70,0,0,0,0,0,0,0,1,1
09/25/2021,Gulf Coast,4,CAH,1,80,71,27,44,4,0,4,23,0,23,5,0,5,80,71,27,44,4,0,4,23,0,23,5,0,5
09/25/2021,Gulf Coast,4,GACH,1,93,50,50,0,9,9,0,14,4,10,23,0,23,93,50,50,0,9,9,0,14,4,10,23,0,23
09/25/2021,Interior,6,GACH,1,101,81,75,6,25,7,18,16,2,14,20,3,23,101,81,75,6,25,7,18,16,2,14,20,3,23
09/25/2021,Matanuska-Susitna,3,GACH,1,184,160,99,61,14,14,0,33,13,20,41,0,41,184,160,99,61,14,14,0,33,13,20,41,0,41
09/25/2021,Northern,2,CAH,1,81,43,17,26,0,0,0,36,0,36,1,0,1,81,43,17,26,0,0,0,36,0,36,1,0,1
09/25/2021,Southeast,5,CAH,1,70,70,38,32,5,4,1,33,0,33,6,0,6,70,70,38,32,5,4,1,33,0,33,6,0,6
09/25/2021,Southeast,5,GACH,1,161,133,56,77,9,8,1,20,0,20,10,0,10,161,133,56,77,9,8,1,20,0,20,10,0,10
09/25/2021,Southwest,1,CAH,1,22,12,4,8,0,0,0,4,0,4,2,0,2,22,12,4,8,0,0,0,4,0,4,2,0,2
09/25/2021,Southwest,1,GACH,1,44,35,17,18,0,0,0,4,0,4,3,0,3,44,35,17,18,0,0,0,4,0,4,3,0,3
09/26/2021,Anchorage,7,GACH,1,688,657,586,71,114,102,12,221,50,171,103,1,104,688,657,586,71,114,102,12,221,50,171,103,1,104
09/26/2021,Anchorage,7,LTACH,0,44,44,43,1,6,6,0,23,3,20,0,0,0,44,44,43,1,6,6,0,23,3,20,0,0,0
09/26/2021,Anchorage,7,Psych,0,,,,,,,,,,,,,,220,199,129,70,0,0,0,0,0,0,0,1,1
09/26/2021,Gulf Coast,4,CAH,1,80,71,31,40,4,1,3,24,0,24,5,0,5,80,71,31,40,4,1,3,24,0,24,5,0,5
09/26/2021,Gulf Coast,4,GACH,1,93,50,50,0,9,9,0,14,3,11,22,0,22,93,50,50,0,9,9,0,14,3,11,22,0,22
09/26/2021,Interior,6,GACH,1,101,81,68,13,25,7,18,16,1,15,19,0,19,101,81,68,13,25,7,18,16,1,15,19,0,19
09/26/2021,Matanuska-Susitna,3,GACH,1,184,160,93,67,14,14,0,33,13,20,39,0,39,184,160,93,67,14,14,0,33,13,20,39,0,39
09/26/2021,Northern,2,CAH,1,81,43,17,26,0,0,0,36,0,36,1,0,1,81,43,17,26,0,0,0,36,0,36,1,0,1
09/26/2021,Southeast,5,CAH,1,70,70,39,31,5,4,1,33,0,33,6,0,6,70,70,39,31,5,4,1,33,0,33,6,0,6
09/26/2021,Southeast,5,GACH,1,161,133,49,84,9,6,3,20,0,20,5,0,5,161,133,49,84,9,6,3,20,0,20,5,0,5
09/26/2021,Southwest,1,CAH,1,22,12,3,9,0,0,0,4,0,4,2,0,2,22,12,3,9,0,0,0,4,0,4,2,0,2
09/26/2021,Southwest,1,GACH,1,44,35,22,13,0,0,0,4,0,4,5,0,5,44,35,22,13,0,0,0,4,0,4,5,0,5
09/27/2021,Anchorage,7,GACH,1,691,663,578,85,115,104,11,221,48,173,97,1,98,691,663,578,85,115,104,11,221,48,173,97,1,98
09/27/2021,Anchorage,7,LTACH,0,44,44,43,1,6,6,0,23,4,19,0,0,0,44,44,43,1,6,6,0,23,4,19,0,0,0
09/27/2021,Anchorage,7,Psych,0,,,,,,,,,,,,,,220,199,129,70,0,0,0,0,0,0,0,1,1
09/27/2021,Gulf Coast,4,CAH,1,80,71,36,35,4,1,3,24,0,24,5,0,5,80,71,36,35,4,1,3,24,0,24,5,0,5
09/27/2021,Gulf Coast,4,GACH,1,93,51,51,0,9,9,0,14,5,9,23,0,23,93,51,51,0,9,9,0,14,5,9,23,0,23
09/27/2021,Interior,6,GACH,1,101,81,58,23,25,5,20,16,2,14,18,0,18,101,81,58,23,25,5,20,16,2,14,18,0,18
09/27/2021,Matanuska-Susitna,3,GACH,1,184,160,87,73,14,14,0,33,11,22,41,0,41,184,160,87,73,14,14,0,33,11,22,41,0,41
09/27/2021,Northern,2,CAH,1,81,43,22,21,0,0,0,36,0,36,3,0,3,81,43,22,21,0,0,0,36,0,36,3,0,3
09/27/2021,Southeast,5,CAH,1,70,70,39,31,5,3,2,33,0,33,7,0,7,70,70,39,31,5,3,2,33,0,33,7,0,7
09/27/2021,Southeast,5,GACH,1,161,133,48,85,9,9,0,20,1,19,6,0,6,161,133,48,85,9,9,0,20,1,19,6,0,6
09/27/2021,Southwest,1,CAH,1,22,12,2,10,0,0,0,4,0,4,1,0,1,22,12,2,10,0,0,0,4,0,4,1,0,1
09/27/2021,Southwest,1,GACH,1,44,35,24,11,0,0,0,4,0,4,6,0,6,44,35,24,11,0,0,0,4,0,4,6,0,6
09/28/2021,Anchorage,7,GACH,1,708,680,606,74,123,110,13,221,59,162,105,0,105,708,680,606,74,123,110,13,221,59,162,105,0,105
09/28/2021,Anchorage,7,LTACH,0,44,44,43,1,6,6,0,23,4,19,0,0,0,44,44,43,1,6,6,0,23,4,19,0,0,0
09/28/2021,Anchorage,7,Psych,0,,,,,,,,,,,,,,220,199,129,70,0,0,0,0,0,0,0,1,1
09/28/2021,Gulf Coast,4,CAH,1,80,71,37,34,4,1,3,24,0,24,6,0,6,80,71,37,34,4,1,3,24,0,24,6,0,6
09/28/2021,Gulf Coast,4,GACH,1,93,57,57,0,9,8,1,14,5,9,19,0,19,93,57,57,0,9,8,1,14,5,9,19,0,19
09/28/2021,Interior,6,GACH,1,101,81,61,20,25,6,19,16,2,14,19,1,20,101,81,61,20,25,6,19,16,2,14,19,1,20
09/28/2021,Matanuska-Susitna,3,GACH,1,184,160,97,63,14,14,0,33,14,19,37,0,37,184,160,97,63,14,14,0,33,14,19,37,0,37
09/28/2021,Northern,2,CAH,1,81,43,25,18,0,0,0,36,0,36,1,0,1,81,43,25,18,0,0,0,36,0,36,1,0,1
09/28/2021,Southeast,5,CAH,1,70,70,35,35,4,2,2,33,0,33,7,0,7,70,70,35,35,4,2,2,33,0,33,7,0,7
09/28/2021,Southeast,5,GACH,1,161,133,51,82,9,5,4,20,0,20,7,0,7,161,133,51,82,9,5,4,20,0,20,7,0,7
09/28/2021,Southwest,1,CAH,1,22,12,1,11,0,0,0,4,0,4,1,0,1,22,12,1,11,0,0,0,4,0,4,1,0,1
09/28/2021,Southwest,1,GACH,1,44,35,21,14,0,0,0,8,4,4,6,0,6,44,35,21,14,0,0,0,8,4,4,6,0,6
09/29/2021,Anchorage,7,GACH,1,714,682,606,76,121,109,12,221,58,163,101,0,101,714,682,606,76,121,109,12,221,58,163,101,0,101
09/29/2021,Anchorage,7,LTACH,0,44,44,41,3,6,6,0,23,4,19,0,0,0,44,44,41,3,6,6,0,23,4,19,0,0,0
09/29/2021,Anchorage,7,Psych,0,220,197,133,64,0,0,0,0,0,0,0,2,2,220,197,133,64,0,0,0,0,0,0,0,2,2
09/29/2021,Gulf Coast,4,CAH,1,82,70,39,31,4,2,2,24,0,24,3,0,3,82,70,39,31,4,2,2,24,0,24,3,0,3
09/29/2021,Gulf Coast,4,GACH,1,93,60,60,0,9,9,0,14,4,10,18,0,18,93,60,60,0,9,9,0,14,4,10,18,0,18
09/29/2021,Interior,6,GACH,1,101,81,74,7,25,11,14,16,3,13,21,0,21,101,81,74,7,25,11,14,16,3,13,21,0,21
09/29/2021,Matanuska-Susitna,3,GACH,1,184,160,101,59,14,14,0,33,12,21,41,0,41,184,160,101,59,14,14,0,33,12,21,41,0,41
09/29/2021,Northern,2,CAH,1,81,43,21,22,0,0,0,36,0,36,3,0,3,81,43,21,22,0,0,0,36,0,36,3,0,3
09/29/2021,Southeast,5,CAH,1,70,70,35,35,5,3,2,33,0,33,5,0,5,70,70,35,35,5,3,2,33,0,33,5,0,5
09/29/2021,Southeast,5,GACH,1,161,133,47,86,9,3,6,20,1,19,6,0,6,161,133,47,86,9,3,6,20,1,19,6,0,6
09/29/2021,Southwest,1,CAH,1,22,12,3,9,0,0,0,4,0,4,1,0,1,22,12,3,9,0,0,0,4,0,4,1,0,1
09/29/2021,Southwest,1,GACH,1,44,35,23,12,0,0,0,8,4,4,5,0,5,44,35,23,12,0,0,0,8,4,4,5,0,5
09/30/2021,Anchorage,7,GACH,1,714,683,584,99,119,107,12,221,54,167,94,0,94,714,683,584,99,119,107,12,221,54,167,94,0,94
09/30/2021,Anchorage,7,LTACH,0,44,44,41,3,6,6,0,23,2,21,0,0,0,44,44,41,3,6,6,0,23,2,21,0,0,0
09/30/2021,Anchorage,7,Psych,0,,,,,,,,,,,,,,220,197,133,64,0,0,0,0,0,0,0,2,2
09/30/2021,Gulf Coast,4,CAH,1,82,71,30,41,4,1,3,24,0,24,1,0,1,82,71,30,41,4,1,3,24,0,24,1,0,1
09/30/2021,Gulf Coast,4,GACH,1,93,54,54,0,9,9,0,14,6,8,17,0,17,93,54,54,0,9,9,0,14,6,8,17,0,17
09/30/2021,Interior,6,GACH,1,101,81,73,8,25,11,14,16,2,14,20,0,20,101,81,73,8,25,11,14,16,2,14,20,0,20
09/30/2021,Matanuska-Susitna,3,GACH,1,184,160,97,63,14,14,0,33,16,17,43,0,43,184,160,97,63,14,14,0,33,16,17,43,0,43
09/30/2021,Northern,2,CAH,1,81,43,21,22,0,0,0,36,0,36,3,0,3,81,43,21,22,0,0,0,36,0,36,3,0,3
09/30/2021,Southeast,5,CAH,1,70,70,34,36,5,3,2,33,0,33,5,0,5,70,70,34,36,5,3,2,33,0,33,5,0,5
09/30/2021,Southeast,5,GACH,1,161,133,46,87,9,4,5,20,0,20,5,0,5,161,133,46,87,9,4,5,20,0,20,5,0,5
09/30/2021,Southwest,1,CAH,1,22,12,2,10,0,0,0,4,0,4,2,0,2,22,12,2,10,0,0,0,4,0,4,2,0,2
09/30/2021,Southwest,1,GACH,1,44,35,21,14,0,0,0,8,2,6,6,0,6,44,35,21,14,0,0,0,8,2,6,6,0,6
10/01/2021,Anchorage,7,GACH,1,705,679,596,83,111,100,11,221,58,163,100,1,101,705,679,596,83,111,100,11,221,58,163,100,1,101
10/01/2021,Anchorage,7,LTACH,0,44,44,40,4,6,6,0,23,2,21,0,0,0,44,44,40,4,6,6,0,23,2,21,0,0,0
10/01/2021,Anchorage,7,Psych,0,,,,,,,,,,,,,,220,197,133,64,0,0,0,0,0,0,0,2,2
10/01/2021,Gulf Coast,4,CAH,1,82,71,27,44,4,1,3,24,0,24,1,0,1,82,71,27,44,4,1,3,24,0,24,1,0,1
10/01/2021,Gulf Coast,4,GACH,1,93,52,52,0,9,8,1,14,6,8,19,0,19,93,52,52,0,9,8,1,14,6,8,19,0,19
10/01/2021,Interior,6,GACH,1,101,81,65,16,25,12,13,16,1,15,24,0,24,101,81,65,16,25,12,13,16,1,15,24,0,24
10/01/2021,Matanuska-Susitna,3,GACH,1,184,160,92,68,14,14,0,33,16,17,45,0,45,184,160,92,68,14,14,0,33,16,17,45,0,45
10/01/2021,Northern,2,CAH,1,81,43,22,21,0,0,0,36,0,36,3,0,3,81,43,22,21,0,0,0,36,0,36,3,0,3
10/01/2021,Southeast,5,CAH,1,70,70,37,33,5,3,2,33,0,33,7,0,7,70,70,37,33,5,3,2,33,0,33,7,0,7
10/01/2021,Southeast,5,GACH,1,161,133,43,90,9,5,4,20,0,20,7,0,7,161,133,43,90,9,5,4,20,0,20,7,0,7
10/01/2021,Southwest,1,CAH,1,22,12,5,7,0,0,0,4,0,4,2,0,2,22,12,5,7,0,0,0,4,0,4,2,0,2
10/01/2021,Southwest,1,GACH,1,44,35,22,13,0,0,0,8,2,6,5,0,5,44,35,22,13,0,0,0,8,2,6,5,0,5
10/02/2021,Anchorage,7,GACH,1,705,679,599,80,114,103,11,221,53,168,97,1,98,705,679,599,80,114,103,11,221,53,168,97,1,98
10/02/2021,Anchorage,7,LTACH,0,44,44,43,1,6,6,0,23,3,20,0,0,0,44,44,43,1,6,6,0,23,3,20,0,0,0
10/02/2021,Anchorage,7,Psych,0,,,,,,,,,,,,,,220,197,133,64,0,0,0,0,0,0,0,2,2
10/02/2021,Gulf Coast,4,CAH,1,82,71,30,41,4,2,2,24,0,24,3,0,3,82,71,30,41,4,2,2,24,0,24,3,0,3
10/02/2021,Gulf Coast,4,GACH,1,93,50,50,0,9,9,0,14,6,8,16,0,16,93,50,50,0,9,9,0,14,6,8,16,0,16
10/02/2021,Interior,6,GACH,1,101,83,83,0,25,12,13,16,1,15,27,1,28,101,83,83,0,25,12,13,16,1,15,27,1,28
10/02/2021,Matanuska-Susitna,3,GACH,1,184,160,92,68,14,14,0,33,16,17,45,0,45,184,160,92,68,14,14,0,33,16,17,45,0,45
10/02/2021,Northern,2,CAH,1,81,43,19,24,0,0,0,36,0,36,4,0,4,81,43,19,24,0,0,0,36,0,36,4,0,4
10/02/2021,Southeast,5,CAH,1,70,70,37,33,5,3,2,33,0,33,6,0,6,70,70,37,33,5,3,2,33,0,33,6,0,6
10/02/2021,Southeast,5,GACH,1,161,133,42,91,9,9,0,20,0,20,5,0,5,161,133,42,91,9,9,0,20,0,20,5,0,5
10/02/2021,Southwest,1,CAH,1,22,12,4,8,0,0,0,4,0,4,2,0,2,22,12,4,8,0,0,0,4,0,4,2,0,2
10/02/2021,Southwest,1,GACH,1,44,35,24,11,0,0,0,8,4,4,8,0,8,44,35,24,11,0,0,0,8,4,4,8,0,8
10/03/2021,Anchorage,7,GACH,1,698,672,569,103,120,105,15,221,57,164,87,0,87,698,672,569,103,120,105,15,221,57,164,87,0,87
10/03/2021,Anchorage,7,LTACH,0,44,44,41,3,6,6,0,23,3,20,0,0,0,44,44,41,3,6,6,0,23,3,20,0,0,0
10/03/2021,Anchorage,7,Psych,0,,,,,,,,,,,,,,220,197,133,64,0,0,0,0,0,0,0,2,2
10/03/2021,Gulf Coast,4,CAH,1,82,71,30,41,4,1,3,24,0,24,3,0,3,82,71,30,41,4,1,3,24,0,24,3,0,3
10/03/2021,Gulf Coast,4,GACH,1,93,51,51,0,9,9,0,14,7,7,18,0,18,93,51,51,0,9,9,0,14,7,7,18,0,18
10/03/2021,Interior,6,GACH,1,101,89,89,0,25,13,12,16,1,15,31,3,34,101,89,89,0,25,13,12,16,1,15,31,3,34
10/03/2021,Matanuska-Susitna,3,GACH,1,184,160,92,68,14,14,0,33,16,17,45,0,45,184,160,92,68,14,14,0,33,16,17,45,0,45
10/03/2021,Northern,2,CAH,1,81,43,22,21,0,0,0,36,0,36,5,0,5,81,43,22,21,0,0,0,36,0,36,5,0,5
10/03/2021,Southeast,5,CAH,1,70,70,43,27,5,3,2,33,0,33,6,0,6,70,70,43,27,5,3,2,33,0,33,6,0,6
10/03/2021,Southeast,5,GACH,1,161,133,39,94,9,2,7,20,0,20,6,0,6,161,133,39,94,9,2,7,20,0,20,6,0,6
10/03/2021,Southwest,1,CAH,1,22,12,4,8,0,0,0,4,0,4,2,0,2,22,12,4,8,0,0,0,4,0,4,2,0,2
10/03/2021,Southwest,1,GACH,1,44,35,20,15,0,0,0,8,4,4,8,0,8,44,35,20,15,0,0,0,8,4,4,8,0,8
10/04/2021,Anchorage,7,GACH,1,702,676,587,89,120,108,12,216,54,162,80,1,81,702,676,587,89,120,108,12,216,54,162,80,1,81
10/04/2021,Anchorage,7,LTACH,0,44,44,41,3,6,6,0,23,3,20,0,0,0,44,44,41,3,6,6,0,23,3,20,0,0,0
10/04/2021,Anchorage,7,Psych,0,,,,,,,,,,,,,,220,197,133,64,0,0,0,0,0,0,0,2,2
10/04/2021,Gulf Coast,4,CAH,1,82,71,24,47,4,0,4,24,0,24,3,0,3,82,71,24,47,4,0,4,24,0,24,3,0,3
10/04/2021,Gulf Coast,4,GACH,1,93,49,49,0,9,9,0,14,8,6,18,0,18,93,49,49,0,9,9,0,14,8,6,18,0,18
10/04/2021,Interior,6,GACH,1,101,81,81,0,25,11,14,16,1,15,28,1,29,101,81,81,0,25,11,14,16,1,15,28,1,29
10/04/2021,Matanuska-Susitna,3,GACH,1,184,160,77,83,14,14,0,33,13,20,37,0,37,184,160,77,83,14,14,0,33,13,20,37,0,37
10/04/2021,Northern,2,CAH,1,81,43,23,20,0,0,0,36,0,36,5,0,5,81,43,23,20,0,0,0,36,0,36,5,0,5
10/04/2021,Southeast,5,CAH,1,70,70,34,36,2,0,2,33,0,33,3,0,3,70,70,34,36,2,0,2,33,0,33,3,0,3
10/04/2021,Southeast,5,GACH,1,161,133,39,94,9,2,7,20,0,20,6,0,6,161,133,39,94,9,2,7,20,0,20,6,0,6
10/04/2021,Southwest,1,CAH,1,22,12,3,9,0,0,0,4,0,4,1,0,1,22,12,3,9,0,0,0,4,0,4,1,0,1
10/04/2021,Southwest,1,GACH,1,44,35,21,14,0,0,0,8,4,4,9,0,9,44,35,21,14,0,0,0,8,4,4,9,0,9
10/05/2021,Anchorage,7,GACH,1,719,691,600,91,124,110,14,221,47,174,81,1,82,719,691,600,91,124,110,14,221,47,174,81,1,82
10/05/2021,Anchorage,7,LTACH,0,44,44,41,3,6,6,0,23,3,20,0,0,0,44,44,41,3,6,6,0,23,3,20,0,0,0
10/05/2021,Anchorage,7,Psych,0,,,,,,,,,,,,,,220,197,133,64,0,0,0,0,0,0,0,2,2
10/05/2021,Gulf Coast,4,CAH,1,82,70,27,43,4,0,4,24,0,24,4,0,4,82,70,27,43,4,0,4,24,0,24,4,0,4
10/05/2021,Gulf Coast,4,GACH,1,93,49,48,1,9,9,0,14,10,4,19,0,19,93,49,48,1,9,9,0,14,10,4,19,0,19
10/05/2021,Interior,6,GACH,1,101,88,88,0,25,5,20,16,1,15,28,1,29,101,88,88,0,25,5,20,16,1,15,28,1,29
10/05/2021,Matanuska-Susitna,3,GACH,1,184,160,86,74,14,14,0,33,12,21,33,0,33,184,160,86,74,14,14,0,33,12,21,33,0,33
10/05/2021,Northern,2,CAH,1,81,43,22,21,0,0,0,36,0,36,3,0,3,81,43,22,21,0,0,0,36,0,36,3,0,3
10/05/2021,Southeast,5,CAH,1,70,70,35,35,5,3,2,33,0,33,3,0,3,70,70,35,35,5,3,2,33,0,33,3,0,3
10/05/2021,Southeast,5,GACH,1,161,133,38,95,9,2,7,20,0,20,2,0,2,161,133,38,95,9,2,7,20,0,20,2,0,2
10/05/2021,Southwest,1,CAH,1,22,12,3,9,0,0,0,4,0,4,1,0,1,22,12,3,9,0,0,0,4,0,4,1,0,1
10/05/2021,Southwest,1,GACH,1,44,35,19,16,0,0,0,8,4,4,7,0,7,44,35,19,16,0,0,0,8,4,4,7,0,7
10/06/2021,Anchorage,7,GACH,1,732,703,619,84,123,108,15,221,45,176,88,0,88,732,703,619,84,123,108,15,221,45,176,88,0,88
10/06/2021,Anchorage,7,LTACH,0,44,44,41,3,6,6,0,23,3,20,0,0,0,44,44,41,3,6,6,0,23,3,20,0,0,0
10/06/2021,Anchorage,7,Psych,0,220,197,129,68,0,0,0,0,0,0,0,2,2,220,197,129,68,0,0,0,0,0,0,0,2,2
10/06/2021,Gulf Coast,4,CAH,1,82,70,29,41,4,0,4,24,0,24,5,0,5,82,70,29,41,4,0,4,24,0,24,5,0,5
10/06/2021,Gulf Coast,4,GACH,1,93,49,48,1,9,8,1,14,7,7,17,0,17,93,49,48,1,9,8,1,14,7,7,17,0,17
10/06/2021,Interior,6,GACH,1,101,81,76,5,25,7,18,16,1,15,26,0,26,101,81,76,5,25,7,18,16,1,15,26,0,26
10/06/2021,Matanuska-Susitna,3,GACH,1,184,160,97,63,14,14,0,33,13,20,34,0,34,184,160,97,63,14,14,0,33,13,20,34,0,34
10/06/2021,Northern,2,CAH,1,81,43,25,18,0,0,0,36,0,36,4,0,4,81,43,25,18,0,0,0,36,0,36,4,0,4
10/06/2021,Southeast,5,CAH,1,70,70,35,35,4,2,2,33,0,33,2,0,2,70,70,35,35,4,2,2,33,0,33,2,0,2
10/06/2021,Southeast,5,GACH,1,161,133,39,94,9,4,5,20,1,19,2,0,2,161,133,39,94,9,4,5,20,1,19,2,0,2
10/06/2021,Southwest,1,CAH,1,22,12,4,8,0,0,0,4,0,4,1,0,1,22,12,4,8,0,0,0,4,0,4,1,0,1
10/06/2021,Southwest,1,GACH,1,44,35,19,16,0,0,0,8,4,4,7,0,7,44,35,19,16,0,0,0,8,4,4,7,0,7
10/07/2021,Anchorage,7,GACH,1,734,706,634,72,129,116,13,221,50,171,86,0,86,734,706,634,72,129,116,13,221,50,171,86,0,86
10/07/2021,Anchorage,7,LTACH,0,44,44,43,1,6,6,0,23,4,19,0,0,0,44,44,43,1,6,6,0,23,4,19,0,0,0
10/07/2021,Anchorage,7,Psych,0,,,,,,,,,,,,,,220,197,129,68,0,0,0,0,0,0,0,2,2
10/07/2021,Gulf Coast,4,CAH,1,82,70,30,40,4,1,3,24,0,24,6,0,6,82,70,30,40,4,1,3,24,0,24,6,0,6
10/07/2021,Gulf Coast,4,GACH,1,93,49,48,1,9,8,1,14,7,7,16,0,16,93,49,48,1,9,8,1,14,7,7,16,0,16
10/07/2021,Interior,6,GACH,1,101,81,77,4,25,13,12,16,0,16,25,0,25,101,81,77,4,25,13,12,16,0,16,25,0,25
10/07/2021,Matanuska-Susitna,3,GACH,1,184,160,91,69,14,14,0,33,13,20,38,0,38,184,160,91,69,14,14,0,33,13,20,38,0,38
10/07/2021,Northern,2,CAH,1,81,43,21,22,0,0,0,36,0,36,4,0,4,81,43,21,22,0,0,0,36,0,36,4,0,4
10/07/2021,Southeast,5,CAH,1,70,70,34,36,4,2,2,33,0,33,2,0,2,70,70,34,36,4,2,2,33,0,33,2,0,2
10/07/2021,Southeast,5,GACH,1,161,133,35,98,9,6,3,20,3,17,3,0,3,161,133,35,98,9,6,3,20,3,17,3,0,3
10/07/2021,Southwest,1,CAH,1,22,12,5,7,0,0,0,4,0,4,0,0,0,22,12,5,7,0,0,0,4,0,4,0,0,0
10/07/2021,Southwest,1,GACH,1,44,35,14,21,0,0,0,8,3,5,4,0,4,44,35,14,21,0,0,0,8,3,5,4,0,4
10/08/2021,Anchorage,7,GACH,1,720,693,628,65,134,123,11,221,58,163,88,0,88,720,693,628,65,134,123,11,221,58,163,88,0,88
10/08/2021,Anchorage,7,LTACH,0,44,44,42,2,6,6,0,23,5,18,0,0,0,44,44,42,2,6,6,0,23,5,18,0,0,0
10/08/2021,Anchorage,7,Psych,0,,,,,,,,,,,,,,220,197,129,68,0,0,0,0,0,0,0,2,2
10/08/2021,Gulf Coast,4,CAH,1,82,70,33,37,4,1,3,24,0,24,6,0,6,82,70,33,37,4,1,3,24,0,24,6,0,6
10/08/2021,Gulf Coast,4,GACH,1,93,53,53,0,9,9,0,14,5,9,17,0,17,93,53,53,0,9,9,0,14,5,9,17,0,17
10/08/2021,Interior,6,GACH,1,101,81,81,0,25,11,14,16,0,16,25,0,25,101,81,81,0,25,11,14,16,0,16,25,0,25
10/08/2021,Matanuska-Susitna,3,GACH,1,184,160,77,83,14,14,0,33,9,24,38,0,38,184,160,77,83,14,14,0,33,9,24,38,0,38
10/08/2021,Northern,2,CAH,1,81,43,23,20,0,0,0,36,0,36,4,0,4,81,43,23,20,0,0,0,36,0,36,4,0,4
10/08/2021,Southeast,5,CAH,1,70,70,34,36,4,2,2,33,0,33,2,0,2,70,70,34,36,4,2,2,33,0,33,2,0,2
10/08/2021,Southeast,5,GACH,1,161,133,29,104,9,5,4,20,2,18,3,0,3,161,133,29,104,9,5,4,20,2,18,3,0,3
10/08/2021,Southwest,1,CAH,1,22,12,4,8,0,0,0,4,0,4,0,0,0,22,12,4,8,0,0,0,4,0,4,0,0,0
10/08/2021,Southwest,1,GACH,1,44,35,15,20,0,0,0,8,3,5,4,0,4,44,35,15,20,0,0,0,8,3,5,4,0,4
10/09/2021,Anchorage,7,GACH,1,700,673,620,53,131,123,8,221,55,166,85,0,85,700,673,620,53,131,123,8,221,55,166,85,0,85
10/09/2021,Anchorage,7,LTACH,0,44,44,42,2,6,6,0,23,6,17,0,0,0,44,44,42,2,6,6,0,23,6,17,0,0,0
10/09/2021,Anchorage,7,Psych,0,,,,,,,,,,,,,,220,197,129,68,0,0,0,0,0,0,0,2,2
10/09/2021,Gulf Coast,4,CAH,1,82,70,34,36,4,1,3,24,0,24,7,0,7,82,70,34,36,4,1,3,24,0,24,7,0,7
10/09/2021,Gulf Coast,4,GACH,1,93,51,51,0,9,9,0,14,5,9,19,0,19,93,51,51,0,9,9,0,14,5,9,19,0,19
10/09/2021,Interior,6,GACH,1,101,81,79,2,25,11,14,16,0,16,18,0,18,101,81,79,2,25,11,14,16,0,16,18,0,18
10/09/2021,Matanuska-Susitna,3,GACH,1,184,160,81,79,14,14,0,33,10,23,36,0,36,184,160,81,79,14,14,0,33,10,23,36,0,36
10/09/2021,Northern,2,CAH,1,81,43,27,16,0,0,0,36,0,36,2,0,2,81,43,27,16,0,0,0,36,0,36,2,0,2
10/09/2021,Southeast,5,CAH,1,70,70,35,35,4,2,2,33,0,33,2,0,2,70,70,35,35,4,2,2,33,0,33,2,0,2
10/09/2021,Southeast,5,GACH,1,161,133,35,98,9,2,7,20,2,18,3,0,3,161,133,35,98,9,2,7,20,2,18,3,0,3
10/09/2021,Southwest,1,CAH,1,22,12,5,7,0,0,0,4,0,4,0,0,0,22,12,5,7,0,0,0,4,0,4,0,0,0
10/09/2021,Southwest,1,GACH,1,44,35,18,17,0,0,0,8,3,5,5,0,5,44,35,18,17,0,0,0,8,3,5,5,0,5
10/10/2021,Anchorage,7,GACH,1,723,691,640,51,119,115,4,221,47,174,90,0,90,723,691,640,51,119,115,4,221,47,174,90,0,90
10/10/2021,Anchorage,7,LTACH,0,44,44,40,4,6,6,0,23,5,18,0,0,0,44,44,40,4,6,6,0,23,5,18,0,0,0
10/10/2021,Anchorage,7,Psych,0,,,,,,,,,,,,,,220,197,129,68,0,0,0,0,0,0,0,2,2
10/10/2021,Gulf Coast,4,CAH,1,82,71,33,38,4,1,3,24,0,24,6,0,6,82,71,33,38,4,1,3,24,0,24,6,0,6
10/10/2021,Gulf Coast,4,GACH,1,93,53,53,0,9,8,1,14,5,9,22,0,22,93,53,53,0,9,8,1,14,5,9,22,0,22
10/10/2021,Interior,6,GACH,1,101,84,84,0,25,13,12,16,0,16,20,0,20,101,84,84,0,25,13,12,16,0,16,20,0,20
10/10/2021,Matanuska-Susitna,3,GACH,1,184,160,95,65,14,14,0,33,9,24,39,0,39,184,160,95,65,14,14,0,33,9,24,39,0,39
10/10/2021,Northern,2,CAH,1,81,43,28,15,0,0,0,36,0,36,2,0,2,81,43,28,15,0,0,0,36,0,36,2,0,2
10/10/2021,Southeast,5,CAH,1,70,70,42,28,4,2,2,33,0,33,2,0,2,70,70,42,28,4,2,2,33,0,33,2,0,2
10/10/2021,Southeast,5,GACH,1,161,133,44,89,9,4,5,20,1,19,3,0,3,161,133,44,89,9,4,5,20,1,19,3,0,3
10/10/2021,Southwest,1,CAH,1,22,12,7,5,0,0,0,4,0,4,0,0,0,22,12,7,5,0,0,0,4,0,4,0,0,0
10/10/2021,Southwest,1,GACH,1,44,35,17,18,0,0,0,8,2,6,4,0,4,44,35,17,18,0,0,0,8,2,6,4,0,4
10/11/2021,Anchorage,7,GACH,1,721,695,618,77,128,113,15,221,45,176,89,0,89,721,695,618,77,128,113,15,221,45,176,89,0,89
10/11/2021,Anchorage,7,LTACH,0,44,44,39,5,6,6,0,23,6,17,0,0,0,44,44,39,5,6,6,0,23,6,17,0,0,0
10/11/2021,Anchorage,7,Psych,0,,,,,,,,,,,,,,220,197,129,68,0,0,0,0,0,0,0,2,2
10/11/2021,Gulf Coast,4,CAH,1,82,70,30,40,4,1,3,24,0,24,5,0,5,82,70,30,40,4,1,3,24,0,24,5,0,5
10/11/2021,Gulf Coast,4,GACH,1,93,55,55,0,9,9,0,14,5,9,25,0,25,93,55,55,0,9,9,0,14,5,9,25,0,25
10/11/2021,Interior,6,GACH,1,101,84,84,0,25,11,14,16,0,16,23,0,23,101,84,84,0,25,11,14,16,0,16,23,0,23
10/11/2021,Matanuska-Susitna,3,GACH,1,184,160,90,70,14,14,0,33,7,26,35,0,35,184,160,90,70,14,14,0,33,7,26,35,0,35
10/11/2021,Northern,2,CAH,1,81,43,16,27,0,0,0,36,0,36,1,0,1,81,43,16,27,0,0,0,36,0,36,1,0,1
10/11/2021,Southeast,5,CAH,1,70,70,34,36,4,2,2,33,0,33,2,0,2,70,70,34,36,4,2,2,33,0,33,2,0,2
10/11/2021,Southeast,5,GACH,1,161,133,44,89,9,5,4,20,0,20,3,0,3,161,133,44,89,9,5,4,20,0,20,3,0,3
10/11/2021,Southwest,1,CAH,1,22,12,5,7,0,0,0,4,0,4,0,0,0,22,12,5,7,0,0,0,4,0,4,0,0,0
10/11/2021,Southwest,1,GACH,1,44,35,15,20,0,0,0,8,2,6,5,0,5,44,35,15,20,0,0,0,8,2,6,5,0,5
10/12/2021,Anchorage,7,GACH,1,728,700,649,51,132,120,12,221,52,169,94,1,95,728,700,649,51,132,120,12,221,52,169,94,1,95
10/12/2021,Anchorage,7,LTACH,0,44,44,40,4,6,6,0,23,6,17,0,0,0,44,44,40,4,6,6,0,23,6,17,0,0,0
10/12/2021,Anchorage,7,Psych,0,,,,,,,,,,,,,,220,197,129,68,0,0,0,0,0,0,0,2,2
10/12/2021,Gulf Coast,4,CAH,1,82,70,34,36,4,0,4,24,0,24,4,0,4,82,70,34,36,4,0,4,24,0,24,4,0,4
10/12/2021,Gulf Coast,4,GACH,1,93,57,57,0,9,9,0,14,5,9,22,0,22,93,57,57,0,9,9,0,14,5,9,22,0,22
10/12/2021,Interior,6,GACH,1,101,85,85,0,25,11,14,16,0,16,24,1,25,101,85,85,0,25,11,14,16,0,16,24,1,25
10/12/2021,Matanuska-Susitna,3,GACH,1,184,160,97,63,14,13,1,33,7,26,41,0,41,184,160,97,63,14,13,1,33,7,26,41,0,41
10/12/2021,Northern,2,CAH,1,81,43,23,20,0,0,0,36,0,36,3,0,3,81,43,23,20,0,0,0,36,0,36,3,0,3
10/12/2021,Southeast,5,CAH,1,70,70,35,35,3,3,0,33,0,33,1,0,1,70,70,35,35,3,3,0,33,0,33,1,0,1
10/12/2021,Southeast,5,GACH,1,161,133,42,91,9,5,4,20,0,20,3,0,3,161,133,42,91,9,5,4,20,0,20,3,0,3
10/12/2021,Southwest,1,CAH,1,22,12,6,6,0,0,0,4,0,4,0,0,0,22,12,6,6,0,0,0,4,0,4,0,0,0
10/12/2021,Southwest,1,GACH,1,44,35,17,18,0,0,0,8,2,6,5,0,5,44,35,17,18,0,0,0,8,2,6,5,0,5
10/13/2021,Anchorage,7,GACH,1,739,708,654,54,129,115,14,221,39,182,93,2,95,739,708,654,54,129,115,14,221,39,182,93,2,95
10/13/2021,Anchorage,7,LTACH,0,44,44,40,4,6,6,0,23,6,17,0,0,0,44,44,40,4,6,6,0,23,6,17,0,0,0
10/13/2021,Anchorage,7,Psych,0,220,191,131,60,0,0,0,0,0,0,1,0,1,220,191,131,60,0,0,0,0,0,0,1,0,1
10/13/2021,Gulf Coast,4,CAH,1,83,71,30,41,4,0,4,24,0,24,4,0,4,83,71,30,41,4,0,4,24,0,24,4,0,4
10/13/2021,Gulf Coast,4,GACH,1,93,58,58,0,9,9,0,14,5,9,22,0,22,93,58,58,0,9,9,0,14,5,9,22,0,22
10/13/2021,Interior,6,GACH,1,101,94,94,0,25,13,12,16,0,16,30,0,30,101,94,94,0,25,13,12,16,0,16,30,0,30
10/13/2021,Matanuska-Susitna,3,GACH,1,184,160,102,58,14,13,1,33,9,24,46,0,46,184,160,102,58,14,13,1,33,9,24,46,0,46
10/13/2021,Northern,2,CAH,1,81,43,25,18,0,0,0,36,0,36,4,0,4,81,43,25,18,0,0,0,36,0,36,4,0,4
10/13/2021,Southeast,5,CAH,1,70,70,35,35,3,2,1,33,0,33,2,0,2,70,70,35,35,3,2,1,33,0,33,2,0,2
10/13/2021,Southeast,5,GACH,1,161,133,39,94,9,6,3,20,0,20,1,0,1,161,133,39,94,9,6,3,20,0,20,1,0,1
10/13/2021,Southwest,1,CAH,1,22,12,5,7,0,0,0,4,0,4,1,0,1,22,12,5,7,0,0,0,4,0,4,1,0,1
10/13/2021,Southwest,1,GACH,1,44,35,16,19,0,0,0,8,0,8,6,0,6,44,35,16,19,0,0,0,8,0,8,6,0,6
10/14/2021,Anchorage,7,GACH,1,737,706,640,66,124,110,14,219,48,171,98,1,99,737,706,640,66,124,110,14,219,48,171,98,1,99
10/14/2021,Anchorage,7,LTACH,0,44,44,40,4,6,6,0,23,6,17,0,0,0,44,44,40,4,6,6,0,23,6,17,0,0,0
10/14/2021,Anchorage,7,Psych,0,,,,,,,,,,,,,,220,191,131,60,0,0,0,0,0,0,1,0,1
10/14/2021,Gulf Coast,4,CAH,1,82,70,27,43,4,0,4,24,0,24,3,0,3,82,70,27,43,4,0,4,24,0,24,3,0,3
10/14/2021,Gulf Coast,4,GACH,1,93,54,53,1,9,6,3,14,5,9,20,0,20,93,54,53,1,9,6,3,14,5,9,20,0,20
10/14/2021,Interior,6,GACH,1,101,84,84,0,25,16,9,16,0,16,27,0,27,101,84,84,0,25,16,9,16,0,16,27,0,27
10/14/2021,Matanuska-Susitna,3,GACH,1,184,160,106,54,14,14,0,33,9,24,44,0,44,184,160,106,54,14,14,0,33,9,24,44,0,44
10/14/2021,Northern,2,CAH,1,81,43,20,23,0,0,0,36,0,36,2,0,2,81,43,20,23,0,0,0,36,0,36,2,0,2
10/14/2021,Southeast,5,CAH,1,70,70,37,33,6,5,1,33,0,33,2,0,2,70,70,37,33,6,5,1,33,0,33,2,0,2
10/14/2021,Southeast,5,GACH,1,161,133,38,95,9,5,4,20,0,20,0,0,0,161,133,38,95,9,5,4,20,0,20,0,0,0
10/14/2021,Southwest,1,CAH,1,22,12,5,7,0,0,0,4,0,4,1,0,1,22,12,5,7,0,0,0,4,0,4,1,0,1
10/14/2021,Southwest,1,GACH,1,44,35,17,18,0,0,0,8,0,8,6,0,6,44,35,17,18,0,0,0,8,0,8,6,0,6
10/15/2021,Anchorage,7,GACH,1,735,705,633,72,127,114,13,219,51,168,101,1,102,735,705,633,72,127,114,13,219,51,168,101,1,102
10/15/2021,Anchorage,7,LTACH,0,44,44,40,4,6,6,0,23,6,17,0,0,0,44,44,40,4,6,6,0,23,6,17,0,0,0
10/15/2021,Anchorage,7,Psych,0,,,,,,,,,,,,,,220,191,131,60,0,0,0,0,0,0,1,0,1
10/15/2021,Gulf Coast,4,CAH,1,83,73,23,50,4,0,4,24,0,24,5,0,5,83,73,23,50,4,0,4,24,0,24,5,0,5
10/15/2021,Gulf Coast,4,GACH,1,93,50,50,0,9,8,1,14,6,8,21,0,21,93,50,50,0,9,8,1,14,6,8,21,0,21
10/15/2021,Interior,6,GACH,1,101,81,75,6,25,11,14,16,1,15,25,0,25,101,81,75,6,25,11,14,16,1,15,25,0,25
10/15/2021,Matanuska-Susitna,3,GACH,1,184,160,106,54,14,14,0,33,13,20,45,0,45,184,160,106,54,14,14,0,33,13,20,45,0,45
10/15/2021,Northern,2,CAH,1,81,43,21,22,0,0,0,36,0,36,2,0,2,81,43,21,22,0,0,0,36,0,36,2,0,2
10/15/2021,Southeast,5,CAH,1,70,70,32,38,5,3,2,33,0,33,2,0,2,70,70,32,38,5,3,2,33,0,33,2,0,2
10/15/2021,Southeast,5,GACH,1,161,133,40,93,9,3,6,20,1,19,1,0,1,161,133,40,93,9,3,6,20,1,19,1,0,1
10/15/2021,Southwest,1,CAH,1,22,12,4,8,0,0,0,4,0,4,0,0,0,22,12,4,8,0,0,0,4,0,4,0,0,0
10/15/2021,Southwest,1,GACH,1,44,35,18,17,0,0,0,8,0,8,7,0,7,44,35,18,17,0,0,0,8,0,8,7,0,7
10/16/2021,Anchorage,7,GACH,1,728,697,618,79,127,116,11,219,50,169,107,1,108,728,697,618,79,127,116,11,219,50,169,107,1,108
10/16/2021,Anchorage,7,LTACH,0,44,44,39,5,6,6,0,23,6,17,0,0,0,44,44,39,5,6,6,0,23,6,17,0,0,0
10/16/2021,Anchorage,7,Psych,0,,,,,,,,,,,,,,220,191,131,60,0,0,0,0,0,0,1,0,1
10/16/2021,Gulf Coast,4,CAH,1,81,71,23,48,4,0,4,24,0,24,5,0,5,81,71,23,48,4,0,4,24,0,24,5,0,5
10/16/2021,Gulf Coast,4,GACH,1,93,49,43,6,9,8,1,14,6,8,18,0,18,93,49,43,6,9,8,1,14,6,8,18,0,18
10/16/2021,Interior,6,GACH,1,101,82,82,0,25,15,10,16,1,15,25,0,25,101,82,82,0,25,15,10,16,1,15,25,0,25
10/16/2021,Matanuska-Susitna,3,GACH,1,184,160,100,60,14,14,0,33,13,20,42,0,42,184,160,100,60,14,14,0,33,13,20,42,0,42
10/16/2021,Northern,2,CAH,1,81,43,17,26,0,0,0,36,0,36,2,0,2,81,43,17,26,0,0,0,36,0,36,2,0,2
10/16/2021,Southeast,5,CAH,1,70,70,39,31,5,3,2,33,0,33,1,0,1,70,70,39,31,5,3,2,33,0,33,1,0,1
10/16/2021,Southeast,5,GACH,1,161,133,35,98,9,5,4,20,1,19,2,0,2,161,133,35,98,9,5,4,20,1,19,2,0,2
10/16/2021,Southwest,1,CAH,1,22,12,5,7,0,0,0,4,0,4,1,0,1,22,12,5,7,0,0,0,4,0,4,1,0,1
10/16/2021,Southwest,1,GACH,1,44,35,20,15,0,0,0,8,0,8,6,0,6,44,35,20,15,0,0,0,8,0,8,6,0,6
10/17/2021,Anchorage,7,GACH,1,750,709,635,74,129,117,12,219,53,166,101,1,102,750,709,635,74,129,117,12,219,53,166,101,1,102
10/17/2021,Anchorage,7,LTACH,0,44,44,39,5,6,6,0,23,5,18,0,0,0,44,44,39,5,6,6,0,23,5,18,0,0,0
10/17/2021,Anchorage,7,Psych,0,,,,,,,,,,,,,,220,191,131,60,0,0,0,0,0,0,1,0,1
10/17/2021,Gulf Coast,4,CAH,1,81,71,24,47,4,1,3,24,0,24,6,0,6,81,71,24,47,4,1,3,24,0,24,6,0,6
10/17/2021,Gulf Coast,4,GACH,1,93,49,48,1,9,9,0,14,6,8,21,0,21,93,49,48,1,9,9,0,14,6,8,21,0,21
10/17/2021,Interior,6,GACH,1,101,81,81,0,25,14,11,16,2,14,28,0,28,101,81,81,0,25,14,11,16,2,14,28,0,28
10/17/2021,Matanuska-Susitna,3,GACH,1,184,160,95,65,14,14,0,33,10,23,43,0,43,184,160,95,65,14,14,0,33,10,23,43,0,43
10/17/2021,Northern,2,CAH,1,81,43,17,26,0,0,0,36,0,36,2,0,2,81,43,17,26,0,0,0,36,0,36,2,0,2
10/17/2021,Southeast,5,CAH,1,70,70,40,30,5,3,2,33,0,33,1,0,1,70,70,40,30,5,3,2,33,0,33,1,0,1
10/17/2021,Southeast,5,GACH,1,161,133,32,101,9,7,2,20,0,20,1,0,1,161,133,32,101,9,7,2,20,0,20,1,0,1
10/17/2021,Southwest,1,CAH,1,22,12,5,7,0,0,0,4,0,4,0,0,0,22,12,5,7,0,0,0,4,0,4,0,0,0
10/17/2021,Southwest,1,GACH,1,44,35,20,15,0,0,0,8,0,8,7,0,7,44,35,20,15,0,0,0,8,0,8,7,0,7
10/18/2021,Anchorage,7,GACH,1,765,731,656,75,133,121,12,219,51,168,103,2,105,765,731,656,75,133,121,12,219,51,168,103,2,105
10/18/2021,Anchorage,7,LTACH,0,44,44,39,5,6,6,0,23,5,18,0,0,0,44,44,39,5,6,6,0,23,5,18,0,0,0
10/18/2021,Anchorage,7,Psych,0,,,,,,,,,,,,,,220,191,131,60,0,0,0,0,0,0,1,0,1
10/18/2021,Gulf Coast,4,CAH,1,81,71,26,45,4,1,3,24,0,24,5,0,5,81,71,26,45,4,1,3,24,0,24,5,0,5
10/18/2021,Gulf Coast,4,GACH,1,93,49,49,0,9,8,1,14,6,8,18,0,18,93,49,49,0,9,8,1,14,6,8,18,0,18
10/18/2021,Interior,6,GACH,1,101,81,71,10,25,10,15,16,1,15,24,0,24,101,81,71,10,25,10,15,16,1,15,24,0,24
10/18/2021,Matanuska-Susitna,3,GACH,1,184,160,104,56,14,14,0,33,9,24,46,0,46,184,160,104,56,14,14,0,33,9,24,46,0,46
10/18/2021,Northern,2,CAH,1,81,43,21,22,0,0,0,36,0,36,3,0,3,81,43,21,22,0,0,0,36,0,36,3,0,3
10/18/2021,Southeast,5,CAH,1,70,70,39,31,5,3,2,33,0,33,1,0,1,70,70,39,31,5,3,2,33,0,33,1,0,1
10/18/2021,Southeast,5,GACH,1,161,133,35,98,9,8,1,20,0,20,1,0,1,161,133,35,98,9,8,1,20,0,20,1,0,1
10/18/2021,Southwest,1,CAH,1,22,12,4,8,0,0,0,4,0,4,1,0,1,22,12,4,8,0,0,0,4,0,4,1,0,1
10/18/2021,Southwest,1,GACH,1,44,35,26,9,0,0,0,8,0,8,8,0,8,44,35,26,9,0,0,0,8,0,8,8,0,8
10/19/2021,Anchorage,7,GACH,1,772,736,655,81,130,116,14,219,47,172,97,2,99,772,736,655,81,130,116,14,219,47,172,97,2,99
10/19/2021,Anchorage,7,LTACH,0,44,44,38,6,6,6,0,23,3,20,0,0,0,44,44,38,6,6,6,0,23,3,20,0,0,0
10/19/2021,Anchorage,7,Psych,0,,,,,,,,,,,,,,220,191,131,60,0,0,0,0,0,0,1,0,1
10/19/2021,Gulf Coast,4,CAH,1,81,71,33,38,4,0,4,24,0,24,5,0,5,81,71,33,38,4,0,4,24,0,24,5,0,5
10/19/2021,Gulf Coast,4,GACH,1,93,54,49,5,9,9,0,14,6,8,18,0,18,93,54,49,5,9,9,0,14,6,8,18,0,18
10/19/2021,Interior,6,GACH,1,101,81,75,6,25,11,14,16,2,14,23,0,23,101,81,75,6,25,11,14,16,2,14,23,0,23
10/19/2021,Matanuska-Susitna,3,GACH,1,184,160,111,49,14,14,0,33,13,20,45,0,45,184,160,111,49,14,14,0,33,13,20,45,0,45
10/19/2021,Northern,2,CAH,1,81,43,19,24,0,0,0,36,0,36,3,0,3,81,43,19,24,0,0,0,36,0,36,3,0,3
10/19/2021,Southeast,5,CAH,1,70,70,41,29,3,1,2,33,0,33,1,0,1,70,70,41,29,3,1,2,33,0,33,1,0,1
10/19/2021,Southeast,5,GACH,1,161,133,39,94,9,8,1,20,0,20,1,0,1,161,133,39,94,9,8,1,20,0,20,1,0,1
10/19/2021,Southwest,1,CAH,1,22,12,3,9,0,0,0,4,0,4,1,0,1,22,12,3,9,0,0,0,4,0,4,1,0,1
10/19/2021,Southwest,1,GACH,1,44,35,21,14,0,0,0,8,0,8,7,0,7,44,35,21,14,0,0,0,8,0,8,7,0,7
10/20/2021,Anchorage,7,GACH,1,762,732,670,62,127,118,9,219,44,175,109,1,110,762,732,670,62,127,118,9,219,44,175,109,1,110
10/20/2021,Anchorage,7,LTACH,0,44,44,40,4,6,6,0,23,4,19,0,0,0,44,44,40,4,6,6,0,23,4,19,0,0,0
10/20/2021,Anchorage,7,Psych,0,220,190,128,62,0,0,0,0,0,0,7,0,7,220,190,128,62,0,0,0,0,0,0,7,0,7
10/20/2021,Gulf Coast,4,CAH,1,81,71,32,39,4,1,3,24,0,24,4,0,4,81,71,32,39,4,1,3,24,0,24,4,0,4
10/20/2021,Gulf Coast,4,GACH,1,93,58,58,0,9,9,0,14,5,9,21,0,21,93,58,58,0,9,9,0,14,5,9,21,0,21
10/20/2021,Interior,6,GACH,1,101,81,80,1,25,11,14,16,2,14,30,0,30,101,81,80,1,25,11,14,16,2,14,30,0,30
10/20/2021,Matanuska-Susitna,3,GACH,1,184,160,96,64,14,14,0,33,16,17,49,0,49,184,160,96,64,14,14,0,33,16,17,49,0,49
10/20/2021,Northern,2,CAH,1,81,43,20,23,0,0,0,36,0,36,3,0,3,81,43,20,23,0,0,0,36,0,36,3,0,3
10/20/2021,Southeast,5,CAH,1,70,70,44,26,5,3,2,33,0,33,1,0,1,70,70,44,26,5,3,2,33,0,33,1,0,1
10/20/2021,Southeast,5,GACH,1,161,133,50,83,9,7,2,20,1,19,4,0,4,161,133,50,83,9,7,2,20,1,19,4,0,4
10/20/2021,Southwest,1,CAH,1,22,12,3,9,0,0,0,4,0,4,2,0,2,22,12,3,9,0,0,0,4,0,4,2,0,2
10/20/2021,Southwest,1,GACH,1,44,35,21,14,0,0,0,8,0,8,7,0,7,44,35,21,14,0,0,0,8,0,8,7,0,7
10/21/2021,Anchorage,7,GACH,1,763,731,672,59,127,117,10,221,44,177,105,0,105,763,731,672,59,127,117,10,221,44,177,105,0,105
10/21/2021,Anchorage,7,LTACH,0,44,44,41,3,6,6,0,23,4,19,0,0,0,44,44,41,3,6,6,0,23,4,19,0,0,0
10/21/2021,Anchorage,7,Psych,0,,,,,,,,,,,,,,220,190,128,62,0,0,0,0,0,0,7,0,7
10/21/2021,Gulf Coast,4,CAH,1,82,71,30,41,4,1,3,24,0,24,5,0,5,82,71,30,41,4,1,3,24,0,24,5,0,5
10/21/2021,Gulf Coast,4,GACH,1,93,57,57,0,9,9,0,14,5,9,21,0,21,93,57,57,0,9,9,0,14,5,9,21,0,21
10/21/2021,Interior,6,GACH,1,101,81,65,16,25,12,13,16,2,14,22,0,22,101,81,65,16,25,12,13,16,2,14,22,0,22
10/21/2021,Matanuska-Susitna,3,GACH,1,184,160,103,57,14,14,0,33,16,17,49,0,49,184,160,103,57,14,14,0,33,16,17,49,0,49
10/21/2021,Northern,2,CAH,1,81,43,26,17,0,0,0,36,0,36,6,0,6,81,43,26,17,0,0,0,36,0,36,6,0,6
10/21/2021,Southeast,5,CAH,1,45,45,29,16,2,0,2,16,0,16,2,0,2,70,70,46,24,5,3,2,33,0,33,2,0,2
10/21/2021,Southeast,5,GACH,1,161,133,49,84,9,8,1,20,0,20,2,0,2,161,133,49,84,9,8,1,20,0,20,2,0,2
10/21/2021,Southwest,1,CAH,1,22,12,3,9,0,0,0,4,0,4,2,0,2,22,12,3,9,0,0,0,4,0,4,2,0,2
10/21/2021,Southwest,1,GACH,1,44,35,18,17,0,0,0,8,0,8,7,0,7,44,35,18,17,0,0,0,8,0,8,7,0,7
10/22/2021,Anchorage,7,GACH,1,746,714,656,58,123,114,9,221,47,174,105,0,105,746,714,656,58,123,114,9,221,47,174,105,0,105
10/22/2021,Anchorage,7,LTACH,0,44,44,42,2,6,6,0,23,4,19,0,0,0,44,44,42,2,6,6,0,23,4,19,0,0,0
10/22/2021,Anchorage,7,Psych,0,,,,,,,,,,,,,,220,190,128,62,0,0,0,0,0,0,7,0,7
10/22/2021,Gulf Coast,4,CAH,1,82,71,31,40,4,2,2,24,0,24,4,0,4,82,71,31,40,4,2,2,24,0,24,4,0,4
10/22/2021,Gulf Coast,4,GACH,1,93,56,56,0,9,9,0,14,5,9,24,0,24,93,56,56,0,9,9,0,14,5,9,24,0,24
10/22/2021,Interior,6,GACH,1,101,81,64,17,25,9,16,16,1,15,23,0,23,101,81,64,17,25,9,16,16,1,15,23,0,23
10/22/2021,Matanuska-Susitna,3,GACH,1,184,160,99,61,14,14,0,33,14,19,48,0,48,184,160,99,61,14,14,0,33,14,19,48,0,48
10/22/2021,Northern,2,CAH,1,81,43,26,17,0,0,0,36,0,36,6,0,6,81,43,26,17,0,0,0,36,0,36,6,0,6
10/22/2021,Southeast,5,CAH,1,70,70,43,27,2,0,2,33,0,33,5,0,5,70,70,43,27,2,0,2,33,0,33,5,0,5
10/22/2021,Southeast,5,GACH,1,161,133,41,92,9,6,3,20,0,20,5,0,5,161,133,41,92,9,6,3,20,0,20,5,0,5
10/22/2021,Southwest,1,CAH,1,22,12,4,8,0,0,0,4,0,4,1,0,1,22,12,4,8,0,0,0,4,0,4,1,0,1
10/22/2021,Southwest,1,GACH,1,44,35,17,18,0,0,0,8,0,8,5,0,5,44,35,17,18,0,0,0,8,0,8,5,0,5
10/23/2021,Anchorage,7,GACH,1,738,701,639,62,121,113,8,221,44,177,107,0,107,738,701,639,62,121,113,8,221,44,177,107,0,107
10/23/2021,Anchorage,7,LTACH,0,44,44,42,2,6,6,0,23,6,17,0,0,0,44,44,42,2,6,6,0,23,6,17,0,0,0
10/23/2021,Anchorage,7,Psych,0,,,,,,,,,,,,,,220,190,128,62,0,0,0,0,0,0,7,0,7
10/23/2021,Gulf Coast,4,CAH,1,82,71,28,43,4,2,2,24,0,24,6,0,6,82,71,28,43,4,2,2,24,0,24,6,0,6
10/23/2021,Gulf Coast,4,GACH,1,93,58,58,0,9,9,0,14,7,7,29,0,29,93,58,58,0,9,9,0,14,7,7,29,0,29
10/23/2021,Interior,6,GACH,1,101,81,66,15,25,11,14,16,2,14,20,0,20,101,81,66,15,25,11,14,16,2,14,20,0,20
10/23/2021,Matanuska-Susitna,3,GACH,1,184,160,101,59,14,14,0,33,14,19,46,0,46,184,160,101,59,14,14,0,33,14,19,46,0,46
10/23/2021,Northern,2,CAH,1,81,43,21,22,0,0,0,36,0,36,4,0,4,81,43,21,22,0,0,0,36,0,36,4,0,4
10/23/2021,Southeast,5,CAH,1,70,70,40,30,2,1,1,33,0,33,5,0,5,70,70,40,30,2,1,1,33,0,33,5,0,5
10/23/2021,Southeast,5,GACH,1,161,133,41,92,9,6,3,20,0,20,5,0,5,161,133,41,92,9,6,3,20,0,20,5,0,5
10/23/2021,Southwest,1,CAH,1,22,12,4,8,0,0,0,4,0,4,1,0,1,22,12,4,8,0,0,0,4,0,4,1,0,1
10/23/2021,Southwest,1,GACH,1,44,35,19,16,0,0,0,8,0,8,5,0,5,44,35,19,16,0,0,0,8,0,8,5,0,5
10/24/2021,Anchorage,7,GACH,1,717,685,622,63,123,114,9,221,42,179,113,0,113,717,685,622,63,123,114,9,221,42,179,113,0,113
10/24/2021,Anchorage,7,LTACH,0,44,44,42,2,6,6,0,23,6,17,0,0,0,44,44,42,2,6,6,0,23,6,17,0,0,0
10/24/2021,Anchorage,7,Psych,0,,,,,,,,,,,,,,220,190,128,62,0,0,0,0,0,0,7,0,7
10/24/2021,Gulf Coast,4,CAH,1,82,71,31,40,4,1,3,24,0,24,7,0,7,82,71,31,40,4,1,3,24,0,24,7,0,7
10/24/2021,Gulf Coast,4,GACH,1,93,61,61,0,9,9,0,14,5,9,31,0,31,93,61,61,0,9,9,0,14,5,9,31,0,31
10/24/2021,Interior,6,GACH,1,101,81,76,5,25,8,17,16,2,14,23,0,23,101,81,76,5,25,8,17,16,2,14,23,0,23
10/24/2021,Matanuska-Susitna,3,GACH,1,184,160,98,62,14,14,0,33,15,18,43,0,43,184,160,98,62,14,14,0,33,15,18,43,0,43
10/24/2021,Northern,2,CAH,1,81,43,23,20,0,0,0,36,0,36,5,0,5,81,43,23,20,0,0,0,36,0,36,5,0,5
10/24/2021,Southeast,5,CAH,1,70,70,33,37,2,0,2,33,0,33,4,0,4,70,70,33,37,2,0,2,33,0,33,4,0,4
10/24/2021,Southeast,5,GACH,1,161,133,36,97,9,4,5,20,1,19,4,0,4,161,133,36,97,9,4,5,20,1,19,4,0,4
10/24/2021,Southwest,1,CAH,1,22,12,6,6,0,0,0,4,0,4,2,0,2,22,12,6,6,0,0,0,4,0,4,2,0,2
10/24/2021,Southwest,1,GACH,1,44,35,16,19,0,0,0,8,0,8,5,0,5,44,35,16,19,0,0,0,8,0,8,5,0,5
10/25/2021,Anchorage,7,GACH,1,724,695,635,60,120,109,11,221,35,186,106,1,107,724,695,635,60,120,109,11,221,35,186,106,1,107
10/25/2021,Anchorage,7,LTACH,0,44,44,42,2,6,6,0,23,6,17,0,0,0,44,44,42,2,6,6,0,23,6,17,0,0,0
10/25/2021,Anchorage,7,Psych,0,,,,,,,,,,,,,,220,190,128,62,0,0,0,0,0,0,7,0,7
10/25/2021,Gulf Coast,4,CAH,1,82,71,33,38,4,1,3,24,0,24,7,0,7,82,71,33,38,4,1,3,24,0,24,7,0,7
10/25/2021,Gulf Coast,4,GACH,1,93,62,62,0,9,9,0,14,6,8,31,0,31,93,62,62,0,9,9,0,14,6,8,31,0,31
10/25/2021,Interior,6,GACH,1,101,81,74,7,25,13,12,16,3,13,24,0,24,101,81,74,7,25,13,12,16,3,13,24,0,24
10/25/2021,Matanuska-Susitna,3,GACH,1,184,160,101,59,14,14,0,33,16,17,46,0,46,184,160,101,59,14,14,0,33,16,17,46,0,46
10/25/2021,Northern,2,CAH,1,81,43,22,21,0,0,0,36,0,36,3,0,3,81,43,22,21,0,0,0,36,0,36,3,0,3
10/25/2021,Southeast,5,CAH,1,70,70,29,41,4,2,2,33,0,33,4,0,4,70,70,29,41,4,2,2,33,0,33,4,0,4
10/25/2021,Southeast,5,GACH,1,161,133,44,89,9,5,4,20,0,20,4,0,4,161,133,44,89,9,5,4,20,0,20,4,0,4
10/25/2021,Southwest,1,CAH,1,22,12,5,7,0,0,0,4,0,4,2,0,2,22,12,5,7,0,0,0,4,0,4,2,0,2
10/25/2021,Southwest,1,GACH,1,44,35,15,20,0,0,0,8,0,8,3,0,3,44,35,15,20,0,0,0,8,0,8,3,0,3
10/26/2021,Anchorage,7,GACH,1,756,718,659,59,123,108,15,221,42,179,108,0,108,756,718,659,59,123,108,15,221,42,179,108,0,108
10/26/2021,Anchorage,7,LTACH,0,44,44,42,2,6,6,0,23,6,17,0,0,0,44,44,42,2,6,6,0,23,6,17,0,0,0
10/26/2021,Anchorage,7,Psych,0,,,,,,,,,,,,,,220,190,128,62,0,0,0,0,0,0,7,0,7
10/26/2021,Gulf Coast,4,CAH,1,82,71,31,40,4,1,3,24,0,24,8,0,8,82,71,31,40,4,1,3,24,0,24,8,0,8
10/26/2021,Gulf Coast,4,GACH,1,93,64,64,0,9,8,1,14,6,8,29,0,29,93,64,64,0,9,8,1,14,6,8,29,0,29
10/26/2021,Interior,6,GACH,1,101,81,79,2,25,15,10,16,3,13,22,1,23,101,81,79,2,25,15,10,16,3,13,22,1,23
10/26/2021,Matanuska-Susitna,3,GACH,1,184,160,102,58,14,14,0,33,13,20,47,0,47,184,160,102,58,14,14,0,33,13,20,47,0,47
10/26/2021,Northern,2,CAH,1,81,43,20,23,0,0,0,36,0,36,4,0,4,81,43,20,23,0,0,0,36,0,36,4,0,4
10/26/2021,Southeast,5,CAH,1,70,70,31,39,4,2,2,33,0,33,3,0,3,70,70,31,39,4,2,2,33,0,33,3,0,3
10/26/2021,Southeast,5,GACH,1,161,133,49,84,9,6,3,20,0,20,5,0,5,161,133,49,84,9,6,3,20,0,20,5,0,5
10/26/2021,Southwest,1,CAH,1,22,12,5,7,0,0,0,4,0,4,3,0,3,22,12,5,7,0,0,0,4,0,4,3,0,3
10/26/2021,Southwest,1,GACH,1,44,35,10,25,0,0,0,8,0,8,2,0,2,44,35,10,25,0,0,0,8,0,8,2,0,2
10/27/2021,Anchorage,7,GACH,1,742,716,665,51,122,111,11,221,46,175,103,1,104,742,716,665,51,122,111,11,221,46,175,103,1,104
10/27/2021,Anchorage,7,LTACH,0,44,44,43,1,6,6,0,23,4,19,0,0,0,44,44,43,1,6,6,0,23,4,19,0,0,0
10/27/2021,Anchorage,7,Psych,0,220,191,131,60,0,0,0,0,0,0,12,0,12,220,191,131,60,0,0,0,0,0,0,12,0,12
10/27/2021,Gulf Coast,4,CAH,1,82,71,29,42,4,1,3,24,0,24,7,0,7,82,71,29,42,4,1,3,24,0,24,7,0,7
10/27/2021,Gulf Coast,4,GACH,1,93,62,62,0,9,9,0,14,6,8,24,0,24,93,62,62,0,9,9,0,14,6,8,24,0,24
10/27/2021,Interior,6,GACH,1,101,81,74,7,25,15,10,16,2,14,19,2,21,101,81,74,7,25,15,10,16,2,14,19,2,21
10/27/2021,Matanuska-Susitna,3,GACH,1,184,160,100,60,14,14,0,33,11,22,50,0,50,184,160,100,60,14,14,0,33,11,22,50,0,50
10/27/2021,Northern,2,CAH,1,81,43,25,18,0,0,0,36,0,36,3,0,3,81,43,25,18,0,0,0,36,0,36,3,0,3
10/27/2021,Southeast,5,CAH,1,70,70,34,36,6,4,2,33,0,33,4,0,4,70,70,34,36,6,4,2,33,0,33,4,0,4
10/27/2021,Southeast,5,GACH,1,161,133,45,88,9,6,3,20,1,19,5,0,5,161,133,45,88,9,6,3,20,1,19,5,0,5
10/27/2021,Southwest,1,CAH,1,22,12,5,7,0,0,0,4,0,4,3,0,3,22,12,5,7,0,0,0,4,0,4,3,0,3
10/27/2021,Southwest,1,GACH,1,44,35,11,24,0,0,0,8,0,8,3,0,3,44,35,11,24,0,0,0,8,0,8,3,0,3
10/28/2021,Anchorage,7,GACH,1,752,721,662,59,119,108,11,221,51,170,100,1,101,752,721,662,59,119,108,11,221,51,170,100,1,101
10/28/2021,Anchorage,7,LTACH,0,44,44,40,4,6,6,0,23,4,19,0,0,0,44,44,40,4,6,6,0,23,4,19,0,0,0
10/28/2021,Anchorage,7,Psych,0,,,,,,,,,,,,,,220,191,131,60,0,0,0,0,0,0,12,0,12
10/28/2021,Gulf Coast,4,CAH,1,82,71,28,43,4,1,3,24,0,24,8,0,8,82,71,28,43,4,1,3,24,0,24,8,0,8
10/28/2021,Gulf Coast,4,GACH,1,93,69,69,0,9,9,0,14,4,10,25,0,25,93,69,69,0,9,9,0,14,4,10,25,0,25
10/28/2021,Interior,6,GACH,1,101,81,66,15,25,12,13,16,2,14,19,1,20,101,81,66,15,25,12,13,16,2,14,19,1,20
10/28/2021,Matanuska-Susitna,3,GACH,1,184,160,108,52,14,14,0,33,13,20,50,0,50,184,160,108,52,14,14,0,33,13,20,50,0,50
10/28/2021,Northern,2,CAH,1,81,43,24,19,0,0,0,36,0,36,4,0,4,81,43,24,19,0,0,0,36,0,36,4,0,4
10/28/2021,Southeast,5,CAH,1,70,70,33,37,4,2,2,33,0,33,3,0,3,70,70,33,37,4,2,2,33,0,33,3,0,3
10/28/2021,Southeast,5,GACH,1,161,133,40,93,9,4,5,20,0,20,4,0,4,161,133,40,93,9,4,5,20,0,20,4,0,4
10/28/2021,Southwest,1,CAH,1,22,12,6,6,0,0,0,4,0,4,3,0,3,22,12,6,6,0,0,0,4,0,4,3,0,3
10/28/2021,Southwest,1,GACH,1,44,35,12,23,0,0,0,8,0,8,3,0,3,44,35,12,23,0,0,0,8,0,8,3,0,3
10/29/2021,Anchorage,7,GACH,1,754,725,660,65,109,98,11,221,44,177,94,1,95,754,725,660,65,109,98,11,221,44,177,94,1,95
10/29/2021,Anchorage,7,LTACH,0,44,44,40,4,6,6,0,23,5,18,0,0,0,44,44,40,4,6,6,0,23,5,18,0,0,0
10/29/2021,Anchorage,7,Psych,0,,,,,,,,,,,,,,220,191,131,60,0,0,0,0,0,0,12,0,12
10/29/2021,Gulf Coast,4,CAH,1,82,71,28,43,4,0,4,24,0,24,9,0,9,82,71,28,43,4,0,4,24,0,24,9,0,9
10/29/2021,Gulf Coast,4,GACH,1,93,65,65,0,9,9,0,14,3,11,24,0,24,93,65,65,0,9,9,0,14,3,11,24,0,24
10/29/2021,Interior,6,GACH,1,101,81,70,11,25,11,14,16,2,14,18,1,19,101,81,70,11,25,11,14,16,2,14,18,1,19
10/29/2021,Matanuska-Susitna,3,GACH,1,184,160,103,57,14,14,0,33,12,21,44,0,44,184,160,103,57,14,14,0,33,12,21,44,0,44
10/29/2021,Northern,2,CAH,1,81,43,26,17,0,0,0,36,0,36,4,0,4,81,43,26,17,0,0,0,36,0,36,4,0,4
10/29/2021,Southeast,5,CAH,1,45,45,23,22,2,0,2,16,0,16,2,0,2,70,70,34,36,4,2,2,33,0,33,2,0,2
10/29/2021,Southeast,5,GACH,1,161,133,37,96,9,4,5,20,0,20,3,0,3,161,133,37,96,9,4,5,20,0,20,3,0,3
10/29/2021,Southwest,1,CAH,1,22,12,4,8,0,0,0,4,0,4,2,0,2,22,12,4,8,0,0,0,4,0,4,2,0,2
10/29/2021,Southwest,1,GACH,1,44,35,15,20,0,0,0,8,0,8,3,0,3,44,35,15,20,0,0,0,8,0,8,3,0,3
10/30/2021,Anchorage,7,GACH,1,719,693,609,84,121,106,15,221,45,176,86,1,87,719,693,609,84,121,106,15,221,45,176,86,1,87
10/30/2021,Anchorage,7,LTACH,0,44,44,38,6,6,6,0,23,4,19,0,0,0,44,44,38,6,6,6,0,23,4,19,0,0,0
10/30/2021,Anchorage,7,Psych,0,,,,,,,,,,,,,,220,191,131,60,0,0,0,0,0,0,12,0,12
10/30/2021,Gulf Coast,4,CAH,1,82,71,28,43,4,1,3,24,0,24,6,0,6,82,71,28,43,4,1,3,24,0,24,6,0,6
10/30/2021,Gulf Coast,4,GACH,1,93,62,62,0,9,9,0,14,3,11,22,0,22,93,62,62,0,9,9,0,14,3,11,22,0,22
10/30/2021,Interior,6,GACH,1,101,81,68,13,25,12,13,16,2,14,18,1,19,101,81,68,13,25,12,13,16,2,14,18,1,19
10/30/2021,Matanuska-Susitna,3,GACH,1,184,160,91,69,14,14,0,33,10,23,39,0,39,184,160,91,69,14,14,0,33,10,23,39,0,39
10/30/2021,Northern,2,CAH,1,81,43,28,15,0,0,0,36,0,36,1,0,1,81,43,28,15,0,0,0,36,0,36,1,0,1
10/30/2021,Southeast,5,CAH,1,45,45,20,25,2,0,2,16,0,16,2,0,2,70,70,31,39,4,2,2,33,0,33,2,0,2
10/30/2021,Southeast,5,GACH,1,161,133,34,99,9,3,6,20,0,20,2,0,2,161,133,34,99,9,3,6,20,0,20,2,0,2
10/30/2021,Southwest,1,CAH,1,22,12,1,11,0,0,0,4,0,4,1,0,1,22,12,1,11,0,0,0,4,0,4,1,0,1
10/30/2021,Southwest,1,GACH,1,44,35,15,20,0,0,0,8,0,8,3,0,3,44,35,15,20,0,0,0,8,0,8,3,0,3
10/31/2021,Anchorage,7,GACH,1,720,691,613,78,122,107,15,221,45,176,83,0,83,720,691,613,78,122,107,15,221,45,176,83,0,83
10/31/2021,Anchorage,7,LTACH,0,44,44,39,5,6,6,0,23,5,18,0,0,0,44,44,39,5,6,6,0,23,5,18,0,0,0
10/31/2021,Anchorage,7,Psych,0,,,,,,,,,,,,,,220,191,131,60,0,0,0,0,0,0,12,0,12
10/31/2021,Gulf Coast,4,CAH,1,82,71,30,41,4,0,4,24,0,24,7,0,7,82,71,30,41,4,0,4,24,0,24,7,0,7
10/31/2021,Gulf Coast,4,GACH,1,93,63,63,0,9,8,1,14,3,11,23,0,23,93,63,63,0,9,8,1,14,3,11,23,0,23
10/31/2021,Interior,6,GACH,1,101,81,75,6,25,10,15,16,2,14,19,0,19,101,81,75,6,25,10,15,16,2,14,19,0,19
10/31/2021,Matanuska-Susitna,3,GACH,1,184,160,91,69,14,14,0,33,12,21,44,0,44,184,160,91,69,14,14,0,33,12,21,44,0,44
10/31/2021,Northern,2,CAH,1,81,43,29,14,0,0,0,36,0,36,5,0,5,81,43,29,14,0,0,0,36,0,36,5,0,5
10/31/2021,Southeast,5,CAH,1,45,45,17,28,2,0,2,16,0,16,1,0,1,70,70,28,42,4,2,2,33,0,33,1,0,1
10/31/2021,Southeast,5,GACH,1,161,133,28,105,9,1,8,20,0,20,2,0,2,161,133,28,105,9,1,8,20,0,20,2,0,2
10/31/2021,Southwest,1,CAH,1,22,12,3,9,0,0,0,4,0,4,1,0,1,22,12,3,9,0,0,0,4,0,4,1,0,1
10/31/2021,Southwest,1,GACH,1,44,35,12,23,0,0,0,8,0,8,2,0,2,44,35,12,23,0,0,0,8,0,8,2,0,2
11/01/2021,Anchorage,7,GACH,1,738,709,626,83,123,107,16,219,45,174,85,1,86,738,709,626,83,123,107,16,219,45,174,85,1,86
11/01/2021,Anchorage,7,LTACH,0,44,44,38,6,6,6,0,23,5,18,0,0,0,44,44,38,6,6,6,0,23,5,18,0,0,0
11/01/2021,Anchorage,7,Psych,0,,,,,,,,,,,,,,220,191,131,60,0,0,0,0,0,0,12,0,12
11/01/2021,Gulf Coast,4,CAH,1,82,71,30,41,4,0,4,24,0,24,6,0,6,82,71,30,41,4,0,4,24,0,24,6,0,6
11/01/2021,Gulf Coast,4,GACH,1,93,60,60,0,9,9,0,19,1,18,22,0,22,93,60,60,0,9,9,0,19,1,18,22,0,22
11/01/2021,Interior,6,GACH,1,101,81,72,9,25,11,14,16,2,14,20,0,20,101,81,72,9,25,11,14,16,2,14,20,0,20
11/01/2021,Matanuska-Susitna,3,GACH,1,184,160,103,57,14,14,0,33,11,22,42,0,42,184,160,103,57,14,14,0,33,11,22,42,0,42
11/01/2021,Northern,2,CAH,1,81,43,26,17,0,0,0,36,0,36,5,0,5,81,43,26,17,0,0,0,36,0,36,5,0,5
11/01/2021,Southeast,5,CAH,1,70,70,33,37,2,1,1,33,0,33,1,0,1,70,70,33,37,2,1,1,33,0,33,1,0,1
11/01/2021,Southeast,5,GACH,1,161,133,27,106,9,2,7,20,0,20,3,0,3,161,133,27,106,9,2,7,20,0,20,3,0,3
11/01/2021,Southwest,1,CAH,1,22,12,3,9,0,0,0,4,0,4,1,0,1,22,12,3,9,0,0,0,4,0,4,1,0,1
11/01/2021,Southwest,1,GACH,1,44,35,17,18,0,0,0,8,0,8,3,1,4,44,35,17,18,0,0,0,8,0,8,3,1,4
11/02/2021,Anchorage,7,GACH,1,743,717,625,92,124,106,18,219,45,174,80,1,81,743,717,625,92,124,106,18,219,45,174,80,1,81
11/02/2021,Anchorage,7,LTACH,0,44,44,39,5,6,6,0,23,6,17,0,0,0,44,44,39,5,6,6,0,23,6,17,0,0,0
11/02/2021,Anchorage,7,Psych,0,,,,,,,,,,,,,,220,191,131,60,0,0,0,0,0,0,12,0,12
11/02/2021,Gulf Coast,4,CAH,1,82,71,29,42,4,0,4,24,0,24,3,0,3,82,71,29,42,4,0,4,24,0,24,3,0,3
11/02/2021,Gulf Coast,4,GACH,1,93,58,58,0,9,7,2,19,2,17,21,0,21,93,58,58,0,9,7,2,19,2,17,21,0,21
11/02/2021,Interior,6,GACH,1,101,81,71,10,25,10,15,16,0,16,13,0,13,101,81,71,10,25,10,15,16,0,16,13,0,13
11/02/2021,Matanuska-Susitna,3,GACH,1,184,160,113,47,14,14,0,33,12,21,46,0,46,184,160,113,47,14,14,0,33,12,21,46,0,46
11/02/2021,Northern,2,CAH,1,81,43,26,17,0,0,0,36,0,36,6,0,6,81,43,26,17,0,0,0,36,0,36,6,0,6
11/02/2021,Southeast,5,CAH,1,70,70,36,34,2,1,1,33,0,33,2,0,2,70,70,36,34,2,1,1,33,0,33,2,0,2
11/02/2021,Southeast,5,GACH,1,161,133,36,97,9,3,6,20,0,20,4,0,4,161,133,36,97,9,3,6,20,0,20,4,0,4
11/02/2021,Southwest,1,CAH,1,22,12,2,10,0,0,0,4,0,4,1,0,1,22,12,2,10,0,0,0,4,0,4,1,0,1
11/02/2021,Southwest,1,GACH,1,44,35,17,18,0,0,0,8,0,8,3,0,3,44,35,17,18,0,0,0,8,0,8,3,0,3
11/03/2021,Anchorage,7,GACH,1,739,711,614,97,124,107,17,219,52,167,71,0,71,739,711,614,97,124,107,17,219,52,167,71,0,71
11/03/2021,Anchorage,7,LTACH,0,44,44,40,4,6,6,0,23,6,17,0,0,0,44,44,40,4,6,6,0,23,6,17,0,0,0
11/03/2021,Anchorage,7,Psych,0,220,195,134,61,0,0,0,0,0,0,11,0,11,220,195,134,61,0,0,0,0,0,0,11,0,11
11/03/2021,Gulf Coast,4,CAH,1,82,71,28,43,4,0,4,24,0,24,4,0,4,82,71,28,43,4,0,4,24,0,24,4,0,4
11/03/2021,Gulf Coast,4,GACH,1,93,62,62,0,9,8,1,19,2,17,19,0,19,93,62,62,0,9,8,1,19,2,17,19,0,19
11/03/2021,Interior,6,GACH,1,101,81,78,3,25,15,10,16,0,16,13,0,13,101,81,78,3,25,15,10,16,0,16,13,0,13
11/03/2021,Matanuska-Susitna,3,GACH,1,184,160,109,51,14,14,0,33,10,23,36,1,37,184,160,109,51,14,14,0,33,10,23,36,1,37
11/03/2021,Northern,2,CAH,1,81,43,26,17,0,0,0,36,0,36,4,0,4,81,43,26,17,0,0,0,36,0,36,4,0,4
11/03/2021,Southeast,5,CAH,1,70,70,33,37,2,1,1,33,0,33,2,0,2,70,70,33,37,2,1,1,33,0,33,2,0,2
11/03/2021,Southeast,5,GACH,1,161,133,34,99,9,4,5,20,0,20,3,0,3,161,133,34,99,9,4,5,20,0,20,3,0,3
11/03/2021,Southwest,1,CAH,1,22,12,4,8,0,0,0,4,0,4,2,0,2,22,12,4,8,0,0,0,4,0,4,2,0,2
11/03/2021,Southwest,1,GACH,1,44,35,15,20,0,0,0,8,0,8,3,0,3,44,35,15,20,0,0,0,8,0,8,3,0,3
11/04/2021,Anchorage,7,GACH,1,743,716,632,84,118,100,18,221,54,167,67,0,67,743,716,632,84,118,100,18,221,54,167,67,0,67
11/04/2021,Anchorage,7,LTACH,0,44,44,41,3,6,6,0,23,8,15,0,0,0,44,44,41,3,6,6,0,23,8,15,0,0,0
11/04/2021,Anchorage,7,Psych,0,,,,,,,,,,,,,,220,195,134,61,0,0,0,0,0,0,11,0,11
11/04/2021,Gulf Coast,4,CAH,1,82,71,28,43,4,0,4,24,0,24,2,0,2,82,71,28,43,4,0,4,24,0,24,2,0,2
11/04/2021,Gulf Coast,4,GACH,1,93,62,62,0,9,9,0,19,6,13,19,0,19,93,62,62,0,9,9,0,19,6,13,19,0,19
11/04/2021,Interior,6,GACH,1,101,81,74,7,25,13,12,16,0,16,13,0,13,101,81,74,7,25,13,12,16,0,16,13,0,13
11/04/2021,Matanuska-Susitna,3,GACH,1,184,160,110,50,14,13,1,33,10,23,32,0,32,184,160,110,50,14,13,1,33,10,23,32,0,32
11/04/2021,Northern,2,CAH,1,81,43,23,20,0,0,0,36,0,36,3,0,3,81,43,23,20,0,0,0,36,0,36,3,0,3
11/04/2021,Southeast,5,CAH,1,70,70,33,37,5,3,2,33,0,33,2,0,2,70,70,33,37,5,3,2,33,0,33,2,0,2
11/04/2021,Southeast,5,GACH,1,161,133,40,93,9,3,6,20,0,20,3,0,3,161,133,40,93,9,3,6,20,0,20,3,0,3
11/04/2021,Southwest,1,CAH,1,22,12,2,10,0,0,0,4,0,4,2,0,2,22,12,2,10,0,0,0,4,0,4,2,0,2
11/04/2021,Southwest,1,GACH,1,44,35,15,20,0,0,0,8,0,8,4,0,4,44,35,15,20,0,0,0,8,0,8,4,0,4
11/05/2021,Anchorage,7,GACH,1,720,697,619,78,121,104,17,221,58,163,64,0,64,720,697,619,78,121,104,17,221,58,163,64,0,64
11/05/2021,Anchorage,7,LTACH,0,44,44,40,4,6,6,0,23,7,16,0,0,0,44,44,40,4,6,6,0,23,7,16,0,0,0
11/05/2021,Anchorage,7,Psych,0,,,,,,,,,,,,,,220,195,134,61,0,0,0,0,0,0,11,0,11
11/05/2021,Gulf Coast,4,CAH,1,82,71,24,47,4,0,4,24,0,24,1,0,1,82,71,24,47,4,0,4,24,0,24,1,0,1
11/05/2021,Gulf Coast,4,GACH,1,93,54,50,4,9,8,1,19,2,17,16,0,16,93,54,50,4,9,8,1,19,2,17,16,0,16
11/05/2021,Interior,6,GACH,1,101,81,69,12,25,10,15,16,0,16,12,0,12,101,81,69,12,25,10,15,16,0,16,12,0,12
11/05/2021,Matanuska-Susitna,3,GACH,1,184,160,104,56,14,14,0,33,10,23,30,0,30,184,160,104,56,14,14,0,33,10,23,30,0,30
11/05/2021,Northern,2,CAH,1,81,43,26,17,0,0,0,36,0,36,4,0,4,81,43,26,17,0,0,0,36,0,36,4,0,4
11/05/2021,Southeast,5,CAH,1,70,70,26,44,4,2,2,33,0,33,1,0,1,70,70,26,44,4,2,2,33,0,33,1,0,1
11/05/2021,Southeast,5,GACH,1,161,133,35,98,9,6,3,20,0,20,4,0,4,161,133,35,98,9,6,3,20,0,20,4,0,4
11/05/2021,Southwest,1,CAH,1,22,12,3,9,0,0,0,4,0,4,2,0,2,22,12,3,9,0,0,0,4,0,4,2,0,2
11/05/2021,Southwest,1,GACH,1,44,35,15,20,0,0,0,8,0,8,4,0,4,44,35,15,20,0,0,0,8,0,8,4,0,4
11/06/2021,Anchorage,7,GACH,1,702,673,588,85,121,105,16,221,46,175,64,0,64,702,673,588,85,121,105,16,221,46,175,64,0,64
11/06/2021,Anchorage,7,LTACH,0,44,44,41,3,6,6,0,23,7,16,0,0,0,44,44,41,3,6,6,0,23,7,16,0,0,0
11/06/2021,Anchorage,7,Psych,0,,,,,,,,,,,,,,220,195,134,61,0,0,0,0,0,0,11,0,11
11/06/2021,Gulf Coast,4,CAH,1,85,71,22,49,4,0,4,24,0,24,2,0,2,85,71,22,49,4,0,4,24,0,24,2,0,2
11/06/2021,Gulf Coast,4,GACH,1,93,54,44,10,9,5,4,19,2,17,11,0,11,93,54,44,10,9,5,4,19,2,17,11,0,11
11/06/2021,Interior,6,GACH,1,101,81,65,16,25,11,14,16,1,15,8,0,8,101,81,65,16,25,11,14,16,1,15,8,0,8
11/06/2021,Matanuska-Susitna,3,GACH,1,184,160,107,53,14,14,0,33,13,20,30,0,30,184,160,107,53,14,14,0,33,13,20,30,0,30
11/06/2021,Northern,2,CAH,1,81,43,22,21,0,0,0,36,0,36,4,0,4,81,43,22,21,0,0,0,36,0,36,4,0,4
11/06/2021,Southeast,5,CAH,1,70,70,30,40,4,2,2,33,0,33,1,0,1,70,70,30,40,4,2,2,33,0,33,1,0,1
11/06/2021,Southeast,5,GACH,1,161,133,28,105,9,3,6,20,0,20,4,0,4,161,133,28,105,9,3,6,20,0,20,4,0,4
11/06/2021,Southwest,1,CAH,1,22,12,4,8,0,0,0,4,0,4,2,0,2,22,12,4,8,0,0,0,4,0,4,2,0,2
11/06/2021,Southwest,1,GACH,1,44,35,13,22,0,0,0,8,0,8,3,0,3,44,35,13,22,0,0,0,8,0,8,3,0,3
11/07/2021,Anchorage,7,GACH,1,709,682,591,91,113,98,15,221,40,181,60,0,60,709,682,591,91,113,98,15,221,40,181,60,0,60
11/07/2021,Anchorage,7,LTACH,0,44,44,39,5,6,6,0,23,6,17,0,0,0,44,44,39,5,6,6,0,23,6,17,0,0,0
11/07/2021,Anchorage,7,Psych,0,,,,,,,,,,,,,,220,195,134,61,0,0,0,0,0,0,11,0,11
11/07/2021,Gulf Coast,4,CAH,1,85,71,24,47,4,1,3,24,0,24,3,0,3,85,71,24,47,4,1,3,24,0,24,3,0,3
11/07/2021,Gulf Coast,4,GACH,1,93,54,41,13,9,6,3,19,2,17,10,0,10,93,54,41,13,9,6,3,19,2,17,10,0,10
11/07/2021,Interior,6,GACH,1,101,81,65,16,25,12,13,16,1,15,6,0,6,101,81,65,16,25,12,13,16,1,15,6,0,6
11/07/2021,Matanuska-Susitna,3,GACH,1,184,160,100,60,14,14,0,33,12,21,35,0,35,184,160,100,60,14,14,0,33,12,21,35,0,35
11/07/2021,Northern,2,CAH,1,81,43,28,15,0,0,0,36,0,36,5,0,5,81,43,28,15,0,0,0,36,0,36,5,0,5
11/07/2021,Southeast,5,CAH,1,70,70,28,42,4,3,1,33,0,33,1,0,1,70,70,28,42,4,3,1,33,0,33,1,0,1
11/07/2021,Southeast,5,GACH,1,161,133,29,104,9,2,7,20,0,20,4,0,4,161,133,29,104,9,2,7,20,0,20,4,0,4
11/07/2021,Southwest,1,CAH,1,22,12,3,9,0,0,0,4,0,4,1,0,1,22,12,3,9,0,0,0,4,0,4,1,0,1
11/07/2021,Southwest,1,GACH,1,44,35,13,22,0,0,0,8,0,8,4,0,4,44,35,13,22,0,0,0,8,0,8,4,0,4
11/08/2021,Anchorage,7,GACH,1,713,684,576,108,117,101,16,220,45,175,57,0,57,713,684,576,108,117,101,16,220,45,175,57,0,57
11/08/2021,Anchorage,7,LTACH,0,44,44,38,6,6,6,0,23,5,18,0,0,0,44,44,38,6,6,6,0,23,5,18,0,0,0
11/08/2021,Anchorage,7,Psych,0,,,,,,,,,,,,,,220,195,134,61,0,0,0,0,0,0,11,0,11
11/08/2021,Gulf Coast,4,CAH,1,85,71,21,50,4,1,3,24,0,24,3,0,3,85,71,21,50,4,1,3,24,0,24,3,0,3
11/08/2021,Gulf Coast,4,GACH,1,93,54,42,12,9,6,3,19,2,17,10,0,10,93,54,42,12,9,6,3,19,2,17,10,0,10
11/08/2021,Interior,6,GACH,1,101,81,65,16,25,13,12,16,1,15,6,0,6,101,81,65,16,25,13,12,16,1,15,6,0,6
11/08/2021,Matanuska-Susitna,3,GACH,1,184,160,94,66,14,14,0,33,13,20,34,0,34,184,160,94,66,14,14,0,33,13,20,34,0,34
11/08/2021,Northern,2,CAH,1,81,43,29,14,0,0,0,36,0,36,6,0,6,81,43,29,14,0,0,0,36,0,36,6,0,6
11/08/2021,Southeast,5,CAH,1,70,70,29,41,6,4,2,33,0,33,1,0,1,70,70,29,41,6,4,2,33,0,33,1,0,1
11/08/2021,Southeast,5,GACH,1,161,133,32,101,9,3,6,20,0,20,5,0,5,161,133,32,101,9,3,6,20,0,20,5,0,5
11/08/2021,Southwest,1,CAH,1,22,12,3,9,0,0,0,4,0,4,1,0,1,22,12,3,9,0,0,0,4,0,4,1,0,1
11/08/2021,Southwest,1,GACH,1,44,35,13,22,0,0,0,8,0,8,5,0,5,44,35,13,22,0,0,0,8,0,8,5,0,5
11/09/2021,Anchorage,7,GACH,1,724,696,588,108,118,103,15,220,46,174,66,2,68,724,696,588,108,118,103,15,220,46,174,66,2,68
11/09/2021,Anchorage,7,LTACH,0,44,44,38,6,6,6,0,23,5,18,0,0,0,44,44,38,6,6,6,0,23,5,18,0,0,0
11/09/2021,Anchorage,7,Psych,0,,,,,,,,,,,,,,220,195,134,61,0,0,0,0,0,0,11,0,11
11/09/2021,Gulf Coast,4,CAH,1,85,71,29,42,4,0,4,24,0,24,4,0,4,85,71,29,42,4,0,4,24,0,24,4,0,4
11/09/2021,Gulf Coast,4,GACH,1,93,54,46,8,9,6,3,19,2,17,10,0,10,93,54,46,8,9,6,3,19,2,17,10,0,10
11/09/2021,Interior,6,GACH,1,101,81,70,11,25,10,15,16,0,16,10,0,10,101,81,70,11,25,10,15,16,0,16,10,0,10
11/09/2021,Matanuska-Susitna,3,GACH,1,184,160,102,58,14,14,0,33,12,21,28,0,28,184,160,102,58,14,14,0,33,12,21,28,0,28
11/09/2021,Northern,2,CAH,1,81,43,29,14,0,0,0,36,0,36,7,0,7,81,43,29,14,0,0,0,36,0,36,7,0,7
11/09/2021,Southeast,5,CAH,1,70,70,28,42,6,4,2,33,0,33,2,0,2,70,70,28,42,6,4,2,33,0,33,2,0,2
11/09/2021,Southeast,5,GACH,1,161,133,35,98,9,2,7,20,0,20,5,0,5,161,133,35,98,9,2,7,20,0,20,5,0,5
11/09/2021,Southwest,1,CAH,1,22,12,2,10,0,0,0,4,0,4,0,0,0,22,12,2,10,0,0,0,4,0,4,0,0,0
11/09/2021,Southwest,1,GACH,1,44,35,12,23,0,0,0,8,0,8,3,0,3,44,35,12,23,0,0,0,8,0,8,3,0,3
11/10/2021,Anchorage,7,GACH,1,719,694,596,98,124,109,15,220,44,176,70,0,70,719,694,596,98,124,109,15,220,44,176,70,0,70
11/10/2021,Anchorage,7,LTACH,0,44,44,38,6,6,6,0,23,5,18,0,0,0,44,44,38,6,6,6,0,23,5,18,0,0,0
11/10/2021,Anchorage,7,Psych,0,220,198,128,70,0,0,0,0,0,0,9,2,11,220,198,128,70,0,0,0,0,0,0,9,2,11
11/10/2021,Gulf Coast,4,CAH,1,85,71,31,40,4,1,3,24,0,24,2,0,2,85,71,31,40,4,1,3,24,0,24,2,0,2
11/10/2021,Gulf Coast,4,GACH,1,93,54,51,3,9,6,3,19,2,17,9,0,9,93,54,51,3,9,6,3,19,2,17,9,0,9
11/10/2021,Interior,6,GACH,1,101,81,76,5,25,8,17,16,0,16,10,0,10,101,81,76,5,25,8,17,16,0,16,10,0,10
11/10/2021,Matanuska-Susitna,3,GACH,1,184,160,103,57,14,14,0,33,11,22,29,0,29,184,160,103,57,14,14,0,33,11,22,29,0,29
11/10/2021,Northern,2,CAH,1,81,43,28,15,0,0,0,36,0,36,6,0,6,81,43,28,15,0,0,0,36,0,36,6,0,6
11/10/2021,Southeast,5,CAH,1,70,70,28,42,6,5,1,33,0,33,2,0,2,70,70,28,42,6,5,1,33,0,33,2,0,2
11/10/2021,Southeast,5,GACH,1,161,133,45,88,9,6,3,20,0,20,5,0,5,161,133,45,88,9,6,3,20,0,20,5,0,5
11/10/2021,Southwest,1,CAH,1,22,12,5,7,0,0,0,4,0,4,1,0,1,22,12,5,7,0,0,0,4,0,4,1,0,1
11/10/2021,Southwest,1,GACH,1,44,35,13,22,0,0,0,8,0,8,3,0,3,44,35,13,22,0,0,0,8,0,8,3,0,3
11/11/2021,Anchorage,7,GACH,1,732,706,634,72,127,109,18,220,44,176,65,0,65,732,706,634,72,127,109,18,220,44,176,65,0,65
11/11/2021,Anchorage,7,LTACH,0,44,44,38,6,6,6,0,23,6,17,0,0,0,44,44,38,6,6,6,0,23,6,17,0,0,0
11/11/2021,Anchorage,7,Psych,0,,,,,,,,,,,,,,220,198,128,70,0,0,0,0,0,0,9,2,11
11/11/2021,Gulf Coast,4,CAH,1,85,71,33,38,4,1,3,24,0,24,3,0,3,85,71,33,38,4,1,3,24,0,24,3,0,3
11/11/2021,Gulf Coast,4,GACH,1,93,54,49,5,9,6,3,19,2,17,5,0,5,93,54,49,5,9,6,3,19,2,17,5,0,5
11/11/2021,Interior,6,GACH,1,101,81,61,20,25,8,17,16,0,16,9,0,9,101,81,61,20,25,8,17,16,0,16,9,0,9
11/11/2021,Matanuska-Susitna,3,GACH,1,184,160,104,56,14,14,0,33,13,20,26,0,26,184,160,104,56,14,14,0,33,13,20,26,0,26
11/11/2021,Northern,2,CAH,1,81,43,24,19,0,0,0,36,0,36,4,0,4,81,43,24,19,0,0,0,36,0,36,4,0,4
11/11/2021,Southeast,5,CAH,1,70,70,36,34,6,4,2,33,0,33,3,0,3,70,70,36,34,6,4,2,33,0,33,3,0,3
11/11/2021,Southeast,5,GACH,1,161,133,34,99,9,6,3,20,0,20,4,0,4,161,133,34,99,9,6,3,20,0,20,4,0,4
11/11/2021,Southwest,1,CAH,1,22,12,5,7,0,0,0,4,0,4,1,0,1,22,12,5,7,0,0,0,4,0,4,1,0,1
11/11/2021,Southwest,1,GACH,1,44,35,14,21,0,0,0,8,0,8,3,0,3,44,35,14,21,0,0,0,8,0,8,3,0,3
11/12/2021,Anchorage,7,GACH,1,740,716,651,65,124,109,15,220,45,175,72,2,74,740,716,651,65,124,109,15,220,45,175,72,2,74
11/12/2021,Anchorage,7,LTACH,0,44,44,38,6,6,6,0,23,5,18,0,0,0,44,44,38,6,6,6,0,23,5,18,0,0,0
11/12/2021,Anchorage,7,Psych,0,,,,,,,,,,,,,,220,198,128,70,0,0,0,0,0,0,9,2,11
11/12/2021,Gulf Coast,4,CAH,1,85,71,29,42,4,1,3,24,0,24,3,0,3,85,71,29,42,4,1,3,24,0,24,3,0,3
11/12/2021,Gulf Coast,4,GACH,1,93,54,44,10,9,8,1,19,3,16,6,0,6,93,54,44,10,9,8,1,19,3,16,6,0,6
11/12/2021,Interior,6,GACH,1,101,81,55,26,25,11,14,16,0,16,14,0,14,101,81,55,26,25,11,14,16,0,16,14,0,14
11/12/2021,Matanuska-Susitna,3,GACH,1,184,160,108,52,14,14,0,33,13,20,29,0,29,184,160,108,52,14,14,0,33,13,20,29,0,29
11/12/2021,Northern,2,CAH,1,81,43,22,21,0,0,0,36,0,36,3,0,3,81,43,22,21,0,0,0,36,0,36,3,0,3
11/12/2021,Southeast,5,CAH,1,70,70,33,37,6,4,2,33,0,33,3,0,3,70,70,33,37,6,4,2,33,0,33,3,0,3
11/12/2021,Southeast,5,GACH,1,161,133,29,104,9,5,4,20,0,20,4,0,4,161,133,29,104,9,5,4,20,0,20,4,0,4
11/12/2021,Southwest,1,CAH,1,22,12,5,7,0,0,0,4,0,4,1,0,1,22,12,5,7,0,0,0,4,0,4,1,0,1
11/12/2021,Southwest,1,GACH,1,44,35,12,23,0,0,0,8,0,8,3,0,3,44,35,12,23,0,0,0,8,0,8,3,0,3
11/13/2021,Anchorage,7,GACH,1,720,696,615,81,119,104,15,220,43,177,77,2,79,720,696,615,81,119,104,15,220,43,177,77,2,79
11/13/2021,Anchorage,7,LTACH,0,44,44,37,7,6,6,0,23,4,19,0,0,0,44,44,37,7,6,6,0,23,4,19,0,0,0
11/13/2021,Anchorage,7,Psych,0,,,,,,,,,,,,,,220,198,128,70,0,0,0,0,0,0,9,2,11
11/13/2021,Gulf Coast,4,CAH,1,85,71,25,46,4,0,4,24,0,24,2,0,2,85,71,25,46,4,0,4,24,0,24,2,0,2
11/13/2021,Gulf Coast,4,GACH,1,93,49,34,15,9,8,1,19,3,16,5,0,5,93,49,34,15,9,8,1,19,3,16,5,0,5
11/13/2021,Interior,6,GACH,1,101,81,72,9,25,5,20,16,0,16,15,0,15,101,81,72,9,25,5,20,16,0,16,15,0,15
11/13/2021,Matanuska-Susitna,3,GACH,1,184,160,105,55,14,14,0,33,13,20,23,0,23,184,160,105,55,14,14,0,33,13,20,23,0,23
11/13/2021,Northern,2,CAH,1,81,43,28,15,0,0,0,36,0,36,3,0,3,81,43,28,15,0,0,0,36,0,36,3,0,3
11/13/2021,Southeast,5,CAH,1,70,70,31,39,6,4,2,33,0,33,3,0,3,70,70,31,39,6,4,2,33,0,33,3,0,3
11/13/2021,Southeast,5,GACH,1,161,133,35,98,9,6,3,20,0,20,3,0,3,161,133,35,98,9,6,3,20,0,20,3,0,3
11/13/2021,Southwest,1,CAH,1,22,12,5,7,0,0,0,4,0,4,1,0,1,22,12,5,7,0,0,0,4,0,4,1,0,1
11/13/2021,Southwest,1,GACH,1,44,35,11,24,0,0,0,8,0,8,3,0,3,44,35,11,24,0,0,0,8,0,8,3,0,3
11/14/2021,Anchorage,7,GACH,1,729,697,611,86,114,99,15,218,43,175,78,0,78,729,697,611,86,114,99,15,218,43,175,78,0,78
11/14/2021,Anchorage,7,LTACH,0,44,44,37,7,6,6,0,23,4,19,0,0,0,44,44,37,7,6,6,0,23,4,19,0,0,0
11/14/2021,Anchorage,7,Psych,0,,,,,,,,,,,,,,220,198,128,70,0,0,0,0,0,0,9,2,11
11/14/2021,Gulf Coast,4,CAH,1,85,71,26,45,4,0,4,24,0,24,2,0,2,85,71,26,45,4,0,4,24,0,24,2,0,2
11/14/2021,Gulf Coast,4,GACH,1,93,49,37,12,9,7,2,19,3,16,6,0,6,93,49,37,12,9,7,2,19,3,16,6,0,6
11/14/2021,Interior,6,GACH,1,101,81,74,7,25,7,18,16,0,16,15,1,16,101,81,74,7,25,7,18,16,0,16,15,1,16
11/14/2021,Matanuska-Susitna,3,GACH,1,184,160,92,68,14,14,0,33,12,21,30,0,30,184,160,92,68,14,14,0,33,12,21,30,0,30
11/14/2021,Northern,2,CAH,1,81,43,27,16,0,0,0,36,0,36,3,0,3,81,43,27,16,0,0,0,36,0,36,3,0,3
11/14/2021,Southeast,5,CAH,1,70,70,33,37,6,4,2,33,0,33,3,0,3,70,70,33,37,6,4,2,33,0,33,3,0,3
11/14/2021,Southeast,5,GACH,1,161,133,30,103,9,4,5,20,0,20,3,0,3,161,133,30,103,9,4,5,20,0,20,3,0,3
11/14/2021,Southwest,1,CAH,1,22,12,4,8,0,0,0,4,0,4,0,0,0,22,12,4,8,0,0,0,4,0,4,0,0,0
11/14/2021,Southwest,1,GACH,1,44,35,10,25,0,0,0,8,0,8,3,0,3,44,35,10,25,0,0,0,8,0,8,3,0,3
11/15/2021,Anchorage,7,GACH,1,716,684,600,84,124,106,18,218,42,176,70,1,71,716,684,600,84,124,106,18,218,42,176,70,1,71
11/15/2021,Anchorage,7,LTACH,0,44,44,36,8,6,6,0,23,3,20,0,0,0,44,44,36,8,6,6,0,23,3,20,0,0,0
11/15/2021,Anchorage,7,Psych,0,,,,,,,,,,,,,,220,198,128,70,0,0,0,0,0,0,9,2,11
11/15/2021,Gulf Coast,4,CAH,1,85,71,32,39,4,0,4,24,0,24,3,0,3,85,71,32,39,4,0,4,24,0,24,3,0,3
11/15/2021,Gulf Coast,4,GACH,1,93,49,37,12,9,7,2,19,3,16,5,0,5,93,49,37,12,9,7,2,19,3,16,5,0,5
11/15/2021,Interior,6,GACH,1,101,81,72,9,25,8,17,16,0,16,16,1,17,101,81,72,9,25,8,17,16,0,16,16,1,17
11/15/2021,Matanuska-Susitna,3,GACH,1,184,160,87,73,14,14,0,33,12,21,30,0,30,184,160,87,73,14,14,0,33,12,21,30,0,30
11/15/2021,Northern,2,CAH,1,81,43,26,17,0,0,0,36,0,36,5,0,5,81,43,26,17,0,0,0,36,0,36,5,0,5
11/15/2021,Southeast,5,CAH,1,70,70,33,37,6,4,2,33,0,33,4,0,4,70,70,33,37,6,4,2,33,0,33,4,0,4
11/15/2021,Southeast,5,GACH,1,161,133,25,108,9,2,7,20,0,20,3,0,3,161,133,25,108,9,2,7,20,0,20,3,0,3
11/15/2021,Southwest,1,CAH,1,22,12,4,8,0,0,0,4,0,4,0,0,0,22,12,4,8,0,0,0,4,0,4,0,0,0
11/15/2021,Southwest,1,GACH,1,44,35,11,24,0,0,0,8,0,8,4,0,4,44,35,11,24,0,0,0,8,0,8,4,0,4
11/16/2021,Anchorage,7,GACH,1,733,700,632,68,125,111,14,218,37,181,69,0,69,733,700,632,68,125,111,14,218,37,181,69,0,69
11/16/2021,Anchorage,7,LTACH,0,44,44,36,8,6,6,0,23,4,19,0,0,0,44,44,36,8,6,6,0,23,4,19,0,0,0
11/16/2021,Anchorage,7,Psych,0,,,,,,,,,,,,,,220,198,128,70,0,0,0,0,0,0,9,2,11
11/16/2021,Gulf Coast,4,CAH,1,85,71,24,47,4,2,2,24,0,24,3,0,3,85,71,24,47,4,2,2,24,0,24,3,0,3
11/16/2021,Gulf Coast,4,GACH,1,93,49,46,3,9,8,1,19,3,16,6,0,6,93,49,46,3,9,8,1,19,3,16,6,0,6
11/16/2021,Interior,6,GACH,1,101,81,71,10,25,9,16,16,0,16,19,0,19,101,81,71,10,25,9,16,16,0,16,19,0,19
11/16/2021,Matanuska-Susitna,3,GACH,1,184,160,101,59,14,14,0,33,11,22,25,0,25,184,160,101,59,14,14,0,33,11,22,25,0,25
11/16/2021,Northern,2,CAH,1,81,43,22,21,0,0,0,36,0,36,5,0,5,81,43,22,21,0,0,0,36,0,36,5,0,5
11/16/2021,Southeast,5,CAH,1,70,70,33,37,4,2,2,33,0,33,8,0,8,70,70,33,37,4,2,2,33,0,33,8,0,8
11/16/2021,Southeast,5,GACH,1,161,133,28,105,9,1,8,20,1,19,3,0,3,161,133,28,105,9,1,8,20,1,19,3,0,3
11/16/2021,Southwest,1,CAH,1,22,12,4,8,0,0,0,4,0,4,0,0,0,22,12,4,8,0,0,0,4,0,4,0,0,0
11/16/2021,Southwest,1,GACH,1,44,35,15,20,0,0,0,8,0,8,5,0,5,44,35,15,20,0,0,0,8,0,8,5,0,5
11/17/2021,Anchorage,7,GACH,1,730,701,621,80,126,115,11,218,42,176,66,0,66,730,701,621,80,126,115,11,218,42,176,66,0,66
11/17/2021,Anchorage,7,LTACH,0,44,44,36,8,6,6,0,23,4,19,0,0,0,44,44,36,8,6,6,0,23,4,19,0,0,0
11/17/2021,Anchorage,7,Psych,0,220,194,163,31,0,0,0,0,0,0,2,0,2,220,194,163,31,0,0,0,0,0,0,2,0,2
11/17/2021,Gulf Coast,4,CAH,1,85,71,25,46,4,0,4,24,0,24,1,0,1,85,71,25,46,4,0,4,24,0,24,1,0,1
11/17/2021,Gulf Coast,4,GACH,1,93,51,51,0,9,9,0,19,4,15,6,0,6,93,51,51,0,9,9,0,19,4,15,6,0,6
11/17/2021,Interior,6,GACH,1,101,81,78,3,25,10,15,16,0,16,20,0,20,101,81,78,3,25,10,15,16,0,16,20,0,20
11/17/2021,Matanuska-Susitna,3,GACH,1,184,160,103,57,14,14,0,33,10,23,24,0,24,184,160,103,57,14,14,0,33,10,23,24,0,24
11/17/2021,Northern,2,CAH,1,81,43,24,19,0,0,0,36,0,36,4,0,4,81,43,24,19,0,0,0,36,0,36,4,0,4
11/17/2021,Southeast,5,CAH,1,70,70,36,34,4,2,2,33,0,33,8,0,8,70,70,36,34,4,2,2,33,0,33,8,0,8
11/17/2021,Southeast,5,GACH,1,161,133,38,95,9,5,4,20,0,20,2,0,2,161,133,38,95,9,5,4,20,0,20,2,0,2
11/17/2021,Southwest,1,CAH,1,22,12,4,8,0,0,0,4,0,4,0,0,0,22,12,4,8,0,0,0,4,0,4,0,0,0
11/17/2021,Southwest,1,GACH,1,44,35,18,17,0,0,0,8,0,8,6,0,6,44,35,18,17,0,0,0,8,0,8,6,0,6
11/18/2021,Anchorage,7,GACH,1,742,717,660,57,130,118,12,219,44,175,67,0,67,742,717,660,57,130,118,12,219,44,175,67,0,67
11/18/2021,Anchorage,7,LTACH,0,44,44,37,7,6,6,0,23,4,19,0,0,0,44,44,37,7,6,6,0,23,4,19,0,0,0
11/18/2021,Anchorage,7,Psych,0,,,,,,,,,,,,,,220,194,163,31,0,0,0,0,0,0,2,0,2
11/18/2021,Gulf Coast,4,CAH,1,85,71,25,46,4,0,4,24,0,24,2,0,2,85,71,25,46,4,0,4,24,0,24,2,0,2
11/18/2021,Gulf Coast,4,GACH,1,93,49,46,3,9,8,1,19,3,16,6,0,6,93,49,46,3,9,8,1,19,3,16,6,0,6
11/18/2021,Interior,6,GACH,1,101,81,71,10,25,8,17,16,0,16,16,0,16,101,81,71,10,25,8,17,16,0,16,16,0,16
11/18/2021,Matanuska-Susitna,3,GACH,1,184,160,110,50,14,14,0,33,11,22,23,0,23,184,160,110,50,14,14,0,33,11,22,23,0,23
11/18/2021,Northern,2,CAH,1,81,43,26,17,0,0,0,36,0,36,3,0,3,81,43,26,17,0,0,0,36,0,36,3,0,3
11/18/2021,Southeast,5,CAH,1,70,70,39,31,5,3,2,33,0,33,9,0,9,70,70,39,31,5,3,2,33,0,33,9,0,9
11/18/2021,Southeast,5,GACH,1,161,133,39,94,9,4,5,20,0,20,2,0,2,161,133,39,94,9,4,5,20,0,20,2,0,2
11/18/2021,Southwest,1,CAH,1,22,12,4,8,0,0,0,4,0,4,0,0,0,22,12,4,8,0,0,0,4,0,4,0,0,0
11/18/2021,Southwest,1,GACH,1,44,35,18,17,0,0,0,8,0,8,6,0,6,44,35,18,17,0,0,0,8,0,8,6,0,6
11/19/2021,Anchorage,7,GACH,1,751,726,660,66,132,121,11,218,42,176,65,1,66,751,726,660,66,132,121,11,218,42,176,65,1,66
11/19/2021,Anchorage,7,LTACH,0,44,44,38,6,6,6,0,23,6,17,0,0,0,44,44,38,6,6,6,0,23,6,17,0,0,0
11/19/2021,Anchorage,7,Psych,0,,,,,,,,,,,,,,220,194,163,31,0,0,0,0,0,0,2,0,2
11/19/2021,Gulf Coast,4,CAH,1,85,71,20,51,4,0,4,24,0,24,1,0,1,85,71,20,51,4,0,4,24,0,24,1,0,1
11/19/2021,Gulf Coast,4,GACH,1,93,49,49,0,9,9,0,19,3,16,5,0,5,93,49,49,0,9,9,0,19,3,16,5,0,5
11/19/2021,Interior,6,GACH,1,101,81,62,19,25,8,17,16,0,16,14,0,14,101,81,62,19,25,8,17,16,0,16,14,0,14
11/19/2021,Matanuska-Susitna,3,GACH,1,184,160,107,53,14,14,0,33,11,22,19,0,19,184,160,107,53,14,14,0,33,11,22,19,0,19
11/19/2021,Northern,2,CAH,1,81,43,25,18,0,0,0,36,0,36,4,0,4,81,43,25,18,0,0,0,36,0,36,4,0,4
11/19/2021,Southeast,5,CAH,1,70,70,35,35,6,4,2,33,0,33,7,0,7,70,70,35,35,6,4,2,33,0,33,7,0,7
11/19/2021,Southeast,5,GACH,1,161,133,41,92,9,5,4,20,0,20,2,0,2,161,133,41,92,9,5,4,20,0,20,2,0,2
11/19/2021,Southwest,1,CAH,1,22,12,4,8,0,0,0,4,0,4,0,0,0,22,12,4,8,0,0,0,4,0,4,0,0,0
11/19/2021,Southwest,1,GACH,1,44,35,18,17,0,0,0,8,0,8,4,0,4,44,35,18,17,0,0,0,8,0,8,4,0,4
11/20/2021,Anchorage,7,GACH,1,737,712,631,81,129,118,11,220,53,167,56,1,57,737,712,631,81,129,118,11,220,53,167,56,1,57
11/20/2021,Anchorage,7,LTACH,0,44,44,37,7,6,6,0,23,6,17,0,0,0,44,44,37,7,6,6,0,23,6,17,0,0,0
11/20/2021,Anchorage,7,Psych,0,,,,,,,,,,,,,,220,194,163,31,0,0,0,0,0,0,2,0,2
11/20/2021,Gulf Coast,4,CAH,1,85,71,20,51,4,0,4,24,0,24,0,0,0,85,71,20,51,4,0,4,24,0,24,0,0,0
11/20/2021,Gulf Coast,4,GACH,1,93,49,48,1,9,9,0,19,3,16,6,0,6,93,49,48,1,9,9,0,19,3,16,6,0,6
11/20/2021,Interior,6,GACH,1,101,81,55,26,25,10,15,16,0,16,11,0,11,101,81,55,26,25,10,15,16,0,16,11,0,11
11/20/2021,Matanuska-Susitna,3,GACH,1,184,160,101,59,14,14,0,33,9,24,17,0,17,184,160,101,59,14,14,0,33,9,24,17,0,17
11/20/2021,Northern,2,CAH,1,81,43,21,22,0,0,0,36,0,36,1,0,1,81,43,21,22,0,0,0,36,0,36,1,0,1
11/20/2021,Southeast,5,CAH,1,70,70,35,35,6,4,2,33,0,33,7,0,7,70,70,35,35,6,4,2,33,0,33,7,0,7
11/20/2021,Southeast,5,GACH,1,161,133,32,101,9,3,6,20,0,20,1,0,1,161,133,32,101,9,3,6,20,0,20,1,0,1
11/20/2021,Southwest,1,CAH,1,22,12,5,7,0,0,0,4,0,4,0,0,0,22,12,5,7,0,0,0,4,0,4,0,0,0
11/20/2021,Southwest,1,GACH,1,44,35,13,22,0,0,0,8,0,8,4,0,4,44,35,13,22,0,0,0,8,0,8,4,0,4
11/21/2021,Anchorage,7,GACH,1,721,696,602,94,129,115,14,232,50,182,54,1,55,721,696,602,94,129,115,14,232,50,182,54,1,55
11/21/2021,Anchorage,7,LTACH,0,44,44,36,8,6,6,0,23,5,18,0,0,0,44,44,36,8,6,6,0,23,5,18,0,0,0
11/21/2021,Anchorage,7,Psych,0,,,,,,,,,,,,,,220,194,163,31,0,0,0,0,0,0,2,0,2
11/21/2021,Gulf Coast,4,CAH,1,85,71,25,46,4,0,4,24,0,24,0,0,0,85,71,25,46,4,0,4,24,0,24,0,0,0
11/21/2021,Gulf Coast,4,GACH,1,93,49,45,4,9,8,1,19,3,16,5,0,5,93,49,45,4,9,8,1,19,3,16,5,0,5
11/21/2021,Interior,6,GACH,1,101,81,61,20,25,12,13,16,1,15,12,0,12,101,81,61,20,25,12,13,16,1,15,12,0,12
11/21/2021,Matanuska-Susitna,3,GACH,1,184,160,101,59,14,14,0,33,9,24,19,0,19,184,160,101,59,14,14,0,33,9,24,19,0,19
11/21/2021,Northern,2,CAH,1,81,43,20,23,0,0,0,36,0,36,1,0,1,81,43,20,23,0,0,0,36,0,36,1,0,1
11/21/2021,Southeast,5,CAH,1,70,70,36,34,6,5,1,33,0,33,7,0,7,70,70,36,34,6,5,1,33,0,33,7,0,7
11/21/2021,Southeast,5,GACH,1,161,133,25,108,9,2,7,20,0,20,0,0,0,161,133,25,108,9,2,7,20,0,20,0,0,0
11/21/2021,Southwest,1,CAH,1,22,12,4,8,0,0,0,4,0,4,0,0,0,22,12,4,8,0,0,0,4,0,4,0,0,0
11/21/2021,Southwest,1,GACH,1,44,35,10,25,0,0,0,8,0,8,3,0,3,44,35,10,25,0,0,0,8,0,8,3,0,3
11/22/2021,Anchorage,7,GACH,1,732,705,600,105,127,112,15,232,52,180,52,0,52,732,705,600,105,127,112,15,232,52,180,52,0,52
11/22/2021,Anchorage,7,LTACH,0,44,44,36,8,6,6,0,23,5,18,0,0,0,44,44,36,8,6,6,0,23,5,18,0,0,0
11/22/2021,Anchorage,7,Psych,0,,,,,,,,,,,,,,220,194,163,31,0,0,0,0,0,0,2,0,2
11/22/2021,Gulf Coast,4,CAH,1,85,71,28,43,4,1,3,24,0,24,0,0,0,85,71,28,43,4,1,3,24,0,24,0,0,0
11/22/2021,Gulf Coast,4,GACH,1,93,49,49,0,9,9,0,19,3,16,6,0,6,93,49,49,0,9,9,0,19,3,16,6,0,6
11/22/2021,Interior,6,GACH,1,101,81,63,18,25,8,17,16,2,14,10,0,10,101,81,63,18,25,8,17,16,2,14,10,0,10
11/22/2021,Matanuska-Susitna,3,GACH,1,184,160,101,59,14,13,1,33,6,27,20,0,20,184,160,101,59,14,13,1,33,6,27,20,0,20
11/22/2021,Northern,2,CAH,1,81,43,25,18,0,0,0,36,0,36,1,0,1,81,43,25,18,0,0,0,36,0,36,1,0,1
11/22/2021,Southeast,5,CAH,1,70,70,33,37,2,1,1,33,0,33,4,0,4,70,70,33,37,2,1,1,33,0,33,4,0,4
11/22/2021,Southeast,5,GACH,1,161,133,26,107,9,4,5,20,0,20,0,0,0,161,133,26,107,9,4,5,20,0,20,0,0,0
11/22/2021,Southwest,1,CAH,1,22,12,3,9,0,0,0,4,0,4,0,0,0,22,12,3,9,0,0,0,4,0,4,0,0,0
11/22/2021,Southwest,1,GACH,1,44,35,9,26,0,0,0,8,0,8,2,0,2,44,35,9,26,0,0,0,8,0,8,2,0,2
11/23/2021,Anchorage,7,GACH,1,738,707,606,101,127,115,12,232,52,180,50,0,50,738,707,606,101,127,115,12,232,52,180,50,0,50
11/23/2021,Anchorage,7,LTACH,0,44,44,36,8,6,6,0,23,5,18,0,0,0,44,44,36,8,6,6,0,23,5,18,0,0,0
11/23/2021,Anchorage,7,Psych,0,,,,,,,,,,,,,,220,194,163,31,0,0,0,0,0,0,2,0,2
11/23/2021,Gulf Coast,4,CAH,1,85,71,31,40,4,1,3,24,0,24,0,0,0,85,71,31,40,4,1,3,24,0,24,0,0,0
11/23/2021,Gulf Coast,4,GACH,1,93,49,44,5,9,7,2,19,2,17,4,0,4,93,49,44,5,9,7,2,19,2,17,4,0,4
11/23/2021,Interior,6,GACH,1,101,83,83,0,25,13,12,16,2,14,13,0,13,101,83,83,0,25,13,12,16,2,14,13,0,13
11/23/2021,Matanuska-Susitna,3,GACH,1,184,160,100,60,14,12,2,33,5,28,16,0,16,184,160,100,60,14,12,2,33,5,28,16,0,16
11/23/2021,Northern,2,CAH,1,81,43,24,19,0,0,0,36,0,36,1,0,1,81,43,24,19,0,0,0,36,0,36,1,0,1
11/23/2021,Southeast,5,CAH,1,70,70,35,35,2,1,1,33,0,33,4,0,4,70,70,35,35,2,1,1,33,0,33,4,0,4
11/23/2021,Southeast,5,GACH,1,161,133,31,102,9,7,2,20,0,20,0,0,0,161,133,31,102,9,7,2,20,0,20,0,0,0
11/23/2021,Southwest,1,CAH,1,22,12,2,10,0,0,0,4,0,4,0,0,0,22,12,2,10,0,0,0,4,0,4,0,0,0
11/23/2021,Southwest,1,GACH,1,44,35,8,27,0,0,0,8,0,8,2,0,2,44,35,8,27,0,0,0,8,0,8,2,0,2
11/24/2021,Anchorage,7,GACH,1,731,700,613,87,120,112,8,232,47,185,53,0,53,731,700,613,87,120,112,8,232,47,185,53,0,53
11/24/2021,Anchorage,7,LTACH,0,44,44,36,8,6,6,0,23,6,17,0,0,0,44,44,36,8,6,6,0,23,6,17,0,0,0
11/24/2021,Anchorage,7,Psych,0,220,196,163,33,0,0,0,0,0,0,0,0,0,220,196,163,33,0,0,0,0,0,0,0,0,0
11/24/2021,Gulf Coast,4,CAH,1,86,72,31,41,4,1,3,24,0,24,0,0,0,86,72,31,41,4,1,3,24,0,24,0,0,0
11/24/2021,Gulf Coast,4,GACH,1,93,49,46,3,9,8,1,19,1,18,3,0,3,93,49,46,3,9,8,1,19,1,18,3,0,3
11/24/2021,Interior,6,GACH,1,101,81,77,4,25,14,11,16,3,13,12,0,12,101,81,77,4,25,14,11,16,3,13,12,0,12
11/24/2021,Matanuska-Susitna,3,GACH,1,184,160,93,67,14,11,3,33,6,27,16,0,16,184,160,93,67,14,11,3,33,6,27,16,0,16
11/24/2021,Northern,2,CAH,1,81,43,29,14,0,0,0,36,0,36,1,0,1,81,43,29,14,0,0,0,36,0,36,1,0,1
11/24/2021,Southeast,5,CAH,1,70,70,33,37,2,0,2,33,0,33,4,0,4,70,70,33,37,2,0,2,33,0,33,4,0,4
11/24/2021,Southeast,5,GACH,1,161,133,36,97,9,4,5,20,0,20,0,0,0,161,133,36,97,9,4,5,20,0,20,0,0,0
11/24/2021,Southwest,1,CAH,1,22,12,5,7,0,0,0,4,0,4,1,0,1,22,12,5,7,0,0,0,4,0,4,1,0,1
11/24/2021,Southwest,1,GACH,1,44,35,9,26,0,0,0,8,0,8,1,0,1,44,35,9,26,0,0,0,8,0,8,1,0,1
11/25/2021,Anchorage,7,GACH,1,723,692,597,95,124,112,12,232,48,184,51,0,51,723,692,597,95,124,112,12,232,48,184,51,0,51
11/25/2021,Anchorage,7,LTACH,0,44,44,37,7,6,6,0,23,7,16,0,0,0,44,44,37,7,6,6,0,23,7,16,0,0,0
11/25/2021,Anchorage,7,Psych,0,,,,,,,,,,,,,,220,196,163,33,0,0,0,0,0,0,0,0,0
11/25/2021,Gulf Coast,4,CAH,1,85,71,29,42,4,1,3,24,0,24,2,0,2,85,71,29,42,4,1,3,24,0,24,2,0,2
11/25/2021,Gulf Coast,4,GACH,1,93,49,43,6,9,9,0,19,1,18,3,0,3,93,49,43,6,9,9,0,19,1,18,3,0,3
11/25/2021,Interior,6,GACH,1,101,81,60,21,25,14,11,16,5,11,8,0,8,101,81,60,21,25,14,11,16,5,11,8,0,8
11/25/2021,Matanuska-Susitna,3,GACH,1,184,160,85,75,14,11,3,33,7,26,17,0,17,184,160,85,75,14,11,3,33,7,26,17,0,17
11/25/2021,Northern,2,CAH,1,81,43,21,22,0,0,0,36,0,36,0,0,0,81,43,21,22,0,0,0,36,0,36,0,0,0
11/25/2021,Southeast,5,CAH,1,70,70,34,36,2,0,2,33,0,33,4,0,4,70,70,34,36,2,0,2,33,0,33,4,0,4
11/25/2021,Southeast,5,GACH,1,161,133,33,100,9,4,5,20,0,20,0,0,0,161,133,33,100,9,4,5,20,0,20,0,0,0
11/25/2021,Southwest,1,CAH,1,22,12,3,9,0,0,0,4,0,4,1,0,1,22,12,3,9,0,0,0,4,0,4,1,0,1
11/25/2021,Southwest,1,GACH,1,44,35,9,26,0,0,0,8,0,8,1,0,1,44,35,9,26,0,0,0,8,0,8,1,0,1
11/26/2021,Anchorage,7,GACH,1,727,697,598,99,118,104,14,232,36,196,42,0,42,727,697,598,99,118,104,14,232,36,196,42,0,42
11/26/2021,Anchorage,7,LTACH,0,44,44,37,7,6,6,0,23,7,16,0,0,0,44,44,37,7,6,6,0,23,7,16,0,0,0
11/26/2021,Anchorage,7,Psych,0,,,,,,,,,,,,,,220,196,163,33,0,0,0,0,0,0,0,0,0
11/26/2021,Gulf Coast,4,CAH,1,85,71,26,45,4,1,3,24,0,24,2,0,2,85,71,26,45,4,1,3,24,0,24,2,0,2
11/26/2021,Gulf Coast,4,GACH,1,93,49,43,6,9,5,4,19,0,19,3,0,3,93,49,43,6,9,5,4,19,0,19,3,0,3
11/26/2021,Interior,6,GACH,1,101,81,63,18,25,15,10,16,2,14,7,0,7,101,81,63,18,25,15,10,16,2,14,7,0,7
11/26/2021,Matanuska-Susitna,3,GACH,1,184,160,88,72,14,13,1,33,8,25,18,0,18,184,160,88,72,14,13,1,33,8,25,18,0,18
11/26/2021,Northern,2,CAH,1,81,43,22,21,0,0,0,36,0,36,0,0,0,81,43,22,21,0,0,0,36,0,36,0,0,0
11/26/2021,Southeast,5,CAH,1,70,70,32,38,2,0,2,33,0,33,4,0,4,70,70,32,38,2,0,2,33,0,33,4,0,4
11/26/2021,Southeast,5,GACH,1,161,133,31,102,9,2,7,20,0,20,0,0,0,161,133,31,102,9,2,7,20,0,20,0,0,0
11/26/2021,Southwest,1,CAH,1,22,12,4,8,0,0,0,4,0,4,0,0,0,22,12,4,8,0,0,0,4,0,4,0,0,0
11/26/2021,Southwest,1,GACH,1,44,35,8,27,0,0,0,8,0,8,2,0,2,44,35,8,27,0,0,0,8,0,8,2,0,2
11/27/2021,Anchorage,7,GACH,1,725,699,595,104,118,102,16,232,37,195,40,0,40,725,699,595,104,118,102,16,232,37,195,40,0,40
11/27/2021,Anchorage,7,LTACH,0,44,44,37,7,6,6,0,23,7,16,0,0,0,44,44,37,7,6,6,0,23,7,16,0,0,0
11/27/2021,Anchorage,7,Psych,0,,,,,,,,,,,,,,220,196,163,33,0,0,0,0,0,0,0,0,0
11/27/2021,Gulf Coast,4,CAH,1,85,71,29,42,4,0,4,24,0,24,2,0,2,85,71,29,42,4,0,4,24,0,24,2,0,2
11/27/2021,Gulf Coast,4,GACH,1,93,49,43,6,9,5,4,19,1,18,5,0,5,93,49,43,6,9,5,4,19,1,18,5,0,5
11/27/2021,Interior,6,GACH,1,101,81,62,19,25,12,13,16,2,14,7,0,7,101,81,62,19,25,12,13,16,2,14,7,0,7
11/27/2021,Matanuska-Susitna,3,GACH,1,184,160,88,72,14,13,1,33,8,25,18,0,18,184,160,88,72,14,13,1,33,8,25,18,0,18
11/27/2021,Northern,2,CAH,1,81,43,22,21,0,0,0,36,0,36,0,0,0,81,43,22,21,0,0,0,36,0,36,0,0,0
11/27/2021,Southeast,5,CAH,1,70,70,32,38,2,0,2,33,0,33,6,0,6,70,70,32,38,2,0,2,33,0,33,6,0,6
11/27/2021,Southeast,5,GACH,1,161,133,32,101,9,4,5,20,0,20,0,0,0,161,133,32,101,9,4,5,20,0,20,0,0,0
11/27/2021,Southwest,1,CAH,1,22,12,2,10,0,0,0,4,0,4,0,0,0,22,12,2,10,0,0,0,4,0,4,0,0,0
11/27/2021,Southwest,1,GACH,1,44,35,8,27,0,0,0,8,0,8,2,0,2,44,35,8,27,0,0,0,8,0,8,2,0,2
11/28/2021,Anchorage,7,GACH,1,727,701,597,104,116,103,13,232,35,197,40,1,41,727,701,597,104,116,103,13,232,35,197,40,1,41
11/28/2021,Anchorage,7,LTACH,0,44,44,37,7,6,6,0,23,7,16,0,0,0,44,44,37,7,6,6,0,23,7,16,0,0,0
11/28/2021,Anchorage,7,Psych,0,,,,,,,,,,,,,,220,196,163,33,0,0,0,0,0,0,0,0,0
11/28/2021,Gulf Coast,4,CAH,1,85,71,27,44,4,1,3,24,0,24,2,0,2,85,71,27,44,4,1,3,24,0,24,2,0,2
11/28/2021,Gulf Coast,4,GACH,1,93,49,48,1,9,8,1,19,2,17,5,0,5,93,49,48,1,9,8,1,19,2,17,5,0,5
11/28/2021,Interior,6,GACH,1,101,81,63,18,25,12,13,16,2,14,7,0,7,101,81,63,18,25,12,13,16,2,14,7,0,7
11/28/2021,Matanuska-Susitna,3,GACH,1,184,160,96,64,14,12,2,33,7,26,17,0,17,184,160,96,64,14,12,2,33,7,26,17,0,17
11/28/2021,Northern,2,CAH,1,81,43,30,13,0,0,0,36,0,36,0,0,0,81,43,30,13,0,0,0,36,0,36,0,0,0
11/28/2021,Southeast,5,CAH,1,70,70,31,39,2,0,2,33,0,33,6,0,6,70,70,31,39,2,0,2,33,0,33,6,0,6
11/28/2021,Southeast,5,GACH,1,161,133,35,98,9,6,3,20,0,20,0,0,0,161,133,35,98,9,6,3,20,0,20,0,0,0
11/28/2021,Southwest,1,CAH,1,22,12,2,10,0,0,0,4,0,4,0,0,0,22,12,2,10,0,0,0,4,0,4,0,0,0
11/28/2021,Southwest,1,GACH,1,44,35,10,25,0,0,0,8,0,8,1,0,1,44,35,10,25,0,0,0,8,0,8,1,0,1
11/29/2021,Anchorage,7,GACH,1,727,700,595,105,118,104,14,232,30,202,39,0,39,727,700,595,105,118,104,14,232,30,202,39,0,39
11/29/2021,Anchorage,7,LTACH,0,44,44,38,6,6,6,0,23,6,17,0,0,0,44,44,38,6,6,6,0,23,6,17,0,0,0
11/29/2021,Anchorage,7,Psych,0,,,,,,,,,,,,,,220,196,163,33,0,0,0,0,0,0,0,0,0
11/29/2021,Gulf Coast,4,CAH,1,85,71,33,38,4,1,3,24,0,24,2,0,2,85,71,33,38,4,1,3,24,0,24,2,0,2
11/29/2021,Gulf Coast,4,GACH,1,93,53,53,0,9,9,0,19,2,17,4,0,4,93,53,53,0,9,9,0,19,2,17,4,0,4
11/29/2021,Interior,6,GACH,1,101,81,72,9,25,14,11,16,2,14,7,0,7,101,81,72,9,25,14,11,16,2,14,7,0,7
11/29/2021,Matanuska-Susitna,3,GACH,1,184,160,84,76,14,12,2,33,8,25,18,0,18,184,160,84,76,14,12,2,33,8,25,18,0,18
11/29/2021,Northern,2,CAH,1,81,43,32,11,0,0,0,36,0,36,0,0,0,81,43,32,11,0,0,0,36,0,36,0,0,0
11/29/2021,Southeast,5,CAH,1,70,70,34,36,3,1,2,33,0,33,7,0,7,70,70,34,36,3,1,2,33,0,33,7,0,7
11/29/2021,Southeast,5,GACH,1,161,133,37,96,9,5,4,20,0,20,0,0,0,161,133,37,96,9,5,4,20,0,20,0,0,0
11/29/2021,Southwest,1,CAH,1,22,12,2,10,0,0,0,4,0,4,0,0,0,22,12,2,10,0,0,0,4,0,4,0,0,0
11/29/2021,Southwest,1,GACH,1,44,35,9,26,0,0,0,8,0,8,1,0,1,44,35,9,26,0,0,0,8,0,8,1,0,1
11/30/2021,Anchorage,7,GACH,1,742,715,622,93,119,106,13,230,34,196,33,0,33,742,715,622,93,119,106,13,230,34,196,33,0,33
11/30/2021,Anchorage,7,LTACH,0,44,44,38,6,6,6,0,23,5,18,0,0,0,44,44,38,6,6,6,0,23,5,18,0,0,0
11/30/2021,Anchorage,7,Psych,0,,,,,,,,,,,,,,220,196,163,33,0,0,0,0,0,0,0,0,0
11/30/2021,Gulf Coast,4,CAH,1,85,71,36,35,4,2,2,24,0,24,2,0,2,85,71,36,35,4,2,2,24,0,24,2,0,2
11/30/2021,Gulf Coast,4,GACH,1,93,49,49,0,9,8,1,19,2,17,4,0,4,93,49,49,0,9,8,1,19,2,17,4,0,4
11/30/2021,Interior,6,GACH,1,101,81,72,9,25,11,14,16,2,14,5,0,5,101,81,72,9,25,11,14,16,2,14,5,0,5
11/30/2021,Matanuska-Susitna,3,GACH,1,184,160,96,64,14,12,2,33,9,24,20,0,20,184,160,96,64,14,12,2,33,9,24,20,0,20
11/30/2021,Northern,2,CAH,1,81,43,28,15,0,0,0,36,0,36,0,0,0,81,43,28,15,0,0,0,36,0,36,0,0,0
11/30/2021,Southeast,5,CAH,1,70,70,37,33,3,1,2,33,0,33,4,0,4,70,70,37,33,3,1,2,33,0,33,4,0,4
11/30/2021,Southeast,5,GACH,1,161,133,41,92,9,4,5,20,0,20,0,0,0,161,133,41,92,9,4,5,20,0,20,0,0,0
11/30/2021,Southwest,1,CAH,1,22,12,0,12,0,0,0,4,0,4,0,0,0,22,12,0,12,0,0,0,4,0,4,0,0,0
11/30/2021,Southwest,1,GACH,1,44,35,13,22,0,0,0,8,0,8,3,0,3,44,35,13,22,0,0,0,8,0,8,3,0,3
12/01/2021,Anchorage,7,GACH,1,751,725,630,95,114,102,12,230,33,197,35,0,35,751,725,630,95,114,102,12,230,33,197,35,0,35
12/01/2021,Anchorage,7,LTACH,0,44,44,38,6,6,6,0,23,5,18,0,0,0,44,44,38,6,6,6,0,23,5,18,0,0,0
12/01/2021,Anchorage,7,Psych,0,199,199,174,25,0,0,0,0,0,0,0,0,0,199,199,174,25,0,0,0,0,0,0,0,0,0
12/01/2021,Gulf Coast,4,CAH,1,85,71,34,37,4,1,3,24,0,24,2,0,2,85,71,34,37,4,1,3,24,0,24,2,0,2
12/01/2021,Gulf Coast,4,GACH,1,93,55,55,0,9,9,0,22,2,20,2,0,2,93,55,55,0,9,9,0,22,2,20,2,0,2
12/01/2021,Interior,6,GACH,1,101,81,73,8,25,11,14,16,2,14,6,0,6,101,81,73,8,25,11,14,16,2,14,6,0,6
12/01/2021,Matanuska-Susitna,3,GACH,1,184,160,99,61,14,12,2,33,8,25,20,0,20,184,160,99,61,14,12,2,33,8,25,20,0,20
12/01/2021,Northern,2,CAH,1,81,43,25,18,0,0,0,36,0,36,1,0,1,81,43,25,18,0,0,0,36,0,36,1,0,1
12/01/2021,Southeast,5,CAH,1,70,70,39,31,5,3,2,33,0,33,3,0,3,70,70,39,31,5,3,2,33,0,33,3,0,3
12/01/2021,Southeast,5,GACH,1,161,133,43,90,9,3,6,20,0,20,0,0,0,161,133,43,90,9,3,6,20,0,20,0,0,0
12/01/2021,Southwest,1,CAH,1,22,12,0,12,0,0,0,4,0,4,0,0,0,22,12,0,12,0,0,0,4,0,4,0,0,0
12/01/2021,Southwest,1,GACH,1,44,35,19,16,0,0,0,8,0,8,3,0,3,44,35,19,16,0,0,0,8,0,8,3,0,3
12/02/2021,Anchorage,7,GACH,1,749,719,631,88,122,105,17,232,39,193,32,0,32,749,719,631,88,122,105,17,232,39,193,32,0,32
12/02/2021,Anchorage,7,LTACH,0,44,44,37,7,6,6,0,23,5,18,0,0,0,44,44,37,7,6,6,0,23,5,18,0,0,0
12/02/2021,Anchorage,7,Psych,0,,,,,,,,,,,,,,199,199,174,25,0,0,0,0,0,0,0,0,0
12/02/2021,Gulf Coast,4,CAH,1,81,71,35,36,4,1,3,24,0,24,2,0,2,81,71,35,36,4,1,3,24,0,24,2,0,2
12/02/2021,Gulf Coast,4,GACH,1,93,52,52,0,9,9,0,22,2,20,2,0,2,93,52,52,0,9,9,0,22,2,20,2,0,2
12/02/2021,Interior,6,GACH,1,101,86,86,0,25,10,15,16,1,15,7,0,7,101,86,86,0,25,10,15,16,1,15,7,0,7
12/02/2021,Matanuska-Susitna,3,GACH,1,184,160,109,51,14,14,0,33,9,24,21,0,21,184,160,109,51,14,14,0,33,9,24,21,0,21
12/02/2021,Northern,2,CAH,1,81,43,21,22,0,0,0,36,0,36,1,0,1,81,43,21,22,0,0,0,36,0,36,1,0,1
12/02/2021,Southeast,5,CAH,1,70,70,42,28,3,2,1,33,0,33,4,0,4,70,70,42,28,3,2,1,33,0,33,4,0,4
12/02/2021,Southeast,5,GACH,1,161,133,48,85,9,5,4,20,0,20,0,0,0,161,133,48,85,9,5,4,20,0,20,0,0,0
12/02/2021,Southwest,1,CAH,1,22,12,0,12,0,0,0,4,0,4,0,0,0,22,12,0,12,0,0,0,4,0,4,0,0,0
12/02/2021,Southwest,1,GACH,1,44,35,17,18,0,0,0,8,0,8,3,0,3,44,35,17,18,0,0,0,8,0,8,3,0,3
12/03/2021,Anchorage,7,GACH,1,732,706,599,107,115,105,10,232,44,188,31,1,32,732,706,599,107,115,105,10,232,44,188,31,1,32
12/03/2021,Anchorage,7,LTACH,0,44,44,36,8,6,6,0,23,4,19,0,0,0,44,44,36,8,6,6,0,23,4,19,0,0,0
12/03/2021,Anchorage,7,Psych,0,,,,,,,,,,,,,,199,199,174,25,0,0,0,0,0,0,0,0,0
12/03/2021,Gulf Coast,4,CAH,1,81,71,35,36,4,3,1,24,0,24,2,0,2,81,71,35,36,4,3,1,24,0,24,2,0,2
12/03/2021,Gulf Coast,4,GACH,1,93,57,57,0,9,9,0,22,1,21,2,0,2,93,57,57,0,9,9,0,22,1,21,2,0,2
12/03/2021,Interior,6,GACH,1,101,81,73,8,25,13,12,16,1,15,7,0,7,101,81,73,8,25,13,12,16,1,15,7,0,7
12/03/2021,Matanuska-Susitna,3,GACH,1,184,160,107,53,14,14,0,33,10,23,23,0,23,184,160,107,53,14,14,0,33,10,23,23,0,23
12/03/2021,Northern,2,CAH,1,81,43,18,25,0,0,0,36,0,36,1,0,1,81,43,18,25,0,0,0,36,0,36,1,0,1
12/03/2021,Southeast,5,CAH,1,70,70,37,33,3,1,2,33,0,33,4,0,4,70,70,37,33,3,1,2,33,0,33,4,0,4
12/03/2021,Southeast,5,GACH,1,161,133,45,88,9,4,5,20,0,20,0,0,0,161,133,45,88,9,4,5,20,0,20,0,0,0
12/03/2021,Southwest,1,CAH,1,22,12,2,10,0,0,0,4,0,4,0,0,0,22,12,2,10,0,0,0,4,0,4,0,0,0
12/03/2021,Southwest,1,GACH,1,44,35,17,18,0,0,0,8,0,8,3,0,3,44,35,17,18,0,0,0,8,0,8,3,0,3
12/04/2021,Anchorage,7,GACH,1,733,709,579,130,112,103,9,232,41,191,32,1,33,733,709,579,130,112,103,9,232,41,191,32,1,33
12/04/2021,Anchorage,7,LTACH,0,44,44,38,6,6,6,0,23,2,21,0,0,0,44,44,38,6,6,6,0,23,2,21,0,0,0
12/04/2021,Anchorage,7,Psych,0,,,,,,,,,,,,,,199,199,174,25,0,0,0,0,0,0,0,0,0
12/04/2021,Gulf Coast,4,CAH,1,81,71,29,42,4,2,2,24,0,24,3,0,3,81,71,29,42,4,2,2,24,0,24,3,0,3
12/04/2021,Gulf Coast,4,GACH,1,93,49,49,0,9,8,1,22,1,21,2,0,2,93,49,49,0,9,8,1,22,1,21,2,0,2
12/04/2021,Interior,6,GACH,1,101,81,68,13,25,11,14,16,1,15,6,0,6,101,81,68,13,25,11,14,16,1,15,6,0,6
12/04/2021,Matanuska-Susitna,3,GACH,1,184,160,92,68,14,12,2,33,10,23,24,0,24,184,160,92,68,14,12,2,33,10,23,24,0,24
12/04/2021,Northern,2,CAH,1,81,43,14,29,0,0,0,36,0,36,0,0,0,81,43,14,29,0,0,0,36,0,36,0,0,0
12/04/2021,Southeast,5,CAH,1,70,70,42,28,3,1,2,33,0,33,5,0,5,70,70,42,28,3,1,2,33,0,33,5,0,5
12/04/2021,Southeast,5,GACH,1,161,133,42,91,9,2,7,20,0,20,0,0,0,161,133,42,91,9,2,7,20,0,20,0,0,0
12/04/2021,Southwest,1,CAH,1,22,12,1,11,0,0,0,4,0,4,0,0,0,22,12,1,11,0,0,0,4,0,4,0,0,0
12/04/2021,Southwest,1,GACH,1,44,35,15,20,0,0,0,8,0,8,2,0,2,44,35,15,20,0,0,0,8,0,8,2,0,2
12/05/2021,Anchorage,7,GACH,1,703,677,555,122,112,102,10,232,36,196,36,0,36,703,677,555,122,112,102,10,232,36,196,36,0,36
12/05/2021,Anchorage,7,LTACH,0,44,44,39,5,6,6,0,23,2,21,0,0,0,44,44,39,5,6,6,0,23,2,21,0,0,0
12/05/2021,Anchorage,7,Psych,0,,,,,,,,,,,,,,199,199,174,25,0,0,0,0,0,0,0,0,0
12/05/2021,Gulf Coast,4,CAH,1,81,71,29,42,4,2,2,24,0,24,4,0,4,81,71,29,42,4,2,2,24,0,24,4,0,4
12/05/2021,Gulf Coast,4,GACH,1,93,49,42,7,9,6,3,22,0,22,2,0,2,93,49,42,7,9,6,3,22,0,22,2,0,2
12/05/2021,Interior,6,GACH,1,101,81,60,21,25,10,15,16,2,14,6,0,6,101,81,60,21,25,10,15,16,2,14,6,0,6
12/05/2021,Matanuska-Susitna,3,GACH,1,184,160,99,61,14,14,0,33,11,22,24,0,24,184,160,99,61,14,14,0,33,11,22,24,0,24
12/05/2021,Northern,2,CAH,1,81,43,16,27,0,0,0,36,0,36,0,0,0,81,43,16,27,0,0,0,36,0,36,0,0,0
12/05/2021,Southeast,5,CAH,1,70,70,39,31,3,1,2,33,0,33,5,0,5,70,70,39,31,3,1,2,33,0,33,5,0,5
12/05/2021,Southeast,5,GACH,1,161,133,37,96,9,2,7,20,1,19,0,0,0,161,133,37,96,9,2,7,20,1,19,0,0,0
12/05/2021,Southwest,1,CAH,1,22,12,1,11,0,0,0,4,0,4,0,0,0,22,12,1,11,0,0,0,4,0,4,0,0,0
12/05/2021,Southwest,1,GACH,1,44,35,15,20,0,0,0,8,0,8,2,0,2,44,35,15,20,0,0,0,8,0,8,2,0,2
12/06/2021,Anchorage,7,GACH,1,721,695,579,116,115,105,10,232,38,194,34,1,35,721,695,579,116,115,105,10,232,38,194,34,1,35
12/06/2021,Anchorage,7,LTACH,0,44,44,39,5,6,6,0,23,2,21,0,0,0,44,44,39,5,6,6,0,23,2,21,0,0,0
12/06/2021,Anchorage,7,Psych,0,,,,,,,,,,,,,,199,199,174,25,0,0,0,0,0,0,0,0,0
12/06/2021,Gulf Coast,4,CAH,1,81,71,29,42,4,2,2,24,0,24,5,0,5,81,71,29,42,4,2,2,24,0,24,5,0,5
12/06/2021,Gulf Coast,4,GACH,1,93,49,45,4,9,6,3,22,0,22,1,0,1,93,49,45,4,9,6,3,22,0,22,1,0,1
12/06/2021,Interior,6,GACH,1,101,81,70,11,25,12,13,16,1,15,8,0,8,101,81,70,11,25,12,13,16,1,15,8,0,8
12/06/2021,Matanuska-Susitna,3,GACH,1,184,160,95,65,14,14,0,33,10,23,23,0,23,184,160,95,65,14,14,0,33,10,23,23,0,23
12/06/2021,Northern,2,CAH,1,81,43,17,26,0,0,0,36,0,36,0,0,0,81,43,17,26,0,0,0,36,0,36,0,0,0
12/06/2021,Southeast,5,CAH,1,70,70,39,31,3,1,2,33,0,33,5,0,5,70,70,39,31,3,1,2,33,0,33,5,0,5
12/06/2021,Southeast,5,GACH,1,161,133,39,94,9,2,7,20,1,19,0,0,0,161,133,39,94,9,2,7,20,1,19,0,0,0
12/06/2021,Southwest,1,CAH,1,22,12,1,11,0,0,0,4,0,4,0,0,0,22,12,1,11,0,0,0,4,0,4,0,0,0
12/06/2021,Southwest,1,GACH,1,44,35,16,19,0,0,0,8,0,8,2,0,2,44,35,16,19,0,0,0,8,0,8,2,0,2
12/07/2021,Anchorage,7,GACH,1,741,716,614,102,122,113,9,232,44,188,36,1,37,741,716,614,102,122,113,9,232,44,188,36,1,37
12/07/2021,Anchorage,7,LTACH,0,44,44,39,5,6,6,0,23,2,21,0,0,0,44,44,39,5,6,6,0,23,2,21,0,0,0
12/07/2021,Anchorage,7,Psych,0,,,,,,,,,,,,,,199,199,174,25,0,0,0,0,0,0,0,0,0
12/07/2021,Gulf Coast,4,CAH,1,81,71,23,48,4,1,3,24,0,24,3,0,3,81,71,23,48,4,1,3,24,0,24,3,0,3
12/07/2021,Gulf Coast,4,GACH,1,93,49,49,0,9,7,2,22,0,22,1,0,1,93,49,49,0,9,7,2,22,0,22,1,0,1
12/07/2021,Interior,6,GACH,1,101,81,69,12,25,9,16,16,1,15,8,0,8,101,81,69,12,25,9,16,16,1,15,8,0,8
12/07/2021,Matanuska-Susitna,3,GACH,1,184,160,103,57,14,14,0,33,8,25,24,0,24,184,160,103,57,14,14,0,33,8,25,24,0,24
12/07/2021,Northern,2,CAH,1,81,43,19,24,0,0,0,36,0,36,0,0,0,81,43,19,24,0,0,0,36,0,36,0,0,0
12/07/2021,Southeast,5,CAH,1,70,70,40,30,5,4,1,33,0,33,6,0,6,70,70,40,30,5,4,1,33,0,33,6,0,6
12/07/2021,Southeast,5,GACH,1,161,133,26,107,9,4,5,20,0,20,0,0,0,161,133,26,107,9,4,5,20,0,20,0,0,0
12/07/2021,Southwest,1,CAH,1,22,12,1,11,0,0,0,4,0,4,0,0,0,22,12,1,11,0,0,0,4,0,4,0,0,0
12/07/2021,Southwest,1,GACH,1,44,35,21,14,0,0,0,8,0,8,3,0,3,44,35,21,14,0,0,0,8,0,8,3,0,3
12/08/2021,Anchorage,7,GACH,1,741,717,630,87,122,112,10,232,43,189,35,1,36,741,717,630,87,122,112,10,232,43,189,35,1,36
12/08/2021,Anchorage,7,LTACH,0,44,44,36,8,6,6,0,23,2,21,0,0,0,44,44,36,8,6,6,0,23,2,21,0,0,0
12/08/2021,Anchorage,7,Psych,0,203,203,179,24,0,0,0,0,0,0,0,0,0,203,203,179,24,0,0,0,0,0,0,0,0,0
12/08/2021,Gulf Coast,4,CAH,1,81,71,22,49,4,1,3,24,0,24,3,0,3,81,71,22,49,4,1,3,24,0,24,3,0,3
12/08/2021,Gulf Coast,4,GACH,1,93,49,46,3,9,4,5,22,0,22,1,0,1,93,49,46,3,9,4,5,22,0,22,1,0,1
12/08/2021,Interior,6,GACH,1,101,81,72,9,25,11,14,16,0,16,7,0,7,101,81,72,9,25,11,14,16,0,16,7,0,7
12/08/2021,Matanuska-Susitna,3,GACH,1,184,160,107,53,14,14,0,33,8,25,26,0,26,184,160,107,53,14,14,0,33,8,25,26,0,26
12/08/2021,Northern,2,CAH,1,81,43,18,25,0,0,0,36,0,36,0,0,0,81,43,18,25,0,0,0,36,0,36,0,0,0
12/08/2021,Southeast,5,CAH,1,70,70,39,31,4,2,2,33,0,33,7,0,7,70,70,39,31,4,2,2,33,0,33,7,0,7
12/08/2021,Southeast,5,GACH,1,161,133,26,107,9,4,5,20,0,20,1,0,1,161,133,26,107,9,4,5,20,0,20,1,0,1
12/08/2021,Southwest,1,CAH,1,22,12,1,11,0,0,0,4,0,4,0,0,0,22,12,1,11,0,0,0,4,0,4,0,0,0
12/08/2021,Southwest,1,GACH,1,44,35,17,18,0,0,0,8,0,8,3,0,3,44,35,17,18,0,0,0,8,0,8,3,0,3
12/09/2021,Anchorage,7,GACH,1,746,718,640,78,114,105,9,232,44,188,31,1,32,746,718,640,78,114,105,9,232,44,188,31,1,32
12/09/2021,Anchorage,7,LTACH,0,44,44,36,8,6,6,0,23,2,21,0,0,0,44,44,36,8,6,6,0,23,2,21,0,0,0
12/09/2021,Anchorage,7,Psych,0,,,,,,,,,,,,,,203,203,179,24,0,0,0,0,0,0,0,0,0
12/09/2021,Gulf Coast,4,CAH,1,81,71,24,47,4,0,4,24,0,24,2,0,2,81,71,24,47,4,0,4,24,0,24,2,0,2
12/09/2021,Gulf Coast,4,GACH,1,93,49,45,4,9,4,5,22,0,22,1,0,1,93,49,45,4,9,4,5,22,0,22,1,0,1
12/09/2021,Interior,6,GACH,1,101,81,72,9,25,12,13,16,0,16,5,0,5,101,81,72,9,25,12,13,16,0,16,5,0,5
12/09/2021,Matanuska-Susitna,3,GACH,1,184,160,116,44,14,14,0,33,7,26,23,0,23,184,160,116,44,14,14,0,33,7,26,23,0,23
12/09/2021,Northern,2,CAH,1,81,43,23,20,0,0,0,36,0,36,1,0,1,81,43,23,20,0,0,0,36,0,36,1,0,1
12/09/2021,Southeast,5,CAH,1,70,70,37,33,7,5,2,33,0,33,6,0,6,70,70,37,33,7,5,2,33,0,33,6,0,6
12/09/2021,Southeast,5,GACH,1,161,133,31,102,9,5,4,20,0,20,1,0,1,161,133,31,102,9,5,4,20,0,20,1,0,1
12/09/2021,Southwest,1,CAH,1,22,12,1,11,0,0,0,4,0,4,0,0,0,22,12,1,11,0,0,0,4,0,4,0,0,0
12/09/2021,Southwest,1,GACH,1,44,35,17,18,0,0,0,8,0,8,3,0,3,44,35,17,18,0,0,0,8,0,8,3,0,3
12/10/2021,Anchorage,7,GACH,1,745,719,637,82,125,113,12,230,39,191,33,1,34,745,719,637,82,125,113,12,230,39,191,33,1,34
12/10/2021,Anchorage,7,LTACH,0,44,44,37,7,6,6,0,23,4,19,0,0,0,44,44,37,7,6,6,0,23,4,19,0,0,0
12/10/2021,Anchorage,7,Psych,0,,,,,,,,,,,,,,203,203,179,24,0,0,0,0,0,0,0,0,0
12/10/2021,Gulf Coast,4,CAH,1,81,71,25,46,4,0,4,24,0,24,3,0,3,81,71,25,46,4,0,4,24,0,24,3,0,3
12/10/2021,Gulf Coast,4,GACH,1,93,49,47,2,9,7,2,22,0,22,1,0,1,93,49,47,2,9,7,2,22,0,22,1,0,1
12/10/2021,Interior,6,GACH,1,101,81,70,11,25,13,12,16,0,16,4,0,4,101,81,70,11,25,13,12,16,0,16,4,0,4
12/10/2021,Matanuska-Susitna,3,GACH,1,184,160,108,52,14,13,1,33,4,29,19,0,19,184,160,108,52,14,13,1,33,4,29,19,0,19
12/10/2021,Northern,2,CAH,1,81,43,23,20,0,0,0,36,0,36,1,0,1,81,43,23,20,0,0,0,36,0,36,1,0,1
12/10/2021,Southeast,5,CAH,1,70,70,38,32,4,2,2,33,0,33,8,0,8,70,70,38,32,4,2,2,33,0,33,8,0,8
12/10/2021,Southeast,5,GACH,1,161,133,32,101,9,7,2,20,0,20,1,0,1,161,133,32,101,9,7,2,20,0,20,1,0,1
12/10/2021,Southwest,1,CAH,1,22,12,2,10,0,0,0,4,0,4,0,0,0,22,12,2,10,0,0,0,4,0,4,0,0,0
12/10/2021,Southwest,1,GACH,1,44,35,15,20,0,0,0,8,0,8,3,0,3,44,35,15,20,0,0,0,8,0,8,3,0,3
12/11/2021,Anchorage,7,GACH,1,727,698,623,75,123,112,11,230,36,194,26,1,27,727,698,623,75,123,112,11,230,36,194,26,1,27
12/11/2021,Anchorage,7,LTACH,0,44,44,37,7,6,6,0,23,4,19,0,0,0,44,44,37,7,6,6,0,23,4,19,0,0,0
12/11/2021,Anchorage,7,Psych,0,,,,,,,,,,,,,,203,203,179,24,0,0,0,0,0,0,0,0,0
12/11/2021,Gulf Coast,4,CAH,1,81,71,33,38,4,1,3,24,0,24,3,0,3,81,71,33,38,4,1,3,24,0,24,3,0,3
12/11/2021,Gulf Coast,4,GACH,1,93,49,41,8,9,4,5,22,0,22,1,0,1,93,49,41,8,9,4,5,22,0,22,1,0,1
12/11/2021,Interior,6,GACH,1,101,83,83,0,25,12,13,16,0,16,3,0,3,101,83,83,0,25,12,13,16,0,16,3,0,3
12/11/2021,Matanuska-Susitna,3,GACH,1,184,160,105,55,14,12,2,33,5,28,19,0,19,184,160,105,55,14,12,2,33,5,28,19,0,19
12/11/2021,Northern,2,CAH,1,81,43,21,22,0,0,0,36,0,36,2,0,2,81,43,21,22,0,0,0,36,0,36,2,0,2
12/11/2021,Southeast,5,CAH,1,70,70,43,27,4,3,1,33,0,33,10,0,10,70,70,43,27,4,3,1,33,0,33,10,0,10
12/11/2021,Southeast,5,GACH,1,161,133,40,93,9,5,4,20,0,20,1,0,1,161,133,40,93,9,5,4,20,0,20,1,0,1
12/11/2021,Southwest,1,CAH,1,22,12,2,10,0,0,0,4,0,4,0,0,0,22,12,2,10,0,0,0,4,0,4,0,0,0
12/11/2021,Southwest,1,GACH,1,44,35,10,25,0,0,0,8,0,8,1,0,1,44,35,10,25,0,0,0,8,0,8,1,0,1
12/12/2021,Anchorage,7,GACH,1,727,695,629,66,118,110,8,230,37,193,28,1,29,727,695,629,66,118,110,8,230,37,193,28,1,29
12/12/2021,Anchorage,7,LTACH,0,44,44,37,7,6,6,0,23,4,19,0,0,0,44,44,37,7,6,6,0,23,4,19,0,0,0
12/12/2021,Anchorage,7,Psych,0,,,,,,,,,,,,,,203,203,179,24,0,0,0,0,0,0,0,0,0
12/12/2021,Gulf Coast,4,CAH,1,81,71,33,38,4,0,4,24,0,24,3,0,3,81,71,33,38,4,0,4,24,0,24,3,0,3
12/12/2021,Gulf Coast,4,GACH,1,93,49,38,11,9,6,3,22,0,22,0,0,0,93,49,38,11,9,6,3,22,0,22,0,0,0
12/12/2021,Interior,6,GACH,1,101,81,76,5,25,12,13,16,0,16,1,0,1,101,81,76,5,25,12,13,16,0,16,1,0,1
12/12/2021,Matanuska-Susitna,3,GACH,1,184,160,94,66,14,12,2,33,8,25,17,0,17,184,160,94,66,14,12,2,33,8,25,17,0,17
12/12/2021,Northern,2,CAH,1,81,43,18,25,0,0,0,36,0,36,2,0,2,81,43,18,25,0,0,0,36,0,36,2,0,2
12/12/2021,Southeast,5,CAH,1,70,70,41,29,4,3,1,33,0,33,10,0,10,70,70,41,29,4,3,1,33,0,33,10,0,10
12/12/2021,Southeast,5,GACH,1,161,133,37,96,9,6,3,20,1,19,1,0,1,161,133,37,96,9,6,3,20,1,19,1,0,1
12/12/2021,Southwest,1,CAH,1,22,12,1,11,0,0,0,4,0,4,0,0,0,22,12,1,11,0,0,0,4,0,4,0,0,0
12/12/2021,Southwest,1,GACH,1,44,35,11,24,0,0,0,8,0,8,1,0,1,44,35,11,24,0,0,0,8,0,8,1,0,1
12/13/2021,Anchorage,7,GACH,1,724,695,614,81,119,109,10,230,38,192,30,1,31,724,695,614,81,119,109,10,230,38,192,30,1,31
12/13/2021,Anchorage,7,LTACH,0,44,44,38,6,6,6,0,23,4,19,0,0,0,44,44,38,6,6,6,0,23,4,19,0,0,0
12/13/2021,Anchorage,7,Psych,0,,,,,,,,,,,,,,203,203,179,24,0,0,0,0,0,0,0,0,0
12/13/2021,Gulf Coast,4,CAH,1,81,71,30,41,4,1,3,24,0,24,3,0,3,81,71,30,41,4,1,3,24,0,24,3,0,3
12/13/2021,Gulf Coast,4,GACH,1,93,49,40,9,9,5,4,22,0,22,1,0,1,93,49,40,9,9,5,4,22,0,22,1,0,1
12/13/2021,Interior,6,GACH,1,101,81,75,6,25,15,10,16,0,16,2,0,2,101,81,75,6,25,15,10,16,0,16,2,0,2
12/13/2021,Matanuska-Susitna,3,GACH,1,184,160,85,75,14,13,1,33,8,25,16,0,16,184,160,85,75,14,13,1,33,8,25,16,0,16
12/13/2021,Northern,2,CAH,1,81,43,17,26,0,0,0,36,0,36,1,0,1,81,43,17,26,0,0,0,36,0,36,1,0,1
12/13/2021,Southeast,5,CAH,1,70,70,38,32,4,2,2,33,0,33,8,0,8,70,70,38,32,4,2,2,33,0,33,8,0,8
12/13/2021,Southeast,5,GACH,1,161,133,36,97,9,3,6,20,1,19,2,0,2,161,133,36,97,9,3,6,20,1,19,2,0,2
12/13/2021,Southwest,1,CAH,1,22,12,0,12,0,0,0,4,0,4,0,0,0,22,12,0,12,0,0,0,4,0,4,0,0,0
12/13/2021,Southwest,1,GACH,1,44,35,14,21,0,0,0,8,0,8,0,0,0,44,35,14,21,0,0,0,8,0,8,0,0,0
12/14/2021,Anchorage,7,GACH,1,734,704,626,78,124,111,13,230,41,189,32,1,33,734,704,626,78,124,111,13,230,41,189,32,1,33
12/14/2021,Anchorage,7,LTACH,0,44,44,38,6,6,6,0,23,3,20,0,0,0,44,44,38,6,6,6,0,23,3,20,0,0,0
12/14/2021,Anchorage,7,Psych,0,,,,,,,,,,,,,,203,203,179,24,0,0,0,0,0,0,0,0,0
12/14/2021,Gulf Coast,4,CAH,1,81,71,30,41,4,1,3,24,0,24,2,0,2,81,71,30,41,4,1,3,24,0,24,2,0,2
12/14/2021,Gulf Coast,4,GACH,1,93,49,44,5,9,6,3,22,0,22,2,0,2,93,49,44,5,9,6,3,22,0,22,2,0,2
12/14/2021,Interior,6,GACH,1,101,82,82,0,25,14,11,16,0,16,2,0,2,101,82,82,0,25,14,11,16,0,16,2,0,2
12/14/2021,Matanuska-Susitna,3,GACH,1,184,160,96,64,14,13,1,33,8,25,18,0,18,184,160,96,64,14,13,1,33,8,25,18,0,18
12/14/2021,Northern,2,CAH,1,81,43,18,25,0,0,0,36,0,36,1,0,1,81,43,18,25,0,0,0,36,0,36,1,0,1
12/14/2021,Southeast,5,CAH,1,70,70,41,29,4,2,2,33,0,33,11,0,11,70,70,41,29,4,2,2,33,0,33,11,0,11
12/14/2021,Southeast,5,GACH,1,161,133,38,95,9,4,5,20,0,20,2,0,2,161,133,38,95,9,4,5,20,0,20,2,0,2
12/14/2021,Southwest,1,CAH,1,22,12,1,11,0,0,0,4,0,4,0,0,0,22,12,1,11,0,0,0,4,0,4,0,0,0
12/14/2021,Southwest,1,GACH,1,44,35,14,21,0,0,0,8,0,8,0,0,0,44,35,14,21,0,0,0,8,0,8,0,0,0
12/15/2021,Anchorage,7,GACH,1,744,713,638,75,119,107,12,230,40,190,30,0,30,744,713,638,75,119,107,12,230,40,190,30,0,30
12/15/2021,Anchorage,7,LTACH,0,44,44,37,7,6,6,0,23,3,20,0,0,0,44,44,37,7,6,6,0,23,3,20,0,0,0
12/15/2021,Anchorage,7,Psych,0,203,203,177,26,0,0,0,0,0,0,0,0,0,203,203,177,26,0,0,0,0,0,0,0,0,0
12/15/2021,Gulf Coast,4,CAH,1,81,71,28,43,4,1,3,24,0,24,0,0,0,81,71,28,43,4,1,3,24,0,24,0,0,0
12/15/2021,Gulf Coast,4,GACH,1,93,50,50,0,9,9,0,22,0,22,3,0,3,93,50,50,0,9,9,0,22,0,22,3,0,3
12/15/2021,Interior,6,GACH,1,101,81,80,1,25,15,10,16,0,16,4,0,4,101,81,80,1,25,15,10,16,0,16,4,0,4
12/15/2021,Matanuska-Susitna,3,GACH,1,184,160,90,70,14,11,3,33,5,28,18,0,18,184,160,90,70,14,11,3,33,5,28,18,0,18
12/15/2021,Northern,2,CAH,1,81,43,17,26,0,0,0,36,0,36,1,0,1,81,43,17,26,0,0,0,36,0,36,1,0,1
12/15/2021,Southeast,5,CAH,1,70,70,45,25,6,4,2,33,0,33,7,0,7,70,70,45,25,6,4,2,33,0,33,7,0,7
12/15/2021,Southeast,5,GACH,1,161,133,39,94,9,4,5,20,0,20,2,0,2,161,133,39,94,9,4,5,20,0,20,2,0,2
12/15/2021,Southwest,1,CAH,1,22,12,0,12,0,0,0,4,0,4,0,0,0,22,12,0,12,0,0,0,4,0,4,0,0,0
12/15/2021,Southwest,1,GACH,1,44,35,15,20,0,0,0,8,0,8,0,0,0,44,35,15,20,0,0,0,8,0,8,0,0,0
12/16/2021,Anchorage,7,GACH,1,747,711,638,73,119,108,11,230,37,193,24,0,24,747,711,638,73,119,108,11,230,37,193,24,0,24
12/16/2021,Anchorage,7,LTACH,0,44,44,38,6,6,6,0,23,5,18,0,0,0,44,44,38,6,6,6,0,23,5,18,0,0,0
12/16/2021,Anchorage,7,Psych,0,,,,,,,,,,,,,,203,203,177,26,0,0,0,0,0,0,0,0,0
12/16/2021,Gulf Coast,4,CAH,1,81,71,30,41,4,1,3,24,0,24,0,0,0,81,71,30,41,4,1,3,24,0,24,0,0,0
12/16/2021,Gulf Coast,4,GACH,1,93,51,51,0,9,9,0,22,0,22,2,0,2,93,51,51,0,9,9,0,22,0,22,2,0,2
12/16/2021,Interior,6,GACH,1,101,81,78,3,25,15,10,16,0,16,3,0,3,101,81,78,3,25,15,10,16,0,16,3,0,3
12/16/2021,Matanuska-Susitna,3,GACH,1,184,160,98,62,14,13,1,33,4,29,16,0,16,184,160,98,62,14,13,1,33,4,29,16,0,16
12/16/2021,Northern,2,CAH,1,81,43,15,28,0,0,0,36,0,36,1,0,1,81,43,15,28,0,0,0,36,0,36,1,0,1
12/16/2021,Southeast,5,CAH,1,45,45,27,18,2,0,2,16,0,16,3,0,3,70,70,44,26,6,4,2,33,0,33,7,0,7
12/16/2021,Southeast,5,GACH,1,161,133,46,87,9,7,2,20,0,20,3,0,3,161,133,46,87,9,7,2,20,0,20,3,0,3
12/16/2021,Southwest,1,CAH,1,22,12,4,8,0,0,0,4,0,4,0,0,0,22,12,4,8,0,0,0,4,0,4,0,0,0
12/16/2021,Southwest,1,GACH,1,44,35,15,20,0,0,0,8,0,8,0,0,0,44,35,15,20,0,0,0,8,0,8,0,0,0
12/17/2021,Anchorage,7,GACH,1,730,698,616,82,121,107,14,230,34,196,28,0,28,730,698,616,82,121,107,14,230,34,196,28,0,28
12/17/2021,Anchorage,7,LTACH,0,44,44,38,6,6,6,0,23,5,18,0,0,0,44,44,38,6,6,6,0,23,5,18,0,0,0
12/17/2021,Anchorage,7,Psych,0,,,,,,,,,,,,,,203,203,177,26,0,0,0,0,0,0,0,0,0
12/17/2021,Gulf Coast,4,CAH,1,81,71,24,47,4,0,4,24,0,24,0,0,0,81,71,24,47,4,0,4,24,0,24,0,0,0
12/17/2021,Gulf Coast,4,GACH,1,93,55,55,0,9,9,0,22,0,22,5,0,5,93,55,55,0,9,9,0,22,0,22,5,0,5
12/17/2021,Interior,6,GACH,1,101,81,74,7,25,14,11,16,0,16,2,0,2,101,81,74,7,25,14,11,16,0,16,2,0,2
12/17/2021,Matanuska-Susitna,3,GACH,1,184,160,101,59,14,12,2,33,3,30,15,0,15,184,160,101,59,14,12,2,33,3,30,15,0,15
12/17/2021,Northern,2,CAH,1,81,43,18,25,0,0,0,36,0,36,1,0,1,81,43,18,25,0,0,0,36,0,36,1,0,1
12/17/2021,Southeast,5,CAH,1,70,70,35,35,4,2,2,33,0,33,7,0,7,70,70,35,35,4,2,2,33,0,33,7,0,7
12/17/2021,Southeast,5,GACH,1,161,133,37,96,9,4,5,20,0,20,1,0,1,161,133,37,96,9,4,5,20,0,20,1,0,1
12/17/2021,Southwest,1,CAH,1,22,12,2,10,0,0,0,4,0,4,0,0,0,22,12,2,10,0,0,0,4,0,4,0,0,0
12/17/2021,Southwest,1,GACH,1,44,35,19,16,0,0,0,8,0,8,1,0,1,44,35,19,16,0,0,0,8,0,8,1,0,1
12/18/2021,Anchorage,7,GACH,1,724,696,616,80,121,106,15,230,32,198,30,0,30,724,696,616,80,121,106,15,230,32,198,30,0,30
12/18/2021,Anchorage,7,LTACH,0,44,44,35,9,6,6,0,23,5,18,0,0,0,44,44,35,9,6,6,0,23,5,18,0,0,0
12/18/2021,Anchorage,7,Psych,0,,,,,,,,,,,,,,203,203,177,26,0,0,0,0,0,0,0,0,0
12/18/2021,Gulf Coast,4,CAH,1,81,71,25,46,4,0,4,24,0,24,0,0,0,81,71,25,46,4,0,4,24,0,24,0,0,0
12/18/2021,Gulf Coast,4,GACH,1,93,51,51,0,9,6,3,22,0,22,6,0,6,93,51,51,0,9,6,3,22,0,22,6,0,6
12/18/2021,Interior,6,GACH,1,101,81,62,19,25,15,10,16,0,16,3,0,3,101,81,62,19,25,15,10,16,0,16,3,0,3
12/18/2021,Matanuska-Susitna,3,GACH,1,184,160,101,59,14,13,1,33,4,29,16,0,16,184,160,101,59,14,13,1,33,4,29,16,0,16
12/18/2021,Northern,2,CAH,1,81,43,19,24,0,0,0,36,0,36,2,0,2,81,43,19,24,0,0,0,36,0,36,2,0,2
12/18/2021,Southeast,5,CAH,1,70,70,33,37,4,2,2,33,0,33,7,0,7,70,70,33,37,4,2,2,33,0,33,7,0,7
12/18/2021,Southeast,5,GACH,1,161,133,39,94,9,4,5,20,0,20,1,0,1,161,133,39,94,9,4,5,20,0,20,1,0,1
12/18/2021,Southwest,1,CAH,1,22,12,4,8,0,0,0,4,0,4,0,0,0,22,12,4,8,0,0,0,4,0,4,0,0,0
12/18/2021,Southwest,1,GACH,1,44,35,17,18,0,0,0,8,0,8,1,0,1,44,35,17,18,0,0,0,8,0,8,1,0,1
12/19/2021,Anchorage,7,GACH,1,736,707,614,93,122,105,17,230,33,197,32,0,32,736,707,614,93,122,105,17,230,33,197,32,0,32
12/19/2021,Anchorage,7,LTACH,0,44,44,35,9,6,6,0,23,5,18,0,0,0,44,44,35,9,6,6,0,23,5,18,0,0,0
12/19/2021,Anchorage,7,Psych,0,,,,,,,,,,,,,,203,203,177,26,0,0,0,0,0,0,0,0,0
12/19/2021,Gulf Coast,4,CAH,1,81,71,27,44,4,0,4,24,0,24,0,0,0,81,71,27,44,4,0,4,24,0,24,0,0,0
12/19/2021,Gulf Coast,4,GACH,1,93,50,50,0,9,6,3,22,0,22,5,0,5,93,50,50,0,9,6,3,22,0,22,5,0,5
12/19/2021,Interior,6,GACH,1,101,81,62,19,25,15,10,16,0,16,4,0,4,101,81,62,19,25,15,10,16,0,16,4,0,4
12/19/2021,Matanuska-Susitna,3,GACH,1,184,160,105,55,14,12,2,33,6,27,15,0,15,184,160,105,55,14,12,2,33,6,27,15,0,15
12/19/2021,Northern,2,CAH,1,81,43,22,21,0,0,0,36,0,36,2,0,2,81,43,22,21,0,0,0,36,0,36,2,0,2
12/19/2021,Southeast,5,CAH,1,70,70,32,38,4,2,2,33,0,33,7,0,7,70,70,32,38,4,2,2,33,0,33,7,0,7
12/19/2021,Southeast,5,GACH,1,161,133,33,100,9,3,6,20,0,20,1,0,1,161,133,33,100,9,3,6,20,0,20,1,0,1
12/19/2021,Southwest,1,CAH,1,22,12,3,9,0,0,0,4,0,4,0,0,0,22,12,3,9,0,0,0,4,0,4,0,0,0
12/19/2021,Southwest,1,GACH,1,44,35,15,20,0,0,0,8,0,8,1,0,1,44,35,15,20,0,0,0,8,0,8,1,0,1
12/20/2021,Anchorage,7,GACH,1,744,713,626,87,126,109,17,232,38,194,28,0,28,744,713,626,87,126,109,17,232,38,194,28,0,28
12/20/2021,Anchorage,7,LTACH,0,44,44,35,9,6,6,0,23,5,18,0,0,0,44,44,35,9,6,6,0,23,5,18,0,0,0
12/20/2021,Anchorage,7,Psych,0,,,,,,,,,,,,,,203,203,177,26,0,0,0,0,0,0,0,0,0
12/20/2021,Gulf Coast,4,CAH,1,81,71,28,43,4,1,3,24,0,24,0,0,0,81,71,28,43,4,1,3,24,0,24,0,0,0
12/20/2021,Gulf Coast,4,GACH,1,93,52,52,0,9,8,1,22,2,20,6,0,6,93,52,52,0,9,8,1,22,2,20,6,0,6
12/20/2021,Interior,6,GACH,1,101,81,60,21,25,8,17,16,0,16,4,0,4,101,81,60,21,25,8,17,16,0,16,4,0,4
12/20/2021,Matanuska-Susitna,3,GACH,1,184,160,103,57,14,12,2,33,5,28,16,0,16,184,160,103,57,14,12,2,33,5,28,16,0,16
12/20/2021,Northern,2,CAH,1,81,43,19,24,0,0,0,36,0,36,2,0,2,81,43,19,24,0,0,0,36,0,36,2,0,2
12/20/2021,Southeast,5,CAH,1,70,70,31,39,4,2,2,33,0,33,7,0,7,70,70,31,39,4,2,2,33,0,33,7,0,7
12/20/2021,Southeast,5,GACH,1,161,133,33,100,9,1,8,20,0,20,0,0,0,161,133,33,100,9,1,8,20,0,20,0,0,0
12/20/2021,Southwest,1,CAH,1,22,12,3,9,0,0,0,4,0,4,0,0,0,22,12,3,9,0,0,0,4,0,4,0,0,0
12/20/2021,Southwest,1,GACH,1,44,35,19,16,0,0,0,8,0,8,1,0,1,44,35,19,16,0,0,0,8,0,8,1,0,1
12/21/2021,Anchorage,7,GACH,1,725,693,606,87,123,103,20,231,39,192,27,0,27,725,693,606,87,123,103,20,231,39,192,27,0,27
12/21/2021,Anchorage,7,LTACH,0,44,44,36,8,6,6,0,23,5,18,0,0,0,44,44,36,8,6,6,0,23,5,18,0,0,0
12/21/2021,Anchorage,7,Psych,0,,,,,,,,,,,,,,203,203,177,26,0,0,0,0,0,0,0,0,0
12/21/2021,Gulf Coast,4,CAH,1,81,71,28,43,4,2,2,24,0,24,0,0,0,81,71,28,43,4,2,2,24,0,24,0,0,0
12/21/2021,Gulf Coast,4,GACH,1,93,49,47,2,9,8,1,22,1,21,3,0,3,93,49,47,2,9,8,1,22,1,21,3,0,3
12/21/2021,Interior,6,GACH,1,101,81,70,11,25,11,14,16,0,16,4,0,4,101,81,70,11,25,11,14,16,0,16,4,0,4
12/21/2021,Matanuska-Susitna,3,GACH,1,184,160,99,61,14,11,3,33,5,28,14,0,14,184,160,99,61,14,11,3,33,5,28,14,0,14
12/21/2021,Northern,2,CAH,1,81,43,21,22,0,0,0,36,0,36,1,0,1,81,43,21,22,0,0,0,36,0,36,1,0,1
12/21/2021,Southeast,5,CAH,1,70,70,32,38,5,3,2,33,0,33,5,0,5,70,70,32,38,5,3,2,33,0,33,5,0,5
12/21/2021,Southeast,5,GACH,1,161,133,29,104,9,1,8,20,0,20,0,0,0,161,133,29,104,9,1,8,20,0,20,0,0,0
12/21/2021,Southwest,1,CAH,1,22,12,3,9,0,0,0,4,0,4,0,0,0,22,12,3,9,0,0,0,4,0,4,0,0,0
12/21/2021,Southwest,1,GACH,1,44,35,17,18,0,0,0,8,0,8,1,0,1,44,35,17,18,0,0,0,8,0,8,1,0,1
12/22/2021,Anchorage,7,GACH,1,727,697,599,98,121,104,17,231,35,196,28,0,28,727,697,599,98,121,104,17,231,35,196,28,0,28
12/22/2021,Anchorage,7,LTACH,0,44,44,33,11,6,6,0,23,6,17,0,0,0,44,44,33,11,6,6,0,23,6,17,0,0,0
12/22/2021,Anchorage,7,Psych,0,195,195,163,32,0,0,0,0,0,0,0,0,0,195,195,163,32,0,0,0,0,0,0,0,0,0
12/22/2021,Gulf Coast,4,CAH,1,81,71,28,43,4,2,2,24,0,24,0,0,0,81,71,28,43,4,2,2,24,0,24,0,0,0
12/22/2021,Gulf Coast,4,GACH,1,93,49,44,5,9,6,3,22,1,21,4,0,4,93,49,44,5,9,6,3,22,1,21,4,0,4
12/22/2021,Interior,6,GACH,1,101,87,87,0,25,12,13,16,0,16,5,0,5,101,87,87,0,25,12,13,16,0,16,5,0,5
12/22/2021,Matanuska-Susitna,3,GACH,1,184,160,91,69,14,9,5,33,5,28,12,0,12,184,160,91,69,14,9,5,33,5,28,12,0,12
12/22/2021,Northern,2,CAH,1,81,43,23,20,0,0,0,36,0,36,1,0,1,81,43,23,20,0,0,0,36,0,36,1,0,1
12/22/2021,Southeast,5,CAH,1,70,70,38,32,6,4,2,33,0,33,4,0,4,70,70,38,32,6,4,2,33,0,33,4,0,4
12/22/2021,Southeast,5,GACH,1,161,133,39,94,9,2,7,20,0,20,0,0,0,161,133,39,94,9,2,7,20,0,20,0,0,0
12/22/2021,Southwest,1,CAH,1,22,12,2,10,0,0,0,4,0,4,0,0,0,22,12,2,10,0,0,0,4,0,4,0,0,0
12/22/2021,Southwest,1,GACH,1,44,35,15,20,0,0,0,8,0,8,1,0,1,44,35,15,20,0,0,0,8,0,8,1,0,1
12/23/2021,Anchorage,7,GACH,1,715,680,583,97,120,103,17,231,35,196,28,0,28,715,680,583,97,120,103,17,231,35,196,28,0,28
12/23/2021,Anchorage,7,LTACH,0,44,44,34,10,6,6,0,23,7,16,0,0,0,44,44,34,10,6,6,0,23,7,16,0,0,0
12/23/2021,Anchorage,7,Psych,0,,,,,,,,,,,,,,195,195,163,32,0,0,0,0,0,0,0,0,0
12/23/2021,Gulf Coast,4,CAH,1,81,71,21,50,4,2,2,24,0,24,0,0,0,81,71,21,50,4,2,2,24,0,24,0,0,0
12/23/2021,Gulf Coast,4,GACH,1,93,49,41,8,9,7,2,22,1,21,4,0,4,93,49,41,8,9,7,2,22,1,21,4,0,4
12/23/2021,Interior,6,GACH,1,101,81,65,16,25,6,19,16,0,16,5,0,5,101,81,65,16,25,6,19,16,0,16,5,0,5
12/23/2021,Matanuska-Susitna,3,GACH,1,184,160,82,78,14,10,4,33,3,30,10,0,10,184,160,82,78,14,10,4,33,3,30,10,0,10
12/23/2021,Northern,2,CAH,1,81,43,26,17,0,0,0,36,0,36,1,0,1,81,43,26,17,0,0,0,36,0,36,1,0,1
12/23/2021,Southeast,5,CAH,1,70,70,33,37,6,4,2,33,0,33,4,0,4,70,70,33,37,6,4,2,33,0,33,4,0,4
12/23/2021,Southeast,5,GACH,1,161,133,35,98,9,5,4,20,0,20,0,0,0,161,133,35,98,9,5,4,20,0,20,0,0,0
12/23/2021,Southwest,1,CAH,1,22,12,2,10,0,0,0,4,0,4,0,0,0,22,12,2,10,0,0,0,4,0,4,0,0,0
12/23/2021,Southwest,1,GACH,1,44,35,12,23,0,0,0,8,0,8,1,0,1,44,35,12,23,0,0,0,8,0,8,1,0,1
12/24/2021,Anchorage,7,GACH,1,681,656,545,111,118,99,19,230,35,195,31,0,31,681,656,545,111,118,99,19,230,35,195,31,0,31
12/24/2021,Anchorage,7,LTACH,0,44,44,33,11,6,6,0,23,7,16,0,0,0,44,44,33,11,6,6,0,23,7,16,0,0,0
12/24/2021,Anchorage,7,Psych,0,,,,,,,,,,,,,,195,195,163,32,0,0,0,0,0,0,0,0,0
12/24/2021,Gulf Coast,4,CAH,1,81,71,15,56,4,1,3,24,0,24,0,0,0,81,71,15,56,4,1,3,24,0,24,0,0,0
12/24/2021,Gulf Coast,4,GACH,1,93,49,40,9,9,6,3,22,1,21,5,0,5,93,49,40,9,9,6,3,22,1,21,5,0,5
12/24/2021,Interior,6,GACH,1,101,81,67,14,25,12,13,16,1,15,3,0,3,101,81,67,14,25,12,13,16,1,15,3,0,3
12/24/2021,Matanuska-Susitna,3,GACH,1,184,160,79,81,14,10,4,33,3,30,8,0,8,184,160,79,81,14,10,4,33,3,30,8,0,8
12/24/2021,Northern,2,CAH,1,81,43,25,18,0,0,0,36,0,36,1,0,1,81,43,25,18,0,0,0,36,0,36,1,0,1
12/24/2021,Southeast,5,CAH,1,70,70,32,38,6,4,2,33,0,33,3,0,3,70,70,32,38,6,4,2,33,0,33,3,0,3
12/24/2021,Southeast,5,GACH,1,161,133,36,97,9,3,6,20,0,20,0,0,0,161,133,36,97,9,3,6,20,0,20,0,0,0
12/24/2021,Southwest,1,CAH,1,22,12,3,9,0,0,0,4,0,4,0,0,0,22,12,3,9,0,0,0,4,0,4,0,0,0
12/24/2021,Southwest,1,GACH,1,44,35,8,27,0,0,0,8,0,8,1,0,1,44,35,8,27,0,0,0,8,0,8,1,0,1
12/25/2021,Anchorage,7,GACH,1,685,658,540,118,129,99,30,230,34,196,29,0,29,685,658,540,118,129,99,30,230,34,196,29,0,29
12/25/2021,Anchorage,7,LTACH,0,44,44,32,12,6,6,0,23,8,15,0,0,0,44,44,32,12,6,6,0,23,8,15,0,0,0
12/25/2021,Anchorage,7,Psych,0,,,,,,,,,,,,,,195,195,163,32,0,0,0,0,0,0,0,0,0
12/25/2021,Gulf Coast,4,CAH,1,81,71,19,52,4,1,3,24,0,24,0,0,0,81,71,19,52,4,1,3,24,0,24,0,0,0
12/25/2021,Gulf Coast,4,GACH,1,93,49,45,4,9,7,2,22,1,21,5,0,5,93,49,45,4,9,7,2,22,1,21,5,0,5
12/25/2021,Interior,6,GACH,1,101,81,52,29,25,11,14,16,0,16,2,0,2,101,81,52,29,25,11,14,16,0,16,2,0,2
12/25/2021,Matanuska-Susitna,3,GACH,1,184,160,77,83,14,9,5,33,3,30,9,0,9,184,160,77,83,14,9,5,33,3,30,9,0,9
12/25/2021,Northern,2,CAH,1,81,43,27,16,0,0,0,36,0,36,1,0,1,81,43,27,16,0,0,0,36,0,36,1,0,1
12/25/2021,Southeast,5,CAH,1,70,70,29,41,6,4,2,33,0,33,4,0,4,70,70,29,41,6,4,2,33,0,33,4,0,4
12/25/2021,Southeast,5,GACH,1,161,133,32,101,9,3,6,20,0,20,0,0,0,161,133,32,101,9,3,6,20,0,20,0,0,0
12/25/2021,Southwest,1,CAH,1,22,12,2,10,0,0,0,4,0,4,0,0,0,22,12,2,10,0,0,0,4,0,4,0,0,0
12/25/2021,Southwest,1,GACH,1,44,35,7,28,0,0,0,8,0,8,1,0,1,44,35,7,28,0,0,0,8,0,8,1,0,1
12/26/2021,Anchorage,7,GACH,1,694,665,558,107,130,102,28,230,37,193,32,0,32,694,665,558,107,130,102,28,230,37,193,32,0,32
12/26/2021,Anchorage,7,LTACH,0,44,44,32,12,6,6,0,23,8,15,0,0,0,44,44,32,12,6,6,0,23,8,15,0,0,0
12/26/2021,Anchorage,7,Psych,0,,,,,,,,,,,,,,195,195,163,32,0,0,0,0,0,0,0,0,0
12/26/2021,Gulf Coast,4,CAH,1,81,71,18,53,4,1,3,24,0,24,0,0,0,81,71,18,53,4,1,3,24,0,24,0,0,0
12/26/2021,Gulf Coast,4,GACH,1,93,49,43,6,9,7,2,22,1,21,4,0,4,93,49,43,6,9,7,2,22,1,21,4,0,4
12/26/2021,Interior,6,GACH,1,101,81,48,33,25,9,16,16,0,16,2,0,2,101,81,48,33,25,9,16,16,0,16,2,0,2
12/26/2021,Matanuska-Susitna,3,GACH,1,184,160,81,79,14,6,8,33,3,30,9,0,9,184,160,81,79,14,6,8,33,3,30,9,0,9
12/26/2021,Northern,2,CAH,1,81,43,24,19,0,0,0,36,0,36,1,0,1,81,43,24,19,0,0,0,36,0,36,1,0,1
12/26/2021,Southeast,5,CAH,1,70,70,31,39,6,4,2,33,0,33,5,0,5,70,70,31,39,6,4,2,33,0,33,5,0,5
12/26/2021,Southeast,5,GACH,1,161,133,30,103,9,3,6,20,0,20,0,0,0,161,133,30,103,9,3,6,20,0,20,0,0,0
12/26/2021,Southwest,1,CAH,1,22,12,3,9,0,0,0,4,0,4,0,0,0,22,12,3,9,0,0,0,4,0,4,0,0,0
12/26/2021,Southwest,1,GACH,1,44,35,5,30,0,0,0,8,0,8,1,0,1,44,35,5,30,0,0,0,8,0,8,1,0,1
12/27/2021,Anchorage,7,GACH,1,716,685,571,114,130,101,29,230,37,193,28,0,28,716,685,571,114,130,101,29,230,37,193,28,0,28
12/27/2021,Anchorage,7,LTACH,0,44,44,32,12,6,6,0,23,8,15,0,0,0,44,44,32,12,6,6,0,23,8,15,0,0,0
12/27/2021,Anchorage,7,Psych,0,,,,,,,,,,,,,,195,195,163,32,0,0,0,0,0,0,0,0,0
12/27/2021,Gulf Coast,4,CAH,1,81,71,15,56,4,1,3,24,0,24,0,0,0,81,71,15,56,4,1,3,24,0,24,0,0,0
12/27/2021,Gulf Coast,4,GACH,1,93,49,47,2,9,8,1,22,1,21,4,0,4,93,49,47,2,9,8,1,22,1,21,4,0,4
12/27/2021,Interior,6,GACH,1,101,81,50,31,25,7,18,16,0,16,2,0,2,101,81,50,31,25,7,18,16,0,16,2,0,2
12/27/2021,Matanuska-Susitna,3,GACH,1,184,160,84,76,14,8,6,33,3,30,7,0,7,184,160,84,76,14,8,6,33,3,30,7,0,7
12/27/2021,Northern,2,CAH,1,81,43,25,18,0,0,0,36,0,36,0,0,0,81,43,25,18,0,0,0,36,0,36,0,0,0
12/27/2021,Southeast,5,CAH,1,70,70,30,40,6,4,2,33,0,33,5,0,5,70,70,30,40,6,4,2,33,0,33,5,0,5
12/27/2021,Southeast,5,GACH,1,161,133,30,103,9,3,6,20,0,20,0,0,0,161,133,30,103,9,3,6,20,0,20,0,0,0
12/27/2021,Southwest,1,CAH,1,22,12,3,9,0,0,0,4,0,4,0,0,0,22,12,3,9,0,0,0,4,0,4,0,0,0
12/27/2021,Southwest,1,GACH,1,44,35,6,29,0,0,0,8,0,8,1,0,1,44,35,6,29,0,0,0,8,0,8,1,0,1
12/28/2021,Anchorage,7,GACH,1,714,682,585,97,132,105,27,230,36,194,31,1,32,714,682,585,97,132,105,27,230,36,194,31,1,32
12/28/2021,Anchorage,7,LTACH,0,44,44,32,12,6,6,0,23,7,16,0,0,0,44,44,32,12,6,6,0,23,7,16,0,0,0
12/28/2021,Anchorage,7,Psych,0,,,,,,,,,,,,,,195,195,163,32,0,0,0,0,0,0,0,0,0
12/28/2021,Gulf Coast,4,CAH,1,82,69,22,47,4,2,2,24,0,24,0,0,0,82,69,22,47,4,2,2,24,0,24,0,0,0
12/28/2021,Gulf Coast,4,GACH,1,93,55,55,0,9,9,0,22,1,21,5,0,5,93,55,55,0,9,9,0,22,1,21,5,0,5
12/28/2021,Interior,6,GACH,1,101,81,54,27,25,8,17,16,1,15,5,0,5,101,81,54,27,25,8,17,16,1,15,5,0,5
12/28/2021,Matanuska-Susitna,3,GACH,1,184,160,83,77,14,7,7,33,3,30,8,0,8,184,160,83,77,14,7,7,33,3,30,8,0,8
12/28/2021,Northern,2,CAH,1,81,43,29,14,0,0,0,36,0,36,0,0,0,81,43,29,14,0,0,0,36,0,36,0,0,0
12/28/2021,Southeast,5,CAH,1,70,70,31,39,6,5,1,33,0,33,5,0,5,70,70,31,39,6,5,1,33,0,33,5,0,5
12/28/2021,Southeast,5,GACH,1,161,133,28,105,9,6,3,20,0,20,0,0,0,161,133,28,105,9,6,3,20,0,20,0,0,0
12/28/2021,Southwest,1,CAH,1,22,12,2,10,0,0,0,4,0,4,0,0,0,22,12,2,10,0,0,0,4,0,4,0,0,0
12/28/2021,Southwest,1,GACH,1,44,35,6,29,0,0,0,8,0,8,1,0,1,44,35,6,29,0,0,0,8,0,8,1,0,1
12/29/2021,Anchorage,7,GACH,1,724,690,604,86,130,107,23,230,36,194,34,2,36,724,690,604,86,130,107,23,230,36,194,34,2,36
12/29/2021,Anchorage,7,LTACH,0,44,44,32,12,6,6,0,23,7,16,0,0,0,44,44,32,12,6,6,0,23,7,16,0,0,0
12/29/2021,Anchorage,7,Psych,0,199,199,168,31,0,0,0,0,0,0,0,0,0,199,199,168,31,0,0,0,0,0,0,0,0,0
12/29/2021,Gulf Coast,4,CAH,1,82,69,26,43,4,1,3,24,0,24,1,0,1,82,69,26,43,4,1,3,24,0,24,1,0,1
12/29/2021,Gulf Coast,4,GACH,1,93,54,52,2,9,8,1,22,1,21,5,0,5,93,54,52,2,9,8,1,22,1,21,5,0,5
12/29/2021,Interior,6,GACH,1,101,81,58,23,25,11,14,16,1,15,5,0,5,101,81,58,23,25,11,14,16,1,15,5,0,5
12/29/2021,Matanuska-Susitna,3,GACH,1,184,160,87,73,14,7,7,33,3,30,7,0,7,184,160,87,73,14,7,7,33,3,30,7,0,7
12/29/2021,Northern,2,CAH,1,81,43,28,15,0,0,0,36,0,36,0,0,0,81,43,28,15,0,0,0,36,0,36,0,0,0
12/29/2021,Southeast,5,CAH,1,70,70,31,39,6,4,2,33,0,33,5,0,5,70,70,31,39,6,4,2,33,0,33,5,0,5
12/29/2021,Southeast,5,GACH,1,161,133,37,96,9,7,2,20,0,20,0,0,0,161,133,37,96,9,7,2,20,0,20,0,0,0
12/29/2021,Southwest,1,CAH,1,22,12,1,11,0,0,0,4,0,4,0,0,0,22,12,1,11,0,0,0,4,0,4,0,0,0
12/29/2021,Southwest,1,GACH,1,44,35,6,29,0,0,0,8,0,8,1,0,1,44,35,6,29,0,0,0,8,0,8,1,0,1
12/30/2021,Anchorage,7,GACH,1,729,696,611,85,130,100,30,230,32,198,35,1,36,729,696,611,85,130,100,30,230,32,198,35,1,36
12/30/2021,Anchorage,7,LTACH,0,44,44,32,12,6,6,0,23,7,16,0,0,0,44,44,32,12,6,6,0,23,7,16,0,0,0
12/30/2021,Anchorage,7,Psych,0,,,,,,,,,,,,,,199,199,168,31,0,0,0,0,0,0,0,0,0
12/30/2021,Gulf Coast,4,CAH,1,82,70,24,46,4,0,4,24,0,24,1,0,1,82,70,24,46,4,0,4,24,0,24,1,0,1
12/30/2021,Gulf Coast,4,GACH,1,93,54,53,1,9,7,2,22,1,21,4,0,4,93,54,53,1,9,7,2,22,1,21,4,0,4
12/30/2021,Interior,6,GACH,1,101,81,75,6,25,11,14,15,2,13,4,0,4,101,81,75,6,25,11,14,15,2,13,4,0,4
12/30/2021,Matanuska-Susitna,3,GACH,1,184,160,78,82,14,9,5,33,3,30,5,0,5,184,160,78,82,14,9,5,33,3,30,5,0,5
12/30/2021,Northern,2,CAH,1,81,43,30,13,0,0,0,36,0,36,0,0,0,81,43,30,13,0,0,0,36,0,36,0,0,0
12/30/2021,Southeast,5,CAH,1,70,70,29,41,6,4,2,33,0,33,3,0,3,70,70,29,41,6,4,2,33,0,33,3,0,3
12/30/2021,Southeast,5,GACH,1,161,133,41,92,9,5,4,20,0,20,0,0,0,161,133,41,92,9,5,4,20,0,20,0,0,0
12/30/2021,Southwest,1,CAH,1,22,12,6,6,0,0,0,4,0,4,0,0,0,22,12,6,6,0,0,0,4,0,4,0,0,0
12/30/2021,Southwest,1,GACH,1,44,35,6,29,0,0,0,8,0,8,1,0,1,44,35,6,29,0,0,0,8,0,8,1,0,1
12/31/2021,Anchorage,7,GACH,1,720,689,600,89,130,106,24,231,33,198,33,0,33,720,689,600,89,130,106,24,231,33,198,33,0,33
12/31/2021,Anchorage,7,LTACH,0,44,44,34,10,6,6,0,23,9,14,0,0,0,44,44,34,10,6,6,0,23,9,14,0,0,0
12/31/2021,Anchorage,7,Psych,0,,,,,,,,,,,,,,199,199,168,31,0,0,0,0,0,0,0,0,0
12/31/2021,Gulf Coast,4,CAH,1,82,70,21,49,4,0,4,24,0,24,1,0,1,82,70,21,49,4,0,4,24,0,24,1,0,1
12/31/2021,Gulf Coast,4,GACH,1,93,59,59,0,9,8,1,22,1,21,2,0,2,93,59,59,0,9,8,1,22,1,21,2,0,2
12/31/2021,Interior,6,GACH,1,101,81,71,10,25,8,17,15,1,14,4,0,4,101,81,71,10,25,8,17,15,1,14,4,0,4
12/31/2021,Matanuska-Susitna,3,GACH,1,184,160,88,72,14,11,3,33,4,29,5,0,5,184,160,88,72,14,11,3,33,4,29,5,0,5
12/31/2021,Northern,2,CAH,1,81,44,33,11,0,0,0,36,0,36,0,0,0,81,44,33,11,0,0,0,36,0,36,0,0,0
12/31/2021,Southeast,5,CAH,1,70,70,34,36,6,4,2,33,0,33,4,0,4,70,70,34,36,6,4,2,33,0,33,4,0,4
12/31/2021,Southeast,5,GACH,1,161,133,43,90,9,4,5,20,0,20,0,1,1,161,133,43,90,9,4,5,20,0,20,0,1,1
12/31/2021,Southwest,1,CAH,1,22,12,5,7,0,0,0,4,0,4,0,0,0,22,12,5,7,0,0,0,4,0,4,0,0,0
12/31/2021,Southwest,1,GACH,1,44,35,10,25,0,0,0,8,0,8,1,0,1,44,35,10,25,0,0,0,8,0,8,1,0,1
01/01/2022,Anchorage,7,GACH,1,718,689,602,87,131,102,29,231,32,199,31,0,31,718,689,602,87,131,102,29,231,32,199,31,0,31
01/01/2022,Anchorage,7,LTACH,0,44,44,34,10,6,6,0,23,9,14,0,0,0,44,44,34,10,6,6,0,23,9,14,0,0,0
01/01/2022,Anchorage,7,Psych,0,,,,,,,,,,,,,,199,199,168,31,0,0,0,0,0,0,0,0,0
01/01/2022,Gulf Coast,4,CAH,1,82,70,23,47,4,0,4,24,0,24,1,0,1,82,70,23,47,4,0,4,24,0,24,1,0,1
01/01/2022,Gulf Coast,4,GACH,1,93,55,55,0,9,8,1,22,1,21,2,0,2,93,55,55,0,9,8,1,22,1,21,2,0,2
01/01/2022,Interior,6,GACH,1,101,81,75,6,25,10,15,15,2,13,3,0,3,101,81,75,6,25,10,15,15,2,13,3,0,3
01/01/2022,Matanuska-Susitna,3,GACH,1,184,160,80,80,14,11,3,33,2,31,5,0,5,184,160,80,80,14,11,3,33,2,31,5,0,5
01/01/2022,Northern,2,CAH,1,81,43,29,14,1,0,1,36,0,36,0,0,0,81,43,29,14,1,0,1,36,0,36,0,0,0
01/01/2022,Southeast,5,CAH,1,70,70,39,31,6,5,1,33,0,33,6,0,6,70,70,39,31,6,5,1,33,0,33,6,0,6
01/01/2022,Southeast,5,GACH,1,161,133,34,99,9,4,5,20,0,20,0,0,0,161,133,34,99,9,4,5,20,0,20,0,0,0
01/01/2022,Southwest,1,CAH,1,22,12,6,6,0,0,0,4,0,4,0,0,0,22,12,6,6,0,0,0,4,0,4,0,0,0
01/01/2022,Southwest,1,GACH,1,44,35,9,26,0,0,0,8,0,8,2,0,2,44,35,9,26,0,0,0,8,0,8,2,0,2
01/02/2022,Anchorage,7,GACH,1,726,697,612,85,129,101,28,231,34,197,33,0,33,726,697,612,85,129,101,28,231,34,197,33,0,33
01/02/2022,Anchorage,7,LTACH,0,44,44,34,10,6,6,0,23,9,14,0,0,0,44,44,34,10,6,6,0,23,9,14,0,0,0
01/02/2022,Anchorage,7,Psych,0,,,,,,,,,,,,,,199,199,168,31,0,0,0,0,0,0,0,0,0
01/02/2022,Gulf Coast,4,CAH,1,82,71,26,45,4,0,4,24,0,24,2,0,2,82,71,26,45,4,0,4,24,0,24,2,0,2
01/02/2022,Gulf Coast,4,GACH,1,93,54,50,4,9,7,2,22,1,21,2,0,2,93,54,50,4,9,7,2,22,1,21,2,0,2
01/02/2022,Interior,6,GACH,1,101,81,75,6,25,10,15,15,2,13,3,0,3,101,81,75,6,25,10,15,15,2,13,3,0,3
01/02/2022,Matanuska-Susitna,3,GACH,1,184,160,78,82,14,10,4,33,4,29,5,0,5,184,160,78,82,14,10,4,33,4,29,5,0,5
01/02/2022,Northern,2,CAH,1,81,43,29,14,0,0,0,36,0,36,0,0,0,81,43,29,14,0,0,0,36,0,36,0,0,0
01/02/2022,Southeast,5,CAH,1,70,70,37,33,6,5,1,33,0,33,7,0,7,70,70,37,33,6,5,1,33,0,33,7,0,7
01/02/2022,Southeast,5,GACH,1,161,133,29,104,9,4,5,20,0,20,0,0,0,161,133,29,104,9,4,5,20,0,20,0,0,0
01/02/2022,Southwest,1,CAH,1,22,12,3,9,0,0,0,4,0,4,0,0,0,22,12,3,9,0,0,0,4,0,4,0,0,0
01/02/2022,Southwest,1,GACH,1,44,35,8,27,0,0,0,8,0,8,2,0,2,44,35,8,27,0,0,0,8,0,8,2,0,2
01/03/2022,Anchorage,7,GACH,1,725,696,603,93,130,107,23,232,39,193,35,0,35,725,696,603,93,130,107,23,232,39,193,35,0,35
01/03/2022,Anchorage,7,LTACH,0,44,44,34,10,6,6,0,23,7,16,0,0,0,44,44,34,10,6,6,0,23,7,16,0,0,0
01/03/2022,Anchorage,7,Psych,0,,,,,,,,,,,,,,199,199,168,31,0,0,0,0,0,0,0,0,0
01/03/2022,Gulf Coast,4,CAH,1,82,71,28,43,4,0,4,24,0,24,1,0,1,82,71,28,43,4,0,4,24,0,24,1,0,1
01/03/2022,Gulf Coast,4,GACH,1,93,54,43,11,9,5,4,22,1,21,1,0,1,93,54,43,11,9,5,4,22,1,21,1,0,1
01/03/2022,Interior,6,GACH,1,101,81,76,5,25,12,13,15,1,14,3,0,3,101,81,76,5,25,12,13,15,1,14,3,0,3
01/03/2022,Matanuska-Susitna,3,GACH,1,184,160,103,57,14,14,0,33,4,29,6,0,6,184,160,103,57,14,14,0,33,4,29,6,0,6
01/03/2022,Northern,2,CAH,1,81,43,22,21,0,0,0,36,0,36,1,0,1,81,43,22,21,0,0,0,36,0,36,1,0,1
01/03/2022,Southeast,5,CAH,1,70,70,40,30,6,4,2,33,0,33,9,0,9,70,70,40,30,6,4,2,33,0,33,9,0,9
01/03/2022,Southeast,5,GACH,1,161,133,29,104,9,2,7,20,0,20,1,0,1,161,133,29,104,9,2,7,20,0,20,1,0,1
01/03/2022,Southwest,1,CAH,1,22,12,4,8,0,0,0,4,0,4,0,0,0,22,12,4,8,0,0,0,4,0,4,0,0,0
01/03/2022,Southwest,1,GACH,1,44,35,12,23,0,0,0,8,0,8,1,0,1,44,35,12,23,0,0,0,8,0,8,1,0,1
01/04/2022,Anchorage,7,GACH,1,739,708,640,68,137,116,21,232,47,185,35,0,35,739,708,640,68,137,116,21,232,47,185,35,0,35
01/04/2022,Anchorage,7,LTACH,0,44,42,34,8,9,9,0,23,8,15,0,0,0,44,42,34,8,9,9,0,23,8,15,0,0,0
01/04/2022,Anchorage,7,Psych,0,,,,,,,,,,,,,,199,199,168,31,0,0,0,0,0,0,0,0,0
01/04/2022,Gulf Coast,4,CAH,1,84,71,30,41,4,0,4,24,0,24,1,0,1,84,71,30,41,4,0,4,24,0,24,1,0,1
01/04/2022,Gulf Coast,4,GACH,1,93,54,45,9,9,6,3,22,1,21,1,0,1,93,54,45,9,9,6,3,22,1,21,1,0,1
01/04/2022,Interior,6,GACH,1,101,81,69,12,25,12,13,15,3,12,4,0,4,101,81,69,12,25,12,13,15,3,12,4,0,4
01/04/2022,Matanuska-Susitna,3,GACH,1,184,160,100,60,14,14,0,33,3,30,6,0,6,184,160,100,60,14,14,0,33,3,30,6,0,6
01/04/2022,Northern,2,CAH,1,81,43,24,19,0,0,0,36,0,36,2,0,2,81,43,24,19,0,0,0,36,0,36,2,0,2
01/04/2022,Southeast,5,CAH,1,70,70,43,27,5,3,2,33,0,33,8,0,8,70,70,43,27,5,3,2,33,0,33,8,0,8
01/04/2022,Southeast,5,GACH,1,161,133,34,99,9,4,5,20,0,20,3,0,3,161,133,34,99,9,4,5,20,0,20,3,0,3
01/04/2022,Southwest,1,CAH,1,22,12,3,9,0,0,0,4,0,4,0,0,0,22,12,3,9,0,0,0,4,0,4,0,0,0
01/04/2022,Southwest,1,GACH,1,44,35,17,18,0,0,0,8,0,8,1,0,1,44,35,17,18,0,0,0,8,0,8,1,0,1
01/05/2022,Anchorage,7,GACH,1,750,710,646,64,133,119,14,232,31,201,37,0,37,750,710,646,64,133,119,14,232,31,201,37,0,37
01/05/2022,Anchorage,7,LTACH,0,44,42,36,6,9,9,0,23,10,13,0,0,0,44,42,36,6,9,9,0,23,10,13,0,0,0
01/05/2022,Anchorage,7,Psych,0,203,203,180,23,0,0,0,0,0,0,1,0,1,203,203,180,23,0,0,0,0,0,0,1,0,1
01/05/2022,Gulf Coast,4,CAH,1,84,71,29,42,4,0,4,24,0,24,1,0,1,84,71,29,42,4,0,4,24,0,24,1,0,1
01/05/2022,Gulf Coast,4,GACH,1,93,54,45,9,9,6,3,22,1,21,2,0,2,93,54,45,9,9,6,3,22,1,21,2,0,2
01/05/2022,Interior,6,GACH,1,101,81,77,4,25,13,12,15,3,12,4,0,4,101,81,77,4,25,13,12,15,3,12,4,0,4
01/05/2022,Matanuska-Susitna,3,GACH,1,184,160,103,57,14,10,4,33,5,28,5,0,5,184,160,103,57,14,10,4,33,5,28,5,0,5
01/05/2022,Northern,2,CAH,1,81,43,25,18,0,0,0,36,0,36,1,0,1,81,43,25,18,0,0,0,36,0,36,1,0,1
01/05/2022,Southeast,5,CAH,1,70,70,36,34,6,4,2,33,0,33,7,0,7,70,70,36,34,6,4,2,33,0,33,7,0,7
01/05/2022,Southeast,5,GACH,1,161,133,35,98,9,5,4,20,0,20,1,0,1,161,133,35,98,9,5,4,20,0,20,1,0,1
01/05/2022,Southwest,1,CAH,1,22,12,3,9,0,0,0,4,0,4,0,0,0,22,12,3,9,0,0,0,4,0,4,0,0,0
01/05/2022,Southwest,1,GACH,1,44,35,22,13,0,0,0,8,0,8,3,0,3,44,35,22,13,0,0,0,8,0,8,3,0,3
01/06/2022,Anchorage,7,GACH,1,746,706,645,61,131,110,21,232,45,187,45,0,45,746,706,645,61,131,110,21,232,45,187,45,0,45
01/06/2022,Anchorage,7,LTACH,0,44,42,37,5,9,9,0,23,11,12,0,0,0,44,42,37,5,9,9,0,23,11,12,0,0,0
01/06/2022,Anchorage,7,Psych,0,140,140,117,23,0,0,0,0,0,0,1,0,1,203,203,180,23,0,0,0,0,0,0,1,0,1
01/06/2022,Gulf Coast,4,CAH,1,84,71,28,43,4,3,1,24,0,24,0,0,0,84,71,28,43,4,3,1,24,0,24,0,0,0
01/06/2022,Gulf Coast,4,GACH,1,93,54,44,10,9,4,5,22,0,22,2,0,2,93,54,44,10,9,4,5,22,0,22,2,0,2
01/06/2022,Interior,6,GACH,1,101,81,81,0,25,9,16,15,1,14,6,0,6,101,81,81,0,25,9,16,15,1,14,6,0,6
01/06/2022,Matanuska-Susitna,3,GACH,1,184,160,105,55,14,9,5,33,4,29,9,0,9,184,160,105,55,14,9,5,33,4,29,9,0,9
01/06/2022,Northern,2,CAH,1,81,43,23,20,0,0,0,36,0,36,1,0,1,81,43,23,20,0,0,0,36,0,36,1,0,1
01/06/2022,Southeast,5,CAH,1,70,70,39,31,5,3,2,33,0,33,8,0,8,70,70,39,31,5,3,2,33,0,33,8,0,8
01/06/2022,Southeast,5,GACH,1,161,133,38,95,9,5,4,20,0,20,0,0,0,161,133,38,95,9,5,4,20,0,20,0,0,0
01/06/2022,Southwest,1,CAH,1,22,12,3,9,0,0,0,4,0,4,0,0,0,22,12,3,9,0,0,0,4,0,4,0,0,0
01/06/2022,Southwest,1,GACH,1,44,35,20,15,0,0,0,8,0,8,3,0,3,44,35,20,15,0,0,0,8,0,8,3,0,3
01/07/2022,Anchorage,7,GACH,1,753,710,665,45,131,111,20,232,48,184,51,0,51,753,710,665,45,131,111,20,232,48,184,51,0,51
01/07/2022,Anchorage,7,LTACH,0,44,42,38,4,9,9,0,23,11,12,0,0,0,44,42,38,4,9,9,0,23,11,12,0,0,0
01/07/2022,Anchorage,7,Psych,0,,,,,,,,,,,,,,203,203,180,23,0,0,0,0,0,0,1,0,1
01/07/2022,Gulf Coast,4,CAH,1,84,71,31,40,4,2,2,24,0,24,0,0,0,84,71,31,40,4,2,2,24,0,24,0,0,0
01/07/2022,Gulf Coast,4,GACH,1,93,54,42,12,9,5,4,22,1,21,3,0,3,93,54,42,12,9,5,4,22,1,21,3,0,3
01/07/2022,Interior,6,GACH,1,,101,76,25,13,10,3,,,,7,0,7,101,101,76,25,13,10,3,15,1,14,7,0,7
01/07/2022,Matanuska-Susitna,3,GACH,1,184,160,111,49,14,9,5,33,3,30,11,0,11,184,160,111,49,14,9,5,33,3,30,11,0,11
01/07/2022,Northern,2,CAH,1,81,43,28,15,0,0,0,36,0,36,0,0,0,81,43,28,15,0,0,0,36,0,36,0,0,0
01/07/2022,Southeast,5,CAH,1,58,70,32,38,5,3,2,30,0,30,6,0,6,70,70,32,38,5,3,2,33,0,33,6,0,6
01/07/2022,Southeast,5,GACH,1,161,133,41,92,9,4,5,20,0,20,0,0,0,161,133,41,92,9,4,5,20,0,20,0,0,0
01/07/2022,Southwest,1,CAH,1,22,12,7,5,0,0,0,4,0,4,0,0,0,22,12,7,5,0,0,0,4,0,4,0,0,0
01/07/2022,Southwest,1,GACH,1,44,35,16,19,0,0,0,8,0,8,1,0,1,44,35,16,19,0,0,0,8,0,8,1,0,1
01/08/2022,Anchorage,7,GACH,1,751,722,648,74,130,109,21,232,49,183,56,1,57,751,722,648,74,130,109,21,232,49,183,56,1,57
01/08/2022,Anchorage,7,LTACH,0,42,42,39,3,9,7,2,24,10,14,0,0,0,42,42,39,3,9,7,2,24,10,14,0,0,0
01/08/2022,Anchorage,7,Psych,0,,,,,,,,,,,,,,203,203,180,23,0,0,0,0,0,0,1,0,1
01/08/2022,Gulf Coast,4,CAH,1,53,71,32,39,4,2,2,15,0,15,0,0,0,84,71,32,39,4,2,2,24,0,24,0,0,0
01/08/2022,Gulf Coast,4,GACH,1,93,54,33,21,9,6,3,22,1,21,2,0,2,93,54,33,21,9,6,3,22,1,21,2,0,2
01/08/2022,Interior,6,GACH,1,,101,76,25,13,10,3,,,,6,0,6,101,101,76,25,13,10,3,15,1,14,6,0,6
01/08/2022,Matanuska-Susitna,3,GACH,1,184,160,104,56,14,13,1,33,3,30,12,0,12,184,160,104,56,14,13,1,33,3,30,12,0,12
01/08/2022,Northern,2,CAH,1,81,43,26,17,0,0,0,36,0,36,0,0,0,81,43,26,17,0,0,0,36,0,36,0,0,0
01/08/2022,Southeast,5,CAH,1,58,70,36,34,5,3,2,30,0,30,6,0,6,70,70,36,34,5,3,2,33,0,33,6,0,6
01/08/2022,Southeast,5,GACH,1,57,57,37,20,9,2,7,20,0,20,0,0,0,57,57,37,20,9,2,7,20,0,20,0,0,0
01/08/2022,Southwest,1,CAH,1,22,12,8,4,0,0,0,4,0,4,0,0,0,22,12,8,4,0,0,0,4,0,4,0,0,0
01/08/2022,Southwest,1,GACH,1,44,35,16,19,0,0,0,8,0,8,0,0,0,44,35,16,19,0,0,0,8,0,8,0,0,0
01/09/2022,Anchorage,7,GACH,1,735,711,643,68,129,113,16,232,46,186,55,1,56,735,711,643,68,129,113,16,232,46,186,55,1,56
01/09/2022,Anchorage,7,LTACH,0,,42,39,3,9,7,2,,,,0,0,0,42,42,39,3,9,7,2,24,10,14,0,0,0
01/09/2022,Anchorage,7,Psych,0,,,,,,,,,,,,,,203,203,180,23,0,0,0,0,0,0,1,0,1
01/09/2022,Gulf Coast,4,CAH,1,53,71,29,42,4,1,3,15,0,15,1,0,1,84,71,29,42,4,1,3,24,0,24,1,0,1
01/09/2022,Gulf Coast,4,GACH,1,93,54,31,23,9,1,8,22,0,22,2,0,2,93,54,31,23,9,1,8,22,0,22,2,0,2
01/09/2022,Interior,6,GACH,1,,101,73,28,13,9,4,,,,6,0,6,101,101,73,28,13,9,4,15,1,14,6,0,6
01/09/2022,Matanuska-Susitna,3,GACH,1,184,160,98,62,14,12,2,33,3,30,15,0,15,184,160,98,62,14,12,2,33,3,30,15,0,15
01/09/2022,Northern,2,CAH,1,81,43,24,19,0,0,0,36,0,36,0,0,0,81,43,24,19,0,0,0,36,0,36,0,0,0
01/09/2022,Southeast,5,CAH,1,25,70,32,38,5,4,1,17,0,17,5,0,5,70,70,32,38,5,4,1,33,0,33,5,0,5
01/09/2022,Southeast,5,GACH,1,,57,37,20,9,2,7,,,,0,0,0,57,57,37,20,9,2,7,20,0,20,0,0,0
01/09/2022,Southwest,1,CAH,1,22,12,6,6,0,0,0,4,0,4,0,0,0,22,12,6,6,0,0,0,4,0,4,0,0,0
01/09/2022,Southwest,1,GACH,1,44,35,17,18,0,0,0,8,0,8,0,0,0,44,35,17,18,0,0,0,8,0,8,0,0,0
01/10/2022,Anchorage,7,GACH,1,743,718,653,65,127,115,12,230,47,183,54,1,55,743,718,653,65,127,115,12,230,47,183,54,1,55
01/10/2022,Anchorage,7,LTACH,0,42,42,39,3,9,8,1,24,10,14,0,0,0,42,42,39,3,9,8,1,24,10,14,0,0,0
01/10/2022,Anchorage,7,Psych,0,,,,,,,,,,,,,,203,203,180,23,0,0,0,0,0,0,1,0,1
01/10/2022,Gulf Coast,4,CAH,1,53,71,23,48,4,1,3,15,0,15,0,0,0,84,71,23,48,4,1,3,24,0,24,0,0,0
01/10/2022,Gulf Coast,4,GACH,1,,54,35,19,9,2,7,,,,1,0,1,93,54,35,19,9,2,7,22,0,22,1,0,1
01/10/2022,Interior,6,GACH,1,,101,77,24,13,7,6,,,,5,0,5,101,101,77,24,13,7,6,15,1,14,5,0,5
01/10/2022,Matanuska-Susitna,3,GACH,1,184,160,101,59,14,12,2,33,3,30,14,0,14,184,160,101,59,14,12,2,33,3,30,14,0,14
01/10/2022,Northern,2,CAH,1,8,43,25,18,0,0,0,8,0,8,0,0,0,65,43,25,18,0,0,0,36,0,36,0,0,0
01/10/2022,Southeast,5,CAH,1,25,70,28,42,4,2,2,17,0,17,1,0,1,70,70,28,42,4,2,2,33,0,33,1,0,1
01/10/2022,Southeast,5,GACH,1,,57,35,22,9,1,8,,,,0,0,0,57,57,35,22,9,1,8,20,0,20,0,0,0
01/10/2022,Southwest,1,CAH,1,22,12,5,7,0,0,0,4,0,4,0,0,0,22,12,5,7,0,0,0,4,0,4,0,0,0
01/10/2022,Southwest,1,GACH,1,35,35,20,15,0,0,0,8,0,8,1,0,1,35,35,20,15,0,0,0,8,0,8,1,0,1
01/11/2022,Anchorage,7,GACH,1,550,727,649,78,132,116,16,166,34,132,62,1,63,752,727,649,78,132,116,16,230,50,180,62,1,63
01/11/2022,Anchorage,7,LTACH,0,,47,40,7,9,8,1,,,,0,0,0,42,47,40,7,9,8,1,24,10,14,0,0,0
01/11/2022,Anchorage,7,Psych,0,,,,,,,,,,,,,,203,203,180,23,0,0,0,0,0,0,1,0,1
01/11/2022,Gulf Coast,4,CAH,1,53,71,29,42,4,2,2,15,0,15,1,0,1,84,71,29,42,4,2,2,24,0,24,1,0,1
01/11/2022,Gulf Coast,4,GACH,1,,54,46,8,9,7,2,,,,2,0,2,93,54,46,8,9,7,2,22,0,22,2,0,2
01/11/2022,Interior,6,GACH,1,,101,67,34,13,8,5,,,,5,0,5,101,101,67,34,13,8,5,15,1,14,5,0,5
01/11/2022,Matanuska-Susitna,3,GACH,1,,160,106,54,14,10,4,,,,16,0,16,184,160,106,54,14,10,4,33,3,30,16,0,16
01/11/2022,Northern,2,CAH,1,12,43,22,21,0,0,0,8,0,8,0,0,0,69,43,22,21,0,0,0,36,0,36,0,0,0
01/11/2022,Southeast,5,CAH,1,25,70,33,37,2,0,2,17,0,17,2,0,2,70,70,33,37,2,0,2,33,0,33,2,0,2
01/11/2022,Southeast,5,GACH,1,,57,41,16,9,4,5,,,,0,0,0,57,57,41,16,9,4,5,20,0,20,0,0,0
01/11/2022,Southwest,1,CAH,1,22,12,6,6,0,0,0,4,0,4,0,0,0,22,12,6,6,0,0,0,4,0,4,0,0,0
01/11/2022,Southwest,1,GACH,1,,35,15,20,0,0,0,,,,0,0,0,35,35,15,20,0,0,0,8,0,8,0,0,0
01/12/2022,Anchorage,7,GACH,1,550,723,651,72,130,113,17,166,9,157,64,2,66,752,723,651,72,130,113,17,230,25,205,64,2,66
01/12/2022,Anchorage,7,LTACH,0,,47,42,5,9,8,1,,,,0,0,0,42,47,42,5,9,8,1,24,10,14,0,0,0
01/12/2022,Anchorage,7,Psych,0,215,195,171,24,0,0,0,0,0,0,16,0,16,215,195,171,24,0,0,0,0,0,0,16,0,16
01/12/2022,Gulf Coast,4,CAH,1,53,71,29,42,4,1,3,15,0,15,0,0,0,84,71,29,42,4,1,3,24,0,24,0,0,0
01/12/2022,Gulf Coast,4,GACH,1,,54,52,2,9,9,0,,,,2,0,2,93,54,52,2,9,9,0,22,0,22,2,0,2
01/12/2022,Interior,6,GACH,1,,101,73,28,13,9,4,,,,5,0,5,101,101,73,28,13,9,4,15,1,14,5,0,5
01/12/2022,Matanuska-Susitna,3,GACH,1,,160,112,48,14,10,4,,,,15,0,15,184,160,112,48,14,10,4,33,3,30,15,0,15
01/12/2022,Northern,2,CAH,1,59,43,21,22,0,0,0,19,0,19,0,0,0,69,43,21,22,0,0,0,36,0,36,0,0,0
01/12/2022,Southeast,5,CAH,1,25,70,36,34,5,3,2,17,0,17,7,0,7,70,70,36,34,5,3,2,33,0,33,7,0,7
01/12/2022,Southeast,5,GACH,1,,57,44,13,9,4,5,,,,2,0,2,57,57,44,13,9,4,5,20,0,20,2,0,2
01/12/2022,Southwest,1,CAH,1,22,12,5,7,0,0,0,4,0,4,0,0,0,22,12,5,7,0,0,0,4,0,4,0,0,0
01/12/2022,Southwest,1,GACH,1,,36,23,13,0,0,0,,,,1,0,1,35,36,23,13,0,0,0,8,0,8,1,0,1
01/13/2022,Anchorage,7,GACH,1,530,704,616,88,133,112,21,166,31,135,56,1,57,732,704,616,88,133,112,21,230,47,183,56,1,57
01/13/2022,Anchorage,7,LTACH,0,,47,44,3,9,9,0,,,,0,0,0,42,47,44,3,9,9,0,24,10,14,0,0,0
01/13/2022,Anchorage,7,Psych,0,,,,,,,,,,,,,,215,195,171,24,0,0,0,0,0,0,16,0,16
01/13/2022,Gulf Coast,4,CAH,1,53,71,26,45,4,0,4,15,0,15,1,0,1,84,71,26,45,4,0,4,24,0,24,1,0,1
01/13/2022,Gulf Coast,4,GACH,1,,54,40,14,9,7,2,,,,1,0,1,93,54,40,14,9,7,2,22,0,22,1,0,1
01/13/2022,Interior,6,GACH,1,,101,76,25,13,8,5,,,,5,0,5,101,101,76,25,13,8,5,15,1,14,5,0,5
01/13/2022,Matanuska-Susitna,3,GACH,1,,160,108,52,14,12,2,,,,14,0,14,184,160,108,52,14,12,2,33,3,30,14,0,14
01/13/2022,Northern,2,CAH,1,24,43,22,21,0,0,0,8,0,8,0,0,0,81,43,22,21,0,0,0,36,0,36,0,0,0
01/13/2022,Southeast,5,CAH,1,25,70,40,30,4,3,1,17,0,17,7,0,7,70,70,40,30,4,3,1,33,0,33,7,0,7
01/13/2022,Southeast,5,GACH,1,,57,47,10,9,4,5,,,,3,0,3,57,57,47,10,9,4,5,20,0,20,3,0,3
01/13/2022,Southwest,1,CAH,1,22,12,6,6,0,0,0,4,0,4,0,0,0,22,12,6,6,0,0,0,4,0,4,0,0,0
01/13/2022,Southwest,1,GACH,1,,36,19,17,0,0,0,,,,0,0,0,35,36,19,17,0,0,0,8,0,8,0,0,0
01/14/2022,Anchorage,7,GACH,1,536,712,618,94,133,107,26,166,26,140,51,0,51,738,712,618,94,133,107,26,230,42,188,51,0,51
01/14/2022,Anchorage,7,LTACH,0,,47,45,2,9,9,0,,,,0,0,0,42,47,45,2,9,9,0,24,10,14,0,0,0
01/14/2022,Anchorage,7,Psych,0,,,,,,,,,,,,,,215,195,171,24,0,0,0,0,0,0,16,0,16
01/14/2022,Gulf Coast,4,CAH,1,53,72,24,48,4,0,4,15,0,15,0,0,0,84,72,24,48,4,0,4,24,0,24,0,0,0
01/14/2022,Gulf Coast,4,GACH,1,,54,37,17,9,5,4,,,,1,0,1,93,54,37,17,9,5,4,22,0,22,1,0,1
01/14/2022,Interior,6,GACH,1,,101,69,32,13,6,7,,,,5,0,5,101,101,69,32,13,6,7,15,1,14,5,0,5
01/14/2022,Matanuska-Susitna,3,GACH,1,,160,116,44,14,13,1,,,,13,0,13,184,160,116,44,14,13,1,33,3,30,13,0,13
01/14/2022,Northern,2,CAH,1,12,74,21,53,0,0,0,8,0,8,0,0,0,69,74,21,53,0,0,0,36,0,36,0,0,0
01/14/2022,Southeast,5,CAH,1,25,70,33,37,2,1,1,17,0,17,6,0,6,70,70,33,37,2,1,1,33,0,33,6,0,6
01/14/2022,Southeast,5,GACH,1,,57,41,16,9,5,4,,,,3,0,3,57,57,41,16,9,5,4,20,0,20,3,0,3
01/14/2022,Southwest,1,CAH,1,22,12,4,8,0,0,0,4,0,4,0,0,0,22,12,4,8,0,0,0,4,0,4,0,0,0
01/14/2022,Southwest,1,GACH,1,,36,20,16,0,0,0,,,,2,0,2,35,36,20,16,0,0,0,8,0,8,2,0,2
01/15/2022,Anchorage,7,GACH,1,526,703,614,89,134,111,23,166,22,144,68,2,70,728,703,614,89,134,111,23,230,38,192,68,2,70
01/15/2022,Anchorage,7,LTACH,0,,47,46,1,9,9,0,,,,0,0,0,42,47,46,1,9,9,0,24,10,14,0,0,0
01/15/2022,Anchorage,7,Psych,0,,,,,,,,,,,,,,215,195,171,24,0,0,0,0,0,0,16,0,16
01/15/2022,Gulf Coast,4,CAH,1,53,71,22,49,4,0,4,15,0,15,1,0,1,84,71,22,49,4,0,4,24,0,24,1,0,1
01/15/2022,Gulf Coast,4,GACH,1,,54,37,17,9,7,2,,,,1,0,1,93,54,37,17,9,7,2,22,0,22,1,0,1
01/15/2022,Interior,6,GACH,1,,101,69,32,13,4,9,,,,3,0,3,101,101,69,32,13,4,9,15,1,14,3,0,3
01/15/2022,Matanuska-Susitna,3,GACH,1,,160,104,56,14,12,2,,,,13,0,13,184,160,104,56,14,12,2,33,3,30,13,0,13
01/15/2022,Northern,2,CAH,1,24,45,24,21,0,0,0,8,0,8,0,0,0,81,45,24,21,0,0,0,36,0,36,0,0,0
01/15/2022,Southeast,5,CAH,1,25,70,37,33,2,0,2,17,0,17,7,0,7,70,70,37,33,2,0,2,33,0,33,7,0,7
01/15/2022,Southeast,5,GACH,1,,57,40,17,9,6,3,,,,4,0,4,57,57,40,17,9,6,3,20,0,20,4,0,4
01/15/2022,Southwest,1,CAH,1,22,12,4,8,0,0,0,4,0,4,0,0,0,22,12,4,8,0,0,0,4,0,4,0,0,0
01/15/2022,Southwest,1,GACH,1,,36,17,19,0,0,0,,,,1,0,1,35,36,17,19,0,0,0,8,0,8,1,0,1
01/16/2022,Anchorage,7,GACH,1,524,703,595,108,134,113,21,166,31,135,67,2,69,726,703,595,108,134,113,21,230,47,183,67,2,69
01/16/2022,Anchorage,7,LTACH,0,,47,47,0,9,9,0,,,,0,0,0,42,47,47,0,9,9,0,24,10,14,0,0,0
01/16/2022,Anchorage,7,Psych,0,,,,,,,,,,,,,,215,195,171,24,0,0,0,0,0,0,16,0,16
01/16/2022,Gulf Coast,4,CAH,1,51,72,25,47,4,0,4,15,0,15,1,0,1,82,72,25,47,4,0,4,24,0,24,1,0,1
01/16/2022,Gulf Coast,4,GACH,1,,54,32,22,9,4,5,,,,1,0,1,93,54,32,22,9,4,5,22,0,22,1,0,1
01/16/2022,Interior,6,GACH,1,,101,76,25,13,7,6,,,,7,1,8,101,101,76,25,13,7,6,15,1,14,7,1,8
01/16/2022,Matanuska-Susitna,3,GACH,1,,160,101,59,14,10,4,,,,12,0,12,184,160,101,59,14,10,4,33,3,30,12,0,12
01/16/2022,Northern,2,CAH,1,24,74,21,53,0,0,0,8,0,8,0,0,0,81,74,21,53,0,0,0,36,0,36,0,0,0
01/16/2022,Southeast,5,CAH,1,25,70,33,37,2,0,2,17,0,17,7,0,7,70,70,33,37,2,0,2,33,0,33,7,0,7
01/16/2022,Southeast,5,GACH,1,,57,41,16,9,7,2,,,,5,0,5,57,57,41,16,9,7,2,20,0,20,5,0,5
01/16/2022,Southwest,1,CAH,1,22,12,4,8,0,0,0,4,0,4,0,0,0,22,12,4,8,0,0,0,4,0,4,0,0,0
01/16/2022,Southwest,1,GACH,1,,36,20,16,0,0,0,,,,1,0,1,35,36,20,16,0,0,0,8,0,8,1,0,1
01/17/2022,Anchorage,7,GACH,1,532,710,598,112,132,108,24,166,27,139,63,2,65,734,710,598,112,132,108,24,230,43,187,63,2,65
01/17/2022,Anchorage,7,LTACH,0,,47,47,0,9,9,0,,,,0,0,0,42,47,47,0,9,9,0,24,10,14,0,0,0
01/17/2022,Anchorage,7,Psych,0,,,,,,,,,,,,,,215,195,171,24,0,0,0,0,0,0,16,0,16
01/17/2022,Gulf Coast,4,CAH,1,51,72,22,50,4,0,4,15,0,15,1,0,1,82,72,22,50,4,0,4,24,0,24,1,0,1
01/17/2022,Gulf Coast,4,GACH,1,,54,29,25,9,5,4,,,,1,0,1,93,54,29,25,9,5,4,22,0,22,1,0,1
01/17/2022,Interior,6,GACH,1,,101,75,26,13,8,5,,,,5,1,6,101,101,75,26,13,8,5,15,1,14,5,1,6
01/17/2022,Matanuska-Susitna,3,GACH,1,,160,101,59,14,11,3,,,,11,0,11,184,160,101,59,14,11,3,33,3,30,11,0,11
01/17/2022,Northern,2,CAH,1,24,45,25,20,0,0,0,8,0,8,1,0,1,81,45,25,20,0,0,0,36,0,36,1,0,1
01/17/2022,Southeast,5,CAH,1,25,70,40,30,3,2,1,17,0,17,11,0,11,70,70,40,30,3,2,1,33,0,33,11,0,11
01/17/2022,Southeast,5,GACH,1,,57,41,16,9,5,4,,,,5,0,5,57,57,41,16,9,5,4,20,0,20,5,0,5
01/17/2022,Southwest,1,CAH,1,22,12,3,9,0,0,0,4,0,4,0,0,0,22,12,3,9,0,0,0,4,0,4,0,0,0
01/17/2022,Southwest,1,GACH,1,,36,21,15,0,0,0,,,,1,0,1,35,36,21,15,0,0,0,8,0,8,1,0,1
01/18/2022,Anchorage,7,GACH,1,548,726,624,102,133,111,22,166,30,136,65,0,65,750,726,624,102,133,111,22,230,46,184,65,0,65
01/18/2022,Anchorage,7,LTACH,0,,47,46,1,9,9,0,,,,0,0,0,42,47,46,1,9,9,0,24,10,14,0,0,0
01/18/2022,Anchorage,7,Psych,0,,,,,,,,,,,,,,215,195,171,24,0,0,0,0,0,0,16,0,16
01/18/2022,Gulf Coast,4,CAH,1,51,72,21,51,4,0,4,15,0,15,1,0,1,82,72,21,51,4,0,4,24,0,24,1,0,1
01/18/2022,Gulf Coast,4,GACH,1,,54,34,20,9,4,5,,,,4,0,4,93,54,34,20,9,4,5,22,0,22,4,0,4
01/18/2022,Interior,6,GACH,1,,101,68,33,13,5,8,,,,7,0,7,101,101,68,33,13,5,8,15,1,14,7,0,7
01/18/2022,Matanuska-Susitna,3,GACH,1,,160,102,58,14,12,2,,,,11,0,11,184,160,102,58,14,12,2,33,3,30,11,0,11
01/18/2022,Northern,2,CAH,1,24,45,20,25,0,0,0,8,0,8,2,0,2,81,45,20,25,0,0,0,36,0,36,2,0,2
01/18/2022,Southeast,5,CAH,1,25,70,44,26,5,4,1,17,0,17,11,0,11,70,70,44,26,5,4,1,33,0,33,11,0,11
01/18/2022,Southeast,5,GACH,1,,57,41,16,9,3,6,,,,5,0,5,57,57,41,16,9,3,6,20,0,20,5,0,5
01/18/2022,Southwest,1,CAH,1,22,12,3,9,0,0,0,4,0,4,1,0,1,22,12,3,9,0,0,0,4,0,4,1,0,1
01/18/2022,Southwest,1,GACH,1,,36,21,15,0,0,0,,,,1,0,1,35,36,21,15,0,0,0,8,0,8,1,0,1
01/19/2022,Anchorage,7,GACH,1,550,731,651,80,132,111,21,166,36,130,81,0,81,752,731,651,80,132,111,21,230,52,178,81,0,81
01/19/2022,Anchorage,7,LTACH,0,,47,44,3,9,9,0,,,,0,0,0,42,47,44,3,9,9,0,24,10,14,0,0,0
01/19/2022,Anchorage,7,Psych,0,140,195,132,63,0,0,0,0,0,0,7,0,7,195,195,132,63,0,0,0,0,0,0,7,0,7
01/19/2022,Gulf Coast,4,CAH,1,51,71,22,49,4,1,3,15,0,15,4,0,4,82,71,22,49,4,1,3,24,0,24,4,0,4
01/19/2022,Gulf Coast,4,GACH,1,,54,39,15,9,4,5,,,,4,0,4,93,54,39,15,9,4,5,22,0,22,4,0,4
01/19/2022,Interior,6,GACH,1,,101,63,38,13,4,9,,,,7,1,8,101,101,63,38,13,4,9,15,1,14,7,1,8
01/19/2022,Matanuska-Susitna,3,GACH,1,,160,86,74,14,13,1,,,,9,0,9,184,160,86,74,14,13,1,33,3,30,9,0,9
01/19/2022,Northern,2,CAH,1,12,45,26,19,0,0,0,8,0,8,4,0,4,69,45,26,19,0,0,0,36,0,36,4,0,4
01/19/2022,Southeast,5,CAH,1,25,70,34,36,3,2,1,17,0,17,8,0,8,70,70,34,36,3,2,1,33,0,33,8,0,8
01/19/2022,Southeast,5,GACH,1,,57,44,13,9,4,5,,,,5,0,5,57,57,44,13,9,4,5,20,0,20,5,0,5
01/19/2022,Southwest,1,CAH,1,22,12,1,11,0,0,0,4,0,4,0,0,0,22,12,1,11,0,0,0,4,0,4,0,0,0
01/19/2022,Southwest,1,GACH,1,,36,24,12,0,0,0,,,,2,0,2,35,36,24,12,0,0,0,8,0,8,2,0,2
01/20/2022,Anchorage,7,GACH,1,540,722,632,90,134,110,24,166,33,133,85,1,86,742,722,632,90,134,110,24,230,49,181,85,1,86
01/20/2022,Anchorage,7,LTACH,0,,47,45,2,9,9,0,,,,0,0,0,42,47,45,2,9,9,0,24,10,14,0,0,0
01/20/2022,Anchorage,7,Psych,0,,,,,,,,,,,,,,195,195,132,63,0,0,0,0,0,0,7,0,7
01/20/2022,Gulf Coast,4,CAH,1,51,71,21,50,4,1,3,15,0,15,4,0,4,82,71,21,50,4,1,3,24,0,24,4,0,4
01/20/2022,Gulf Coast,4,GACH,1,,54,43,11,9,6,3,,,,2,0,2,93,54,43,11,9,6,3,22,0,22,2,0,2
01/20/2022,Interior,6,GACH,1,,101,72,29,13,7,6,,,,8,1,9,101,101,72,29,13,7,6,15,1,14,8,1,9
01/20/2022,Matanuska-Susitna,3,GACH,1,,160,90,70,14,12,2,,,,14,0,14,184,160,90,70,14,12,2,33,3,30,14,0,14
01/20/2022,Northern,2,CAH,1,12,45,25,20,0,0,0,8,0,8,5,0,5,69,45,25,20,0,0,0,36,0,36,5,0,5
01/20/2022,Southeast,5,CAH,1,25,70,34,36,4,3,1,17,0,17,6,0,6,70,70,34,36,4,3,1,33,0,33,6,0,6
01/20/2022,Southeast,5,GACH,1,,57,47,10,9,4,5,,,,8,0,8,57,57,47,10,9,4,5,20,0,20,8,0,8
01/20/2022,Southwest,1,CAH,1,22,12,2,10,0,0,0,4,0,4,0,0,0,22,12,2,10,0,0,0,4,0,4,0,0,0
01/20/2022,Southwest,1,GACH,1,,36,21,15,0,0,0,,,,1,0,1,35,36,21,15,0,0,0,8,0,8,1,0,1
01/21/2022,Anchorage,7,GACH,1,530,709,630,79,133,115,18,166,28,138,91,2,93,732,709,630,79,133,115,18,230,44,186,91,2,93
01/21/2022,Anchorage,7,LTACH,0,,47,46,1,9,9,0,,,,0,0,0,42,47,46,1,9,9,0,24,10,14,0,0,0
01/21/2022,Anchorage,7,Psych,0,,,,,,,,,,,,,,195,195,132,63,0,0,0,0,0,0,7,0,7
01/21/2022,Gulf Coast,4,CAH,1,51,71,19,52,4,1,3,16,0,16,5,0,5,82,71,19,52,4,1,3,25,0,25,5,0,5
01/21/2022,Gulf Coast,4,GACH,1,,54,38,16,9,1,8,,,,5,0,5,93,54,38,16,9,1,8,22,0,22,5,0,5
01/21/2022,Interior,6,GACH,1,,101,63,38,13,6,7,,,,8,1,9,101,101,63,38,13,6,7,15,1,14,8,1,9
01/21/2022,Matanuska-Susitna,3,GACH,1,,160,93,67,14,12,2,,,,16,0,16,184,160,93,67,14,12,2,33,3,30,16,0,16
01/21/2022,Northern,2,CAH,1,24,45,25,20,0,0,0,8,0,8,4,0,4,81,45,25,20,0,0,0,36,0,36,4,0,4
01/21/2022,Southeast,5,CAH,1,25,70,31,39,4,2,2,17,0,17,4,0,4,70,70,31,39,4,2,2,33,0,33,4,0,4
01/21/2022,Southeast,5,GACH,1,,57,48,9,9,6,3,,,,8,0,8,57,57,48,9,9,6,3,20,0,20,8,0,8
01/21/2022,Southwest,1,CAH,1,22,12,2,10,0,0,0,4,0,4,0,0,0,22,12,2,10,0,0,0,4,0,4,0,0,0
01/21/2022,Southwest,1,GACH,1,,36,21,15,0,0,0,,,,1,0,1,35,36,21,15,0,0,0,8,0,8,1,0,1
01/22/2022,Anchorage,7,GACH,1,518,694,608,86,132,104,28,166,28,138,87,2,89,720,694,608,86,132,104,28,230,44,186,87,2,89
01/22/2022,Anchorage,7,LTACH,0,,47,47,0,9,9,0,,,,0,0,0,42,47,47,0,9,9,0,24,10,14,0,0,0
01/22/2022,Anchorage,7,Psych,0,,,,,,,,,,,,,,195,195,132,63,0,0,0,0,0,0,7,0,7
01/22/2022,Gulf Coast,4,CAH,1,51,71,25,46,4,1,3,15,0,15,6,0,6,82,71,25,46,4,1,3,24,0,24,6,0,6
01/22/2022,Gulf Coast,4,GACH,1,,54,35,19,9,2,7,,,,4,0,4,93,54,35,19,9,2,7,22,0,22,4,0,4
01/22/2022,Interior,6,GACH,1,,101,75,26,13,7,6,,,,7,1,8,101,101,75,26,13,7,6,15,1,14,7,1,8
01/22/2022,Matanuska-Susitna,3,GACH,1,,160,90,70,14,11,3,,,,20,0,20,184,160,90,70,14,11,3,33,3,30,20,0,20
01/22/2022,Northern,2,CAH,1,12,45,22,23,0,0,0,8,0,8,3,0,3,69,45,22,23,0,0,0,36,0,36,3,0,3
01/22/2022,Southeast,5,CAH,1,25,70,33,37,4,2,2,17,0,17,6,0,6,70,70,33,37,4,2,2,33,0,33,6,0,6
01/22/2022,Southeast,5,GACH,1,,57,47,10,9,5,4,,,,9,0,9,57,57,47,10,9,5,4,20,0,20,9,0,9
01/22/2022,Southwest,1,CAH,1,22,12,2,10,0,0,0,4,0,4,0,0,0,22,12,2,10,0,0,0,4,0,4,0,0,0
01/22/2022,Southwest,1,GACH,1,,36,18,18,0,0,0,,,,0,0,0,35,36,18,18,0,0,0,8,0,8,0,0,0
01/23/2022,Anchorage,7,GACH,1,519,699,610,89,131,112,19,166,28,138,83,2,85,721,699,610,89,131,112,19,230,44,186,83,2,85
01/23/2022,Anchorage,7,LTACH,0,,47,47,0,9,9,0,,,,0,0,0,42,47,47,0,9,9,0,24,10,14,0,0,0
01/23/2022,Anchorage,7,Psych,0,,,,,,,,,,,,,,195,195,132,63,0,0,0,0,0,0,7,0,7
01/23/2022,Gulf Coast,4,CAH,1,51,71,22,49,4,0,4,15,0,15,5,0,5,82,71,22,49,4,0,4,24,0,24,5,0,5
01/23/2022,Gulf Coast,4,GACH,1,,54,33,21,9,4,5,,,,2,0,2,93,54,33,21,9,4,5,22,0,22,2,0,2
01/23/2022,Interior,6,GACH,1,,101,77,24,13,5,8,,,,7,1,8,101,101,77,24,13,5,8,15,1,14,7,1,8
01/23/2022,Matanuska-Susitna,3,GACH,1,,160,84,76,14,10,4,,,,18,0,18,184,160,84,76,14,10,4,33,3,30,18,0,18
01/23/2022,Northern,2,CAH,1,24,45,23,22,0,0,0,8,0,8,0,0,0,81,45,23,22,0,0,0,36,0,36,0,0,0
01/23/2022,Southeast,5,CAH,1,25,70,33,37,4,2,2,17,0,17,8,0,8,70,70,33,37,4,2,2,33,0,33,8,0,8
01/23/2022,Southeast,5,GACH,1,,57,43,14,9,6,3,,,,8,0,8,57,57,43,14,9,6,3,20,0,20,8,0,8
01/23/2022,Southwest,1,CAH,1,22,12,4,8,0,0,0,4,0,4,0,0,0,22,12,4,8,0,0,0,4,0,4,0,0,0
01/23/2022,Southwest,1,GACH,1,,36,22,14,0,0,0,,,,1,0,1,35,36,22,14,0,0,0,8,0,8,1,0,1
01/24/2022,Anchorage,7,GACH,1,526,706,614,92,131,106,25,166,24,142,95,2,97,728,706,614,92,131,106,25,230,40,190,95,2,97
01/24/2022,Anchorage,7,LTACH,0,,47,47,0,9,9,0,,,,0,0,0,42,47,47,0,9,9,0,24,10,14,0,0,0
01/24/2022,Anchorage,7,Psych,0,,,,,,,,,,,,,,195,195,132,63,0,0,0,0,0,0,7,0,7
01/24/2022,Gulf Coast,4,CAH,1,51,71,23,48,4,0,4,15,0,15,6,0,6,82,71,23,48,4,0,4,24,0,24,6,0,6
01/24/2022,Gulf Coast,4,GACH,1,,54,34,20,9,6,3,,,,1,0,1,93,54,34,20,9,6,3,22,0,22,1,0,1
01/24/2022,Interior,6,GACH,1,,101,78,23,13,5,8,,,,10,2,12,101,101,78,23,13,5,8,15,1,14,10,2,12
01/24/2022,Matanuska-Susitna,3,GACH,1,,160,78,82,14,10,4,,,,13,0,13,184,160,78,82,14,10,4,33,3,30,13,0,13
01/24/2022,Northern,2,CAH,1,24,45,24,21,0,0,0,8,0,8,1,0,1,81,45,24,21,0,0,0,36,0,36,1,0,1
01/24/2022,Southeast,5,CAH,1,25,70,35,35,5,3,2,17,0,17,7,0,7,70,70,35,35,5,3,2,33,0,33,7,0,7
01/24/2022,Southeast,5,GACH,1,,57,44,13,9,6,3,,,,5,0,5,57,57,44,13,9,6,3,20,0,20,5,0,5
01/24/2022,Southwest,1,CAH,1,22,12,3,9,0,0,0,4,0,4,1,0,1,22,12,3,9,0,0,0,4,0,4,1,0,1
01/24/2022,Southwest,1,GACH,1,,36,21,15,0,0,0,,,,1,0,1,35,36,21,15,0,0,0,8,0,8,1,0,1
01/25/2022,Anchorage,7,GACH,1,528,706,612,94,129,99,30,166,23,143,89,0,89,730,706,612,94,129,99,30,230,39,191,89,0,89
01/25/2022,Anchorage,7,LTACH,0,,47,46,1,9,9,0,,,,1,0,1,42,47,46,1,9,9,0,24,10,14,1,0,1
01/25/2022,Anchorage,7,Psych,0,140,140,69,71,0,0,0,0,0,0,32,0,32,195,195,124,71,0,0,0,0,0,0,32,0,32
01/25/2022,Gulf Coast,4,CAH,1,51,71,26,45,4,0,4,15,0,15,3,0,3,82,71,26,45,4,0,4,24,0,24,3,0,3
01/25/2022,Gulf Coast,4,GACH,1,,54,36,18,9,4,5,,,,2,0,2,93,54,36,18,9,4,5,22,0,22,2,0,2
01/25/2022,Interior,6,GACH,1,,101,78,23,13,8,5,,,,11,2,13,101,101,78,23,13,8,5,15,1,14,11,2,13
01/25/2022,Matanuska-Susitna,3,GACH,1,,160,82,78,14,12,2,,,,11,0,11,184,160,82,78,14,12,2,33,3,30,11,0,11
01/25/2022,Northern,2,CAH,1,24,35,21,14,0,0,0,8,0,8,0,0,0,81,45,27,18,0,0,0,36,0,36,1,0,1
01/25/2022,Southeast,5,CAH,1,25,70,30,40,4,2,2,17,0,17,4,0,4,70,70,30,40,4,2,2,33,0,33,4,0,4
01/25/2022,Southeast,5,GACH,1,,57,41,16,9,3,6,,,,4,0,4,57,57,41,16,9,3,6,20,0,20,4,0,4
01/25/2022,Southwest,1,CAH,1,22,12,4,8,0,0,0,4,0,4,1,0,1,22,12,4,8,0,0,0,4,0,4,1,0,1
01/25/2022,Southwest,1,GACH,1,,36,17,19,0,0,0,,,,1,0,1,35,36,17,19,0,0,0,8,0,8,1,0,1
01/26/2022,Anchorage,7,GACH,1,538,718,632,86,130,106,24,166,23,143,97,2,99,740,718,632,86,130,106,24,230,39,191,97,2,99
01/26/2022,Anchorage,7,LTACH,0,,47,42,5,9,9,0,,,,1,0,1,42,47,42,5,9,9,0,24,10,14,1,0,1
01/26/2022,Anchorage,7,Psych,0,0,58,58,0,0,0,0,0,0,0,0,0,0,140,198,127,71,0,0,0,0,0,0,32,0,32
01/26/2022,Gulf Coast,4,CAH,1,51,71,26,45,4,0,4,15,0,15,6,0,6,82,71,26,45,4,0,4,24,0,24,6,0,6
01/26/2022,Gulf Coast,4,GACH,1,,54,39,15,9,3,6,,,,3,0,3,93,54,39,15,9,3,6,22,0,22,3,0,3
01/26/2022,Interior,6,GACH,1,,101,68,33,13,8,5,,,,10,3,13,101,101,68,33,13,8,5,15,1,14,10,3,13
01/26/2022,Matanuska-Susitna,3,GACH,1,,160,79,81,14,10,4,,,,13,0,13,184,160,79,81,14,10,4,33,3,30,13,0,13
01/26/2022,Northern,2,CAH,1,24,45,25,20,0,0,0,8,0,8,3,0,3,81,45,25,20,0,0,0,36,0,36,3,0,3
01/26/2022,Southeast,5,CAH,1,25,70,38,32,6,5,1,17,0,17,6,0,6,70,70,38,32,6,5,1,33,0,33,6,0,6
01/26/2022,Southeast,5,GACH,1,,57,44,13,9,3,6,,,,5,0,5,57,57,44,13,9,3,6,20,0,20,5,0,5
01/26/2022,Southwest,1,CAH,1,22,12,4,8,0,0,0,4,0,4,1,0,1,22,12,4,8,0,0,0,4,0,4,1,0,1
01/26/2022,Southwest,1,GACH,1,,36,17,19,0,0,0,,,,2,0,2,35,36,17,19,0,0,0,8,0,8,2,0,2
01/27/2022,Anchorage,7,GACH,1,537,713,632,81,132,106,26,166,25,141,101,3,104,739,713,632,81,132,106,26,230,41,189,101,3,104
01/27/2022,Anchorage,7,LTACH,0,,47,45,2,9,9,0,,,,2,0,2,42,47,45,2,9,9,0,24,10,14,2,0,2
01/27/2022,Anchorage,7,Psych,0,,,,,,,,,,,,,,140,198,127,71,0,0,0,0,0,0,32,0,32
01/27/2022,Gulf Coast,4,CAH,1,51,71,30,41,4,1,3,15,0,15,5,0,5,82,71,30,41,4,1,3,24,0,24,5,0,5
01/27/2022,Gulf Coast,4,GACH,1,,54,37,17,9,5,4,,,,3,0,3,93,54,37,17,9,5,4,22,0,22,3,0,3
01/27/2022,Interior,6,GACH,1,,101,74,27,13,8,5,,,,8,1,9,101,101,74,27,13,8,5,15,1,14,8,1,9
01/27/2022,Matanuska-Susitna,3,GACH,1,,160,86,74,14,10,4,,,,20,0,20,184,160,86,74,14,10,4,33,3,30,20,0,20
01/27/2022,Northern,2,CAH,1,24,45,25,20,0,0,0,9,0,9,3,0,3,81,45,25,20,0,0,0,37,0,37,3,0,3
01/27/2022,Southeast,5,CAH,1,25,70,35,35,6,5,1,17,0,17,4,0,4,70,70,35,35,6,5,1,33,0,33,4,0,4
01/27/2022,Southeast,5,GACH,1,,57,44,13,9,4,5,,,,4,0,4,57,57,44,13,9,4,5,20,0,20,4,0,4
01/27/2022,Southwest,1,CAH,1,22,12,4,8,0,0,0,4,0,4,1,0,1,22,12,4,8,0,0,0,4,0,4,1,0,1
01/27/2022,Southwest,1,GACH,1,,36,18,18,0,0,0,,,,4,0,4,35,36,18,18,0,0,0,8,0,8,4,0,4
01/28/2022,Anchorage,7,GACH,1,542,707,622,85,129,108,21,166,25,141,96,3,99,744,707,622,85,129,108,21,230,41,189,96,3,99
01/28/2022,Anchorage,7,LTACH,0,,47,45,2,9,9,0,,,,2,0,2,42,47,45,2,9,9,0,24,10,14,2,0,2
01/28/2022,Anchorage,7,Psych,0,,,,,,,,,,,,,,140,198,127,71,0,0,0,0,0,0,32,0,32
01/28/2022,Gulf Coast,4,CAH,1,51,71,30,41,4,1,3,15,0,15,4,0,4,82,71,30,41,4,1,3,24,0,24,4,0,4
01/28/2022,Gulf Coast,4,GACH,1,,54,36,18,9,4,5,,,,3,0,3,93,54,36,18,9,4,5,22,0,22,3,0,3
01/28/2022,Interior,6,GACH,1,,101,81,20,13,8,5,,,,12,1,13,101,101,81,20,13,8,5,15,1,14,12,1,13
01/28/2022,Matanuska-Susitna,3,GACH,1,,160,98,62,14,11,3,,,,18,1,19,184,160,98,62,14,11,3,33,3,30,18,1,19
01/28/2022,Northern,2,CAH,1,24,45,24,21,0,0,0,8,0,8,2,0,2,81,45,24,21,0,0,0,36,0,36,2,0,2
01/28/2022,Southeast,5,CAH,1,25,70,28,42,6,4,2,17,0,17,4,0,4,70,70,28,42,6,4,2,33,0,33,4,0,4
01/28/2022,Southeast,5,GACH,1,,57,42,15,9,3,6,,,,3,0,3,57,57,42,15,9,3,6,20,0,20,3,0,3
01/28/2022,Southwest,1,CAH,1,22,12,4,8,0,0,0,4,0,4,0,0,0,22,12,4,8,0,0,0,4,0,4,0,0,0
01/28/2022,Southwest,1,GACH,1,,36,18,18,0,0,0,,,,5,0,5,35,36,18,18,0,0,0,8,0,8,5,0,5
01/29/2022,Anchorage,7,GACH,1,531,700,623,77,136,108,28,166,21,145,96,2,98,733,700,623,77,136,108,28,230,37,193,96,2,98
01/29/2022,Anchorage,7,LTACH,0,,47,43,4,9,9,0,,,,1,0,1,42,47,43,4,9,9,0,24,10,14,1,0,1
01/29/2022,Anchorage,7,Psych,0,,,,,,,,,,,,,,140,198,127,71,0,0,0,0,0,0,32,0,32
01/29/2022,Gulf Coast,4,CAH,1,51,71,28,43,4,0,4,15,0,15,3,0,3,82,71,28,43,4,0,4,24,0,24,3,0,3
01/29/2022,Gulf Coast,4,GACH,1,,54,32,22,9,5,4,,,,4,0,4,93,54,32,22,9,5,4,22,0,22,4,0,4
01/29/2022,Interior,6,GACH,1,,101,86,15,13,9,4,,,,13,2,15,101,101,86,15,13,9,4,15,1,14,13,2,15
01/29/2022,Matanuska-Susitna,3,GACH,1,,160,82,78,14,9,5,,,,20,1,21,184,160,82,78,14,9,5,33,3,30,20,1,21
01/29/2022,Northern,2,CAH,1,24,45,20,25,0,0,0,8,0,8,0,0,0,81,45,20,25,0,0,0,36,0,36,0,0,0
01/29/2022,Southeast,5,CAH,1,25,70,27,43,6,4,2,17,0,17,2,0,2,70,70,27,43,6,4,2,33,0,33,2,0,2
01/29/2022,Southeast,5,GACH,1,,57,40,17,9,3,6,,,,4,0,4,57,57,40,17,9,3,6,20,0,20,4,0,4
01/29/2022,Southwest,1,CAH,1,22,12,5,7,0,0,0,4,0,4,0,0,0,22,12,5,7,0,0,0,4,0,4,0,0,0
01/29/2022,Southwest,1,GACH,1,,36,20,16,0,0,0,,,,4,0,4,35,36,20,16,0,0,0,8,0,8,4,0,4
01/30/2022,Anchorage,7,GACH,1,529,698,615,83,135,106,29,166,22,144,97,4,101,731,698,615,83,135,106,29,230,38,192,97,4,101
01/30/2022,Anchorage,7,LTACH,0,,47,43,4,9,9,0,,,,1,0,1,42,47,43,4,9,9,0,24,10,14,1,0,1
01/30/2022,Anchorage,7,Psych,0,,,,,,,,,,,,,,140,198,127,71,0,0,0,0,0,0,32,0,32
01/30/2022,Gulf Coast,4,CAH,1,51,71,22,49,4,0,4,15,0,15,3,0,3,82,71,22,49,4,0,4,24,0,24,3,0,3
01/30/2022,Gulf Coast,4,GACH,1,,54,32,22,9,4,5,,,,4,0,4,93,54,32,22,9,4,5,22,0,22,4,0,4
01/30/2022,Interior,6,GACH,1,,101,73,28,13,8,5,,,,11,1,12,101,101,73,28,13,8,5,15,1,14,11,1,12
01/30/2022,Matanuska-Susitna,3,GACH,1,,160,73,87,14,9,5,,,,19,0,19,184,160,73,87,14,9,5,33,3,30,19,0,19
01/30/2022,Northern,2,CAH,1,24,45,21,24,0,0,0,8,0,8,0,0,0,81,45,21,24,0,0,0,36,0,36,0,0,0
01/30/2022,Southeast,5,CAH,1,25,70,29,41,6,4,2,17,0,17,3,0,3,70,70,29,41,6,4,2,33,0,33,3,0,3
01/30/2022,Southeast,5,GACH,1,,57,41,16,9,4,5,,,,3,0,3,57,57,41,16,9,4,5,20,0,20,3,0,3
01/30/2022,Southwest,1,CAH,1,22,12,3,9,0,0,0,4,0,4,0,0,0,22,12,3,9,0,0,0,4,0,4,0,0,0
01/30/2022,Southwest,1,GACH,1,,36,19,17,0,0,0,,,,5,0,5,35,36,19,17,0,0,0,8,0,8,5,0,5
01/31/2022,Anchorage,7,GACH,1,546,713,623,90,134,111,23,166,24,142,98,1,99,748,713,623,90,134,111,23,230,40,190,98,1,99
01/31/2022,Anchorage,7,LTACH,0,,47,43,4,9,9,0,,,,1,0,1,42,47,43,4,9,9,0,24,10,14,1,0,1
01/31/2022,Anchorage,7,Psych,0,,,,,,,,,,,,,,140,198,127,71,0,0,0,0,0,0,32,0,32
01/31/2022,Gulf Coast,4,CAH,1,51,71,23,48,4,0,4,15,0,15,2,0,2,82,71,23,48,4,0,4,24,0,24,2,0,2
01/31/2022,Gulf Coast,4,GACH,1,,54,36,18,9,5,4,,,,5,0,5,93,54,36,18,9,5,4,22,0,22,5,0,5
01/31/2022,Interior,6,GACH,1,,101,73,28,13,9,4,,,,12,1,13,101,101,73,28,13,9,4,15,1,14,12,1,13
01/31/2022,Matanuska-Susitna,3,GACH,1,,160,83,77,14,10,4,,,,22,0,22,184,160,83,77,14,10,4,33,3,30,22,0,22
01/31/2022,Northern,2,CAH,1,24,45,23,22,0,0,0,8,0,8,2,0,2,81,45,23,22,0,0,0,36,0,36,2,0,2
01/31/2022,Southeast,5,CAH,1,25,70,26,44,2,0,2,17,0,17,1,0,1,70,70,26,44,2,0,2,33,0,33,1,0,1
01/31/2022,Southeast,5,GACH,1,,57,42,15,9,3,6,,,,3,0,3,57,57,42,15,9,3,6,20,0,20,3,0,3
01/31/2022,Southwest,1,CAH,1,22,12,5,7,0,0,0,4,0,4,0,0,0,22,12,5,7,0,0,0,4,0,4,0,0,0
01/31/2022,Southwest,1,GACH,1,,36,20,16,0,0,0,,,,7,0,7,35,36,20,16,0,0,0,8,0,8,7,0,7
02/01/2022,Anchorage,7,GACH,1,540,705,617,88,132,103,29,166,28,138,98,1,99,742,705,617,88,132,103,29,230,44,186,98,1,99
02/01/2022,Anchorage,7,LTACH,0,,47,44,3,9,9,0,,,,1,0,1,42,47,44,3,9,9,0,24,10,14,1,0,1
02/01/2022,Anchorage,7,Psych,0,,,,,,,,,,,,,,140,198,127,71,0,0,0,0,0,0,32,0,32
02/01/2022,Gulf Coast,4,CAH,1,51,71,29,42,4,0,4,15,0,15,3,0,3,82,71,29,42,4,0,4,24,0,24,3,0,3
02/01/2022,Gulf Coast,4,GACH,1,,54,41,13,9,7,2,,,,7,0,7,93,54,41,13,9,7,2,22,0,22,7,0,7
02/01/2022,Interior,6,GACH,1,,101,74,27,13,7,6,,,,10,1,11,101,101,74,27,13,7,6,15,1,14,10,1,11
02/01/2022,Matanuska-Susitna,3,GACH,1,,160,87,73,14,11,3,,,,20,0,20,184,160,87,73,14,11,3,33,3,30,20,0,20
02/01/2022,Northern,2,CAH,1,24,45,14,31,0,0,0,8,0,8,1,0,1,81,45,14,31,0,0,0,36,0,36,1,0,1
02/01/2022,Southeast,5,CAH,1,25,70,31,39,2,0,2,17,0,17,1,0,1,70,70,31,39,2,0,2,33,0,33,1,0,1
02/01/2022,Southeast,5,GACH,1,,57,39,18,9,4,5,,,,0,0,0,57,57,39,18,9,4,5,20,0,20,0,0,0
02/01/2022,Southwest,1,CAH,1,22,12,4,8,0,0,0,4,0,4,0,0,0,22,12,4,8,0,0,0,4,0,4,0,0,0
02/01/2022,Southwest,1,GACH,1,,36,21,15,0,0,0,,,,9,0,9,35,36,21,15,0,0,0,8,0,8,9,0,9
02/02/2022,Anchorage,7,GACH,1,523,694,624,70,132,100,32,166,15,151,92,3,95,725,694,624,70,132,100,32,230,31,199,92,3,95
02/02/2022,Anchorage,7,LTACH,0,,47,43,4,9,9,0,,,,1,0,1,42,47,43,4,9,9,0,24,10,14,1,0,1
02/02/2022,Anchorage,7,Psych,0,140,207,128,79,0,0,0,0,0,0,31,0,31,140,207,128,79,0,0,0,0,0,0,31,0,31
02/02/2022,Gulf Coast,4,CAH,1,51,71,30,41,4,0,4,15,0,15,4,0,4,82,71,30,41,4,0,4,24,0,24,4,0,4
02/02/2022,Gulf Coast,4,GACH,1,,54,50,4,9,9,0,,,,9,0,9,93,54,50,4,9,9,0,22,0,22,9,0,9
02/02/2022,Interior,6,GACH,1,,101,75,26,13,9,4,,,,8,1,9,101,101,75,26,13,9,4,15,1,14,8,1,9
02/02/2022,Matanuska-Susitna,3,GACH,1,,160,95,65,14,14,0,,,,22,1,23,184,160,95,65,14,14,0,33,3,30,22,1,23
02/02/2022,Northern,2,CAH,1,24,45,15,30,0,0,0,8,0,8,1,0,1,81,45,15,30,0,0,0,36,0,36,1,0,1
02/02/2022,Southeast,5,CAH,1,25,70,31,39,4,3,1,17,0,17,0,0,0,70,70,31,39,4,3,1,33,0,33,0,0,0
02/02/2022,Southeast,5,GACH,1,,57,43,14,9,2,7,,,,0,0,0,57,57,43,14,9,2,7,20,0,20,0,0,0
02/02/2022,Southwest,1,CAH,1,22,12,4,8,0,0,0,4,0,4,0,0,0,22,12,4,8,0,0,0,4,0,4,0,0,0
02/02/2022,Southwest,1,GACH,1,,36,20,16,0,0,0,,,,9,0,9,35,36,20,16,0,0,0,8,0,8,9,0,9
02/03/2022,Anchorage,7,GACH,1,526,700,625,75,128,104,24,166,24,142,76,4,80,728,700,625,75,128,104,24,230,40,190,76,4,80
02/03/2022,Anchorage,7,LTACH,0,,47,43,4,9,9,0,,,,1,0,1,42,47,43,4,9,9,0,24,10,14,1,0,1
02/03/2022,Anchorage,7,Psych,0,,,,,,,,,,,,,,140,207,128,79,0,0,0,0,0,0,31,0,31
02/03/2022,Gulf Coast,4,CAH,1,38,71,25,46,4,0,4,12,0,12,3,0,3,82,71,25,46,4,0,4,24,0,24,3,0,3
02/03/2022,Gulf Coast,4,GACH,1,,54,40,14,9,8,1,,,,8,0,8,93,54,40,14,9,8,1,22,0,22,8,0,8
02/03/2022,Interior,6,GACH,1,,101,83,18,13,11,2,,,,11,1,12,101,101,83,18,13,11,2,15,1,14,11,1,12
02/03/2022,Matanuska-Susitna,3,GACH,1,,160,97,63,14,13,1,,,,17,0,17,184,160,97,63,14,13,1,33,3,30,17,0,17
02/03/2022,Northern,2,CAH,1,24,45,15,30,0,0,0,8,0,8,1,0,1,81,45,15,30,0,0,0,36,0,36,1,0,1
02/03/2022,Southeast,5,CAH,1,25,70,32,38,4,3,1,17,0,17,0,0,0,70,70,32,38,4,3,1,33,0,33,0,0,0
02/03/2022,Southeast,5,GACH,1,,57,43,14,9,4,5,,,,0,0,0,57,57,43,14,9,4,5,20,0,20,0,0,0
02/03/2022,Southwest,1,CAH,1,22,12,2,10,0,0,0,4,0,4,0,0,0,22,12,2,10,0,0,0,4,0,4,0,0,0
02/03/2022,Southwest,1,GACH,1,,36,18,18,0,0,0,,,,7,0,7,35,36,18,18,0,0,0,8,0,8,7,0,7
02/04/2022,Anchorage,7,GACH,1,521,684,631,53,126,105,21,166,22,144,71,0,71,723,684,631,53,126,105,21,230,38,192,71,0,71
02/04/2022,Anchorage,7,LTACH,0,,47,44,3,9,9,0,,,,1,0,1,42,47,44,3,9,9,0,24,10,14,1,0,1
02/04/2022,Anchorage,7,Psych,0,,,,,,,,,,,,,,140,207,128,79,0,0,0,0,0,0,31,0,31
02/04/2022,Gulf Coast,4,CAH,1,51,71,28,43,4,0,4,15,0,15,1,0,1,82,71,28,43,4,0,4,24,0,24,1,0,1
02/04/2022,Gulf Coast,4,GACH,1,,54,42,12,9,7,2,,,,9,0,9,93,54,42,12,9,7,2,22,0,22,9,0,9
02/04/2022,Interior,6,GACH,1,,101,68,33,13,8,5,,,,9,0,9,101,101,68,33,13,8,5,15,1,14,9,0,9
02/04/2022,Matanuska-Susitna,3,GACH,1,,160,95,65,14,10,4,,,,20,0,20,184,160,95,65,14,10,4,33,3,30,20,0,20
02/04/2022,Northern,2,CAH,1,24,45,13,32,0,0,0,8,0,8,3,0,3,81,45,13,32,0,0,0,36,0,36,3,0,3
02/04/2022,Southeast,5,CAH,1,25,70,32,38,4,2,2,17,0,17,0,0,0,70,70,32,38,4,2,2,33,0,33,0,0,0
02/04/2022,Southeast,5,GACH,1,,57,47,10,9,3,6,,,,0,0,0,57,57,47,10,9,3,6,20,0,20,0,0,0
02/04/2022,Southwest,1,CAH,1,22,12,2,10,0,0,0,4,0,4,0,0,0,22,12,2,10,0,0,0,4,0,4,0,0,0
02/04/2022,Southwest,1,GACH,1,,36,16,20,0,0,0,,,,5,0,5,35,36,16,20,0,0,0,8,0,8,5,0,5
02/05/2022,Anchorage,7,GACH,1,532,700,641,59,123,110,13,166,22,144,71,0,71,734,700,641,59,123,110,13,230,38,192,71,0,71
02/05/2022,Anchorage,7,LTACH,0,,47,45,2,9,9,0,,,,1,0,1,42,47,45,2,9,9,0,24,10,14,1,0,1
02/05/2022,Anchorage,7,Psych,0,,,,,,,,,,,,,,140,207,128,79,0,0,0,0,0,0,31,0,31
02/05/2022,Gulf Coast,4,CAH,1,51,71,27,44,4,0,4,15,0,15,1,0,1,82,71,27,44,4,0,4,24,0,24,1,0,1
02/05/2022,Gulf Coast,4,GACH,1,,54,45,9,9,9,0,,,,12,0,12,93,54,45,9,9,9,0,22,0,22,12,0,12
02/05/2022,Interior,6,GACH,1,,101,81,20,13,7,6,,,,11,0,11,101,101,81,20,13,7,6,15,1,14,11,0,11
02/05/2022,Matanuska-Susitna,3,GACH,1,,160,97,63,14,12,2,,,,19,0,19,184,160,97,63,14,12,2,33,3,30,19,0,19
02/05/2022,Northern,2,CAH,1,24,45,18,27,0,0,0,8,0,8,4,0,4,81,45,18,27,0,0,0,36,0,36,4,0,4
02/05/2022,Southeast,5,CAH,1,25,70,28,42,4,2,2,17,0,17,0,0,0,70,70,28,42,4,2,2,33,0,33,0,0,0
02/05/2022,Southeast,5,GACH,1,,57,41,16,9,1,8,,,,0,0,0,57,57,41,16,9,1,8,20,0,20,0,0,0
02/05/2022,Southwest,1,CAH,1,22,12,3,9,0,0,0,4,0,4,0,0,0,22,12,3,9,0,0,0,4,0,4,0,0,0
02/05/2022,Southwest,1,GACH,1,,36,18,18,0,0,0,,,,4,0,4,35,36,18,18,0,0,0,8,0,8,4,0,4
02/06/2022,Anchorage,7,GACH,1,535,696,620,76,127,105,22,166,20,146,79,0,79,737,696,620,76,127,105,22,230,36,194,79,0,79
02/06/2022,Anchorage,7,LTACH,0,,47,46,1,9,9,0,,,,1,0,1,42,47,46,1,9,9,0,24,10,14,1,0,1
02/06/2022,Anchorage,7,Psych,0,,,,,,,,,,,,,,140,207,128,79,0,0,0,0,0,0,31,0,31
02/06/2022,Gulf Coast,4,CAH,1,51,71,30,41,4,0,4,15,0,15,2,0,2,82,71,30,41,4,0,4,24,0,24,2,0,2
02/06/2022,Gulf Coast,4,GACH,1,,54,43,11,9,6,3,,,,9,0,9,93,54,43,11,9,6,3,22,0,22,9,0,9
02/06/2022,Interior,6,GACH,1,,101,76,25,13,10,3,,,,9,0,9,101,101,76,25,13,10,3,15,1,14,9,0,9
02/06/2022,Matanuska-Susitna,3,GACH,1,,160,91,69,14,11,3,,,,21,0,21,184,160,91,69,14,11,3,33,3,30,21,0,21
02/06/2022,Northern,2,CAH,1,24,45,23,22,0,0,0,8,0,8,4,0,4,81,45,23,22,0,0,0,36,0,36,4,0,4
02/06/2022,Southeast,5,CAH,1,25,70,23,47,4,2,2,17,0,17,0,0,0,70,70,23,47,4,2,2,33,0,33,0,0,0
02/06/2022,Southeast,5,GACH,1,,57,37,20,9,2,7,,,,0,0,0,57,57,37,20,9,2,7,20,0,20,0,0,0
02/06/2022,Southwest,1,CAH,1,22,12,2,10,0,0,0,4,0,4,0,0,0,22,12,2,10,0,0,0,4,0,4,0,0,0
02/06/2022,Southwest,1,GACH,1,,36,16,20,0,0,0,,,,4,0,4,35,36,16,20,0,0,0,8,0,8,4,0,4
02/07/2022,Anchorage,7,GACH,1,553,717,630,87,128,104,24,166,19,147,81,0,81,755,717,630,87,128,104,24,230,35,195,81,0,81
02/07/2022,Anchorage,7,LTACH,0,,47,46,1,9,9,0,,,,1,0,1,42,47,46,1,9,9,0,24,10,14,1,0,1
02/07/2022,Anchorage,7,Psych,0,,,,,,,,,,,,,,140,207,128,79,0,0,0,0,0,0,31,0,31
02/07/2022,Gulf Coast,4,CAH,1,51,71,27,44,4,1,3,15,0,15,1,0,1,82,71,27,44,4,1,3,24,0,24,1,0,1
02/07/2022,Gulf Coast,4,GACH,1,,54,43,11,9,8,1,,,,9,0,9,93,54,43,11,9,8,1,22,0,22,9,0,9
02/07/2022,Interior,6,GACH,1,,101,72,29,13,8,5,,,,9,0,9,101,101,72,29,13,8,5,15,1,14,9,0,9
02/07/2022,Matanuska-Susitna,3,GACH,1,,160,82,78,14,12,2,,,,17,0,17,184,160,82,78,14,12,2,33,3,30,17,0,17
02/07/2022,Northern,2,CAH,1,24,45,23,22,0,0,0,8,0,8,5,0,5,81,45,23,22,0,0,0,36,0,36,5,0,5
02/07/2022,Southeast,5,CAH,1,25,70,26,44,4,2,2,17,0,17,0,0,0,70,70,26,44,4,2,2,33,0,33,0,0,0
02/07/2022,Southeast,5,GACH,1,,57,38,19,9,4,5,,,,1,0,1,57,57,38,19,9,4,5,20,0,20,1,0,1
02/07/2022,Southwest,1,CAH,1,22,12,2,10,0,0,0,4,0,4,0,0,0,22,12,2,10,0,0,0,4,0,4,0,0,0
02/07/2022,Southwest,1,GACH,1,,36,18,18,0,0,0,,,,5,0,5,35,36,18,18,0,0,0,8,0,8,5,0,5
02/08/2022,Anchorage,7,GACH,1,566,731,643,88,124,108,16,166,19,147,74,0,74,768,731,643,88,124,108,16,230,35,195,74,0,74
02/08/2022,Anchorage,7,LTACH,0,,47,46,1,9,9,0,,,,0,0,0,42,47,46,1,9,9,0,24,10,14,0,0,0
02/08/2022,Anchorage,7,Psych,0,,,,,,,,,,,,,,140,207,128,79,0,0,0,0,0,0,31,0,31
02/08/2022,Gulf Coast,4,CAH,1,38,71,33,38,4,2,2,12,0,12,2,0,2,82,71,33,38,4,2,2,24,0,24,2,0,2
02/08/2022,Gulf Coast,4,GACH,1,,54,43,11,9,6,3,,,,7,0,7,93,54,43,11,9,6,3,22,0,22,7,0,7
02/08/2022,Interior,6,GACH,1,,101,78,23,13,10,3,,,,9,0,9,101,101,78,23,13,10,3,15,1,14,9,0,9
02/08/2022,Matanuska-Susitna,3,GACH,1,,160,96,64,14,11,3,,,,17,0,17,184,160,96,64,14,11,3,33,3,30,17,0,17
02/08/2022,Northern,2,CAH,1,24,45,25,20,0,0,0,8,0,8,6,0,6,81,45,25,20,0,0,0,36,0,36,6,0,6
02/08/2022,Southeast,5,CAH,1,25,70,34,36,6,4,2,17,0,17,2,0,2,70,70,34,36,6,4,2,33,0,33,2,0,2
02/08/2022,Southeast,5,GACH,1,,57,40,17,9,3,6,,,,2,0,2,57,57,40,17,9,3,6,20,0,20,2,0,2
02/08/2022,Southwest,1,CAH,1,22,12,2,10,0,0,0,4,0,4,0,0,0,22,12,2,10,0,0,0,4,0,4,0,0,0
02/08/2022,Southwest,1,GACH,1,,36,22,14,0,0,0,,,,5,0,5,35,36,22,14,0,0,0,8,0,8,5,0,5
02/09/2022,Anchorage,7,GACH,1,543,707,623,84,132,109,23,166,22,144,68,0,68,745,707,623,84,132,109,23,230,38,192,68,0,68
02/09/2022,Anchorage,7,LTACH,0,,47,44,3,9,9,0,,,,0,0,0,42,47,44,3,9,9,0,24,10,14,0,0,0
02/09/2022,Anchorage,7,Psych,0,140,207,131,76,0,0,0,0,0,0,8,0,8,140,207,131,76,0,0,0,0,0,0,8,0,8
02/09/2022,Gulf Coast,4,CAH,1,34,69,34,35,4,1,3,12,0,12,1,0,1,78,69,34,35,4,1,3,24,0,24,1,0,1
02/09/2022,Gulf Coast,4,GACH,1,,54,44,10,9,7,2,,,,5,0,5,93,54,44,10,9,7,2,22,0,22,5,0,5
02/09/2022,Interior,6,GACH,1,,101,76,25,13,8,5,,,,8,0,8,101,101,76,25,13,8,5,15,1,14,8,0,8
02/09/2022,Matanuska-Susitna,3,GACH,1,,160,96,64,14,13,1,,,,13,0,13,184,160,96,64,14,13,1,33,3,30,13,0,13
02/09/2022,Northern,2,CAH,1,24,45,27,18,0,0,0,8,0,8,6,0,6,81,45,27,18,0,0,0,36,0,36,6,0,6
02/09/2022,Southeast,5,CAH,1,25,70,38,32,6,4,2,17,0,17,2,0,2,70,70,38,32,6,4,2,33,0,33,2,0,2
02/09/2022,Southeast,5,GACH,1,,57,45,12,9,6,3,,,,4,0,4,57,57,45,12,9,6,3,20,0,20,4,0,4
02/09/2022,Southwest,1,CAH,1,22,12,2,10,0,0,0,4,0,4,0,0,0,22,12,2,10,0,0,0,4,0,4,0,0,0
02/09/2022,Southwest,1,GACH,1,,36,20,16,0,0,0,,,,4,0,4,35,36,20,16,0,0,0,8,0,8,4,0,4
02/10/2022,Anchorage,7,GACH,1,532,697,614,83,129,104,25,166,26,140,61,0,61,734,697,614,83,129,104,25,230,42,188,61,0,61
02/10/2022,Anchorage,7,LTACH,0,,47,45,2,9,9,0,,,,0,0,0,42,47,45,2,9,9,0,24,10,14,0,0,0
02/10/2022,Anchorage,7,Psych,0,,,,,,,,,,,,,,140,207,131,76,0,0,0,0,0,0,8,0,8
02/10/2022,Gulf Coast,4,CAH,1,34,69,32,37,4,1,3,12,0,12,1,0,1,78,69,32,37,4,1,3,24,0,24,1,0,1
02/10/2022,Gulf Coast,4,GACH,1,,54,42,12,9,6,3,,,,8,0,8,93,54,42,12,9,6,3,22,0,22,8,0,8
02/10/2022,Interior,6,GACH,1,,101,78,23,13,12,1,,,,7,1,8,101,101,78,23,13,12,1,15,1,14,7,1,8
02/10/2022,Matanuska-Susitna,3,GACH,1,,160,93,67,14,13,1,,,,10,0,10,184,160,93,67,14,13,1,33,3,30,10,0,10
02/10/2022,Northern,2,CAH,1,24,45,27,18,0,0,0,8,0,8,5,0,5,81,45,27,18,0,0,0,36,0,36,5,0,5
02/10/2022,Southeast,5,CAH,1,25,70,39,31,5,3,2,17,0,17,2,0,2,70,70,39,31,5,3,2,33,0,33,2,0,2
02/10/2022,Southeast,5,GACH,1,,57,42,15,9,5,4,,,,4,0,4,57,57,42,15,9,5,4,20,0,20,4,0,4
02/10/2022,Southwest,1,CAH,1,22,12,3,9,0,0,0,4,0,4,0,0,0,22,12,3,9,0,0,0,4,0,4,0,0,0
02/10/2022,Southwest,1,GACH,1,,36,21,15,0,0,0,,,,3,0,3,35,36,21,15,0,0,0,8,0,8,3,0,3
02/11/2022,Anchorage,7,GACH,1,528,697,619,78,130,101,29,166,23,143,59,0,59,730,697,619,78,130,101,29,230,39,191,59,0,59
02/11/2022,Anchorage,7,LTACH,0,,47,45,2,9,9,0,,,,0,0,0,42,47,45,2,9,9,0,24,10,14,0,0,0
02/11/2022,Anchorage,7,Psych,0,,,,,,,,,,,,,,140,207,131,76,0,0,0,0,0,0,8,0,8
02/11/2022,Gulf Coast,4,CAH,1,35,70,30,40,4,0,4,12,0,12,1,0,1,79,70,30,40,4,0,4,24,0,24,1,0,1
02/11/2022,Gulf Coast,4,GACH,1,,54,38,16,9,5,4,,,,8,0,8,93,54,38,16,9,5,4,22,0,22,8,0,8
02/11/2022,Interior,6,GACH,1,,101,78,23,13,9,4,,,,9,1,10,101,101,78,23,13,9,4,15,1,14,9,1,10
02/11/2022,Matanuska-Susitna,3,GACH,1,,160,88,72,14,10,4,,,,11,0,11,184,160,88,72,14,10,4,33,3,30,11,0,11
02/11/2022,Northern,2,CAH,1,24,45,29,16,0,0,0,8,0,8,8,0,8,81,45,29,16,0,0,0,36,0,36,8,0,8
02/11/2022,Southeast,5,CAH,1,13,58,34,24,5,3,2,17,0,17,4,0,4,58,58,34,24,5,3,2,33,0,33,4,0,4
02/11/2022,Southeast,5,GACH,1,,57,42,15,9,5,4,,,,4,0,4,57,57,42,15,9,5,4,20,0,20,4,0,4
02/11/2022,Southwest,1,CAH,1,22,12,1,11,0,0,0,4,0,4,0,0,0,22,12,1,11,0,0,0,4,0,4,0,0,0
02/11/2022,Southwest,1,GACH,1,,36,17,19,0,0,0,,,,2,0,2,35,36,17,19,0,0,0,8,0,8,2,0,2
02/12/2022,Anchorage,7,GACH,1,531,691,624,67,126,98,28,162,19,143,61,0,61,733,691,624,67,126,98,28,226,35,191,61,0,61
02/12/2022,Anchorage,7,LTACH,0,,47,41,6,9,9,0,,,,0,0,0,42,47,41,6,9,9,0,24,10,14,0,0,0
02/12/2022,Anchorage,7,Psych,0,,,,,,,,,,,,,,140,207,131,76,0,0,0,0,0,0,8,0,8
02/12/2022,Gulf Coast,4,CAH,1,34,69,26,43,4,1,3,12,0,12,1,0,1,78,69,26,43,4,1,3,24,0,24,1,0,1
02/12/2022,Gulf Coast,4,GACH,1,,54,32,22,9,4,5,,,,5,0,5,93,54,32,22,9,4,5,22,0,22,5,0,5
02/12/2022,Interior,6,GACH,1,,101,80,21,13,10,3,,,,8,1,9,101,101,80,21,13,10,3,15,1,14,8,1,9
02/12/2022,Matanuska-Susitna,3,GACH,1,,160,77,83,14,8,6,,,,10,0,10,184,160,77,83,14,8,6,33,3,30,10,0,10
02/12/2022,Northern,2,CAH,1,24,45,29,16,0,0,0,8,0,8,6,0,6,81,45,29,16,0,0,0,36,0,36,6,0,6
02/12/2022,Southeast,5,CAH,1,13,58,32,26,5,3,2,17,0,17,4,0,4,58,58,32,26,5,3,2,33,0,33,4,0,4
02/12/2022,Southeast,5,GACH,1,,57,42,15,9,5,4,,,,3,0,3,57,57,42,15,9,5,4,20,0,20,3,0,3
02/12/2022,Southwest,1,CAH,1,22,12,2,10,0,0,0,4,0,4,0,0,0,22,12,2,10,0,0,0,4,0,4,0,0,0
02/12/2022,Southwest,1,GACH,1,,36,16,20,0,0,0,,,,4,0,4,35,36,16,20,0,0,0,8,0,8,4,0,4
02/13/2022,Anchorage,7,GACH,1,523,688,624,64,127,106,21,162,22,140,65,0,65,725,688,624,64,127,106,21,226,38,188,65,0,65
02/13/2022,Anchorage,7,LTACH,0,,47,42,5,9,9,0,,,,0,0,0,42,47,42,5,9,9,0,24,10,14,0,0,0
02/13/2022,Anchorage,7,Psych,0,,,,,,,,,,,,,,140,207,131,76,0,0,0,0,0,0,8,0,8
02/13/2022,Gulf Coast,4,CAH,1,34,69,25,44,4,1,3,12,0,12,2,0,2,78,69,25,44,4,1,3,24,0,24,2,0,2
02/13/2022,Gulf Coast,4,GACH,1,,54,29,25,9,3,6,,,,4,0,4,93,54,29,25,9,3,6,22,0,22,4,0,4
02/13/2022,Interior,6,GACH,1,,101,82,19,13,10,3,,,,6,0,6,101,101,82,19,13,10,3,15,1,14,6,0,6
02/13/2022,Matanuska-Susitna,3,GACH,1,,160,77,83,14,8,6,,,,10,0,10,184,160,77,83,14,8,6,33,3,30,10,0,10
02/13/2022,Northern,2,CAH,1,24,45,24,21,0,0,0,8,0,8,6,0,6,81,45,24,21,0,0,0,36,0,36,6,0,6
02/13/2022,Southeast,5,CAH,1,13,58,33,25,5,3,2,17,0,17,3,0,3,58,58,33,25,5,3,2,33,0,33,3,0,3
02/13/2022,Southeast,5,GACH,1,,57,39,18,9,3,6,,,,3,0,3,57,57,39,18,9,3,6,20,0,20,3,0,3
02/13/2022,Southwest,1,CAH,1,22,12,3,9,0,0,0,4,0,4,0,0,0,22,12,3,9,0,0,0,4,0,4,0,0,0
02/13/2022,Southwest,1,GACH,1,,36,15,21,0,0,0,,,,4,0,4,35,36,15,21,0,0,0,8,0,8,4,0,4
02/14/2022,Anchorage,7,GACH,1,539,703,617,86,127,112,15,162,21,141,64,1,65,741,703,617,86,127,112,15,226,37,189,64,1,65
02/14/2022,Anchorage,7,LTACH,0,,47,42,5,9,9,0,,,,0,0,0,42,47,42,5,9,9,0,24,10,14,0,0,0
02/14/2022,Anchorage,7,Psych,0,,,,,,,,,,,,,,140,207,131,76,0,0,0,0,0,0,8,0,8
02/14/2022,Gulf Coast,4,CAH,1,35,70,26,44,4,1,3,12,0,12,1,0,1,79,70,26,44,4,1,3,24,0,24,1,0,1
02/14/2022,Gulf Coast,4,GACH,1,,54,31,23,9,4,5,,,,2,0,2,93,54,31,23,9,4,5,22,0,22,2,0,2
02/14/2022,Interior,6,GACH,1,,101,78,23,13,7,6,,,,5,0,5,101,101,78,23,13,7,6,15,1,14,5,0,5
02/14/2022,Matanuska-Susitna,3,GACH,1,,160,95,65,14,13,1,,,,7,0,7,184,160,95,65,14,13,1,33,3,30,7,0,7
02/14/2022,Northern,2,CAH,1,24,45,26,19,0,0,0,8,0,8,7,0,7,81,45,26,19,0,0,0,36,0,36,7,0,7
02/14/2022,Southeast,5,CAH,1,12,57,31,26,4,2,2,17,0,17,2,0,2,57,57,31,26,4,2,2,33,0,33,2,0,2
02/14/2022,Southeast,5,GACH,1,,57,38,19,9,3,6,,,,3,0,3,57,57,38,19,9,3,6,20,0,20,3,0,3
02/14/2022,Southwest,1,CAH,1,22,12,4,8,0,0,0,4,0,4,0,0,0,22,12,4,8,0,0,0,4,0,4,0,0,0
02/14/2022,Southwest,1,GACH,1,,36,12,24,0,0,0,,,,5,0,5,35,36,12,24,0,0,0,8,0,8,5,0,5
02/15/2022,Anchorage,7,GACH,1,551,715,631,84,128,113,15,162,16,146,58,1,59,753,715,631,84,128,113,15,226,32,194,58,1,59
02/15/2022,Anchorage,7,LTACH,0,,47,42,5,9,9,0,,,,0,0,0,42,47,42,5,9,9,0,24,10,14,0,0,0
02/15/2022,Anchorage,7,Psych,0,,,,,,,,,,,,,,140,207,131,76,0,0,0,0,0,0,8,0,8
02/15/2022,Gulf Coast,4,CAH,1,34,69,27,42,4,1,3,12,0,12,1,0,1,78,69,27,42,4,1,3,24,0,24,1,0,1
02/15/2022,Gulf Coast,4,GACH,1,,54,40,14,9,6,3,,,,3,0,3,93,54,40,14,9,6,3,22,0,22,3,0,3
02/15/2022,Interior,6,GACH,1,,101,70,31,13,5,8,,,,5,0,5,101,101,70,31,13,5,8,15,1,14,5,0,5
02/15/2022,Matanuska-Susitna,3,GACH,1,,160,88,72,14,12,2,,,,9,0,9,184,160,88,72,14,12,2,33,3,30,9,0,9
02/15/2022,Northern,2,CAH,1,24,45,28,17,0,0,0,8,0,8,8,0,8,81,45,28,17,0,0,0,36,0,36,8,0,8
02/15/2022,Southeast,5,CAH,1,12,57,30,27,4,2,2,17,0,17,1,0,1,57,57,30,27,4,2,2,33,0,33,1,0,1
02/15/2022,Southeast,5,GACH,1,,57,51,6,9,4,5,,,,4,0,4,57,57,51,6,9,4,5,20,0,20,4,0,4
02/15/2022,Southwest,1,CAH,1,22,12,4,8,0,0,0,4,0,4,0,0,0,22,12,4,8,0,0,0,4,0,4,0,0,0
02/15/2022,Southwest,1,GACH,1,,36,13,23,0,0,0,,,,3,0,3,35,36,13,23,0,0,0,8,0,8,3,0,3
02/16/2022,Anchorage,7,GACH,1,537,710,639,71,127,109,18,162,15,147,56,1,57,739,710,639,71,127,109,18,226,31,195,56,1,57
02/16/2022,Anchorage,7,LTACH,0,,47,40,7,9,9,0,,,,0,0,0,42,47,40,7,9,9,0,24,10,14,0,0,0
02/16/2022,Anchorage,7,Psych,0,140,201,132,69,0,0,0,0,0,0,11,0,11,140,201,132,69,0,0,0,0,0,0,11,0,11
02/16/2022,Gulf Coast,4,CAH,1,34,69,19,50,4,0,4,12,0,12,1,0,1,78,69,19,50,4,0,4,24,0,24,1,0,1
02/16/2022,Gulf Coast,4,GACH,1,,54,47,7,9,5,4,,,,7,0,7,93,54,47,7,9,5,4,22,0,22,7,0,7
02/16/2022,Interior,6,GACH,1,,101,79,22,13,10,3,,,,8,1,9,101,101,79,22,13,10,3,15,1,14,8,1,9
02/16/2022,Matanuska-Susitna,3,GACH,1,,160,90,70,14,13,1,,,,11,0,11,184,160,90,70,14,13,1,33,3,30,11,0,11
02/16/2022,Northern,2,CAH,1,24,45,30,15,0,0,0,8,0,8,6,0,6,81,45,30,15,0,0,0,36,0,36,6,0,6
02/16/2022,Southeast,5,CAH,1,18,63,39,24,7,5,2,17,0,17,1,0,1,63,63,39,24,7,5,2,33,0,33,1,0,1
02/16/2022,Southeast,5,GACH,1,,57,42,15,9,6,3,,,,4,0,4,57,57,42,15,9,6,3,20,0,20,4,0,4
02/16/2022,Southwest,1,CAH,1,22,12,3,9,0,0,0,4,0,4,0,0,0,22,12,3,9,0,0,0,4,0,4,0,0,0
02/16/2022,Southwest,1,GACH,1,,36,18,18,0,0,0,,,,5,0,5,35,36,18,18,0,0,0,8,0,8,5,0,5
02/17/2022,Anchorage,7,GACH,1,520,685,621,64,128,109,19,162,16,146,50,0,50,722,685,621,64,128,109,19,226,32,194,50,0,50
02/17/2022,Anchorage,7,LTACH,0,,47,39,8,9,9,0,,,,0,0,0,42,47,39,8,9,9,0,24,10,14,0,0,0
02/17/2022,Anchorage,7,Psych,0,,,,,,,,,,,,,,140,201,132,69,0,0,0,0,0,0,11,0,11
02/17/2022,Gulf Coast,4,CAH,1,34,69,19,50,4,0,4,12,0,12,1,0,1,78,69,19,50,4,0,4,24,0,24,1,0,1
02/17/2022,Gulf Coast,4,GACH,1,,54,50,4,9,9,0,,,,7,0,7,93,54,50,4,9,9,0,22,0,22,7,0,7
02/17/2022,Interior,6,GACH,1,,101,79,22,13,6,7,,,,7,1,8,101,101,79,22,13,6,7,15,1,14,7,1,8
02/17/2022,Matanuska-Susitna,3,GACH,1,,160,96,64,14,13,1,,,,14,0,14,184,160,96,64,14,13,1,33,3,30,14,0,14
02/17/2022,Northern,2,CAH,1,24,45,32,13,0,0,0,8,0,8,3,0,3,81,45,32,13,0,0,0,36,0,36,3,0,3
02/17/2022,Southeast,5,CAH,1,12,57,31,26,2,0,2,17,0,17,1,0,1,57,57,31,26,2,0,2,33,0,33,1,0,1
02/17/2022,Southeast,5,GACH,1,,57,42,15,9,6,3,,,,2,0,2,57,57,42,15,9,6,3,20,0,20,2,0,2
02/17/2022,Southwest,1,CAH,1,22,12,3,9,0,0,0,4,0,4,0,0,0,22,12,3,9,0,0,0,4,0,4,0,0,0
02/17/2022,Southwest,1,GACH,1,,36,19,17,0,0,0,,,,5,0,5,35,36,19,17,0,0,0,8,0,8,5,0,5
02/18/2022,Anchorage,7,GACH,1,530,689,626,63,128,110,18,162,20,142,51,1,52,732,689,626,63,128,110,18,226,36,190,51,1,52
02/18/2022,Anchorage,7,LTACH,0,,47,39,8,9,9,0,,,,0,0,0,42,47,39,8,9,9,0,24,10,14,0,0,0
02/18/2022,Anchorage,7,Psych,0,,,,,,,,,,,,,,140,201,132,69,0,0,0,0,0,0,11,0,11
02/18/2022,Gulf Coast,4,CAH,1,34,69,22,47,4,0,4,12,0,12,1,0,1,78,69,22,47,4,0,4,24,0,24,1,0,1
02/18/2022,Gulf Coast,4,GACH,1,,54,46,8,9,7,2,,,,13,0,13,93,54,46,8,9,7,2,22,0,22,13,0,13
02/18/2022,Interior,6,GACH,1,,101,73,28,13,4,9,,,,5,0,5,101,101,73,28,13,4,9,15,1,14,5,0,5
02/18/2022,Matanuska-Susitna,3,GACH,1,,160,93,67,14,9,5,,,,14,0,14,184,160,93,67,14,9,5,33,3,30,14,0,14
02/18/2022,Northern,2,CAH,1,24,45,27,18,0,0,0,8,0,8,3,0,3,81,45,27,18,0,0,0,36,0,36,3,0,3
02/18/2022,Southeast,5,CAH,1,9,54,26,28,3,1,2,17,0,17,2,0,2,54,54,26,28,3,1,2,33,0,33,2,0,2
02/18/2022,Southeast,5,GACH,1,,57,49,8,9,5,4,,,,2,0,2,57,57,49,8,9,5,4,20,0,20,2,0,2
02/18/2022,Southwest,1,CAH,1,22,12,3,9,0,0,0,4,0,4,0,0,0,22,12,3,9,0,0,0,4,0,4,0,0,0
02/18/2022,Southwest,1,GACH,1,,36,21,15,0,0,0,,,,5,0,5,35,36,21,15,0,0,0,8,0,8,5,0,5
02/19/2022,Anchorage,7,GACH,1,535,700,627,73,122,107,15,162,22,140,48,1,49,737,700,627,73,122,107,15,226,38,188,48,1,49
02/19/2022,Anchorage,7,LTACH,0,,47,40,7,9,9,0,,,,1,0,1,42,47,40,7,9,9,0,24,10,14,1,0,1
02/19/2022,Anchorage,7,Psych,0,,,,,,,,,,,,,,140,201,132,69,0,0,0,0,0,0,11,0,11
02/19/2022,Gulf Coast,4,CAH,1,34,69,25,44,4,0,4,12,0,12,0,0,0,78,69,25,44,4,0,4,24,0,24,0,0,0
02/19/2022,Gulf Coast,4,GACH,1,,54,45,9,9,6,3,,,,13,0,13,93,54,45,9,9,6,3,22,0,22,13,0,13
02/19/2022,Interior,6,GACH,1,,101,74,27,13,8,5,,,,3,0,3,101,101,74,27,13,8,5,15,1,14,3,0,3
02/19/2022,Matanuska-Susitna,3,GACH,1,,160,89,71,14,7,7,,,,13,0,13,184,160,89,71,14,7,7,33,3,30,13,0,13
02/19/2022,Northern,2,CAH,1,24,45,22,23,0,0,0,8,0,8,2,0,2,81,45,22,23,0,0,0,36,0,36,2,0,2
02/19/2022,Southeast,5,CAH,1,9,54,26,28,3,1,2,17,0,17,2,0,2,54,54,26,28,3,1,2,33,0,33,2,0,2
02/19/2022,Southeast,5,GACH,1,,57,51,6,9,5,4,,,,2,0,2,57,57,51,6,9,5,4,20,0,20,2,0,2
02/19/2022,Southwest,1,CAH,1,22,12,2,10,0,0,0,4,0,4,0,0,0,22,12,2,10,0,0,0,4,0,4,0,0,0
02/19/2022,Southwest,1,GACH,1,,36,22,14,0,0,0,,,,4,0,4,35,36,22,14,0,0,0,8,0,8,4,0,4
02/20/2022,Anchorage,7,GACH,1,538,700,615,85,122,104,18,162,21,141,45,1,46,740,700,615,85,122,104,18,226,37,189,45,1,46
02/20/2022,Anchorage,7,LTACH,0,,47,39,8,9,9,0,,,,1,0,1,42,47,39,8,9,9,0,24,10,14,1,0,1
02/20/2022,Anchorage,7,Psych,0,,,,,,,,,,,,,,140,201,132,69,0,0,0,0,0,0,11,0,11
02/20/2022,Gulf Coast,4,CAH,1,34,69,21,48,4,1,3,12,0,12,1,0,1,78,69,21,48,4,1,3,24,0,24,1,0,1
02/20/2022,Gulf Coast,4,GACH,1,,54,41,13,9,6,3,,,,13,0,13,93,54,41,13,9,6,3,22,0,22,13,0,13
02/20/2022,Interior,6,GACH,1,,101,69,32,13,3,10,,,,4,0,4,101,101,69,32,13,3,10,15,1,14,4,0,4
02/20/2022,Matanuska-Susitna,3,GACH,1,,160,84,76,14,12,2,,,,14,0,14,184,160,84,76,14,12,2,33,3,30,14,0,14
02/20/2022,Northern,2,CAH,1,24,45,17,28,0,0,0,8,0,8,2,0,2,81,45,17,28,0,0,0,36,0,36,2,0,2
02/20/2022,Southeast,5,CAH,1,9,54,29,25,3,1,2,17,0,17,2,0,2,54,54,29,25,3,1,2,33,0,33,2,0,2
02/20/2022,Southeast,5,GACH,1,,57,50,7,9,5,4,,,,2,0,2,57,57,50,7,9,5,4,20,0,20,2,0,2
02/20/2022,Southwest,1,CAH,1,22,12,3,9,0,0,0,4,0,4,0,0,0,22,12,3,9,0,0,0,4,0,4,0,0,0
02/20/2022,Southwest,1,GACH,1,,36,24,12,0,0,0,,,,4,0,4,35,36,24,12,0,0,0,8,0,8,4,0,4
02/21/2022,Anchorage,7,GACH,1,879,1043,618,425,120,99,21,162,29,133,58,0,58,1081,1043,618,425,120,99,21,226,45,181,58,0,58
02/21/2022,Anchorage,7,LTACH,0,,47,40,7,9,9,0,,,,1,0,1,42,47,40,7,9,9,0,24,10,14,1,0,1
02/21/2022,Anchorage,7,Psych,0,,,,,,,,,,,,,,140,201,132,69,0,0,0,0,0,0,11,0,11
02/21/2022,Gulf Coast,4,CAH,1,34,69,23,46,4,1,3,12,0,12,1,0,1,78,69,23,46,4,1,3,24,0,24,1,0,1
02/21/2022,Gulf Coast,4,GACH,1,,54,40,14,9,6,3,,,,12,0,12,93,54,40,14,9,6,3,22,0,22,12,0,12
02/21/2022,Interior,6,GACH,1,,101,71,30,13,8,5,,,,4,0,4,101,101,71,30,13,8,5,15,1,14,4,0,4
02/21/2022,Matanuska-Susitna,3,GACH,1,,160,83,77,14,10,4,,,,9,0,9,184,160,83,77,14,10,4,33,3,30,9,0,9
02/21/2022,Northern,2,CAH,1,24,45,18,27,0,0,0,8,0,8,0,0,0,81,45,18,27,0,0,0,36,0,36,0,0,0
02/21/2022,Southeast,5,CAH,1,17,62,37,25,5,3,2,17,0,17,5,0,5,62,62,37,25,5,3,2,33,0,33,5,0,5
02/21/2022,Southeast,5,GACH,1,,57,49,8,9,4,5,,,,2,0,2,57,57,49,8,9,4,5,20,0,20,2,0,2
02/21/2022,Southwest,1,CAH,1,22,12,3,9,0,0,0,4,0,4,0,0,0,22,12,3,9,0,0,0,4,0,4,0,0,0
02/21/2022,Southwest,1,GACH,1,,36,23,13,0,0,0,,,,5,0,5,35,36,23,13,0,0,0,8,0,8,5,0,5
02/22/2022,Anchorage,7,GACH,1,909,704,645,59,124,105,19,162,15,147,58,1,59,1111,704,645,59,124,105,19,226,31,195,58,1,59
02/22/2022,Anchorage,7,LTACH,0,,47,39,8,9,9,0,,,,1,0,1,42,47,39,8,9,9,0,24,10,14,1,0,1
02/22/2022,Anchorage,7,Psych,0,,,,,,,,,,,,,,140,201,132,69,0,0,0,0,0,0,11,0,11
02/22/2022,Gulf Coast,4,CAH,1,34,69,26,43,4,1,3,12,0,12,2,0,2,78,69,26,43,4,1,3,24,0,24,2,0,2
02/22/2022,Gulf Coast,4,GACH,1,,54,43,11,9,7,2,,,,13,0,13,93,54,43,11,9,7,2,22,0,22,13,0,13
02/22/2022,Interior,6,GACH,1,,101,63,38,13,10,3,,,,2,0,2,101,101,63,38,13,10,3,15,1,14,2,0,2
02/22/2022,Matanuska-Susitna,3,GACH,1,,160,81,79,14,8,6,,,,9,0,9,184,160,81,79,14,8,6,33,3,30,9,0,9
02/22/2022,Northern,2,CAH,1,24,45,23,22,0,0,0,8,0,8,0,0,0,81,45,23,22,0,0,0,36,0,36,0,0,0
02/22/2022,Southeast,5,CAH,1,11,56,28,28,5,3,2,17,0,17,3,0,3,56,56,28,28,5,3,2,33,0,33,3,0,3
02/22/2022,Southeast,5,GACH,1,,57,48,9,9,4,5,,,,2,0,2,57,57,48,9,9,4,5,20,0,20,2,0,2
02/22/2022,Southwest,1,CAH,1,22,12,2,10,0,0,0,4,0,4,0,0,0,22,12,2,10,0,0,0,4,0,4,0,0,0
02/22/2022,Southwest,1,GACH,1,,36,19,17,0,0,0,,,,3,0,3,35,36,19,17,0,0,0,8,0,8,3,0,3
02/23/2022,Anchorage,7,GACH,1,909,1079,1021,58,206,196,10,162,35,127,54,1,55,1111,1079,1021,58,206,196,10,226,51,175,54,1,55
02/23/2022,Anchorage,7,LTACH,0,,47,39,8,9,9,0,,,,1,0,1,42,47,39,8,9,9,0,24,10,14,1,0,1
02/23/2022,Anchorage,7,Psych,0,140,201,129,72,0,0,0,0,0,0,14,0,14,140,201,129,72,0,0,0,0,0,0,14,0,14
02/23/2022,Gulf Coast,4,CAH,1,34,69,26,43,4,0,4,12,0,12,1,0,1,78,69,26,43,4,0,4,24,0,24,1,0,1
02/23/2022,Gulf Coast,4,GACH,1,,54,48,6,9,9,0,,,,11,0,11,93,54,48,6,9,9,0,22,0,22,11,0,11
02/23/2022,Interior,6,GACH,1,,101,62,39,13,9,4,,,,3,0,3,101,101,62,39,13,9,4,15,1,14,3,0,3
02/23/2022,Matanuska-Susitna,3,GACH,1,,160,79,81,14,10,4,,,,9,0,9,184,160,79,81,14,10,4,33,3,30,9,0,9
02/23/2022,Northern,2,CAH,1,24,45,26,19,0,0,0,8,0,8,0,0,0,81,45,26,19,0,0,0,36,0,36,0,0,0
02/23/2022,Southeast,5,CAH,1,12,57,28,29,2,0,2,17,0,17,2,0,2,57,57,28,29,2,0,2,33,0,33,2,0,2
02/23/2022,Southeast,5,GACH,1,,57,45,12,9,3,6,,,,0,0,0,57,57,45,12,9,3,6,20,0,20,0,0,0
02/23/2022,Southwest,1,CAH,1,22,12,2,10,0,0,0,4,0,4,0,0,0,22,12,2,10,0,0,0,4,0,4,0,0,0
02/23/2022,Southwest,1,GACH,1,,36,16,20,0,0,0,,,,2,0,2,35,36,16,20,0,0,0,8,0,8,2,0,2
02/24/2022,Anchorage,7,GACH,1,891,1057,981,76,199,186,13,162,32,130,48,1,49,1093,1057,981,76,199,186,13,226,48,178,48,1,49
02/24/2022,Anchorage,7,LTACH,0,,47,39,8,9,9,0,,,,1,0,1,42,47,39,8,9,9,0,24,10,14,1,0,1
02/24/2022,Anchorage,7,Psych,0,,,,,,,,,,,,,,140,201,129,72,0,0,0,0,0,0,14,0,14
02/24/2022,Gulf Coast,4,CAH,1,34,69,20,49,4,0,4,12,0,12,1,0,1,78,69,20,49,4,0,4,24,0,24,1,0,1
02/24/2022,Gulf Coast,4,GACH,1,,54,50,4,9,9,0,,,,9,0,9,93,54,50,4,9,9,0,22,0,22,9,0,9
02/24/2022,Interior,6,GACH,1,,101,79,22,13,9,4,,,,4,0,4,101,101,79,22,13,9,4,15,1,14,4,0,4
02/24/2022,Matanuska-Susitna,3,GACH,1,,160,88,72,14,11,3,,,,11,0,11,184,160,88,72,14,11,3,33,3,30,11,0,11
02/24/2022,Northern,2,CAH,1,24,45,23,22,0,0,0,8,0,8,0,0,0,81,45,23,22,0,0,0,36,0,36,0,0,0
02/24/2022,Southeast,5,CAH,1,12,57,29,28,2,0,2,17,0,17,3,0,3,57,57,29,28,2,0,2,33,0,33,3,0,3
02/24/2022,Southeast,5,GACH,1,,57,44,13,9,3,6,,,,0,0,0,57,57,44,13,9,3,6,20,0,20,0,0,0
02/24/2022,Southwest,1,CAH,1,22,12,6,6,0,0,0,4,0,4,0,0,0,22,12,6,6,0,0,0,4,0,4,0,0,0
02/24/2022,Southwest,1,GACH,1,,36,18,18,0,0,0,,,,2,0,2,35,36,18,18,0,0,0,8,0,8,2,0,2
02/25/2022,Anchorage,7,GACH,1,871,997,939,58,190,179,11,156,34,122,45,0,45,1073,997,939,58,190,179,11,220,50,170,45,0,45
02/25/2022,Anchorage,7,LTACH,0,,47,39,8,9,9,0,,,,0,0,0,42,47,39,8,9,9,0,24,10,14,0,0,0
02/25/2022,Anchorage,7,Psych,0,,,,,,,,,,,,,,140,201,129,72,0,0,0,0,0,0,14,0,14
02/25/2022,Gulf Coast,4,CAH,1,34,69,26,43,4,1,3,12,0,12,1,0,1,78,69,26,43,4,1,3,24,0,24,1,0,1
02/25/2022,Gulf Coast,4,GACH,1,,54,40,14,9,7,2,,,,9,0,9,93,54,40,14,9,7,2,22,0,22,9,0,9
02/25/2022,Interior,6,GACH,1,,101,65,36,13,10,3,,,,4,0,4,101,101,65,36,13,10,3,15,1,14,4,0,4
02/25/2022,Matanuska-Susitna,3,GACH,1,,160,85,75,14,5,9,,,,9,0,9,184,160,85,75,14,5,9,33,3,30,9,0,9
02/25/2022,Northern,2,CAH,1,24,45,27,18,0,0,0,8,0,8,0,0,0,81,45,27,18,0,0,0,36,0,36,0,0,0
02/25/2022,Southeast,5,CAH,1,13,58,32,26,2,0,2,17,0,17,2,0,2,58,58,32,26,2,0,2,33,0,33,2,0,2
02/25/2022,Southeast,5,GACH,1,,57,31,26,9,2,7,,,,0,0,0,57,57,31,26,9,2,7,20,0,20,0,0,0
02/25/2022,Southwest,1,CAH,1,22,12,9,3,0,0,0,4,0,4,0,0,0,22,12,9,3,0,0,0,4,0,4,0,0,0
02/25/2022,Southwest,1,GACH,1,,36,17,19,0,0,0,,,,2,0,2,35,36,17,19,0,0,0,8,0,8,2,0,2
02/26/2022,Anchorage,7,GACH,1,853,1012,936,76,186,177,9,156,34,122,40,1,41,1055,1012,936,76,186,177,9,220,50,170,40,1,41
02/26/2022,Anchorage,7,LTACH,0,,47,39,8,9,9,0,,,,0,0,0,42,47,39,8,9,9,0,24,10,14,0,0,0
02/26/2022,Anchorage,7,Psych,0,,,,,,,,,,,,,,140,201,129,72,0,0,0,0,0,0,14,0,14
02/26/2022,Gulf Coast,4,CAH,1,34,69,24,45,4,0,4,12,0,12,1,0,1,78,69,24,45,4,0,4,24,0,24,1,0,1
02/26/2022,Gulf Coast,4,GACH,1,,54,40,14,9,7,2,,,,8,0,8,93,54,40,14,9,7,2,22,0,22,8,0,8
02/26/2022,Interior,6,GACH,1,,101,74,27,13,11,2,,,,5,0,5,101,101,74,27,13,11,2,15,1,14,5,0,5
02/26/2022,Matanuska-Susitna,3,GACH,1,,160,70,90,14,3,11,,,,8,0,8,184,160,70,90,14,3,11,33,3,30,8,0,8
02/26/2022,Northern,2,CAH,1,24,45,21,24,0,0,0,8,0,8,0,0,0,81,45,21,24,0,0,0,36,0,36,0,0,0
02/26/2022,Southeast,5,CAH,1,13,58,29,29,2,0,2,17,0,17,2,0,2,58,58,29,29,2,0,2,33,0,33,2,0,2
02/26/2022,Southeast,5,GACH,1,,57,34,23,9,1,8,,,,0,0,0,57,57,34,23,9,1,8,20,0,20,0,0,0
02/26/2022,Southwest,1,CAH,1,22,12,6,6,0,0,0,4,0,4,0,0,0,22,12,6,6,0,0,0,4,0,4,0,0,0
02/26/2022,Southwest,1,GACH,1,,36,17,19,0,0,0,,,,2,0,2,35,36,17,19,0,0,0,8,0,8,2,0,2
02/27/2022,Anchorage,7,GACH,1,861,1022,928,94,189,176,13,156,29,127,39,0,39,1063,1022,928,94,189,176,13,220,45,175,39,0,39
02/27/2022,Anchorage,7,LTACH,0,,47,38,9,9,9,0,,,,0,0,0,42,47,38,9,9,9,0,24,10,14,0,0,0
02/27/2022,Anchorage,7,Psych,0,,,,,,,,,,,,,,140,201,129,72,0,0,0,0,0,0,14,0,14
02/27/2022,Gulf Coast,4,CAH,1,34,69,23,46,4,0,4,12,0,12,1,0,1,78,69,23,46,4,0,4,24,0,24,1,0,1
02/27/2022,Gulf Coast,4,GACH,1,,54,44,10,9,7,2,,,,9,0,9,93,54,44,10,9,7,2,22,0,22,9,0,9
02/27/2022,Interior,6,GACH,1,,101,61,40,13,10,3,,,,4,0,4,101,101,61,40,13,10,3,15,1,14,4,0,4
02/27/2022,Matanuska-Susitna,3,GACH,1,,160,62,98,14,6,8,,,,9,0,9,184,160,62,98,14,6,8,33,3,30,9,0,9
02/27/2022,Northern,2,CAH,1,24,45,22,23,0,0,0,8,0,8,4,0,4,81,45,22,23,0,0,0,36,0,36,4,0,4
02/27/2022,Southeast,5,CAH,1,13,58,29,29,2,0,2,17,0,17,3,0,3,58,58,29,29,2,0,2,33,0,33,3,0,3
02/27/2022,Southeast,5,GACH,1,,57,34,23,9,2,7,,,,0,0,0,57,57,34,23,9,2,7,20,0,20,0,0,0
02/27/2022,Southwest,1,CAH,1,22,12,6,6,0,0,0,4,0,4,0,0,0,22,12,6,6,0,0,0,4,0,4,0,0,0
02/27/2022,Southwest,1,GACH,1,,36,16,20,0,0,0,,,,2,0,2,35,36,16,20,0,0,0,8,0,8,2,0,2
02/28/2022,Anchorage,7,GACH,1,873,1036,950,86,190,176,14,156,26,130,39,1,40,1075,1036,950,86,190,176,14,220,42,178,39,1,40
02/28/2022,Anchorage,7,LTACH,0,,47,38,9,9,9,0,,,,0,0,0,42,47,38,9,9,9,0,24,10,14,0,0,0
02/28/2022,Anchorage,7,Psych,0,,,,,,,,,,,,,,140,201,129,72,0,0,0,0,0,0,14,0,14
02/28/2022,Gulf Coast,4,CAH,1,34,69,23,46,4,2,2,12,0,12,1,0,1,78,69,23,46,4,2,2,24,0,24,1,0,1
02/28/2022,Gulf Coast,4,GACH,1,,54,41,13,9,8,1,,,,9,0,9,93,54,41,13,9,8,1,22,0,22,9,0,9
02/28/2022,Interior,6,GACH,1,,101,69,32,13,7,6,,,,4,0,4,101,101,69,32,13,7,6,15,1,14,4,0,4
02/28/2022,Matanuska-Susitna,3,GACH,1,,160,67,93,14,4,10,,,,5,0,5,184,160,67,93,14,4,10,33,3,30,5,0,5
02/28/2022,Northern,2,CAH,1,24,45,24,21,0,0,0,8,0,8,4,0,4,81,45,24,21,0,0,0,36,0,36,4,0,4
02/28/2022,Southeast,5,CAH,1,13,58,28,30,2,1,1,17,0,17,3,0,3,58,58,28,30,2,1,1,33,0,33,3,0,3
02/28/2022,Southeast,5,GACH,1,,57,27,30,9,3,6,,,,0,0,0,57,57,27,30,9,3,6,20,0,20,0,0,0
02/28/2022,Southwest,1,CAH,1,22,12,5,7,0,0,0,4,0,4,0,0,0,22,12,5,7,0,0,0,4,0,4,0,0,0
02/28/2022,Southwest,1,GACH,1,,36,14,22,0,0,0,,,,2,0,2,35,36,14,22,0,0,0,8,0,8,2,0,2
03/01/2022,Anchorage,7,GACH,1,899,1064,979,85,185,168,17,156,28,128,33,1,34,1101,1064,979,85,185,168,17,220,44,176,33,1,34
03/01/2022,Anchorage,7,LTACH,0,,47,40,7,9,9,0,,,,0,0,0,42,47,40,7,9,9,0,24,10,14,0,0,0
03/01/2022,Anchorage,7,Psych,0,,,,,,,,,,,,,,140,201,129,72,0,0,0,0,0,0,14,0,14
03/01/2022,Gulf Coast,4,CAH,1,34,69,22,47,4,3,1,12,0,12,2,0,2,78,69,22,47,4,3,1,24,0,24,2,0,2
03/01/2022,Gulf Coast,4,GACH,1,,54,52,2,9,8,1,,,,9,0,9,93,54,52,2,9,8,1,22,0,22,9,0,9
03/01/2022,Interior,6,GACH,1,,101,75,26,13,8,5,,,,2,0,2,101,101,75,26,13,8,5,15,1,14,2,0,2
03/01/2022,Matanuska-Susitna,3,GACH,1,,160,83,77,14,12,2,,,,4,0,4,184,160,83,77,14,12,2,33,3,30,4,0,4
03/01/2022,Northern,2,CAH,1,24,45,27,18,0,0,0,8,0,8,4,0,4,81,45,27,18,0,0,0,36,0,36,4,0,4
03/01/2022,Southeast,5,CAH,1,13,58,28,30,2,0,2,17,0,17,2,0,2,58,58,28,30,2,0,2,33,0,33,2,0,2
03/01/2022,Southeast,5,GACH,1,,57,38,19,9,3,6,,,,0,0,0,57,57,38,19,9,3,6,20,0,20,0,0,0
03/01/2022,Southwest,1,CAH,1,22,12,7,5,0,0,0,4,0,4,0,0,0,22,12,7,5,0,0,0,4,0,4,0,0,0
03/01/2022,Southwest,1,GACH,1,,36,12,24,0,0,0,,,,2,0,2,35,36,12,24,0,0,0,8,0,8,2,0,2
03/02/2022,Anchorage,7,GACH,1,893,1057,986,71,181,163,18,156,21,135,39,1,40,1095,1057,986,71,181,163,18,220,37,183,39,1,40
03/02/2022,Anchorage,7,LTACH,0,,47,40,7,9,9,0,,,,0,0,0,42,47,40,7,9,9,0,24,10,14,0,0,0
03/02/2022,Anchorage,7,Psych,0,200,201,172,29,0,0,0,0,0,0,13,1,14,200,201,172,29,0,0,0,0,0,0,13,1,14
03/02/2022,Gulf Coast,4,CAH,1,34,69,31,38,4,2,2,12,0,12,2,0,2,78,69,31,38,4,2,2,24,0,24,2,0,2
03/02/2022,Gulf Coast,4,GACH,1,,55,55,0,9,8,1,,,,10,0,10,93,55,55,0,9,8,1,22,0,22,10,0,10
03/02/2022,Interior,6,GACH,1,,101,65,36,13,6,7,,,,0,0,0,101,101,65,36,13,6,7,15,1,14,0,0,0
03/02/2022,Matanuska-Susitna,3,GACH,1,,160,68,92,14,10,4,,,,3,0,3,184,160,68,92,14,10,4,33,3,30,3,0,3
03/02/2022,Northern,2,CAH,1,24,45,28,17,0,0,0,8,0,8,3,0,3,81,45,28,17,0,0,0,36,0,36,3,0,3
03/02/2022,Southeast,5,CAH,1,13,58,32,26,2,0,2,17,0,17,1,0,1,58,58,32,26,2,0,2,33,0,33,1,0,1
03/02/2022,Southeast,5,GACH,1,,57,37,20,9,3,6,,,,0,0,0,57,57,37,20,9,3,6,20,0,20,0,0,0
03/02/2022,Southwest,1,CAH,1,22,12,5,7,0,0,0,4,0,4,0,0,0,22,12,5,7,0,0,0,4,0,4,0,0,0
03/02/2022,Southwest,1,GACH,1,,36,16,20,0,0,0,,,,0,0,0,35,36,16,20,0,0,0,8,0,8,0,0,0
03/03/2022,Anchorage,7,GACH,1,895,1056,969,87,178,161,17,156,18,138,31,0,31,1097,1056,969,87,178,161,17,220,34,186,31,0,31
03/03/2022,Anchorage,7,LTACH,0,,47,40,7,9,9,0,,,,0,0,0,42,47,40,7,9,9,0,24,10,14,0,0,0
03/03/2022,Anchorage,7,Psych,0,,,,,,,,,,,,,,200,201,172,29,0,0,0,0,0,0,13,1,14
03/03/2022,Gulf Coast,4,CAH,1,37,70,31,39,4,1,3,12,0,12,2,0,2,81,70,31,39,4,1,3,24,0,24,2,0,2
03/03/2022,Gulf Coast,4,GACH,1,,54,51,3,9,9,0,,,,7,0,7,93,54,51,3,9,9,0,22,0,22,7,0,7
03/03/2022,Interior,6,GACH,1,,101,59,42,13,5,8,,,,0,0,0,101,101,59,42,13,5,8,15,1,14,0,0,0
03/03/2022,Matanuska-Susitna,3,GACH,1,,160,59,101,14,6,8,,,,4,0,4,184,160,59,101,14,6,8,33,3,30,4,0,4
03/03/2022,Northern,2,CAH,1,24,45,29,16,0,0,0,8,0,8,3,0,3,81,45,29,16,0,0,0,36,0,36,3,0,3
03/03/2022,Southeast,5,CAH,1,13,58,34,24,2,0,2,17,0,17,2,0,2,58,58,34,24,2,0,2,33,0,33,2,0,2
03/03/2022,Southeast,5,GACH,1,,57,35,22,9,5,4,,,,0,0,0,57,57,35,22,9,5,4,20,0,20,0,0,0
03/03/2022,Southwest,1,CAH,1,22,12,4,8,0,0,0,4,0,4,0,0,0,22,12,4,8,0,0,0,4,0,4,0,0,0
03/03/2022,Southwest,1,GACH,1,,36,19,17,0,0,0,,,,1,0,1,35,36,19,17,0,0,0,8,0,8,1,0,1
03/04/2022,Anchorage,7,GACH,1,849,1009,931,78,174,161,13,156,24,132,29,0,29,1051,1009,931,78,174,161,13,220,40,180,29,0,29
03/04/2022,Anchorage,7,LTACH,0,,47,41,6,9,9,0,,,,0,0,0,42,47,41,6,9,9,0,24,10,14,0,0,0
03/04/2022,Anchorage,7,Psych,0,,,,,,,,,,,,,,200,201,172,29,0,0,0,0,0,0,13,1,14
03/04/2022,Gulf Coast,4,CAH,1,36,70,40,30,4,1,3,12,0,12,2,0,2,80,70,40,30,4,1,3,24,0,24,2,0,2
03/04/2022,Gulf Coast,4,GACH,1,,54,51,3,9,9,0,,,,6,0,6,93,54,51,3,9,9,0,22,0,22,6,0,6
03/04/2022,Interior,6,GACH,1,,101,62,39,13,4,9,,,,1,1,2,101,101,62,39,13,4,9,15,1,14,1,1,2
03/04/2022,Matanuska-Susitna,3,GACH,1,,160,63,97,14,6,8,,,,3,0,3,184,160,63,97,14,6,8,33,3,30,3,0,3
03/04/2022,Northern,2,CAH,1,24,45,28,17,0,0,0,8,0,8,3,0,3,81,45,28,17,0,0,0,36,0,36,3,0,3
03/04/2022,Southeast,5,CAH,1,13,58,33,25,2,0,2,17,0,17,1,0,1,58,58,33,25,2,0,2,33,0,33,1,0,1
03/04/2022,Southeast,5,GACH,1,,57,34,23,9,4,5,,,,0,0,0,57,57,34,23,9,4,5,20,0,20,0,0,0
03/04/2022,Southwest,1,CAH,1,22,12,4,8,0,0,0,4,0,4,0,0,0,22,12,4,8,0,0,0,4,0,4,0,0,0
03/04/2022,Southwest,1,GACH,1,,36,21,15,0,0,0,,,,1,0,1,35,36,21,15,0,0,0,8,0,8,1,0,1
03/05/2022,Anchorage,7,GACH,1,831,989,902,87,171,154,17,156,25,131,37,0,37,1033,989,902,87,171,154,17,220,41,179,37,0,37
03/05/2022,Anchorage,7,LTACH,0,,47,43,4,9,9,0,,,,0,0,0,42,47,43,4,9,9,0,24,10,14,0,0,0
03/05/2022,Anchorage,7,Psych,0,,,,,,,,,,,,,,200,201,172,29,0,0,0,0,0,0,13,1,14
03/05/2022,Gulf Coast,4,CAH,1,36,70,29,41,4,1,3,12,0,12,2,0,2,80,70,29,41,4,1,3,24,0,24,2,0,2
03/05/2022,Gulf Coast,4,GACH,1,,54,46,8,9,8,1,,,,5,0,5,93,54,46,8,9,8,1,22,0,22,5,0,5
03/05/2022,Interior,6,GACH,1,,101,70,31,13,9,4,,,,2,1,3,101,101,70,31,13,9,4,15,1,14,2,1,3
03/05/2022,Matanuska-Susitna,3,GACH,1,,160,72,88,14,8,6,,,,3,0,3,184,160,72,88,14,8,6,33,3,30,3,0,3
03/05/2022,Northern,2,CAH,1,24,45,29,16,0,0,0,8,0,8,4,0,4,81,45,29,16,0,0,0,36,0,36,4,0,4
03/05/2022,Southeast,5,CAH,1,13,58,36,22,2,0,2,17,0,17,1,0,1,58,58,36,22,2,0,2,33,0,33,1,0,1
03/05/2022,Southeast,5,GACH,1,,57,38,19,9,3,6,,,,0,0,0,57,57,38,19,9,3,6,20,0,20,0,0,0
03/05/2022,Southwest,1,CAH,1,22,12,4,8,0,0,0,4,0,4,0,0,0,22,12,4,8,0,0,0,4,0,4,0,0,0
03/05/2022,Southwest,1,GACH,1,,36,23,13,0,0,0,,,,1,0,1,35,36,23,13,0,0,0,8,0,8,1,0,1
03/06/2022,Anchorage,7,GACH,1,815,964,882,82,172,157,15,156,23,133,39,0,39,1017,964,882,82,172,157,15,220,39,181,39,0,39
03/06/2022,Anchorage,7,LTACH,0,,47,43,4,9,9,0,,,,0,0,0,42,47,43,4,9,9,0,24,10,14,0,0,0
03/06/2022,Anchorage,7,Psych,0,,,,,,,,,,,,,,200,201,172,29,0,0,0,0,0,0,13,1,14
03/06/2022,Gulf Coast,4,CAH,1,36,70,27,43,4,1,3,12,0,12,2,0,2,80,70,27,43,4,1,3,24,0,24,2,0,2
03/06/2022,Gulf Coast,4,GACH,1,,54,41,13,9,6,3,,,,2,0,2,93,54,41,13,9,6,3,22,0,22,2,0,2
03/06/2022,Interior,6,GACH,1,,101,72,29,13,5,8,,,,1,1,2,101,101,72,29,13,5,8,15,1,14,1,1,2
03/06/2022,Matanuska-Susitna,3,GACH,1,,160,69,91,14,9,5,,,,3,0,3,184,160,69,91,14,9,5,33,3,30,3,0,3
03/06/2022,Northern,2,CAH,1,24,45,33,12,0,0,0,8,0,8,5,0,5,81,45,33,12,0,0,0,36,0,36,5,0,5
03/06/2022,Southeast,5,CAH,1,13,58,37,21,2,0,2,17,0,17,1,0,1,58,58,37,21,2,0,2,33,0,33,1,0,1
03/06/2022,Southeast,5,GACH,1,,57,36,21,9,5,4,,,,0,0,0,57,57,36,21,9,5,4,20,0,20,0,0,0
03/06/2022,Southwest,1,CAH,1,22,12,3,9,0,0,0,4,0,4,0,0,0,22,12,3,9,0,0,0,4,0,4,0,0,0
03/06/2022,Southwest,1,GACH,1,,36,16,20,0,0,0,,,,1,0,1,35,36,16,20,0,0,0,8,0,8,1,0,1
03/07/2022,Anchorage,7,GACH,1,855,1004,910,94,184,169,15,156,35,121,38,0,38,1057,1004,910,94,184,169,15,220,51,169,38,0,38
03/07/2022,Anchorage,7,LTACH,0,,47,43,4,9,9,0,,,,0,0,0,42,47,43,4,9,9,0,24,10,14,0,0,0
03/07/2022,Anchorage,7,Psych,0,,,,,,,,,,,,,,200,201,172,29,0,0,0,0,0,0,13,1,14
03/07/2022,Gulf Coast,4,CAH,1,35,70,28,42,4,0,4,12,0,12,1,0,1,79,70,28,42,4,0,4,24,0,24,1,0,1
03/07/2022,Gulf Coast,4,GACH,1,,54,47,7,9,6,3,,,,1,0,1,93,54,47,7,9,6,3,22,0,22,1,0,1
03/07/2022,Interior,6,GACH,1,,101,61,40,13,5,8,,,,0,1,1,101,101,61,40,13,5,8,15,1,14,0,1,1
03/07/2022,Matanuska-Susitna,3,GACH,1,,160,68,92,14,8,6,,,,4,0,4,184,160,68,92,14,8,6,33,3,30,4,0,4
03/07/2022,Northern,2,CAH,1,24,45,31,14,0,0,0,8,0,8,4,0,4,81,45,31,14,0,0,0,36,0,36,4,0,4
03/07/2022,Southeast,5,CAH,1,13,58,36,22,2,0,2,17,0,17,1,0,1,58,58,36,22,2,0,2,33,0,33,1,0,1
03/07/2022,Southeast,5,GACH,1,,57,45,12,9,6,3,,,,2,0,2,57,57,45,12,9,6,3,20,0,20,2,0,2
03/07/2022,Southwest,1,CAH,1,22,12,1,11,0,0,0,4,0,4,0,0,0,22,12,1,11,0,0,0,4,0,4,0,0,0
03/07/2022,Southwest,1,GACH,1,,36,17,19,0,0,0,,,,0,0,0,35,36,17,19,0,0,0,8,0,8,0,0,0
03/08/2022,Anchorage,7,GACH,1,881,1032,939,93,188,172,16,156,33,123,36,0,36,1083,1032,939,93,188,172,16,220,49,171,36,0,36
03/08/2022,Anchorage,7,LTACH,0,,47,43,4,9,9,0,,,,0,0,0,42,47,43,4,9,9,0,24,10,14,0,0,0
03/08/2022,Anchorage,7,Psych,0,,,,,,,,,,,,,,200,201,172,29,0,0,0,0,0,0,13,1,14
03/08/2022,Gulf Coast,4,CAH,1,35,70,29,41,4,0,4,12,0,12,0,0,0,79,70,29,41,4,0,4,24,0,24,0,0,0
03/08/2022,Gulf Coast,4,GACH,1,,54,43,11,9,7,2,,,,3,0,3,93,54,43,11,9,7,2,22,0,22,3,0,3
03/08/2022,Interior,6,GACH,1,,101,61,40,13,9,4,,,,0,1,1,101,101,61,40,13,9,4,15,1,14,0,1,1
03/08/2022,Matanuska-Susitna,3,GACH,1,,160,65,95,14,8,6,,,,3,0,3,184,160,65,95,14,8,6,33,3,30,3,0,3
03/08/2022,Northern,2,CAH,1,24,45,27,18,0,0,0,8,0,8,4,0,4,81,45,27,18,0,0,0,36,0,36,4,0,4
03/08/2022,Southeast,5,CAH,1,13,58,37,21,2,0,2,17,0,17,1,0,1,58,58,37,21,2,0,2,33,0,33,1,0,1
03/08/2022,Southeast,5,GACH,1,,57,42,15,9,4,5,,,,1,0,1,57,57,42,15,9,4,5,20,0,20,1,0,1
03/08/2022,Southwest,1,CAH,1,22,12,0,12,0,0,0,4,0,4,0,0,0,22,12,0,12,0,0,0,4,0,4,0,0,0
03/08/2022,Southwest,1,GACH,1,,36,18,18,0,0,0,,,,0,0,0,35,36,18,18,0,0,0,8,0,8,0,0,0
03/09/2022,Anchorage,7,GACH,1,855,999,920,79,180,163,17,156,34,122,33,0,33,1057,999,920,79,180,163,17,220,50,170,33,0,33
03/09/2022,Anchorage,7,LTACH,0,,47,39,8,9,9,0,,,,0,0,0,42,47,39,8,9,9,0,24,10,14,0,0,0
03/09/2022,Anchorage,7,Psych,0,104,201,128,73,0,0,0,0,0,0,13,0,13,104,201,128,73,0,0,0,0,0,0,13,0,13
03/09/2022,Gulf Coast,4,CAH,1,35,70,29,41,4,0,4,12,1,11,0,0,0,79,70,29,41,4,0,4,24,1,23,0,0,0
03/09/2022,Gulf Coast,4,GACH,1,,54,46,8,9,6,3,,,,2,0,2,93,54,46,8,9,6,3,22,0,22,2,0,2
03/09/2022,Interior,6,GACH,1,,101,69,32,13,6,7,,,,3,1,4,101,101,69,32,13,6,7,15,1,14,3,1,4
03/09/2022,Matanuska-Susitna,3,GACH,1,,160,60,100,14,6,8,,,,3,0,3,184,160,60,100,14,6,8,33,3,30,3,0,3
03/09/2022,Northern,2,CAH,1,17,45,26,19,0,0,0,8,0,8,1,0,1,74,45,26,19,0,0,0,36,0,36,1,0,1
03/09/2022,Southeast,5,CAH,1,13,58,42,16,2,0,2,17,0,17,2,0,2,58,58,42,16,2,0,2,33,0,33,2,0,2
03/09/2022,Southeast,5,GACH,1,,57,42,15,9,4,5,,,,1,0,1,57,57,42,15,9,4,5,20,0,20,1,0,1
03/09/2022,Southwest,1,CAH,1,22,12,3,9,0,0,0,4,0,4,0,0,0,22,12,3,9,0,0,0,4,0,4,0,0,0
03/09/2022,Southwest,1,GACH,1,,36,19,17,0,0,0,,,,0,0,0,35,36,19,17,0,0,0,8,0,8,0,0,0
03/10/2022,Anchorage,7,GACH,1,829,986,914,72,185,172,13,156,34,122,33,0,33,1031,986,914,72,185,172,13,220,50,170,33,0,33
03/10/2022,Anchorage,7,LTACH,0,,47,38,9,9,9,0,,,,0,0,0,42,47,38,9,9,9,0,24,10,14,0,0,0
03/10/2022,Anchorage,7,Psych,0,,,,,,,,,,,,,,104,201,128,73,0,0,0,0,0,0,13,0,13
03/10/2022,Gulf Coast,4,CAH,1,35,70,32,38,4,1,3,12,0,12,0,0,0,79,70,32,38,4,1,3,24,0,24,0,0,0
03/10/2022,Gulf Coast,4,GACH,1,,54,47,7,9,7,2,,,,1,0,1,93,54,47,7,9,7,2,22,0,22,1,0,1
03/10/2022,Interior,6,GACH,1,,101,63,38,13,8,5,,,,2,1,3,101,101,63,38,13,8,5,15,1,14,2,1,3
03/10/2022,Matanuska-Susitna,3,GACH,1,,160,59,101,14,5,9,,,,2,0,2,184,160,59,101,14,5,9,33,3,30,2,0,2
03/10/2022,Northern,2,CAH,1,17,45,25,20,0,0,0,8,0,8,1,0,1,74,45,25,20,0,0,0,36,0,36,1,0,1
03/10/2022,Southeast,5,CAH,1,13,58,36,22,2,0,2,17,0,17,1,0,1,58,58,36,22,2,0,2,33,0,33,1,0,1
03/10/2022,Southeast,5,GACH,1,,57,42,15,9,6,3,,,,1,0,1,57,57,42,15,9,6,3,20,0,20,1,0,1
03/10/2022,Southwest,1,CAH,1,22,12,4,8,0,0,0,4,0,4,0,0,0,22,12,4,8,0,0,0,4,0,4,0,0,0
03/10/2022,Southwest,1,GACH,1,,36,17,19,0,0,0,,,,0,0,0,35,36,17,19,0,0,0,8,0,8,0,0,0
03/11/2022,Anchorage,7,GACH,1,823,975,888,87,169,154,15,156,26,130,29,2,31,1025,975,888,87,169,154,15,220,42,178,29,2,31
03/11/2022,Anchorage,7,LTACH,0,,42,36,6,9,8,1,,,,0,0,0,42,42,36,6,9,8,1,24,10,14,0,0,0
03/11/2022,Anchorage,7,Psych,0,,,,,,,,,,,,,,104,201,128,73,0,0,0,0,0,0,13,0,13
03/11/2022,Gulf Coast,4,CAH,1,35,70,26,44,4,1,3,12,0,12,1,0,1,79,70,26,44,4,1,3,24,0,24,1,0,1
03/11/2022,Gulf Coast,4,GACH,1,,54,51,3,9,9,0,,,,2,0,2,93,54,51,3,9,9,0,22,0,22,2,0,2
03/11/2022,Interior,6,GACH,1,,101,66,35,13,6,7,,,,0,1,1,101,101,66,35,13,6,7,15,1,14,0,1,1
03/11/2022,Matanuska-Susitna,3,GACH,1,,160,70,90,14,8,6,,,,3,0,3,184,160,70,90,14,8,6,33,3,30,3,0,3
03/11/2022,Northern,2,CAH,1,17,45,23,22,0,0,0,8,0,8,1,0,1,74,45,23,22,0,0,0,36,0,36,1,0,1
03/11/2022,Southeast,5,CAH,1,13,58,36,22,2,0,2,17,0,17,1,0,1,58,58,36,22,2,0,2,33,0,33,1,0,1
03/11/2022,Southeast,5,GACH,1,,57,42,15,9,6,3,,,,1,0,1,57,57,42,15,9,6,3,20,0,20,1,0,1
03/11/2022,Southwest,1,CAH,1,22,12,4,8,0,0,0,4,0,4,0,0,0,22,12,4,8,0,0,0,4,0,4,0,0,0
03/11/2022,Southwest,1,GACH,1,,36,19,17,0,0,0,,,,0,0,0,35,36,19,17,0,0,0,8,0,8,0,0,0
03/12/2022,Anchorage,7,GACH,1,821,972,876,96,177,157,20,156,21,135,28,2,30,1023,972,876,96,177,157,20,220,37,183,28,2,30
03/12/2022,Anchorage,7,LTACH,0,,42,38,4,9,8,1,,,,0,0,0,42,42,38,4,9,8,1,24,10,14,0,0,0
03/12/2022,Anchorage,7,Psych,0,,,,,,,,,,,,,,104,201,128,73,0,0,0,0,0,0,13,0,13
03/12/2022,Gulf Coast,4,CAH,1,35,70,26,44,4,0,4,12,0,12,1,0,1,79,70,26,44,4,0,4,24,0,24,1,0,1
03/12/2022,Gulf Coast,4,GACH,1,,54,49,5,9,8,1,,,,1,0,1,93,54,49,5,9,8,1,22,0,22,1,0,1
03/12/2022,Interior,6,GACH,1,,101,78,23,13,7,6,,,,1,1,2,101,101,78,23,13,7,6,15,1,14,1,1,2
03/12/2022,Matanuska-Susitna,3,GACH,1,,160,76,84,14,13,1,,,,2,0,2,184,160,76,84,14,13,1,33,3,30,2,0,2
03/12/2022,Northern,2,CAH,1,17,45,15,30,0,0,0,8,0,8,0,0,0,74,45,15,30,0,0,0,36,0,36,0,0,0
03/12/2022,Southeast,5,CAH,1,13,58,34,24,2,0,2,17,0,17,1,0,1,58,58,34,24,2,0,2,33,0,33,1,0,1
03/12/2022,Southeast,5,GACH,1,,57,42,15,9,3,6,,,,1,0,1,57,57,42,15,9,3,6,20,0,20,1,0,1
03/12/2022,Southwest,1,CAH,1,22,12,4,8,0,0,0,4,0,4,0,0,0,22,12,4,8,0,0,0,4,0,4,0,0,0
03/12/2022,Southwest,1,GACH,1,,36,25,11,0,0,0,,,,0,0,0,35,36,25,11,0,0,0,8,0,8,0,0,0
03/13/2022,Anchorage,7,GACH,1,805,964,863,101,177,156,21,156,23,133,27,2,29,1007,964,863,101,177,156,21,220,39,181,27,2,29
03/13/2022,Anchorage,7,LTACH,0,,42,38,4,9,8,1,,,,0,0,0,42,42,38,4,9,8,1,24,10,14,0,0,0
03/13/2022,Anchorage,7,Psych,0,,,,,,,,,,,,,,104,201,128,73,0,0,0,0,0,0,13,0,13
03/13/2022,Gulf Coast,4,CAH,1,35,70,22,48,4,0,4,12,0,12,1,0,1,79,70,22,48,4,0,4,24,0,24,1,0,1
03/13/2022,Gulf Coast,4,GACH,1,,54,39,15,9,5,4,,,,2,0,2,93,54,39,15,9,5,4,22,0,22,2,0,2
03/13/2022,Interior,6,GACH,1,,101,85,16,13,10,3,,,,2,0,2,101,101,85,16,13,10,3,15,1,14,2,0,2
03/13/2022,Matanuska-Susitna,3,GACH,1,,160,75,85,14,9,5,,,,2,0,2,184,160,75,85,14,9,5,33,3,30,2,0,2
03/13/2022,Northern,2,CAH,1,17,45,14,31,0,0,0,8,0,8,0,0,0,74,45,14,31,0,0,0,36,0,36,0,0,0
03/13/2022,Southeast,5,CAH,1,13,58,34,24,2,0,2,17,0,17,1,0,1,58,58,34,24,2,0,2,33,0,33,1,0,1
03/13/2022,Southeast,5,GACH,1,,57,42,15,9,4,5,,,,1,0,1,57,57,42,15,9,4,5,20,0,20,1,0,1
03/13/2022,Southwest,1,CAH,1,22,12,5,7,0,0,0,4,0,4,0,0,0,22,12,5,7,0,0,0,4,0,4,0,0,0
03/13/2022,Southwest,1,GACH,1,,36,24,12,0,0,0,,,,0,0,0,35,36,24,12,0,0,0,8,0,8,0,0,0
03/14/2022,Anchorage,7,GACH,1,811,970,861,109,162,145,17,156,22,134,32,0,32,1013,970,861,109,162,145,17,220,38,182,32,0,32
03/14/2022,Anchorage,7,LTACH,0,,42,38,4,9,8,1,,,,0,0,0,42,42,38,4,9,8,1,24,10,14,0,0,0
03/14/2022,Anchorage,7,Psych,0,,,,,,,,,,,,,,104,201,128,73,0,0,0,0,0,0,13,0,13
03/14/2022,Gulf Coast,4,CAH,1,35,70,24,46,4,0,4,12,0,12,1,0,1,79,70,24,46,4,0,4,24,0,24,1,0,1
03/14/2022,Gulf Coast,4,GACH,1,,54,38,16,9,4,5,,,,3,0,3,93,54,38,16,9,4,5,22,0,22,3,0,3
03/14/2022,Interior,6,GACH,1,,101,82,19,13,6,7,,,,1,1,2,101,101,82,19,13,6,7,15,1,14,1,1,2
03/14/2022,Matanuska-Susitna,3,GACH,1,,160,65,95,14,7,7,,,,2,0,2,184,160,65,95,14,7,7,33,3,30,2,0,2
03/14/2022,Northern,2,CAH,1,17,45,15,30,0,0,0,8,0,8,0,0,0,74,45,15,30,0,0,0,36,0,36,0,0,0
03/14/2022,Southeast,5,CAH,1,13,58,29,29,2,0,2,17,0,17,1,0,1,58,58,29,29,2,0,2,33,0,33,1,0,1
03/14/2022,Southeast,5,GACH,1,,57,42,15,9,2,7,,,,1,0,1,57,57,42,15,9,2,7,20,0,20,1,0,1
03/14/2022,Southwest,1,CAH,1,22,12,5,7,0,0,0,4,0,4,0,0,0,22,12,5,7,0,0,0,4,0,4,0,0,0
03/14/2022,Southwest,1,GACH,1,,36,18,18,0,0,0,,,,0,0,0,35,36,18,18,0,0,0,8,0,8,0,0,0
03/15/2022,Anchorage,7,GACH,1,851,1017,924,93,176,161,15,156,33,123,31,0,31,1053,1017,924,93,176,161,15,220,49,171,31,0,31
03/15/2022,Anchorage,7,LTACH,0,,42,39,3,9,8,1,,,,0,0,0,42,42,39,3,9,8,1,24,10,14,0,0,0
03/15/2022,Anchorage,7,Psych,0,,,,,,,,,,,,,,104,201,128,73,0,0,0,0,0,0,13,0,13
03/15/2022,Gulf Coast,4,CAH,1,35,70,28,42,4,0,4,12,0,12,1,0,1,79,70,28,42,4,0,4,24,0,24,1,0,1
03/15/2022,Gulf Coast,4,GACH,1,,54,42,12,9,3,6,,,,2,0,2,93,54,42,12,9,3,6,22,0,22,2,0,2
03/15/2022,Interior,6,GACH,1,,101,79,22,13,10,3,,,,1,1,2,101,101,79,22,13,10,3,15,1,14,1,1,2
03/15/2022,Matanuska-Susitna,3,GACH,1,,160,61,99,14,7,7,,,,1,0,1,184,160,61,99,14,7,7,33,3,30,1,0,1
03/15/2022,Northern,2,CAH,1,17,45,14,31,0,0,0,8,0,8,0,0,0,74,45,14,31,0,0,0,36,0,36,0,0,0
03/15/2022,Southeast,5,CAH,1,13,58,33,25,2,0,2,17,0,17,1,0,1,58,58,33,25,2,0,2,33,0,33,1,0,1
03/15/2022,Southeast,5,GACH,1,,57,45,12,9,2,7,,,,1,0,1,57,57,45,12,9,2,7,20,0,20,1,0,1
03/15/2022,Southwest,1,CAH,1,22,12,7,5,0,0,0,4,0,4,0,0,0,22,12,7,5,0,0,0,4,0,4,0,0,0
03/15/2022,Southwest,1,GACH,1,,36,22,14,0,0,0,,,,0,0,0,35,36,22,14,0,0,0,8,0,8,0,0,0
03/16/2022,Anchorage,7,GACH,1,891,1056,981,75,182,167,15,156,25,131,30,0,30,1093,1056,981,75,182,167,15,220,41,179,30,0,30
03/16/2022,Anchorage,7,LTACH,0,,42,39,3,9,8,1,,,,0,0,0,42,42,39,3,9,8,1,24,10,14,0,0,0
03/16/2022,Anchorage,7,Psych,0,,61,60,1,0,0,0,,,,0,0,0,104,201,128,73,0,0,0,0,0,0,0,0,0
03/16/2022,Gulf Coast,4,CAH,1,35,70,23,47,4,0,4,12,0,12,0,0,0,79,70,23,47,4,0,4,24,0,24,0,0,0
03/16/2022,Gulf Coast,4,GACH,1,,54,50,4,9,6,3,,,,2,0,2,93,54,50,4,9,6,3,22,0,22,2,0,2
03/16/2022,Interior,6,GACH,1,,101,76,25,13,6,7,,,,1,1,2,101,101,76,25,13,6,7,15,1,14,1,1,2
03/16/2022,Matanuska-Susitna,3,GACH,1,,160,77,83,14,9,5,,,,2,0,2,184,160,77,83,14,9,5,33,3,30,2,0,2
03/16/2022,Northern,2,CAH,1,17,45,14,31,0,0,0,8,0,8,0,0,0,74,45,14,31,0,0,0,36,0,36,0,0,0
03/16/2022,Southeast,5,CAH,1,13,58,31,27,2,0,2,17,0,17,1,0,1,58,58,31,27,2,0,2,33,0,33,1,0,1
03/16/2022,Southeast,5,GACH,1,,57,50,7,9,3,6,,,,2,0,2,57,57,50,7,9,3,6,20,0,20,2,0,2
03/16/2022,Southwest,1,CAH,1,22,12,6,6,0,0,0,4,0,4,0,0,0,22,12,6,6,0,0,0,4,0,4,0,0,0
03/16/2022,Southwest,1,GACH,1,,36,20,16,0,0,0,,,,0,0,0,35,36,20,16,0,0,0,8,0,8,0,0,0
03/17/2022,Anchorage,7,GACH,1,869,1030,941,89,180,163,17,156,27,129,36,0,36,1071,1030,941,89,180,163,17,220,43,177,36,0,36
03/17/2022,Anchorage,7,LTACH,0,,42,41,1,9,8,1,,,,0,0,0,42,42,41,1,9,8,1,24,10,14,0,0,0
03/17/2022,Anchorage,7,Psych,0,140,140,67,73,0,0,0,0,0,0,0,0,0,140,201,127,74,0,0,0,0,0,0,0,0,0
03/17/2022,Gulf Coast,4,CAH,1,35,70,21,49,4,0,4,12,0,12,0,0,0,79,70,21,49,4,0,4,24,0,24,0,0,0
03/17/2022,Gulf Coast,4,GACH,1,,54,51,3,9,6,3,,,,2,0,2,93,54,51,3,9,6,3,22,0,22,2,0,2
03/17/2022,Interior,6,GACH,1,,101,79,22,13,10,3,,,,1,0,1,101,101,79,22,13,10,3,15,1,14,1,0,1
03/17/2022,Matanuska-Susitna,3,GACH,1,,160,71,89,14,10,4,,,,2,0,2,184,160,71,89,14,10,4,33,3,30,2,0,2
03/17/2022,Northern,2,CAH,1,17,45,20,25,0,0,0,8,0,8,0,0,0,74,45,20,25,0,0,0,36,0,36,0,0,0
03/17/2022,Southeast,5,CAH,1,13,58,30,28,5,3,2,17,0,17,2,0,2,58,58,30,28,5,3,2,33,0,33,2,0,2
03/17/2022,Southeast,5,GACH,1,,57,53,4,9,3,6,,,,2,0,2,57,57,53,4,9,3,6,20,0,20,2,0,2
03/17/2022,Southwest,1,CAH,1,22,12,7,5,0,0,0,4,0,4,0,0,0,22,12,7,5,0,0,0,4,0,4,0,0,0
03/17/2022,Southwest,1,GACH,1,,36,20,16,0,0,0,,,,0,0,0,35,36,20,16,0,0,0,8,0,8,0,0,0
03/18/2022,Anchorage,7,GACH,1,843,1006,933,73,176,161,15,156,28,128,28,0,28,1045,1006,933,73,176,161,15,220,44,176,28,0,28
03/18/2022,Anchorage,7,LTACH,0,,42,40,2,9,8,1,,,,0,0,0,42,42,40,2,9,8,1,24,10,14,0,0,0
03/18/2022,Anchorage,7,Psych,0,,,,,,,,,,,,,,140,201,127,74,0,0,0,0,0,0,0,0,0
03/18/2022,Gulf Coast,4,CAH,1,35,70,18,52,4,0,4,12,0,12,0,0,0,79,70,18,52,4,0,4,24,0,24,0,0,0
03/18/2022,Gulf Coast,4,GACH,1,,54,42,12,9,6,3,,,,2,0,2,93,54,42,12,9,6,3,22,0,22,2,0,2
03/18/2022,Interior,6,GACH,1,,101,77,24,13,9,4,,,,1,0,1,101,101,77,24,13,9,4,15,1,14,1,0,1
03/18/2022,Matanuska-Susitna,3,GACH,1,,160,82,78,14,9,5,,,,2,0,2,184,160,82,78,14,9,5,33,3,30,2,0,2
03/18/2022,Northern,2,CAH,1,17,45,22,23,0,0,0,8,0,8,0,0,0,74,45,22,23,0,0,0,36,0,36,0,0,0
03/18/2022,Southeast,5,CAH,1,15,60,32,28,4,2,2,17,0,17,0,0,0,60,60,32,28,4,2,2,33,0,33,0,0,0
03/18/2022,Southeast,5,GACH,1,,57,48,9,9,3,6,,,,3,0,3,57,57,48,9,9,3,6,20,0,20,3,0,3
03/18/2022,Southwest,1,CAH,1,22,12,6,6,0,0,0,4,0,4,0,0,0,22,12,6,6,0,0,0,4,0,4,0,0,0
03/18/2022,Southwest,1,GACH,1,,36,20,16,0,0,0,,,,0,0,0,35,36,20,16,0,0,0,8,0,8,0,0,0
03/19/2022,Anchorage,7,GACH,1,815,966,884,82,177,165,12,156,30,126,31,0,31,1017,966,884,82,177,165,12,220,46,174,31,0,31
03/19/2022,Anchorage,7,LTACH,0,,42,36,6,9,8,1,,,,0,0,0,42,42,36,6,9,8,1,24,10,14,0,0,0
03/19/2022,Anchorage,7,Psych,0,,,,,,,,,,,,,,140,201,127,74,0,0,0,0,0,0,0,0,0
03/19/2022,Gulf Coast,4,CAH,1,35,70,26,44,4,1,3,12,0,12,0,0,0,79,70,26,44,4,1,3,24,0,24,0,0,0
03/19/2022,Gulf Coast,4,GACH,1,,54,40,14,9,8,1,,,,3,0,3,93,54,40,14,9,8,1,22,0,22,3,0,3
03/19/2022,Interior,6,GACH,1,,101,60,41,13,8,5,,,,1,0,1,101,101,60,41,13,8,5,15,1,14,1,0,1
03/19/2022,Matanuska-Susitna,3,GACH,1,,160,77,83,14,7,7,,,,4,0,4,184,160,77,83,14,7,7,33,3,30,4,0,4
03/19/2022,Northern,2,CAH,1,17,45,17,28,0,0,0,8,0,8,0,0,0,74,45,17,28,0,0,0,36,0,36,0,0,0
03/19/2022,Southeast,5,CAH,1,15,60,31,29,4,2,2,17,0,17,0,0,0,60,60,31,29,4,2,2,33,0,33,0,0,0
03/19/2022,Southeast,5,GACH,1,,57,46,11,9,6,3,,,,4,0,4,57,57,46,11,9,6,3,20,0,20,4,0,4
03/19/2022,Southwest,1,CAH,1,22,12,3,9,0,0,0,4,0,4,0,0,0,22,12,3,9,0,0,0,4,0,4,0,0,0
03/19/2022,Southwest,1,GACH,1,,36,19,17,0,0,0,,,,0,0,0,35,36,19,17,0,0,0,8,0,8,0,0,0
03/20/2022,Anchorage,7,GACH,1,803,964,864,100,178,162,16,156,38,118,26,1,27,1005,964,864,100,178,162,16,220,54,166,26,1,27
03/20/2022,Anchorage,7,LTACH,0,,42,34,8,9,8,1,,,,0,0,0,42,42,34,8,9,8,1,24,10,14,0,0,0
03/20/2022,Anchorage,7,Psych,0,,,,,,,,,,,,,,140,201,127,74,0,0,0,0,0,0,0,0,0
03/20/2022,Gulf Coast,4,CAH,1,35,70,22,48,4,2,2,12,0,12,1,0,1,79,70,22,48,4,2,2,24,0,24,1,0,1
03/20/2022,Gulf Coast,4,GACH,1,,54,38,16,9,8,1,,,,3,0,3,93,54,38,16,9,8,1,22,0,22,3,0,3
03/20/2022,Interior,6,GACH,1,,101,67,34,13,10,3,,,,1,0,1,101,101,67,34,13,10,3,15,1,14,1,0,1
03/20/2022,Matanuska-Susitna,3,GACH,1,,160,62,98,14,5,9,,,,5,0,5,184,160,62,98,14,5,9,33,3,30,5,0,5
03/20/2022,Northern,2,CAH,1,17,45,15,30,0,0,0,8,0,8,1,0,1,74,45,15,30,0,0,0,36,0,36,1,0,1
03/20/2022,Southeast,5,CAH,1,15,60,30,30,4,2,2,17,0,17,0,0,0,60,60,30,30,4,2,2,33,0,33,0,0,0
03/20/2022,Southeast,5,GACH,1,,57,46,11,9,6,3,,,,3,0,3,57,57,46,11,9,6,3,20,0,20,3,0,3
03/20/2022,Southwest,1,CAH,1,22,12,4,8,0,0,0,4,0,4,0,0,0,22,12,4,8,0,0,0,4,0,4,0,0,0
03/20/2022,Southwest,1,GACH,1,,36,20,16,0,0,0,,,,0,0,0,35,36,20,16,0,0,0,8,0,8,0,0,0
03/21/2022,Anchorage,7,GACH,1,847,1004,909,95,186,164,22,156,36,120,23,1,24,1049,1004,909,95,186,164,22,220,52,168,23,1,24
03/21/2022,Anchorage,7,LTACH,0,,42,34,8,9,8,1,,,,0,0,0,42,42,34,8,9,8,1,24,10,14,0,0,0
03/21/2022,Anchorage,7,Psych,0,,,,,,,,,,,,,,140,201,127,74,0,0,0,0,0,0,0,0,0
03/21/2022,Gulf Coast,4,CAH,1,35,70,20,50,4,1,3,12,0,12,1,0,1,79,70,20,50,4,1,3,24,0,24,1,0,1
03/21/2022,Gulf Coast,4,GACH,1,,54,37,17,9,6,3,,,,3,0,3,93,54,37,17,9,6,3,22,0,22,3,0,3
03/21/2022,Interior,6,GACH,1,,101,75,26,13,11,2,,,,2,0,2,101,101,75,26,13,11,2,15,1,14,2,0,2
03/21/2022,Matanuska-Susitna,3,GACH,1,,160,68,92,14,5,9,,,,4,0,4,184,160,68,92,14,5,9,33,3,30,4,0,4
03/21/2022,Northern,2,CAH,1,24,45,13,32,0,0,0,8,0,8,0,0,0,81,45,13,32,0,0,0,36,0,36,0,0,0
03/21/2022,Southeast,5,CAH,1,14,59,26,33,5,4,1,17,0,17,1,0,1,59,59,26,33,5,4,1,33,0,33,1,0,1
03/21/2022,Southeast,5,GACH,1,,57,34,23,9,3,6,,,,3,0,3,57,57,34,23,9,3,6,20,0,20,3,0,3
03/21/2022,Southwest,1,CAH,1,22,12,4,8,0,0,0,4,0,4,0,0,0,22,12,4,8,0,0,0,4,0,4,0,0,0
03/21/2022,Southwest,1,GACH,1,,36,19,17,0,0,0,,,,0,0,0,35,36,19,17,0,0,0,8,0,8,0,0,0
03/22/2022,Anchorage,7,GACH,1,845,1007,897,110,189,167,22,156,28,128,22,0,22,1047,1007,897,110,189,167,22,220,44,176,22,0,22
03/22/2022,Anchorage,7,LTACH,0,,42,32,10,9,8,1,,,,0,0,0,42,42,32,10,9,8,1,24,10,14,0,0,0
03/22/2022,Anchorage,7,Psych,0,,,,,,,,,,,,,,140,201,127,74,0,0,0,0,0,0,0,0,0
03/22/2022,Gulf Coast,4,CAH,1,35,70,22,48,4,1,3,12,0,12,3,0,3,79,70,22,48,4,1,3,24,0,24,3,0,3
03/22/2022,Gulf Coast,4,GACH,1,,54,44,10,9,6,3,,,,3,0,3,93,54,44,10,9,6,3,22,0,22,3,0,3
03/22/2022,Interior,6,GACH,1,,101,81,20,13,10,3,,,,2,0,2,101,101,81,20,13,10,3,15,1,14,2,0,2
03/22/2022,Matanuska-Susitna,3,GACH,1,,160,70,90,14,8,6,,,,4,0,4,184,160,70,90,14,8,6,33,3,30,4,0,4
03/22/2022,Northern,2,CAH,1,17,45,13,32,0,0,0,8,0,8,0,0,0,74,45,13,32,0,0,0,36,0,36,0,0,0
03/22/2022,Southeast,5,CAH,1,14,59,28,31,6,5,1,17,0,17,1,0,1,59,59,28,31,6,5,1,33,0,33,1,0,1
03/22/2022,Southeast,5,GACH,1,,57,34,23,9,4,5,,,,3,0,3,57,57,34,23,9,4,5,20,0,20,3,0,3
03/22/2022,Southwest,1,CAH,1,22,12,4,8,0,0,0,4,0,4,0,0,0,22,12,4,8,0,0,0,4,0,4,0,0,0
03/22/2022,Southwest,1,GACH,1,,36,16,20,0,0,0,,,,0,0,0,35,36,16,20,0,0,0,8,0,8,0,0,0
03/23/2022,Anchorage,7,GACH,1,849,995,906,89,194,175,19,156,27,129,20,1,21,1051,995,906,89,194,175,19,220,43,177,20,1,21
03/23/2022,Anchorage,7,LTACH,0,,42,32,10,9,8,1,,,,0,0,0,42,42,32,10,9,8,1,24,10,14,0,0,0
03/23/2022,Anchorage,7,Psych,0,110,209,135,74,0,0,0,0,0,0,0,0,0,110,209,135,74,0,0,0,0,0,0,0,0,0
03/23/2022,Gulf Coast,4,CAH,1,35,70,24,46,4,1,3,12,0,12,2,0,2,79,70,24,46,4,1,3,24,0,24,2,0,2
03/23/2022,Gulf Coast,4,GACH,1,,54,45,9,9,8,1,,,,3,0,3,93,54,45,9,9,8,1,22,0,22,3,0,3
03/23/2022,Interior,6,GACH,1,,101,72,29,13,10,3,,,,2,0,2,101,101,72,29,13,10,3,15,1,14,2,0,2
03/23/2022,Matanuska-Susitna,3,GACH,1,,160,70,90,14,11,3,,,,4,0,4,184,160,70,90,14,11,3,33,3,30,4,0,4
03/23/2022,Northern,2,CAH,1,17,45,19,26,0,0,0,8,0,8,1,0,1,74,45,19,26,0,0,0,36,0,36,1,0,1
03/23/2022,Southeast,5,CAH,1,13,58,30,28,6,4,2,17,0,17,2,0,2,58,58,30,28,6,4,2,33,0,33,2,0,2
03/23/2022,Southeast,5,GACH,1,,57,41,16,9,2,7,,,,3,0,3,57,57,41,16,9,2,7,20,0,20,3,0,3
03/23/2022,Southwest,1,CAH,1,22,22,5,17,0,0,0,4,0,4,1,0,1,22,22,5,17,0,0,0,4,0,4,1,0,1
03/23/2022,Southwest,1,GACH,1,,36,17,19,0,0,0,,,,0,0,0,35,36,17,19,0,0,0,8,0,8,0,0,0
03/24/2022,Anchorage,7,GACH,1,867,1015,937,78,189,174,15,156,25,131,15,0,15,1069,1015,937,78,189,174,15,220,41,179,15,0,15
03/24/2022,Anchorage,7,LTACH,0,,42,32,10,9,8,1,,,,0,0,0,42,42,32,10,9,8,1,24,10,14,0,0,0
03/24/2022,Anchorage,7,Psych,0,,,,,,,,,,,,,,110,209,135,74,0,0,0,0,0,0,0,0,0
03/24/2022,Gulf Coast,4,CAH,1,35,70,20,50,4,1,3,12,0,12,2,0,2,79,70,20,50,4,1,3,24,0,24,2,0,2
03/24/2022,Gulf Coast,4,GACH,1,,54,48,6,9,6,3,,,,3,0,3,93,54,48,6,9,6,3,22,0,22,3,0,3
03/24/2022,Interior,6,GACH,1,,101,73,28,13,6,7,,,,2,0,2,101,101,73,28,13,6,7,15,1,14,2,0,2
03/24/2022,Matanuska-Susitna,3,GACH,1,,160,62,98,14,7,7,,,,4,0,4,184,160,62,98,14,7,7,33,3,30,4,0,4
03/24/2022,Northern,2,CAH,1,24,45,17,28,0,0,0,8,0,8,1,0,1,81,45,17,28,0,0,0,36,0,36,1,0,1
03/24/2022,Southeast,5,CAH,1,13,58,31,27,4,2,2,17,0,17,0,0,0,58,58,31,27,4,2,2,33,0,33,0,0,0
03/24/2022,Southeast,5,GACH,1,,57,34,23,9,4,5,,,,2,0,2,57,57,34,23,9,4,5,20,0,20,2,0,2
03/24/2022,Southwest,1,CAH,1,22,22,4,18,0,0,0,4,0,4,1,0,1,22,22,4,18,0,0,0,4,0,4,1,0,1
03/24/2022,Southwest,1,GACH,1,,36,20,16,0,0,0,,,,0,0,0,35,36,20,16,0,0,0,8,0,8,0,0,0
03/25/2022,Anchorage,7,GACH,1,853,1003,930,73,196,181,15,156,25,131,20,1,21,1055,1003,930,73,196,181,15,220,41,179,20,1,21
03/25/2022,Anchorage,7,LTACH,0,,42,31,11,6,4,2,,,,0,0,0,42,42,31,11,6,4,2,24,10,14,0,0,0
03/25/2022,Anchorage,7,Psych,0,,,,,,,,,,,,,,110,209,135,74,0,0,0,0,0,0,0,0,0
03/25/2022,Gulf Coast,4,CAH,1,35,70,25,45,4,2,2,12,0,12,2,0,2,79,70,25,45,4,2,2,24,0,24,2,0,2
03/25/2022,Gulf Coast,4,GACH,1,,54,41,13,9,7,2,,,,5,0,5,93,54,41,13,9,7,2,22,0,22,5,0,5
03/25/2022,Interior,6,GACH,1,,101,84,17,13,5,8,,,,2,0,2,101,101,84,17,13,5,8,15,1,14,2,0,2
03/25/2022,Matanuska-Susitna,3,GACH,1,,160,63,97,14,5,9,,,,3,0,3,184,160,63,97,14,5,9,33,3,30,3,0,3
03/25/2022,Northern,2,CAH,1,24,45,17,28,0,0,0,8,0,8,0,0,0,81,45,17,28,0,0,0,36,0,36,0,0,0
03/25/2022,Southeast,5,CAH,1,17,62,38,24,5,3,2,17,0,17,0,0,0,62,62,38,24,5,3,2,33,0,33,0,0,0
03/25/2022,Southeast,5,GACH,1,,57,35,22,9,4,5,,,,2,0,2,57,57,35,22,9,4,5,20,0,20,2,0,2
03/25/2022,Southwest,1,CAH,1,22,22,4,18,0,0,0,4,0,4,1,0,1,22,22,4,18,0,0,0,4,0,4,1,0,1
03/25/2022,Southwest,1,GACH,1,,36,20,16,0,0,0,,,,0,0,0,35,36,20,16,0,0,0,8,0,8,0,0,0
03/26/2022,Anchorage,7,GACH,1,841,1000,906,94,187,172,15,156,22,134,22,1,23,1043,1000,906,94,187,172,15,220,38,182,22,1,23
03/26/2022,Anchorage,7,LTACH,0,,42,32,10,6,4,2,,,,0,0,0,42,42,32,10,6,4,2,24,10,14,0,0,0
03/26/2022,Anchorage,7,Psych,0,,,,,,,,,,,,,,110,209,135,74,0,0,0,0,0,0,0,0,0
03/26/2022,Gulf Coast,4,CAH,1,35,70,24,46,4,2,2,12,0,12,3,0,3,79,70,24,46,4,2,2,24,0,24,3,0,3
03/26/2022,Gulf Coast,4,GACH,1,,54,39,15,9,8,1,,,,3,0,3,93,54,39,15,9,8,1,22,0,22,3,0,3
03/26/2022,Interior,6,GACH,1,,101,74,27,13,4,9,,,,2,0,2,101,101,74,27,13,4,9,15,1,14,2,0,2
03/26/2022,Matanuska-Susitna,3,GACH,1,,160,62,98,14,6,8,,,,3,0,3,184,160,62,98,14,6,8,33,3,30,3,0,3
03/26/2022,Northern,2,CAH,1,24,45,15,30,0,0,0,8,0,8,1,0,1,81,45,15,30,0,0,0,36,0,36,1,0,1
03/26/2022,Southeast,5,CAH,1,17,62,36,26,5,3,2,17,0,17,0,0,0,62,62,36,26,5,3,2,33,0,33,0,0,0
03/26/2022,Southeast,5,GACH,1,,57,32,25,9,3,6,,,,2,0,2,57,57,32,25,9,3,6,20,0,20,2,0,2
03/26/2022,Southwest,1,CAH,1,22,22,4,18,0,0,0,4,0,4,2,0,2,22,22,4,18,0,0,0,4,0,4,2,0,2
03/26/2022,Southwest,1,GACH,1,,36,23,13,0,0,0,,,,0,0,0,35,36,23,13,0,0,0,8,0,8,0,0,0
03/27/2022,Anchorage,7,GACH,1,831,995,907,88,187,171,16,156,24,132,20,0,20,1033,995,907,88,187,171,16,220,40,180,20,0,20
03/27/2022,Anchorage,7,LTACH,0,,42,32,10,6,4,2,,,,0,0,0,42,42,32,10,6,4,2,24,10,14,0,0,0
03/27/2022,Anchorage,7,Psych,0,,,,,,,,,,,,,,110,209,135,74,0,0,0,0,0,0,0,0,0
03/27/2022,Gulf Coast,4,CAH,1,35,70,22,48,4,1,3,12,0,12,3,0,3,79,70,22,48,4,1,3,24,0,24,3,0,3
03/27/2022,Gulf Coast,4,GACH,1,,54,38,16,9,5,4,,,,3,0,3,93,54,38,16,9,5,4,22,0,22,3,0,3
03/27/2022,Interior,6,GACH,1,,101,74,27,13,11,2,,,,2,0,2,101,101,74,27,13,11,2,15,1,14,2,0,2
03/27/2022,Matanuska-Susitna,3,GACH,1,,160,70,90,14,7,7,,,,3,0,3,184,160,70,90,14,7,7,33,3,30,3,0,3
03/27/2022,Northern,2,CAH,1,24,45,16,29,0,0,0,8,0,8,1,0,1,81,45,16,29,0,0,0,36,0,36,1,0,1
03/27/2022,Southeast,5,CAH,1,17,62,36,26,5,4,1,17,0,17,0,0,0,62,62,36,26,5,4,1,33,0,33,0,0,0
03/27/2022,Southeast,5,GACH,1,,57,35,22,9,4,5,,,,2,0,2,57,57,35,22,9,4,5,20,0,20,2,0,2
03/27/2022,Southwest,1,CAH,1,22,22,5,17,0,0,0,4,0,4,2,0,2,22,22,5,17,0,0,0,4,0,4,2,0,2
03/27/2022,Southwest,1,GACH,1,,36,20,16,0,0,0,,,,0,0,0,35,36,20,16,0,0,0,8,0,8,0,0,0
03/28/2022,Anchorage,7,GACH,1,837,995,894,101,185,166,19,156,25,131,22,2,24,1039,995,894,101,185,166,19,220,41,179,22,2,24
03/28/2022,Anchorage,7,LTACH,0,,42,32,10,6,4,2,,,,0,0,0,42,42,32,10,6,4,2,24,10,14,0,0,0
03/28/2022,Anchorage,7,Psych,0,,,,,,,,,,,,,,110,209,135,74,0,0,0,0,0,0,0,0,0
03/28/2022,Gulf Coast,4,CAH,1,37,69,21,48,4,1,3,12,0,12,3,0,3,81,69,21,48,4,1,3,24,0,24,3,0,3
03/28/2022,Gulf Coast,4,GACH,1,,54,36,18,9,2,7,,,,4,0,4,93,54,36,18,9,2,7,22,0,22,4,0,4
03/28/2022,Interior,6,GACH,1,,101,75,26,13,8,5,,,,2,0,2,101,101,75,26,13,8,5,15,1,14,2,0,2
03/28/2022,Matanuska-Susitna,3,GACH,1,,160,81,79,14,8,6,,,,4,0,4,184,160,81,79,14,8,6,33,3,30,4,0,4
03/28/2022,Northern,2,CAH,1,24,45,19,26,0,0,0,8,0,8,1,0,1,81,45,19,26,0,0,0,36,0,36,1,0,1
03/28/2022,Southeast,5,CAH,1,10,55,29,26,3,1,2,17,0,17,0,0,0,55,55,29,26,3,1,2,33,0,33,0,0,0
03/28/2022,Southeast,5,GACH,1,,57,36,21,9,4,5,,,,1,0,1,57,57,36,21,9,4,5,20,0,20,1,0,1
03/28/2022,Southwest,1,CAH,1,22,22,5,17,0,0,0,4,0,4,0,0,0,22,22,5,17,0,0,0,4,0,4,0,0,0
03/28/2022,Southwest,1,GACH,1,,36,20,16,0,0,0,,,,0,0,0,35,36,20,16,0,0,0,8,0,8,0,0,0
03/29/2022,Anchorage,7,GACH,1,855,1014,909,105,187,169,18,156,26,130,14,0,14,1057,1014,909,105,187,169,18,220,42,178,14,0,14
03/29/2022,Anchorage,7,LTACH,0,,42,32,10,6,4,2,,,,0,0,0,42,42,32,10,6,4,2,24,10,14,0,0,0
03/29/2022,Anchorage,7,Psych,0,,,,,,,,,,,,,,110,209,135,74,0,0,0,0,0,0,0,0,0
03/29/2022,Gulf Coast,4,CAH,1,37,71,25,46,4,1,3,12,0,12,4,0,4,81,71,25,46,4,1,3,24,0,24,4,0,4
03/29/2022,Gulf Coast,4,GACH,1,,54,45,9,9,6,3,,,,4,0,4,93,54,45,9,9,6,3,22,0,22,4,0,4
03/29/2022,Interior,6,GACH,1,,101,75,26,13,9,4,,,,2,0,2,101,101,75,26,13,9,4,15,1,14,2,0,2
03/29/2022,Matanuska-Susitna,3,GACH,1,,160,93,67,14,9,5,,,,5,0,5,184,160,93,67,14,9,5,33,3,30,5,0,5
03/29/2022,Northern,2,CAH,1,24,45,22,23,0,0,0,8,0,8,1,0,1,81,45,22,23,0,0,0,36,0,36,1,0,1
03/29/2022,Southeast,5,CAH,1,15,60,33,27,5,3,2,17,0,17,0,0,0,60,60,33,27,5,3,2,33,0,33,0,0,0
03/29/2022,Southeast,5,GACH,1,,57,38,19,9,3,6,,,,2,0,2,57,57,38,19,9,3,6,20,0,20,2,0,2
03/29/2022,Southwest,1,CAH,1,22,22,2,20,0,0,0,4,0,4,0,0,0,22,22,2,20,0,0,0,4,0,4,0,0,0
03/29/2022,Southwest,1,GACH,1,,36,21,15,0,0,0,,,,0,0,0,35,36,21,15,0,0,0,8,0,8,0,0,0
03/30/2022,Anchorage,7,GACH,1,853,1024,925,99,181,162,19,156,26,130,14,0,14,1055,1024,925,99,181,162,19,220,42,178,14,0,14
03/30/2022,Anchorage,7,LTACH,0,,42,34,8,6,4,2,,,,0,0,0,42,42,34,8,6,4,2,24,10,14,0,0,0
03/30/2022,Anchorage,7,Psych,0,,69,66,3,0,0,0,,,,1,0,1,110,209,135,74,0,0,0,0,0,0,1,0,1
03/30/2022,Gulf Coast,4,CAH,1,37,70,33,37,4,1,3,12,0,12,3,0,3,81,70,33,37,4,1,3,24,0,24,3,0,3
03/30/2022,Gulf Coast,4,GACH,1,,54,49,5,9,7,2,,,,4,0,4,93,54,49,5,9,7,2,22,0,22,4,0,4
03/30/2022,Interior,6,GACH,1,,101,82,19,13,9,4,,,,2,0,2,101,101,82,19,13,9,4,15,1,14,2,0,2
03/30/2022,Matanuska-Susitna,3,GACH,1,,160,88,72,14,10,4,,,,5,0,5,184,160,88,72,14,10,4,33,3,30,5,0,5
03/30/2022,Northern,2,CAH,1,24,45,23,22,0,0,0,8,0,8,2,0,2,81,45,23,22,0,0,0,36,0,36,2,0,2
03/30/2022,Southeast,5,CAH,1,15,60,39,21,5,3,2,17,0,17,0,0,0,60,60,39,21,5,3,2,33,0,33,0,0,0
03/30/2022,Southeast,5,GACH,1,,57,42,15,9,2,7,,,,3,0,3,57,57,42,15,9,2,7,20,0,20,3,0,3
03/30/2022,Southwest,1,CAH,1,22,22,2,20,0,0,0,4,0,4,1,0,1,22,22,2,20,0,0,0,4,0,4,1,0,1
03/30/2022,Southwest,1,GACH,1,,36,25,11,0,0,0,,,,0,0,0,35,36,25,11,0,0,0,8,0,8,0,0,0
03/31/2022,Anchorage,7,GACH,1,873,1041,952,89,170,152,18,156,27,129,16,0,16,1075,1041,952,89,170,152,18,220,43,177,16,0,16
03/31/2022,Anchorage,7,LTACH,0,,42,36,6,6,4,2,,,,0,0,0,42,42,36,6,6,4,2,24,10,14,0,0,0
03/31/2022,Anchorage,7,Psych,0,240,140,76,64,0,0,0,0,0,0,0,0,0,240,209,142,67,0,0,0,0,0,0,1,0,1
03/31/2022,Gulf Coast,4,CAH,1,37,69,27,42,4,0,4,12,0,12,2,0,2,81,69,27,42,4,0,4,24,0,24,2,0,2
03/31/2022,Gulf Coast,4,GACH,1,,54,47,7,9,7,2,,,,3,0,3,93,54,47,7,9,7,2,22,0,22,3,0,3
03/31/2022,Interior,6,GACH,1,,101,77,24,13,8,5,,,,2,0,2,101,101,77,24,13,8,5,15,1,14,2,0,2
03/31/2022,Matanuska-Susitna,3,GACH,1,,160,74,86,14,13,1,,,,6,0,6,184,160,74,86,14,13,1,33,3,30,6,0,6
03/31/2022,Northern,2,CAH,1,24,45,24,21,0,0,0,8,0,8,2,0,2,81,45,24,21,0,0,0,36,0,36,2,0,2
03/31/2022,Southeast,5,CAH,1,9,54,35,19,4,2,2,17,0,17,0,0,0,54,54,35,19,4,2,2,33,0,33,0,0,0
03/31/2022,Southeast,5,GACH,1,,57,40,17,9,2,7,,,,2,0,2,57,57,40,17,9,2,7,20,0,20,2,0,2
03/31/2022,Southwest,1,CAH,1,22,22,4,18,0,0,0,4,0,4,0,0,0,22,22,4,18,0,0,0,4,0,4,0,0,0
03/31/2022,Southwest,1,GACH,1,,36,20,16,0,0,0,,,,0,0,0,35,36,20,16,0,0,0,8,0,8,0,0,0
04/01/2022,Anchorage,7,GACH,1,877,1040,945,95,170,150,20,156,21,135,15,0,15,1079,1040,945,95,170,150,20,220,37,183,15,0,15
04/01/2022,Anchorage,7,LTACH,0,,42,35,7,6,4,2,,,,0,0,0,42,42,35,7,6,4,2,24,10,14,0,0,0
04/01/2022,Anchorage,7,Psych,0,,,,,,,,,,,,,,240,209,142,67,0,0,0,0,0,0,1,0,1
04/01/2022,Gulf Coast,4,CAH,1,37,69,26,43,4,0,4,12,0,12,2,0,2,81,69,26,43,4,0,4,24,0,24,2,0,2
04/01/2022,Gulf Coast,4,GACH,1,,54,46,8,9,8,1,,,,4,0,4,93,54,46,8,9,8,1,22,0,22,4,0,4
04/01/2022,Interior,6,GACH,1,,101,65,36,13,7,6,,,,1,0,1,101,101,65,36,13,7,6,15,1,14,1,0,1
04/01/2022,Matanuska-Susitna,3,GACH,1,,160,69,91,14,10,4,,,,5,0,5,184,160,69,91,14,10,4,33,3,30,5,0,5
04/01/2022,Northern,2,CAH,1,24,45,24,21,0,0,0,8,0,8,2,0,2,81,45,24,21,0,0,0,36,0,36,2,0,2
04/01/2022,Southeast,5,CAH,1,9,54,34,20,2,0,2,17,0,17,0,0,0,54,54,34,20,2,0,2,33,0,33,0,0,0
04/01/2022,Southeast,5,GACH,1,,57,40,17,9,3,6,,,,3,0,3,57,57,40,17,9,3,6,20,0,20,3,0,3
04/01/2022,Southwest,1,CAH,1,22,22,5,17,0,0,0,4,0,4,0,0,0,22,22,5,17,0,0,0,4,0,4,0,0,0
04/01/2022,Southwest,1,GACH,1,,36,22,14,0,0,0,,,,0,0,0,35,36,22,14,0,0,0,8,0,8,0,0,0
04/02/2022,Anchorage,7,GACH,1,819,983,892,91,190,177,13,156,29,127,19,0,19,1021,983,892,91,190,177,13,220,45,175,19,0,19
04/02/2022,Anchorage,7,LTACH,0,,42,36,6,6,4,2,,,,0,0,0,42,42,36,6,6,4,2,24,10,14,0,0,0
04/02/2022,Anchorage,7,Psych,0,,,,,,,,,,,,,,240,209,142,67,0,0,0,0,0,0,1,0,1
04/02/2022,Gulf Coast,4,CAH,1,37,69,21,48,4,0,4,12,0,12,1,0,1,81,69,21,48,4,0,4,24,0,24,1,0,1
04/02/2022,Gulf Coast,4,GACH,1,,54,48,6,9,9,0,,,,3,0,3,93,54,48,6,9,9,0,22,0,22,3,0,3
04/02/2022,Interior,6,GACH,1,,101,58,43,13,7,6,,,,2,0,2,101,101,58,43,13,7,6,15,1,14,2,0,2
04/02/2022,Matanuska-Susitna,3,GACH,1,,160,64,96,14,8,6,,,,2,0,2,184,160,64,96,14,8,6,33,3,30,2,0,2
04/02/2022,Northern,2,CAH,1,24,45,23,22,0,0,0,8,0,8,1,0,1,81,45,23,22,0,0,0,36,0,36,1,0,1
04/02/2022,Southeast,5,CAH,1,9,54,36,18,2,0,2,17,0,17,1,0,1,54,54,36,18,2,0,2,33,0,33,1,0,1
04/02/2022,Southeast,5,GACH,1,,57,39,18,9,4,5,,,,2,0,2,57,57,39,18,9,4,5,20,0,20,2,0,2
04/02/2022,Southwest,1,CAH,1,22,22,7,15,0,0,0,4,0,4,0,0,0,22,22,7,15,0,0,0,4,0,4,0,0,0
04/02/2022,Southwest,1,GACH,1,,35,20,15,0,0,0,,,,0,0,0,35,35,20,15,0,0,0,8,0,8,0,0,0
04/03/2022,Anchorage,7,GACH,1,827,986,895,91,182,168,14,156,28,128,19,0,19,1029,986,895,91,182,168,14,220,44,176,19,0,19
04/03/2022,Anchorage,7,LTACH,0,,42,36,6,6,4,2,,,,0,0,0,42,42,36,6,6,4,2,24,10,14,0,0,0
04/03/2022,Anchorage,7,Psych,0,,,,,,,,,,,,,,240,209,142,67,0,0,0,0,0,0,1,0,1
04/03/2022,Gulf Coast,4,CAH,1,37,69,16,53,4,0,4,12,0,12,1,0,1,81,69,16,53,4,0,4,24,0,24,1,0,1
04/03/2022,Gulf Coast,4,GACH,1,,54,41,13,9,8,1,,,,2,0,2,93,54,41,13,9,8,1,22,0,22,2,0,2
04/03/2022,Interior,6,GACH,1,,101,61,40,13,7,6,,,,2,0,2,101,101,61,40,13,7,6,15,1,14,2,0,2
04/03/2022,Matanuska-Susitna,3,GACH,1,,160,55,105,14,9,5,,,,2,0,2,184,160,55,105,14,9,5,33,3,30,2,0,2
04/03/2022,Northern,2,CAH,1,24,45,23,22,0,0,0,8,0,8,2,0,2,81,45,23,22,0,0,0,36,0,36,2,0,2
04/03/2022,Southeast,5,CAH,1,9,54,36,18,2,0,2,17,0,17,0,0,0,54,54,36,18,2,0,2,33,0,33,0,0,0
04/03/2022,Southeast,5,GACH,1,,57,33,24,9,4,5,,,,1,0,1,57,57,33,24,9,4,5,20,0,20,1,0,1
04/03/2022,Southwest,1,CAH,1,22,22,7,15,0,0,0,4,0,4,2,0,2,22,22,7,15,0,0,0,4,0,4,2,0,2
04/03/2022,Southwest,1,GACH,1,,35,22,13,0,0,0,,,,0,0,0,35,35,22,13,0,0,0,8,0,8,0,0,0
04/04/2022,Anchorage,7,GACH,1,863,1021,916,105,191,174,17,156,34,122,19,0,19,1065,1021,916,105,191,174,17,220,50,170,19,0,19
04/04/2022,Anchorage,7,LTACH,0,,42,36,6,6,4,2,,,,0,0,0,42,42,36,6,6,4,2,24,10,14,0,0,0
04/04/2022,Anchorage,7,Psych,0,,,,,,,,,,,,,,240,209,142,67,0,0,0,0,0,0,1,0,1
04/04/2022,Gulf Coast,4,CAH,1,37,70,24,46,4,0,4,12,0,12,1,0,1,81,70,24,46,4,0,4,24,0,24,1,0,1
04/04/2022,Gulf Coast,4,GACH,1,,54,41,13,9,7,2,,,,1,0,1,93,54,41,13,9,7,2,22,0,22,1,0,1
04/04/2022,Interior,6,GACH,1,,101,70,31,13,9,4,,,,2,0,2,101,101,70,31,13,9,4,15,1,14,2,0,2
04/04/2022,Matanuska-Susitna,3,GACH,1,,160,64,96,14,7,7,,,,5,0,5,184,160,64,96,14,7,7,33,3,30,5,0,5
04/04/2022,Northern,2,CAH,1,24,45,19,26,0,0,0,8,0,8,2,0,2,81,45,19,26,0,0,0,36,0,36,2,0,2
04/04/2022,Southeast,5,CAH,1,8,53,33,20,2,0,2,17,0,17,0,0,0,53,53,33,20,2,0,2,33,0,33,0,0,0
04/04/2022,Southeast,5,GACH,1,,57,36,21,9,6,3,,,,1,0,1,57,57,36,21,9,6,3,20,0,20,1,0,1
04/04/2022,Southwest,1,CAH,1,22,22,6,16,0,0,0,4,0,4,0,0,0,22,22,6,16,0,0,0,4,0,4,0,0,0
04/04/2022,Southwest,1,GACH,1,,36,24,12,0,0,0,,,,0,0,0,35,36,24,12,0,0,0,8,0,8,0,0,0
04/05/2022,Anchorage,7,GACH,1,849,1005,891,114,187,170,17,156,10,146,9,0,9,1051,1005,891,114,187,170,17,220,26,194,9,0,9
04/05/2022,Anchorage,7,LTACH,0,,42,36,6,6,4,2,,,,0,0,0,42,42,36,6,6,4,2,24,10,14,0,0,0
04/05/2022,Anchorage,7,Psych,0,,,,,,,,,,,,,,240,209,142,67,0,0,0,0,0,0,1,0,1
04/05/2022,Gulf Coast,4,CAH,1,37,70,21,49,4,0,4,12,0,12,2,0,2,81,70,21,49,4,0,4,24,0,24,2,0,2
04/05/2022,Gulf Coast,4,GACH,1,,54,54,0,9,7,2,,,,3,0,3,93,54,54,0,9,7,2,22,0,22,3,0,3
04/05/2022,Interior,6,GACH,1,,101,76,25,13,9,4,,,,1,0,1,101,101,76,25,13,9,4,15,1,14,1,0,1
04/05/2022,Matanuska-Susitna,3,GACH,1,,160,72,88,14,13,1,,,,2,0,2,184,160,72,88,14,13,1,33,3,30,2,0,2
04/05/2022,Northern,2,CAH,1,24,45,21,24,0,0,0,8,0,8,2,0,2,81,45,21,24,0,0,0,36,0,36,2,0,2
04/05/2022,Southeast,5,CAH,1,9,54,34,20,4,2,2,17,0,17,0,0,0,54,54,34,20,4,2,2,33,0,33,0,0,0
04/05/2022,Southeast,5,GACH,1,,57,44,13,9,3,6,,,,1,0,1,57,57,44,13,9,3,6,20,0,20,1,0,1
04/05/2022,Southwest,1,CAH,1,22,22,4,18,0,0,0,4,0,4,1,0,1,22,22,4,18,0,0,0,4,0,4,1,0,1
04/05/2022,Southwest,1,GACH,1,,36,26,10,0,0,0,,,,0,0,0,35,36,26,10,0,0,0,8,0,8,0,0,0
04/06/2022,Anchorage,7,GACH,1,875,1034,934,100,197,184,13,155,28,127,11,0,11,1077,1034,934,100,197,184,13,219,44,175,11,0,11
04/06/2022,Anchorage,7,LTACH,0,,42,35,7,6,4,2,,,,0,0,0,42,42,35,7,6,4,2,24,10,14,0,0,0
04/06/2022,Anchorage,7,Psych,0,0,209,143,66,0,0,0,0,0,0,0,0,0,0,209,143,66,0,0,0,0,0,0,0,0,0
04/06/2022,Gulf Coast,4,CAH,1,37,69,21,48,4,0,4,12,0,12,1,0,1,81,69,21,48,4,0,4,24,0,24,1,0,1
04/06/2022,Gulf Coast,4,GACH,1,,57,57,0,9,9,0,,,,2,0,2,93,57,57,0,9,9,0,22,0,22,2,0,2
04/06/2022,Interior,6,GACH,1,,101,83,18,13,8,5,,,,2,0,2,101,101,83,18,13,8,5,15,1,14,2,0,2
04/06/2022,Matanuska-Susitna,3,GACH,1,,160,80,80,14,11,3,,,,2,0,2,184,160,80,80,14,11,3,33,3,30,2,0,2
04/06/2022,Northern,2,CAH,1,24,45,24,21,0,0,0,8,0,8,2,0,2,81,45,24,21,0,0,0,36,0,36,2,0,2
04/06/2022,Southeast,5,CAH,1,9,54,30,24,2,0,2,17,0,17,0,0,0,54,54,30,24,2,0,2,33,0,33,0,0,0
04/06/2022,Southeast,5,GACH,1,,57,42,15,9,4,5,,,,1,0,1,57,57,42,15,9,4,5,20,0,20,1,0,1
04/06/2022,Southwest,1,CAH,1,22,22,4,18,0,0,0,4,0,4,0,0,0,22,22,4,18,0,0,0,4,0,4,0,0,0
04/06/2022,Southwest,1,GACH,1,,36,24,12,0,0,0,,,,0,0,0,35,36,24,12,0,0,0,8,0,8,0,0,0
04/07/2022,Anchorage,7,GACH,1,889,1045,956,89,199,182,17,155,23,132,19,0,19,1091,1045,956,89,199,182,17,219,39,180,19,0,19
04/07/2022,Anchorage,7,LTACH,0,,42,37,5,6,4,2,,,,0,0,0,42,42,37,5,6,4,2,24,10,14,0,0,0
04/07/2022,Anchorage,7,Psych,0,,,,,,,,,,,,,,0,209,143,66,0,0,0,0,0,0,0,0,0
04/07/2022,Gulf Coast,4,CAH,1,37,69,28,41,4,0,4,12,0,12,1,0,1,81,69,28,41,4,0,4,24,0,24,1,0,1
04/07/2022,Gulf Coast,4,GACH,1,,58,58,0,9,8,1,,,,2,0,2,93,58,58,0,9,8,1,22,0,22,2,0,2
04/07/2022,Interior,6,GACH,1,,101,78,23,13,7,6,,,,1,0,1,101,101,78,23,13,7,6,15,1,14,1,0,1
04/07/2022,Matanuska-Susitna,3,GACH,1,,160,74,86,14,8,6,,,,2,0,2,184,160,74,86,14,8,6,33,3,30,2,0,2
04/07/2022,Northern,2,CAH,1,24,45,21,24,0,0,0,8,0,8,1,0,1,81,45,21,24,0,0,0,36,0,36,1,0,1
04/07/2022,Southeast,5,CAH,1,9,54,31,23,2,0,2,17,0,17,1,0,1,54,54,31,23,2,0,2,33,0,33,1,0,1
04/07/2022,Southeast,5,GACH,1,,57,36,21,9,5,4,,,,1,0,1,57,57,36,21,9,5,4,20,0,20,1,0,1
04/07/2022,Southwest,1,CAH,1,22,22,5,17,0,0,0,4,0,4,0,0,0,22,22,5,17,0,0,0,4,0,4,0,0,0
04/07/2022,Southwest,1,GACH,1,,36,20,16,0,0,0,,,,0,0,0,35,36,20,16,0,0,0,8,0,8,0,0,0
04/08/2022,Anchorage,7,GACH,1,883,1050,950,100,206,192,14,155,31,124,19,0,19,1085,1050,950,100,206,192,14,219,47,172,19,0,19
04/08/2022,Anchorage,7,LTACH,0,,42,38,4,6,4,2,,,,0,0,0,42,42,38,4,6,4,2,24,10,14,0,0,0
04/08/2022,Anchorage,7,Psych,0,,,,,,,,,,,,,,0,209,143,66,0,0,0,0,0,0,0,0,0
04/08/2022,Gulf Coast,4,CAH,1,37,69,23,46,4,0,4,12,0,12,0,0,0,81,69,23,46,4,0,4,24,0,24,0,0,0
04/08/2022,Gulf Coast,4,GACH,1,,55,55,0,9,8,1,,,,5,0,5,93,55,55,0,9,8,1,22,0,22,5,0,5
04/08/2022,Interior,6,GACH,1,,101,78,23,13,6,7,,,,2,0,2,101,101,78,23,13,6,7,15,1,14,2,0,2
04/08/2022,Matanuska-Susitna,3,GACH,1,,160,83,77,14,11,3,,,,1,0,1,184,160,83,77,14,11,3,33,3,30,1,0,1
04/08/2022,Northern,2,CAH,1,24,45,17,28,0,0,0,8,0,8,1,0,1,81,45,17,28,0,0,0,36,0,36,1,0,1
04/08/2022,Southeast,5,CAH,1,3,48,29,19,2,0,2,17,0,17,2,0,2,48,48,29,19,2,0,2,33,0,33,2,0,2
04/08/2022,Southeast,5,GACH,1,,57,36,21,9,5,4,,,,1,0,1,57,57,36,21,9,5,4,20,0,20,1,0,1
04/08/2022,Southwest,1,CAH,1,22,22,5,17,0,0,0,4,0,4,1,0,1,22,22,5,17,0,0,0,4,0,4,1,0,1
04/08/2022,Southwest,1,GACH,1,,36,17,19,0,0,0,,,,0,0,0,35,36,17,19,0,0,0,8,0,8,0,0,0
04/09/2022,Anchorage,7,GACH,1,897,1065,954,111,206,192,14,154,26,128,22,0,22,1099,1065,954,111,206,192,14,218,42,176,22,0,22
04/09/2022,Anchorage,7,LTACH,0,,42,31,11,6,4,2,,,,0,0,0,42,42,31,11,6,4,2,24,10,14,0,0,0
04/09/2022,Anchorage,7,Psych,0,,,,,,,,,,,,,,0,209,143,66,0,0,0,0,0,0,0,0,0
04/09/2022,Gulf Coast,4,CAH,1,37,69,18,51,4,0,4,12,0,12,0,0,0,81,69,18,51,4,0,4,24,0,24,0,0,0
04/09/2022,Gulf Coast,4,GACH,1,,54,49,5,9,9,0,,,,5,0,5,93,54,49,5,9,9,0,22,0,22,5,0,5
04/09/2022,Interior,6,GACH,1,,101,77,24,13,10,3,,,,3,0,3,101,101,77,24,13,10,3,15,1,14,3,0,3
04/09/2022,Matanuska-Susitna,3,GACH,1,,160,70,90,14,11,3,,,,1,0,1,184,160,70,90,14,11,3,33,3,30,1,0,1
04/09/2022,Northern,2,CAH,1,24,45,17,28,0,0,0,8,0,8,1,0,1,81,45,17,28,0,0,0,36,0,36,1,0,1
04/09/2022,Southeast,5,CAH,1,3,48,26,22,2,0,2,17,0,17,0,0,0,48,48,26,22,2,0,2,33,0,33,0,0,0
04/09/2022,Southeast,5,GACH,1,,57,39,18,9,6,3,,,,1,0,1,57,57,39,18,9,6,3,20,0,20,1,0,1
04/09/2022,Southwest,1,CAH,1,22,22,4,18,0,0,0,4,0,4,1,0,1,22,22,4,18,0,0,0,4,0,4,1,0,1
04/09/2022,Southwest,1,GACH,1,,35,17,18,0,0,0,,,,0,0,0,35,35,17,18,0,0,0,8,0,8,0,0,0
04/10/2022,Anchorage,7,GACH,1,867,1031,928,103,196,185,11,154,24,130,20,0,20,1069,1031,928,103,196,185,11,218,40,178,20,0,20
04/10/2022,Anchorage,7,LTACH,0,,42,34,8,6,4,2,,,,0,0,0,42,42,34,8,6,4,2,24,10,14,0,0,0
04/10/2022,Anchorage,7,Psych,0,,,,,,,,,,,,,,0,209,143,66,0,0,0,0,0,0,0,0,0
04/10/2022,Gulf Coast,4,CAH,1,37,69,18,51,4,0,4,12,0,12,0,0,0,81,69,18,51,4,0,4,24,0,24,0,0,0
04/10/2022,Gulf Coast,4,GACH,1,,54,50,4,9,9,0,,,,5,0,5,93,54,50,4,9,9,0,22,0,22,5,0,5
04/10/2022,Interior,6,GACH,1,,101,85,16,13,12,1,,,,2,1,3,101,101,85,16,13,12,1,15,1,14,2,1,3
04/10/2022,Matanuska-Susitna,3,GACH,1,,160,63,97,14,7,7,,,,0,0,0,184,160,63,97,14,7,7,33,3,30,0,0,0
04/10/2022,Northern,2,CAH,1,24,45,15,30,0,0,0,8,0,8,1,0,1,81,45,15,30,0,0,0,36,0,36,1,0,1
04/10/2022,Southeast,5,CAH,1,3,48,24,24,2,0,2,17,0,17,0,0,0,48,48,24,24,2,0,2,33,0,33,0,0,0
04/10/2022,Southeast,5,GACH,1,,57,36,21,9,5,4,,,,0,0,0,57,57,36,21,9,5,4,20,0,20,0,0,0
04/10/2022,Southwest,1,CAH,1,22,22,3,19,0,0,0,4,0,4,1,0,1,22,22,3,19,0,0,0,4,0,4,1,0,1
04/10/2022,Southwest,1,GACH,1,,35,19,16,0,0,0,,,,0,0,0,35,35,19,16,0,0,0,8,0,8,0,0,0
04/11/2022,Anchorage,7,GACH,1,867,1031,922,109,196,189,7,154,23,131,16,0,16,1069,1031,922,109,196,189,7,218,39,179,16,0,16
04/11/2022,Anchorage,7,LTACH,0,,42,34,8,6,1,5,,,,0,0,0,42,42,34,8,6,1,5,24,10,14,0,0,0
04/11/2022,Anchorage,7,Psych,0,,,,,,,,,,,,,,0,209,143,66,0,0,0,0,0,0,0,0,0
04/11/2022,Gulf Coast,4,CAH,1,32,67,19,48,4,0,4,12,0,12,0,0,0,76,67,19,48,4,0,4,24,0,24,0,0,0
04/11/2022,Gulf Coast,4,GACH,1,,54,50,4,9,8,1,,,,3,0,3,93,54,50,4,9,8,1,22,0,22,3,0,3
04/11/2022,Interior,6,GACH,1,,101,77,24,13,3,10,,,,3,1,4,101,101,77,24,13,3,10,15,1,14,3,1,4
04/11/2022,Matanuska-Susitna,3,GACH,1,,160,66,94,14,6,8,,,,0,0,0,184,160,66,94,14,6,8,33,3,30,0,0,0
04/11/2022,Northern,2,CAH,1,24,45,17,28,0,0,0,8,0,8,2,0,2,81,45,17,28,0,0,0,36,0,36,2,0,2
04/11/2022,Southeast,5,CAH,1,6,51,25,26,2,0,2,17,0,17,1,0,1,51,51,25,26,2,0,2,33,0,33,1,0,1
04/11/2022,Southeast,5,GACH,1,,57,37,20,9,3,6,,,,1,0,1,57,57,37,20,9,3,6,20,0,20,1,0,1
04/11/2022,Southwest,1,CAH,1,22,22,2,20,0,0,0,4,0,4,0,0,0,22,22,2,20,0,0,0,4,0,4,0,0,0
04/11/2022,Southwest,1,GACH,1,,35,17,18,0,0,0,,,,1,0,1,35,35,17,18,0,0,0,8,0,8,1,0,1
04/12/2022,Anchorage,7,GACH,1,857,1017,922,95,198,185,13,154,27,127,14,0,14,1059,1017,922,95,198,185,13,218,43,175,14,0,14
04/12/2022,Anchorage,7,LTACH,0,,42,34,8,6,1,5,,,,0,0,0,42,42,34,8,6,1,5,24,10,14,0,0,0
04/12/2022,Anchorage,7,Psych,0,,,,,,,,,,,,,,0,209,143,66,0,0,0,0,0,0,0,0,0
04/12/2022,Gulf Coast,4,CAH,1,33,68,22,46,4,0,4,12,0,12,0,0,0,77,68,22,46,4,0,4,24,0,24,0,0,0
04/12/2022,Gulf Coast,4,GACH,1,,54,47,7,9,7,2,,,,2,0,2,93,54,47,7,9,7,2,22,0,22,2,0,2
04/12/2022,Interior,6,GACH,1,,101,74,27,13,5,8,,,,2,0,2,101,101,74,27,13,5,8,15,1,14,2,0,2
04/12/2022,Matanuska-Susitna,3,GACH,1,,160,69,91,14,2,12,,,,0,0,0,184,160,69,91,14,2,12,33,3,30,0,0,0
04/12/2022,Northern,2,CAH,1,24,45,15,30,0,0,0,8,0,8,2,0,2,81,45,15,30,0,0,0,36,0,36,2,0,2
04/12/2022,Southeast,5,CAH,1,3,48,21,27,2,0,2,17,0,17,1,0,1,48,48,21,27,2,0,2,33,0,33,1,0,1
04/12/2022,Southeast,5,GACH,1,,57,29,28,9,6,3,,,,0,0,0,57,57,29,28,9,6,3,20,0,20,0,0,0
04/12/2022,Southwest,1,CAH,1,22,22,3,19,0,0,0,4,0,4,0,0,0,22,22,3,19,0,0,0,4,0,4,0,0,0
04/12/2022,Southwest,1,GACH,1,,35,16,19,0,0,0,,,,1,0,1,35,35,16,19,0,0,0,8,0,8,1,0,1
04/13/2022,Anchorage,7,GACH,1,841,1013,914,99,192,175,17,154,26,128,13,0,13,1043,1013,914,99,192,175,17,218,42,176,13,0,13
04/13/2022,Anchorage,7,LTACH,0,,42,35,7,6,1,5,,,,0,0,0,42,42,35,7,6,1,5,24,10,14,0,0,0
04/13/2022,Anchorage,7,Psych,0,140,209,130,79,0,0,0,0,0,0,0,0,0,140,209,130,79,0,0,0,0,0,0,0,0,0
04/13/2022,Gulf Coast,4,CAH,1,34,69,24,45,4,0,4,12,0,12,1,0,1,78,69,24,45,4,0,4,24,0,24,1,0,1
04/13/2022,Gulf Coast,4,GACH,1,,54,44,10,9,7,2,,,,2,0,2,93,54,44,10,9,7,2,22,0,22,2,0,2
04/13/2022,Interior,6,GACH,1,,101,70,31,13,9,4,,,,3,0,3,101,101,70,31,13,9,4,15,1,14,3,0,3
04/13/2022,Matanuska-Susitna,3,GACH,1,,160,72,88,14,6,8,,,,0,0,0,184,160,72,88,14,6,8,33,3,30,0,0,0
04/13/2022,Northern,2,CAH,1,24,45,20,25,0,0,0,8,0,8,2,1,3,81,45,20,25,0,0,0,36,0,36,2,1,3
04/13/2022,Southeast,5,CAH,1,5,50,30,20,3,1,2,17,0,17,1,0,1,50,50,30,20,3,1,2,33,0,33,1,0,1
04/13/2022,Southeast,5,GACH,1,,57,41,16,9,7,2,,,,1,0,1,57,57,41,16,9,7,2,20,0,20,1,0,1
04/13/2022,Southwest,1,CAH,1,22,22,2,20,0,0,0,4,0,4,0,0,0,22,22,2,20,0,0,0,4,0,4,0,0,0
04/13/2022,Southwest,1,GACH,1,,35,23,12,0,0,0,,,,1,0,1,35,35,23,12,0,0,0,8,0,8,1,0,1
04/14/2022,Anchorage,7,GACH,1,885,1052,943,109,181,168,13,154,32,122,11,0,11,1087,1052,943,109,181,168,13,218,48,170,11,0,11
04/14/2022,Anchorage,7,LTACH,0,,42,35,7,6,1,5,,,,0,0,0,42,42,35,7,6,1,5,24,10,14,0,0,0
04/14/2022,Anchorage,7,Psych,0,,,,,,,,,,,,,,140,209,130,79,0,0,0,0,0,0,0,0,0
04/14/2022,Gulf Coast,4,CAH,1,34,69,22,47,4,0,4,12,0,12,1,0,1,78,69,22,47,4,0,4,24,0,24,1,0,1
04/14/2022,Gulf Coast,4,GACH,1,,54,44,10,9,3,6,,,,0,0,0,93,54,44,10,9,3,6,22,0,22,0,0,0
04/14/2022,Interior,6,GACH,1,,101,69,32,13,8,5,,,,3,0,3,101,101,69,32,13,8,5,15,1,14,3,0,3
04/14/2022,Matanuska-Susitna,3,GACH,1,,160,69,91,14,9,5,,,,0,0,0,184,160,69,91,14,9,5,33,3,30,0,0,0
04/14/2022,Northern,2,CAH,1,24,45,14,31,0,0,0,8,0,8,1,0,1,81,45,14,31,0,0,0,36,0,36,1,0,1
04/14/2022,Southeast,5,CAH,1,5,50,31,19,3,1,2,17,0,17,2,0,2,50,50,31,19,3,1,2,33,0,33,2,0,2
04/14/2022,Southeast,5,GACH,1,,57,41,16,9,6,3,,,,1,0,1,57,57,41,16,9,6,3,20,0,20,1,0,1
04/14/2022,Southwest,1,CAH,1,22,22,1,21,0,0,0,4,0,4,0,0,0,22,22,1,21,0,0,0,4,0,4,0,0,0
04/14/2022,Southwest,1,GACH,1,,35,21,14,0,0,0,,,,1,0,1,35,35,21,14,0,0,0,8,0,8,1,0,1
04/15/2022,Anchorage,7,GACH,1,831,987,880,107,183,166,17,154,29,125,14,0,14,1033,987,880,107,183,166,17,218,45,173,14,0,14
04/15/2022,Anchorage,7,LTACH,0,,42,32,10,6,1,5,,,,0,0,0,42,42,32,10,6,1,5,24,10,14,0,0,0
04/15/2022,Anchorage,7,Psych,0,,,,,,,,,,,,,,140,209,130,79,0,0,0,0,0,0,0,0,0
04/15/2022,Gulf Coast,4,CAH,1,32,67,19,48,4,1,3,12,0,12,1,0,1,76,67,19,48,4,1,3,24,0,24,1,0,1
04/15/2022,Gulf Coast,4,GACH,1,,54,39,15,9,3,6,,,,1,0,1,93,54,39,15,9,3,6,22,0,22,1,0,1
04/15/2022,Interior,6,GACH,1,,101,66,35,13,7,6,,,,3,0,3,101,101,66,35,13,7,6,15,1,14,3,0,3
04/15/2022,Matanuska-Susitna,3,GACH,1,,160,73,87,14,8,6,,,,1,0,1,184,160,73,87,14,8,6,33,3,30,1,0,1
04/15/2022,Northern,2,CAH,1,24,45,16,29,0,0,0,8,0,8,1,0,1,81,45,16,29,0,0,0,36,0,36,1,0,1
04/15/2022,Southeast,5,CAH,1,5,50,32,18,3,1,2,17,0,17,3,0,3,50,50,32,18,3,1,2,33,0,33,3,0,3
04/15/2022,Southeast,5,GACH,1,,57,41,16,9,6,3,,,,1,0,1,57,57,41,16,9,6,3,20,0,20,1,0,1
04/15/2022,Southwest,1,CAH,1,22,22,1,21,0,0,0,4,0,4,0,0,0,22,22,1,21,0,0,0,4,0,4,0,0,0
04/15/2022,Southwest,1,GACH,1,,35,26,9,0,0,0,,,,1,0,1,35,35,26,9,0,0,0,8,0,8,1,0,1
04/16/2022,Anchorage,7,GACH,1,827,974,878,96,163,150,13,154,25,129,14,1,15,1029,974,878,96,163,150,13,218,41,177,14,1,15
04/16/2022,Anchorage,7,LTACH,0,,42,32,10,6,1,5,,,,0,0,0,42,42,32,10,6,1,5,24,10,14,0,0,0
04/16/2022,Anchorage,7,Psych,0,,,,,,,,,,,,,,140,209,130,79,0,0,0,0,0,0,0,0,0
04/16/2022,Gulf Coast,4,CAH,1,33,68,25,43,4,0,4,12,0,12,2,0,2,77,68,25,43,4,0,4,24,0,24,2,0,2
04/16/2022,Gulf Coast,4,GACH,1,,54,35,19,9,6,3,,,,0,0,0,93,54,35,19,9,6,3,22,0,22,0,0,0
04/16/2022,Interior,6,GACH,1,,101,64,37,13,10,3,,,,2,0,2,101,101,64,37,13,10,3,15,1,14,2,0,2
04/16/2022,Matanuska-Susitna,3,GACH,1,,160,65,95,14,8,6,,,,1,0,1,184,160,65,95,14,8,6,33,3,30,1,0,1
04/16/2022,Northern,2,CAH,1,24,45,20,25,0,0,0,8,0,8,0,0,0,81,45,20,25,0,0,0,36,0,36,0,0,0
04/16/2022,Southeast,5,CAH,1,5,50,32,18,3,1,2,17,0,17,2,0,2,50,50,32,18,3,1,2,33,0,33,2,0,2
04/16/2022,Southeast,5,GACH,1,,57,37,20,9,6,3,,,,1,0,1,57,57,37,20,9,6,3,20,0,20,1,0,1
04/16/2022,Southwest,1,CAH,1,22,22,2,20,0,0,0,4,0,4,0,0,0,22,22,2,20,0,0,0,4,0,4,0,0,0
04/16/2022,Southwest,1,GACH,1,,35,17,18,0,0,0,,,,1,0,1,35,35,17,18,0,0,0,8,0,8,1,0,1
04/17/2022,Anchorage,7,GACH,1,795,946,848,98,152,137,15,154,18,136,10,1,11,997,946,848,98,152,137,15,218,34,184,10,1,11
04/17/2022,Anchorage,7,LTACH,0,,42,33,9,6,1,5,,,,0,0,0,42,42,33,9,6,1,5,24,10,14,0,0,0
04/17/2022,Anchorage,7,Psych,0,,,,,,,,,,,,,,140,209,130,79,0,0,0,0,0,0,0,0,0
04/17/2022,Gulf Coast,4,CAH,1,33,68,20,48,4,0,4,12,0,12,1,0,1,77,68,20,48,4,0,4,24,0,24,1,0,1
04/17/2022,Gulf Coast,4,GACH,1,,54,37,17,9,6,3,,,,0,0,0,93,54,37,17,9,6,3,22,0,22,0,0,0
04/17/2022,Interior,6,GACH,1,,101,49,52,13,8,5,,,,2,0,2,101,101,49,52,13,8,5,15,1,14,2,0,2
04/17/2022,Matanuska-Susitna,3,GACH,1,,160,59,101,14,8,6,,,,1,0,1,184,160,59,101,14,8,6,33,3,30,1,0,1
04/17/2022,Northern,2,CAH,1,24,45,20,25,0,0,0,8,0,8,0,0,0,81,45,20,25,0,0,0,36,0,36,0,0,0
04/17/2022,Southeast,5,CAH,1,5,50,25,25,3,1,2,17,0,17,1,0,1,50,50,25,25,3,1,2,33,0,33,1,0,1
04/17/2022,Southeast,5,GACH,1,,57,39,18,9,3,6,,,,1,0,1,57,57,39,18,9,3,6,20,0,20,1,0,1
04/17/2022,Southwest,1,CAH,1,22,22,2,20,0,0,0,4,0,4,0,0,0,22,22,2,20,0,0,0,4,0,4,0,0,0
04/17/2022,Southwest,1,GACH,1,,35,17,18,0,0,0,,,,1,0,1,35,35,17,18,0,0,0,8,0,8,1,0,1
04/18/2022,Anchorage,7,GACH,1,849,1004,897,107,186,160,26,154,21,133,8,0,8,1051,1004,897,107,186,160,26,218,37,181,8,0,8
04/18/2022,Anchorage,7,LTACH,0,,42,33,9,6,3,3,23,3,20,0,0,0,42,42,33,9,6,3,3,23,3,20,0,0,0
04/18/2022,Anchorage,7,Psych,0,,,,,,,,,,,,,,140,209,130,79,0,0,0,0,0,0,0,0,0
04/18/2022,Gulf Coast,4,CAH,1,36,71,23,48,4,0,4,6,0,6,1,0,1,80,71,23,48,4,0,4,18,0,18,1,0,1
04/18/2022,Gulf Coast,4,GACH,1,,54,33,21,9,5,4,,,,0,0,0,93,54,33,21,9,5,4,22,0,22,0,0,0
04/18/2022,Interior,6,GACH,1,,101,50,51,13,7,6,,,,2,0,2,101,101,50,51,13,7,6,15,1,14,2,0,2
04/18/2022,Matanuska-Susitna,3,GACH,1,,160,63,97,14,9,5,,,,0,0,0,184,160,63,97,14,9,5,33,3,30,0,0,0
04/18/2022,Northern,2,CAH,1,24,45,19,26,0,0,0,8,0,8,0,0,0,81,45,19,26,0,0,0,36,0,36,0,0,0
04/18/2022,Southeast,5,CAH,1,9,54,32,22,2,0,2,17,0,17,2,0,2,54,54,32,22,2,0,2,33,0,33,2,0,2
04/18/2022,Southeast,5,GACH,1,,57,39,18,9,3,6,,,,2,0,2,57,57,39,18,9,3,6,20,0,20,2,0,2
04/18/2022,Southwest,1,CAH,1,22,22,3,19,0,0,0,4,0,4,0,0,0,22,22,3,19,0,0,0,4,0,4,0,0,0
04/18/2022,Southwest,1,GACH,1,,35,17,18,0,0,0,,,,1,0,1,35,35,17,18,0,0,0,8,0,8,1,0,1
04/19/2022,Anchorage,7,GACH,1,853,1013,923,90,178,162,16,154,28,126,10,1,11,1055,1013,923,90,178,162,16,218,44,174,10,1,11
04/19/2022,Anchorage,7,LTACH,0,,42,33,9,6,1,5,,,,0,0,0,42,42,33,9,6,1,5,23,3,20,0,0,0
04/19/2022,Anchorage,7,Psych,0,,,,,,,,,,,,,,140,209,130,79,0,0,0,0,0,0,0,0,0
04/19/2022,Gulf Coast,4,CAH,1,35,70,19,51,4,0,4,12,0,12,1,0,1,79,70,19,51,4,0,4,24,0,24,1,0,1
04/19/2022,Gulf Coast,4,GACH,1,,54,43,11,9,8,1,,,,0,0,0,93,54,43,11,9,8,1,22,0,22,0,0,0
04/19/2022,Interior,6,GACH,1,,101,59,42,13,11,2,,,,2,0,2,101,101,59,42,13,11,2,15,1,14,2,0,2
04/19/2022,Matanuska-Susitna,3,GACH,1,,160,68,92,14,10,4,,,,1,0,1,184,160,68,92,14,10,4,33,3,30,1,0,1
04/19/2022,Northern,2,CAH,1,24,45,16,29,0,0,0,8,0,8,0,0,0,81,45,16,29,0,0,0,36,0,36,0,0,0
04/19/2022,Southeast,5,CAH,1,16,61,41,20,3,1,2,17,0,17,3,0,3,61,61,41,20,3,1,2,33,0,33,3,0,3
04/19/2022,Southeast,5,GACH,1,,57,37,20,9,4,5,,,,2,0,2,57,57,37,20,9,4,5,20,0,20,2,0,2
04/19/2022,Southwest,1,CAH,1,22,22,2,20,0,0,0,4,0,4,0,0,0,22,22,2,20,0,0,0,4,0,4,0,0,0
04/19/2022,Southwest,1,GACH,1,,35,17,18,0,0,0,,,,1,0,1,35,35,17,18,0,0,0,8,0,8,1,0,1
04/20/2022,Anchorage,7,GACH,1,873,1049,957,92,188,175,13,154,24,130,10,1,11,1075,1049,957,92,188,175,13,218,40,178,10,1,11
04/20/2022,Anchorage,7,LTACH,0,,42,32,10,6,1,5,,,,0,0,0,42,42,32,10,6,1,5,23,3,20,0,0,0
04/20/2022,Anchorage,7,Psych,0,140,209,122,87,0,0,0,0,0,0,0,0,0,140,209,122,87,0,0,0,0,0,0,0,0,0
04/20/2022,Gulf Coast,4,CAH,1,36,71,21,50,4,0,4,12,0,12,0,0,0,80,71,21,50,4,0,4,24,0,24,0,0,0
04/20/2022,Gulf Coast,4,GACH,1,,54,43,11,9,6,3,,,,1,0,1,93,54,43,11,9,6,3,22,0,22,1,0,1
04/20/2022,Interior,6,GACH,1,,101,58,43,13,11,2,,,,2,0,2,101,101,58,43,13,11,2,15,1,14,2,0,2
04/20/2022,Matanuska-Susitna,3,GACH,1,,160,70,90,14,11,3,,,,3,0,3,184,160,70,90,14,11,3,33,3,30,3,0,3
04/20/2022,Northern,2,CAH,1,24,45,24,21,0,0,0,8,0,8,0,0,0,81,45,24,21,0,0,0,36,0,36,0,0,0
04/20/2022,Southeast,5,CAH,1,12,57,31,26,2,0,2,17,0,17,3,0,3,57,57,31,26,2,0,2,33,0,33,3,0,3
04/20/2022,Southeast,5,GACH,1,,57,40,17,9,2,7,,,,1,0,1,57,57,40,17,9,2,7,20,0,20,1,0,1
04/20/2022,Southwest,1,CAH,1,22,22,1,21,0,0,0,4,0,4,0,0,0,22,22,1,21,0,0,0,4,0,4,0,0,0
04/20/2022,Southwest,1,GACH,1,,35,21,14,0,0,0,,,,1,0,1,35,35,21,14,0,0,0,8,0,8,1,0,1
04/21/2022,Anchorage,7,GACH,1,851,1013,924,89,171,155,16,154,16,138,14,1,15,1053,1013,924,89,171,155,16,218,32,186,14,1,15
04/21/2022,Anchorage,7,LTACH,0,,42,31,11,6,1,5,,,,0,0,0,42,42,31,11,6,1,5,23,3,20,0,0,0
04/21/2022,Anchorage,7,Psych,0,,,,,,,,,,,,,,140,209,122,87,0,0,0,0,0,0,0,0,0
04/21/2022,Gulf Coast,4,CAH,1,36,71,24,47,4,0,4,12,0,12,1,0,1,80,71,24,47,4,0,4,24,0,24,1,0,1
04/21/2022,Gulf Coast,4,GACH,1,,54,46,8,9,5,4,,,,1,0,1,93,54,46,8,9,5,4,22,0,22,1,0,1
04/21/2022,Interior,6,GACH,1,,101,62,39,13,7,6,,,,2,0,2,101,101,62,39,13,7,6,15,1,14,2,0,2
04/21/2022,Matanuska-Susitna,3,GACH,1,,160,66,94,14,6,8,,,,2,0,2,184,160,66,94,14,6,8,33,3,30,2,0,2
04/21/2022,Northern,2,CAH,1,24,45,23,22,0,0,0,8,0,8,0,0,0,81,45,23,22,0,0,0,36,0,36,0,0,0
04/21/2022,Southeast,5,CAH,1,13,58,32,26,2,0,2,17,0,17,4,0,4,58,58,32,26,2,0,2,33,0,33,4,0,4
04/21/2022,Southeast,5,GACH,1,,57,45,12,9,5,4,,,,1,0,1,57,57,45,12,9,5,4,20,0,20,1,0,1
04/21/2022,Southwest,1,CAH,1,22,22,2,20,0,0,0,4,0,4,0,0,0,22,22,2,20,0,0,0,4,0,4,0,0,0
04/21/2022,Southwest,1,GACH,1,,35,23,12,0,0,0,,,,1,0,1,35,35,23,12,0,0,0,8,0,8,1,0,1
04/22/2022,Anchorage,7,GACH,1,839,1009,907,102,182,168,14,154,15,139,13,0,13,1041,1009,907,102,182,168,14,218,31,187,13,0,13
04/22/2022,Anchorage,7,LTACH,0,,42,30,12,6,2,4,23,2,21,0,0,0,42,42,30,12,6,2,4,23,2,21,0,0,0
04/22/2022,Anchorage,7,Psych,0,,,,,,,,,,,,,,140,209,122,87,0,0,0,0,0,0,0,0,0
04/22/2022,Gulf Coast,4,CAH,1,35,70,25,45,4,1,3,6,0,6,0,0,0,79,70,25,45,4,1,3,18,0,18,0,0,0
04/22/2022,Gulf Coast,4,GACH,1,,54,46,8,9,7,2,,,,1,0,1,93,54,46,8,9,7,2,22,0,22,1,0,1
04/22/2022,Interior,6,GACH,1,,101,66,35,13,8,5,,,,1,0,1,101,101,66,35,13,8,5,15,1,14,1,0,1
04/22/2022,Matanuska-Susitna,3,GACH,1,,160,69,91,14,10,4,,,,0,0,0,184,160,69,91,14,10,4,33,3,30,0,0,0
04/22/2022,Northern,2,CAH,1,24,45,19,26,0,0,0,8,0,8,0,0,0,81,45,19,26,0,0,0,36,0,36,0,0,0
04/22/2022,Southeast,5,CAH,1,14,59,34,25,3,1,2,17,0,17,2,0,2,59,59,34,25,3,1,2,33,0,33,2,0,2
04/22/2022,Southeast,5,GACH,1,,57,47,10,9,5,4,,,,1,0,1,57,57,47,10,9,5,4,20,0,20,1,0,1
04/22/2022,Southwest,1,CAH,1,22,22,1,21,0,0,0,4,0,4,0,0,0,22,22,1,21,0,0,0,4,0,4,0,0,0
04/22/2022,Southwest,1,GACH,1,,35,21,14,0,0,0,,,,1,0,1,35,35,21,14,0,0,0,8,0,8,1,0,1
04/23/2022,Anchorage,7,GACH,1,843,1014,907,107,177,161,16,154,12,142,11,0,11,1045,1014,907,107,177,161,16,218,28,190,11,0,11
04/23/2022,Anchorage,7,LTACH,0,,42,30,12,6,2,4,,,,0,0,0,42,42,30,12,6,2,4,23,2,21,0,0,0
04/23/2022,Anchorage,7,Psych,0,,,,,,,,,,,,,,140,209,122,87,0,0,0,0,0,0,0,0,0
04/23/2022,Gulf Coast,4,CAH,1,35,70,24,46,4,0,4,12,0,12,1,0,1,79,70,24,46,4,0,4,24,0,24,1,0,1
04/23/2022,Gulf Coast,4,GACH,1,,54,43,11,9,9,0,,,,2,0,2,93,54,43,11,9,9,0,22,0,22,2,0,2
04/23/2022,Interior,6,GACH,1,,101,63,38,13,11,2,,,,0,0,0,101,101,63,38,13,11,2,15,1,14,0,0,0
04/23/2022,Matanuska-Susitna,3,GACH,1,,160,83,77,14,8,6,,,,0,0,0,184,160,83,77,14,8,6,33,3,30,0,0,0
04/23/2022,Northern,2,CAH,1,24,45,15,30,0,0,0,8,0,8,0,0,0,81,45,15,30,0,0,0,36,0,36,0,0,0
04/23/2022,Southeast,5,CAH,1,14,59,33,26,3,1,2,17,0,17,4,0,4,59,59,33,26,3,1,2,33,0,33,4,0,4
04/23/2022,Southeast,5,GACH,1,,57,35,22,9,5,4,,,,1,0,1,57,57,35,22,9,5,4,20,0,20,1,0,1
04/23/2022,Southwest,1,CAH,1,22,22,3,19,0,0,0,4,0,4,0,0,0,22,22,3,19,0,0,0,4,0,4,0,0,0
04/23/2022,Southwest,1,GACH,1,,35,17,18,0,0,0,,,,1,0,1,35,35,17,18,0,0,0,8,0,8,1,0,1
04/24/2022,Anchorage,7,GACH,1,837,998,888,110,180,168,12,154,12,142,15,0,15,1039,998,888,110,180,168,12,218,28,190,15,0,15
04/24/2022,Anchorage,7,LTACH,0,,42,32,10,6,2,4,,,,0,0,0,42,42,32,10,6,2,4,23,2,21,0,0,0
04/24/2022,Anchorage,7,Psych,0,,,,,,,,,,,,,,140,209,122,87,0,0,0,0,0,0,0,0,0
04/24/2022,Gulf Coast,4,CAH,1,34,69,19,50,4,1,3,12,0,12,1,0,1,78,69,19,50,4,1,3,24,0,24,1,0,1
04/24/2022,Gulf Coast,4,GACH,1,,54,39,15,9,5,4,,,,1,0,1,93,54,39,15,9,5,4,22,0,22,1,0,1
04/24/2022,Interior,6,GACH,1,,101,64,37,13,9,4,,,,1,0,1,101,101,64,37,13,9,4,15,1,14,1,0,1
04/24/2022,Matanuska-Susitna,3,GACH,1,,160,81,79,14,9,5,,,,2,0,2,184,160,81,79,14,9,5,33,3,30,2,0,2
04/24/2022,Northern,2,CAH,1,24,45,19,26,0,0,0,8,0,8,0,0,0,81,45,19,26,0,0,0,36,0,36,0,0,0
04/24/2022,Southeast,5,CAH,1,14,59,30,29,3,1,2,17,0,17,2,0,2,59,59,30,29,3,1,2,33,0,33,2,0,2
04/24/2022,Southeast,5,GACH,1,,57,33,24,9,4,5,,,,1,0,1,57,57,33,24,9,4,5,20,0,20,1,0,1
04/24/2022,Southwest,1,CAH,1,22,22,2,20,0,0,0,4,0,4,0,0,0,22,22,2,20,0,0,0,4,0,4,0,0,0
04/24/2022,Southwest,1,GACH,1,,35,15,20,0,0,0,,,,1,0,1,35,35,15,20,0,0,0,8,0,8,1,0,1
04/25/2022,Anchorage,7,GACH,1,855,1019,922,97,180,164,16,154,15,139,20,0,20,1057,1019,922,97,180,164,16,218,31,187,20,0,20
04/25/2022,Anchorage,7,LTACH,0,,42,32,10,6,2,4,,,,0,0,0,42,42,32,10,6,2,4,23,2,21,0,0,0
04/25/2022,Anchorage,7,Psych,0,,,,,,,,,,,,,,140,209,122,87,0,0,0,0,0,0,0,0,0
04/25/2022,Gulf Coast,4,CAH,1,36,71,22,49,4,0,4,12,0,12,1,0,1,80,71,22,49,4,0,4,24,0,24,1,0,1
04/25/2022,Gulf Coast,4,GACH,1,,54,35,19,9,5,4,,,,1,0,1,93,54,35,19,9,5,4,22,0,22,1,0,1
04/25/2022,Interior,6,GACH,1,,101,66,35,13,10,3,,,,1,0,1,101,101,66,35,13,10,3,15,1,14,1,0,1
04/25/2022,Matanuska-Susitna,3,GACH,1,,160,77,83,14,9,5,,,,3,0,3,184,160,77,83,14,9,5,33,3,30,3,0,3
04/25/2022,Northern,2,CAH,1,24,45,21,24,0,0,0,8,0,8,0,0,0,81,45,21,24,0,0,0,36,0,36,0,0,0
04/25/2022,Southeast,5,CAH,1,14,59,31,28,3,1,2,17,0,17,2,0,2,59,59,31,28,3,1,2,33,0,33,2,0,2
04/25/2022,Southeast,5,GACH,1,,57,38,19,9,3,6,,,,1,0,1,57,57,38,19,9,3,6,20,0,20,1,0,1
04/25/2022,Southwest,1,CAH,1,22,22,3,19,0,0,0,4,0,4,0,0,0,22,22,3,19,0,0,0,4,0,4,0,0,0
04/25/2022,Southwest,1,GACH,1,,35,14,21,0,0,0,,,,1,0,1,35,35,14,21,0,0,0,8,0,8,1,0,1
04/26/2022,Anchorage,7,GACH,1,891,1052,966,86,187,174,13,154,15,139,20,0,20,1093,1052,966,86,187,174,13,218,31,187,20,0,20
04/26/2022,Anchorage,7,LTACH,0,49,31,31,0,11,2,9,23,2,21,0,0,0,49,31,31,0,11,2,9,23,2,21,0,0,0
04/26/2022,Anchorage,7,Psych,0,,,,,,,,,,,,,,140,209,122,87,0,0,0,0,0,0,0,0,0
04/26/2022,Gulf Coast,4,CAH,1,34,69,18,51,4,0,4,12,0,12,1,0,1,78,69,18,51,4,0,4,24,0,24,1,0,1
04/26/2022,Gulf Coast,4,GACH,1,,54,43,11,9,6,3,,,,1,0,1,93,54,43,11,9,6,3,22,0,22,1,0,1
04/26/2022,Interior,6,GACH,1,,101,66,35,13,9,4,,,,0,0,0,101,101,66,35,13,9,4,15,1,14,0,0,0
04/26/2022,Matanuska-Susitna,3,GACH,1,,160,85,75,14,7,7,,,,2,0,2,184,160,85,75,14,7,7,33,3,30,2,0,2
04/26/2022,Northern,2,CAH,1,24,45,24,21,0,0,0,8,0,8,0,0,0,81,45,24,21,0,0,0,36,0,36,0,0,0
04/26/2022,Southeast,5,CAH,1,14,59,34,25,3,1,2,17,0,17,3,0,3,59,59,34,25,3,1,2,33,0,33,3,0,3
04/26/2022,Southeast,5,GACH,1,,57,57,0,9,4,5,,,,1,0,1,57,57,57,0,9,4,5,20,0,20,1,0,1
04/26/2022,Southwest,1,CAH,1,22,22,4,18,0,0,0,4,0,4,0,0,0,22,22,4,18,0,0,0,4,0,4,0,0,0
04/26/2022,Southwest,1,GACH,1,,35,15,20,0,0,0,,,,1,0,1,35,35,15,20,0,0,0,8,0,8,1,0,1
04/27/2022,Anchorage,7,GACH,1,849,1008,917,91,184,173,11,154,25,129,18,0,18,1051,1008,917,91,184,173,11,218,41,177,18,0,18
04/27/2022,Anchorage,7,LTACH,0,49,32,32,0,11,2,9,23,1,22,0,0,0,49,32,32,0,11,2,9,23,1,22,0,0,0
04/27/2022,Anchorage,7,Psych,0,140,203,116,87,0,0,0,0,0,0,0,0,0,140,203,116,87,0,0,0,0,0,0,0,0,0
04/27/2022,Gulf Coast,4,CAH,1,34,69,21,48,4,0,4,12,0,12,2,0,2,78,69,21,48,4,0,4,24,0,24,2,0,2
04/27/2022,Gulf Coast,4,GACH,1,,54,53,1,9,9,0,,,,2,0,2,93,54,53,1,9,9,0,22,0,22,2,0,2
04/27/2022,Interior,6,GACH,1,,101,74,27,13,6,7,,,,1,0,1,101,101,74,27,13,6,7,15,1,14,1,0,1
04/27/2022,Matanuska-Susitna,3,GACH,1,,160,86,74,14,6,8,,,,2,0,2,184,160,86,74,14,6,8,33,3,30,2,0,2
04/27/2022,Northern,2,CAH,1,24,45,20,25,0,0,0,8,0,8,0,0,0,81,45,20,25,0,0,0,36,0,36,0,0,0
04/27/2022,Southeast,5,CAH,1,14,59,35,24,3,1,2,17,0,17,3,0,3,59,59,35,24,3,1,2,33,0,33,3,0,3
04/27/2022,Southeast,5,GACH,1,,57,37,20,9,4,5,,,,1,0,1,57,57,37,20,9,4,5,20,0,20,1,0,1
04/27/2022,Southwest,1,CAH,1,22,22,5,17,0,0,0,4,0,4,0,0,0,22,22,5,17,0,0,0,4,0,4,0,0,0
04/27/2022,Southwest,1,GACH,1,,35,12,23,0,0,0,,,,1,0,1,35,35,12,23,0,0,0,8,0,8,1,0,1
04/28/2022,Anchorage,7,GACH,1,861,1022,933,89,188,175,13,154,24,130,14,0,14,1063,1022,933,89,188,175,13,218,40,178,14,0,14
04/28/2022,Anchorage,7,LTACH,0,44,44,33,11,11,2,9,23,1,22,0,0,0,44,44,33,11,11,2,9,23,1,22,0,0,0
04/28/2022,Anchorage,7,Psych,0,,,,,,,,,,,,,,140,203,116,87,0,0,0,0,0,0,0,0,0
04/28/2022,Gulf Coast,4,CAH,1,36,71,23,48,4,0,4,12,0,12,2,0,2,80,71,23,48,4,0,4,24,0,24,2,0,2
04/28/2022,Gulf Coast,4,GACH,1,,54,54,0,9,9,0,,,,2,0,2,93,54,54,0,9,9,0,22,0,22,2,0,2
04/28/2022,Interior,6,GACH,1,,101,72,29,13,6,7,,,,0,0,0,101,101,72,29,13,6,7,15,1,14,0,0,0
04/28/2022,Matanuska-Susitna,3,GACH,1,,160,75,85,14,10,4,,,,3,0,3,184,160,75,85,14,10,4,33,3,30,3,0,3
04/28/2022,Northern,2,CAH,1,24,45,21,24,0,0,0,8,0,8,0,0,0,81,45,21,24,0,0,0,36,0,36,0,0,0
04/28/2022,Southeast,5,CAH,1,14,59,37,22,3,3,0,17,0,17,3,0,3,59,59,37,22,3,3,0,33,0,33,3,0,3
04/28/2022,Southeast,5,GACH,1,,57,35,22,9,6,3,,,,1,0,1,57,57,35,22,9,6,3,20,0,20,1,0,1
04/28/2022,Southwest,1,CAH,1,22,22,7,15,0,0,0,4,0,4,0,0,0,22,22,7,15,0,0,0,4,0,4,0,0,0
04/28/2022,Southwest,1,GACH,1,,35,12,23,0,0,0,,,,2,0,2,35,35,12,23,0,0,0,8,0,8,2,0,2
04/29/2022,Anchorage,7,GACH,1,865,1016,927,89,178,161,17,154,20,134,17,0,17,1067,1016,927,89,178,161,17,218,36,182,17,0,17
04/29/2022,Anchorage,7,LTACH,0,44,34,34,0,11,2,9,23,2,21,0,0,0,44,34,34,0,11,2,9,23,2,21,0,0,0
04/29/2022,Anchorage,7,Psych,0,,,,,,,,,,,,,,140,203,116,87,0,0,0,0,0,0,0,0,0
04/29/2022,Gulf Coast,4,CAH,1,35,70,20,50,4,0,4,12,0,12,2,0,2,79,70,20,50,4,0,4,24,0,24,2,0,2
04/29/2022,Gulf Coast,4,GACH,1,,54,48,6,9,9,0,,,,3,0,3,93,54,48,6,9,9,0,22,0,22,3,0,3
04/29/2022,Interior,6,GACH,1,,101,74,27,13,6,7,,,,1,0,1,101,101,74,27,13,6,7,15,1,14,1,0,1
04/29/2022,Matanuska-Susitna,3,GACH,1,,160,71,89,14,10,4,,,,2,0,2,184,160,71,89,14,10,4,33,3,30,2,0,2
04/29/2022,Northern,2,CAH,1,24,45,21,24,0,0,0,8,0,8,0,0,0,81,45,21,24,0,0,0,36,0,36,0,0,0
04/29/2022,Southeast,5,CAH,1,14,59,35,24,3,3,0,17,0,17,3,0,3,59,59,35,24,3,3,0,33,0,33,3,0,3
04/29/2022,Southeast,5,GACH,1,,57,31,26,9,4,5,,,,1,0,1,57,57,31,26,9,4,5,20,0,20,1,0,1
04/29/2022,Southwest,1,CAH,1,22,22,6,16,0,0,0,4,0,4,0,0,0,22,22,6,16,0,0,0,4,0,4,0,0,0
04/29/2022,Southwest,1,GACH,1,,35,10,25,0,0,0,,,,0,0,0,35,35,10,25,0,0,0,8,0,8,0,0,0
04/30/2022,Anchorage,7,GACH,1,865,1014,923,91,184,169,15,154,14,140,17,0,17,1067,1014,923,91,184,169,15,218,30,188,17,0,17
04/30/2022,Anchorage,7,LTACH,0,44,34,34,0,11,2,9,23,2,21,0,0,0,44,34,34,0,11,2,9,23,2,21,0,0,0
04/30/2022,Anchorage,7,Psych,0,,,,,,,,,,,,,,140,203,116,87,0,0,0,0,0,0,0,0,0
04/30/2022,Gulf Coast,4,CAH,1,35,70,21,49,4,0,4,12,0,12,1,0,1,79,70,21,49,4,0,4,24,0,24,1,0,1
04/30/2022,Gulf Coast,4,GACH,1,,54,48,6,9,9,0,,,,3,0,3,93,54,48,6,9,9,0,22,0,22,3,0,3
04/30/2022,Interior,6,GACH,1,,101,76,25,13,6,7,,,,1,0,1,101,101,76,25,13,6,7,15,1,14,1,0,1
04/30/2022,Matanuska-Susitna,3,GACH,1,,160,57,103,14,6,8,,,,2,0,2,184,160,57,103,14,6,8,33,3,30,2,0,2
04/30/2022,Northern,2,CAH,1,24,45,14,31,0,0,0,8,0,8,0,0,0,81,45,14,31,0,0,0,36,0,36,0,0,0
04/30/2022,Southeast,5,CAH,1,14,59,38,21,3,1,2,17,0,17,2,0,2,59,59,38,21,3,1,2,33,0,33,2,0,2
04/30/2022,Southeast,5,GACH,1,,57,29,28,9,5,4,,,,1,0,1,57,57,29,28,9,5,4,20,0,20,1,0,1
04/30/2022,Southwest,1,CAH,1,22,22,5,17,0,0,0,4,0,4,0,0,0,22,22,5,17,0,0,0,4,0,4,0,0,0
04/30/2022,Southwest,1,GACH,1,,35,10,25,0,0,0,,,,0,0,0,35,35,10,25,0,0,0,8,0,8,0,0,0
05/01/2022,Anchorage,7,GACH,1,877,1025,939,86,182,165,17,154,14,140,20,0,20,1079,1025,939,86,182,165,17,218,30,188,20,0,20
05/01/2022,Anchorage,7,LTACH,0,44,34,34,0,11,2,9,23,1,22,0,0,0,44,34,34,0,11,2,9,23,1,22,0,0,0
05/01/2022,Anchorage,7,Psych,0,,,,,,,,,,,,,,140,203,116,87,0,0,0,0,0,0,0,0,0
05/01/2022,Gulf Coast,4,CAH,1,35,70,22,48,4,0,4,12,0,12,1,0,1,79,70,22,48,4,0,4,24,0,24,1,0,1
05/01/2022,Gulf Coast,4,GACH,1,,54,44,10,9,7,2,,,,2,0,2,93,54,44,10,9,7,2,22,0,22,2,0,2
05/01/2022,Interior,6,GACH,1,,101,71,30,13,6,7,,,,1,0,1,101,101,71,30,13,6,7,15,1,14,1,0,1
05/01/2022,Matanuska-Susitna,3,GACH,1,,160,53,107,14,9,5,,,,0,0,0,184,160,53,107,14,9,5,33,3,30,0,0,0
05/01/2022,Northern,2,CAH,1,24,45,17,28,0,0,0,8,0,8,0,0,0,81,45,17,28,0,0,0,36,0,36,0,0,0
05/01/2022,Southeast,5,CAH,1,14,59,35,24,3,1,2,17,0,17,1,0,1,59,59,35,24,3,1,2,33,0,33,1,0,1
05/01/2022,Southeast,5,GACH,1,,57,39,18,9,4,5,,,,3,0,3,57,57,39,18,9,4,5,20,0,20,3,0,3
05/01/2022,Southwest,1,CAH,1,22,22,5,17,0,0,0,4,0,4,0,0,0,22,22,5,17,0,0,0,4,0,4,0,0,0
05/01/2022,Southwest,1,GACH,1,,35,12,23,0,0,0,,,,0,0,0,35,35,12,23,0,0,0,8,0,8,0,0,0
05/02/2022,Anchorage,7,GACH,1,887,1032,925,107,199,178,21,154,22,132,25,0,25,1089,1032,925,107,199,178,21,218,38,180,25,0,25
05/02/2022,Anchorage,7,LTACH,0,44,34,34,0,11,2,9,23,1,22,0,0,0,44,34,34,0,11,2,9,23,1,22,0,0,0
05/02/2022,Anchorage,7,Psych,0,,,,,,,,,,,,,,140,203,116,87,0,0,0,0,0,0,0,0,0
05/02/2022,Gulf Coast,4,CAH,1,39,71,23,48,4,0,4,12,0,12,1,0,1,83,71,23,48,4,0,4,24,0,24,1,0,1
05/02/2022,Gulf Coast,4,GACH,1,,54,39,15,9,7,2,,,,2,0,2,93,54,39,15,9,7,2,22,0,22,2,0,2
05/02/2022,Interior,6,GACH,1,,101,68,33,13,4,9,,,,1,0,1,101,101,68,33,13,4,9,15,1,14,1,0,1
05/02/2022,Matanuska-Susitna,3,GACH,1,,160,65,95,14,8,6,,,,0,0,0,184,160,65,95,14,8,6,33,3,30,0,0,0
05/02/2022,Northern,2,CAH,1,24,45,22,23,0,0,0,8,0,8,0,0,0,81,45,22,23,0,0,0,36,0,36,0,0,0
05/02/2022,Southeast,5,CAH,1,14,59,38,21,3,1,2,17,0,17,2,0,2,59,59,38,21,3,1,2,33,0,33,2,0,2
05/02/2022,Southeast,5,GACH,1,,,,,,,,,,,,,,57,57,39,18,9,4,5,20,0,20,3,0,3
05/02/2022,Southwest,1,CAH,1,22,22,5,17,0,0,0,4,0,4,0,0,0,22,22,5,17,0,0,0,4,0,4,0,0,0
05/02/2022,Southwest,1,GACH,1,,35,10,25,0,0,0,,,,0,0,0,35,35,10,25,0,0,0,8,0,8,0,0,0
05/03/2022,Anchorage,7,GACH,1,209,364,259,105,42,24,18,71,1,70,2,0,2,1089,1042,937,105,202,184,18,218,37,181,24,0,24
05/03/2022,Anchorage,7,LTACH,0,,,,,,,,,,,,,,44,34,34,0,11,2,9,23,1,22,0,0,0
05/03/2022,Anchorage,7,Psych,0,,,,,,,,,,,,,,140,203,116,87,0,0,0,0,0,0,0,0,0
05/03/2022,Gulf Coast,4,CAH,1,,13,2,11,0,0,0,,,,0,0,0,83,71,23,48,4,0,4,24,0,24,1,0,1
05/03/2022,Gulf Coast,4,GACH,1,,54,43,11,9,4,5,,,,3,0,3,93,54,43,11,9,4,5,22,0,22,3,0,3
05/03/2022,Interior,6,GACH,1,,101,68,33,13,5,8,,,,0,0,0,101,101,68,33,13,5,8,15,1,14,0,0,0
05/03/2022,Matanuska-Susitna,3,GACH,1,,160,83,77,14,10,4,,,,1,0,1,184,160,83,77,14,10,4,33,3,30,1,0,1
05/03/2022,Northern,2,CAH,1,24,45,24,21,0,0,0,8,0,8,0,0,0,81,45,24,21,0,0,0,36,0,36,0,0,0
05/03/2022,Southeast,5,CAH,1,15,48,33,15,6,4,2,17,0,17,1,0,1,60,60,37,23,6,4,2,33,0,33,1,0,1
05/03/2022,Southeast,5,GACH,1,,,,,,,,,,,,,,57,57,39,18,9,4,5,20,0,20,3,0,3
05/03/2022,Southwest,1,CAH,1,,,,,,,,,,,,,,22,22,5,17,0,0,0,4,0,4,0,0,0
05/03/2022,Southwest,1,GACH,1,,35,15,20,0,0,0,,,,0,0,0,35,35,15,20,0,0,0,8,0,8,0,0,0
