"Date","Resident..Y.N.","Occurrence..Y.N.","Borough","Borough.Code","BHR","BHR.Code","Cases..Date.Reported.","Cumulative.Cases..Date.Reported.","Cases..Date.Onset.","Cumulative.Cases..Date.Onset.","Hospitalizations..Date.Hospitalized.","Cumulative.Hospitalizations..Date.Hospitalized.","Deaths..Date.Died.","Cumulative.Deaths..Date.Died."
"06/07/2020","N","Y","Aleutians East Borough",13,"Southwest Region",11,0,0,1,1,0,0,0,0
"06/08/2020","N","Y","Aleutians East Borough",13,"Southwest Region",11,1,1,0,1,0,0,0,0
"06/12/2020","N","Y","Aleutians East Borough",13,"Southwest Region",11,0,1,1,2,0,0,0,0
"06/14/2020","N","Y","Aleutians East Borough",13,"Southwest Region",11,1,2,0,2,0,0,0,0
"09/02/2020","N","Y","Aleutians East Borough",13,"Southwest Region",11,0,2,6,8,0,0,0,0
"09/03/2020","N","Y","Aleutians East Borough",13,"Southwest Region",11,6,8,0,8,0,0,0,0
"09/12/2020","N","Y","Aleutians East Borough",13,"Southwest Region",11,0,8,1,9,0,0,0,0
"09/13/2020","N","Y","Aleutians East Borough",13,"Southwest Region",11,1,9,0,9,0,0,0,0
"10/08/2020","N","Y","Aleutians East Borough",13,"Southwest Region",11,0,9,1,10,0,0,0,0
"10/09/2020","N","Y","Aleutians East Borough",13,"Southwest Region",11,1,10,0,10,0,0,0,0
"01/16/2021","N","Y","Aleutians East Borough",13,"Southwest Region",11,0,10,1,11,0,0,0,0
"01/17/2021","N","Y","Aleutians East Borough",13,"Southwest Region",11,0,10,8,19,0,0,0,0
"01/18/2021","N","Y","Aleutians East Borough",13,"Southwest Region",11,2,12,15,34,0,0,0,0
"01/19/2021","N","Y","Aleutians East Borough",13,"Southwest Region",11,0,12,3,37,0,0,0,0
"01/20/2021","N","Y","Aleutians East Borough",13,"Southwest Region",11,1,13,4,41,0,0,0,0
"01/21/2021","N","Y","Aleutians East Borough",13,"Southwest Region",11,18,31,2,43,0,0,0,0
"01/22/2021","N","Y","Aleutians East Borough",13,"Southwest Region",11,7,38,2,45,0,0,0,0
"01/23/2021","N","Y","Aleutians East Borough",13,"Southwest Region",11,0,38,5,50,0,0,0,0
"01/24/2021","N","Y","Aleutians East Borough",13,"Southwest Region",11,0,38,45,95,1,1,0,0
"01/25/2021","N","Y","Aleutians East Borough",13,"Southwest Region",11,0,38,36,131,1,2,0,0
"01/26/2021","N","Y","Aleutians East Borough",13,"Southwest Region",11,0,38,52,183,1,3,0,0
"01/27/2021","N","Y","Aleutians East Borough",13,"Southwest Region",11,1,39,50,233,1,4,0,0
"01/28/2021","N","Y","Aleutians East Borough",13,"Southwest Region",11,3,42,6,239,2,6,0,0
"01/29/2021","N","Y","Aleutians East Borough",13,"Southwest Region",11,4,46,12,251,0,6,0,0
"01/30/2021","N","Y","Aleutians East Borough",13,"Southwest Region",11,1,47,10,261,1,7,0,0
"01/31/2021","N","Y","Aleutians East Borough",13,"Southwest Region",11,17,64,9,270,0,7,1,1
"02/01/2021","N","Y","Aleutians East Borough",13,"Southwest Region",11,23,87,4,274,1,8,0,1
"02/02/2021","N","Y","Aleutians East Borough",13,"Southwest Region",11,19,106,0,274,1,9,0,1
"02/03/2021","N","Y","Aleutians East Borough",13,"Southwest Region",11,25,131,16,290,0,9,0,1
"02/04/2021","N","Y","Aleutians East Borough",13,"Southwest Region",11,98,229,3,293,0,9,0,1
"02/05/2021","N","Y","Aleutians East Borough",13,"Southwest Region",11,30,259,1,294,0,9,0,1
"02/06/2021","N","Y","Aleutians East Borough",13,"Southwest Region",11,10,269,1,295,0,9,0,1
"02/08/2021","N","Y","Aleutians East Borough",13,"Southwest Region",11,4,273,3,298,0,9,0,1
"02/09/2021","N","Y","Aleutians East Borough",13,"Southwest Region",11,13,286,0,298,0,9,0,1
"02/10/2021","N","Y","Aleutians East Borough",13,"Southwest Region",11,3,289,4,302,0,9,0,1
"02/11/2021","N","Y","Aleutians East Borough",13,"Southwest Region",11,4,293,0,302,0,9,0,1
"02/12/2021","N","Y","Aleutians East Borough",13,"Southwest Region",11,2,295,0,302,0,9,0,1
"02/13/2021","N","Y","Aleutians East Borough",13,"Southwest Region",11,0,295,0,302,0,9,1,2
"02/17/2021","N","Y","Aleutians East Borough",13,"Southwest Region",11,4,299,3,305,0,9,0,2
"02/20/2021","N","Y","Aleutians East Borough",13,"Southwest Region",11,3,302,0,305,0,9,0,2
"02/25/2021","N","Y","Aleutians East Borough",13,"Southwest Region",11,3,305,0,305,0,9,0,2
"02/26/2021","N","Y","Aleutians East Borough",13,"Southwest Region",11,0,305,1,306,0,9,0,2
"03/01/2021","N","Y","Aleutians East Borough",13,"Southwest Region",11,1,306,0,306,0,9,1,3
"03/15/2021","N","Y","Aleutians East Borough",13,"Southwest Region",11,0,306,1,307,0,9,0,3
"03/17/2021","N","Y","Aleutians East Borough",13,"Southwest Region",11,1,307,0,307,0,9,0,3
"05/12/2021","N","Y","Aleutians East Borough",13,"Southwest Region",11,0,307,1,308,0,9,0,3
"05/18/2021","N","Y","Aleutians East Borough",13,"Southwest Region",11,1,308,0,308,0,9,0,3
"09/20/2021","N","Y","Aleutians East Borough",13,"Southwest Region",11,0,308,1,309,0,9,0,3
"09/24/2021","N","Y","Aleutians East Borough",13,"Southwest Region",11,0,308,1,310,0,9,0,3
"09/29/2021","N","Y","Aleutians East Borough",13,"Southwest Region",11,1,309,0,310,0,9,0,3
"10/04/2021","N","Y","Aleutians East Borough",13,"Southwest Region",11,1,310,0,310,0,9,0,3
"10/07/2021","N","Y","Aleutians East Borough",13,"Southwest Region",11,0,310,1,311,0,9,0,3
"10/14/2021","N","Y","Aleutians East Borough",13,"Southwest Region",11,1,311,1,312,0,9,0,3
"10/18/2021","N","Y","Aleutians East Borough",13,"Southwest Region",11,0,311,1,313,1,10,0,3
"10/19/2021","N","Y","Aleutians East Borough",13,"Southwest Region",11,1,312,0,313,0,10,0,3
"10/22/2021","N","Y","Aleutians East Borough",13,"Southwest Region",11,1,313,1,314,0,10,0,3
"11/01/2021","N","Y","Aleutians East Borough",13,"Southwest Region",11,0,313,1,315,0,10,0,3
"11/04/2021","N","Y","Aleutians East Borough",13,"Southwest Region",11,2,315,0,315,0,10,0,3
"12/17/2021","N","Y","Aleutians East Borough",13,"Southwest Region",11,0,315,1,316,0,10,0,3
"12/23/2021","N","Y","Aleutians East Borough",13,"Southwest Region",11,1,316,0,316,0,10,0,3
"12/26/2021","N","Y","Aleutians East Borough",13,"Southwest Region",11,0,316,2,318,0,10,0,3
"12/27/2021","N","Y","Aleutians East Borough",13,"Southwest Region",11,0,316,1,319,0,10,0,3
"12/30/2021","N","Y","Aleutians East Borough",13,"Southwest Region",11,1,317,1,320,0,10,0,3
"12/31/2021","N","Y","Aleutians East Borough",13,"Southwest Region",11,0,317,2,322,0,10,0,3
"01/01/2022","N","Y","Aleutians East Borough",13,"Southwest Region",11,0,317,4,326,0,10,0,3
"01/02/2022","N","Y","Aleutians East Borough",13,"Southwest Region",11,0,317,3,329,0,10,0,3
"01/03/2022","N","Y","Aleutians East Borough",13,"Southwest Region",11,2,319,14,343,0,10,0,3
"01/04/2022","N","Y","Aleutians East Borough",13,"Southwest Region",11,1,320,3,346,0,10,0,3
"01/05/2022","N","Y","Aleutians East Borough",13,"Southwest Region",11,0,320,5,351,0,10,0,3
"01/06/2022","N","Y","Aleutians East Borough",13,"Southwest Region",11,1,321,4,355,0,10,0,3
"01/07/2022","N","Y","Aleutians East Borough",13,"Southwest Region",11,0,321,8,363,0,10,0,3
"01/08/2022","N","Y","Aleutians East Borough",13,"Southwest Region",11,4,325,7,370,0,10,0,3
"01/09/2022","N","Y","Aleutians East Borough",13,"Southwest Region",11,5,330,10,380,0,10,0,3
"01/10/2022","N","Y","Aleutians East Borough",13,"Southwest Region",11,1,331,10,390,0,10,0,3
"01/11/2022","N","Y","Aleutians East Borough",13,"Southwest Region",11,22,353,2,392,0,10,0,3
"01/12/2022","N","Y","Aleutians East Borough",13,"Southwest Region",11,9,362,3,395,0,10,0,3
"01/13/2022","N","Y","Aleutians East Borough",13,"Southwest Region",11,4,366,8,403,0,10,0,3
"01/14/2022","N","Y","Aleutians East Borough",13,"Southwest Region",11,1,367,4,407,0,10,0,3
"01/15/2022","N","Y","Aleutians East Borough",13,"Southwest Region",11,0,367,4,411,0,10,0,3
"01/17/2022","N","Y","Aleutians East Borough",13,"Southwest Region",11,1,368,11,422,0,10,0,3
"01/18/2022","N","Y","Aleutians East Borough",13,"Southwest Region",11,9,377,19,441,0,10,0,3
"01/19/2022","N","Y","Aleutians East Borough",13,"Southwest Region",11,8,385,8,449,0,10,0,3
"01/20/2022","N","Y","Aleutians East Borough",13,"Southwest Region",11,0,385,7,456,0,10,0,3
"01/21/2022","N","Y","Aleutians East Borough",13,"Southwest Region",11,0,385,2,458,0,10,0,3
"01/22/2022","N","Y","Aleutians East Borough",13,"Southwest Region",11,0,385,4,462,0,10,0,3
"01/23/2022","N","Y","Aleutians East Borough",13,"Southwest Region",11,1,386,1,463,0,10,0,3
"01/24/2022","N","Y","Aleutians East Borough",13,"Southwest Region",11,0,386,5,468,0,10,0,3
"01/25/2022","N","Y","Aleutians East Borough",13,"Southwest Region",11,0,386,3,471,0,10,0,3
"01/26/2022","N","Y","Aleutians East Borough",13,"Southwest Region",11,18,404,0,471,0,10,0,3
"01/27/2022","N","Y","Aleutians East Borough",13,"Southwest Region",11,44,448,0,471,0,10,0,3
"01/28/2022","N","Y","Aleutians East Borough",13,"Southwest Region",11,16,464,0,471,0,10,0,3
"01/29/2022","N","Y","Aleutians East Borough",13,"Southwest Region",11,0,464,11,482,0,10,0,3
"01/31/2022","N","Y","Aleutians East Borough",13,"Southwest Region",11,7,471,0,482,0,10,0,3
"02/01/2022","N","Y","Aleutians East Borough",13,"Southwest Region",11,0,471,1,483,0,10,0,3
"02/03/2022","N","Y","Aleutians East Borough",13,"Southwest Region",11,0,471,3,486,0,10,0,3
"02/04/2022","N","Y","Aleutians East Borough",13,"Southwest Region",11,3,474,2,488,0,10,0,3
"02/05/2022","N","Y","Aleutians East Borough",13,"Southwest Region",11,10,484,0,488,0,10,0,3
"02/08/2022","N","Y","Aleutians East Borough",13,"Southwest Region",11,1,485,2,490,0,10,0,3
"02/11/2022","N","Y","Aleutians East Borough",13,"Southwest Region",11,2,487,1,491,0,10,0,3
"02/12/2022","N","Y","Aleutians East Borough",13,"Southwest Region",11,3,490,1,492,0,10,0,3
"02/14/2022","N","Y","Aleutians East Borough",13,"Southwest Region",11,1,491,1,493,0,10,0,3
"02/19/2022","N","Y","Aleutians East Borough",13,"Southwest Region",11,2,493,0,493,0,10,0,3
"06/03/2020","N","Y","Aleutians West Census Area",16,"Southwest Region",11,3,3,2,2,0,0,0,0
"06/04/2020","N","Y","Aleutians West Census Area",16,"Southwest Region",11,0,3,1,3,0,0,0,0
"06/09/2020","N","Y","Aleutians West Census Area",16,"Southwest Region",11,0,3,1,4,0,0,0,0
"06/10/2020","N","Y","Aleutians West Census Area",16,"Southwest Region",11,1,4,0,4,0,0,0,0
"07/01/2020","N","Y","Aleutians West Census Area",16,"Southwest Region",11,1,5,1,5,0,0,0,0
"07/16/2020","N","Y","Aleutians West Census Area",16,"Southwest Region",11,0,5,6,11,0,0,0,0
"07/17/2020","N","Y","Aleutians West Census Area",16,"Southwest Region",11,6,11,45,56,0,0,0,0
"07/18/2020","N","Y","Aleutians West Census Area",16,"Southwest Region",11,32,43,1,57,0,0,0,0
"07/19/2020","N","Y","Aleutians West Census Area",16,"Southwest Region",11,41,84,27,84,0,0,0,0
"07/22/2020","N","Y","Aleutians West Census Area",16,"Southwest Region",11,0,84,0,84,1,1,0,0
"07/23/2020","N","Y","Aleutians West Census Area",16,"Southwest Region",11,0,84,1,85,0,1,0,0
"07/24/2020","N","Y","Aleutians West Census Area",16,"Southwest Region",11,1,85,0,85,0,1,0,0
"07/28/2020","N","Y","Aleutians West Census Area",16,"Southwest Region",11,0,85,1,86,0,1,0,0
"08/01/2020","N","Y","Aleutians West Census Area",16,"Southwest Region",11,1,86,0,86,0,1,0,0
"08/22/2020","N","Y","Aleutians West Census Area",16,"Southwest Region",11,0,86,1,87,0,1,0,0
"08/24/2020","N","Y","Aleutians West Census Area",16,"Southwest Region",11,1,87,1,88,0,1,0,0
"08/25/2020","N","Y","Aleutians West Census Area",16,"Southwest Region",11,1,88,1,89,0,1,0,0
"08/26/2020","N","Y","Aleutians West Census Area",16,"Southwest Region",11,1,89,0,89,0,1,0,0
"09/03/2020","N","Y","Aleutians West Census Area",16,"Southwest Region",11,0,89,1,90,0,1,0,0
"09/04/2020","N","Y","Aleutians West Census Area",16,"Southwest Region",11,1,90,0,90,0,1,0,0
"09/06/2020","N","Y","Aleutians West Census Area",16,"Southwest Region",11,0,90,1,91,0,1,0,0
"09/07/2020","N","Y","Aleutians West Census Area",16,"Southwest Region",11,1,91,0,91,0,1,0,0
"10/08/2020","N","Y","Aleutians West Census Area",16,"Southwest Region",11,0,91,1,92,0,1,0,0
"10/12/2020","N","Y","Aleutians West Census Area",16,"Southwest Region",11,1,92,0,92,0,1,0,0
"12/02/2020","N","Y","Aleutians West Census Area",16,"Southwest Region",11,1,93,3,95,0,1,0,0
"12/03/2020","N","Y","Aleutians West Census Area",16,"Southwest Region",11,0,93,2,97,0,1,0,0
"12/04/2020","N","Y","Aleutians West Census Area",16,"Southwest Region",11,3,96,24,121,0,1,0,0
"12/05/2020","N","Y","Aleutians West Census Area",16,"Southwest Region",11,2,98,0,121,0,1,0,0
"12/06/2020","N","Y","Aleutians West Census Area",16,"Southwest Region",11,20,118,8,129,0,1,0,0
"12/07/2020","N","Y","Aleutians West Census Area",16,"Southwest Region",11,10,128,2,131,0,1,0,0
"12/08/2020","N","Y","Aleutians West Census Area",16,"Southwest Region",11,2,130,0,131,0,1,0,0
"12/09/2020","N","Y","Aleutians West Census Area",16,"Southwest Region",11,0,130,1,132,0,1,0,0
"12/10/2020","N","Y","Aleutians West Census Area",16,"Southwest Region",11,1,131,1,133,0,1,0,0
"12/11/2020","N","Y","Aleutians West Census Area",16,"Southwest Region",11,2,133,0,133,0,1,0,0
"12/13/2020","N","Y","Aleutians West Census Area",16,"Southwest Region",11,0,133,1,134,0,1,0,0
"12/14/2020","N","Y","Aleutians West Census Area",16,"Southwest Region",11,0,133,4,138,0,1,0,0
"12/15/2020","N","Y","Aleutians West Census Area",16,"Southwest Region",11,3,136,1,139,0,1,0,0
"12/16/2020","N","Y","Aleutians West Census Area",16,"Southwest Region",11,1,137,2,141,0,1,0,0
"12/17/2020","N","Y","Aleutians West Census Area",16,"Southwest Region",11,2,139,0,141,0,1,0,0
"12/21/2020","N","Y","Aleutians West Census Area",16,"Southwest Region",11,0,139,1,142,0,1,0,0
"12/22/2020","N","Y","Aleutians West Census Area",16,"Southwest Region",11,1,140,3,145,0,1,0,0
"12/23/2020","N","Y","Aleutians West Census Area",16,"Southwest Region",11,3,143,2,147,0,1,0,0
"12/24/2020","N","Y","Aleutians West Census Area",16,"Southwest Region",11,4,147,3,150,0,1,0,0
"12/26/2020","N","Y","Aleutians West Census Area",16,"Southwest Region",11,2,149,0,150,0,1,0,0
"12/28/2020","N","Y","Aleutians West Census Area",16,"Southwest Region",11,0,149,2,152,0,1,0,0
"12/29/2020","N","Y","Aleutians West Census Area",16,"Southwest Region",11,0,149,6,158,0,1,0,0
"12/30/2020","N","Y","Aleutians West Census Area",16,"Southwest Region",11,5,154,2,160,0,1,0,0
"12/31/2020","N","Y","Aleutians West Census Area",16,"Southwest Region",11,4,158,5,165,0,1,0,0
"01/01/2021","N","Y","Aleutians West Census Area",16,"Southwest Region",11,3,161,0,165,0,1,0,0
"01/02/2021","N","Y","Aleutians West Census Area",16,"Southwest Region",11,4,165,0,165,0,1,0,0
"01/04/2021","N","Y","Aleutians West Census Area",16,"Southwest Region",11,0,165,1,166,0,1,0,0
"01/06/2021","N","Y","Aleutians West Census Area",16,"Southwest Region",11,0,165,1,167,0,1,0,0
"01/07/2021","N","Y","Aleutians West Census Area",16,"Southwest Region",11,1,166,1,168,0,1,0,0
"01/08/2021","N","Y","Aleutians West Census Area",16,"Southwest Region",11,1,167,1,169,0,1,0,0
"01/10/2021","N","Y","Aleutians West Census Area",16,"Southwest Region",11,1,168,1,170,0,1,0,0
"01/11/2021","N","Y","Aleutians West Census Area",16,"Southwest Region",11,1,169,1,171,0,1,0,0
"01/12/2021","N","Y","Aleutians West Census Area",16,"Southwest Region",11,2,171,6,177,0,1,0,0
"01/13/2021","N","Y","Aleutians West Census Area",16,"Southwest Region",11,0,171,1,178,0,1,0,0
"01/14/2021","N","Y","Aleutians West Census Area",16,"Southwest Region",11,2,173,0,178,0,1,0,0
"01/15/2021","N","Y","Aleutians West Census Area",16,"Southwest Region",11,0,173,1,179,0,1,0,0
"01/16/2021","N","Y","Aleutians West Census Area",16,"Southwest Region",11,5,178,2,181,0,1,0,0
"01/18/2021","N","Y","Aleutians West Census Area",16,"Southwest Region",11,1,179,2,183,0,1,0,0
"01/19/2021","N","Y","Aleutians West Census Area",16,"Southwest Region",11,2,181,2,185,0,1,0,0
"01/20/2021","N","Y","Aleutians West Census Area",16,"Southwest Region",11,3,184,4,189,0,1,0,0
"01/21/2021","N","Y","Aleutians West Census Area",16,"Southwest Region",11,3,187,1,190,0,1,0,0
"01/22/2021","N","Y","Aleutians West Census Area",16,"Southwest Region",11,0,187,7,197,0,1,0,0
"01/23/2021","N","Y","Aleutians West Census Area",16,"Southwest Region",11,0,187,3,200,0,1,0,0
"01/24/2021","N","Y","Aleutians West Census Area",16,"Southwest Region",11,0,187,2,202,0,1,0,0
"01/25/2021","N","Y","Aleutians West Census Area",16,"Southwest Region",11,4,191,7,209,0,1,0,0
"01/26/2021","N","Y","Aleutians West Census Area",16,"Southwest Region",11,9,200,5,214,0,1,0,0
"01/27/2021","N","Y","Aleutians West Census Area",16,"Southwest Region",11,4,204,13,227,0,1,0,0
"01/28/2021","N","Y","Aleutians West Census Area",16,"Southwest Region",11,7,211,4,231,0,1,0,0
"01/29/2021","N","Y","Aleutians West Census Area",16,"Southwest Region",11,1,212,5,236,0,1,0,0
"01/30/2021","N","Y","Aleutians West Census Area",16,"Southwest Region",11,4,216,1,237,0,1,0,0
"01/31/2021","N","Y","Aleutians West Census Area",16,"Southwest Region",11,15,231,2,239,0,1,0,0
"02/01/2021","N","Y","Aleutians West Census Area",16,"Southwest Region",11,2,233,4,243,0,1,0,0
"02/02/2021","N","Y","Aleutians West Census Area",16,"Southwest Region",11,5,238,5,248,0,1,0,0
"02/03/2021","N","Y","Aleutians West Census Area",16,"Southwest Region",11,2,240,3,251,0,1,0,0
"02/04/2021","N","Y","Aleutians West Census Area",16,"Southwest Region",11,5,245,4,255,0,1,0,0
"02/05/2021","N","Y","Aleutians West Census Area",16,"Southwest Region",11,3,248,11,266,0,1,0,0
"02/06/2021","N","Y","Aleutians West Census Area",16,"Southwest Region",11,13,261,2,268,0,1,0,0
"02/07/2021","N","Y","Aleutians West Census Area",16,"Southwest Region",11,0,261,1,269,0,1,0,0
"02/08/2021","N","Y","Aleutians West Census Area",16,"Southwest Region",11,2,263,5,274,0,1,0,0
"02/09/2021","N","Y","Aleutians West Census Area",16,"Southwest Region",11,3,266,3,277,0,1,0,0
"02/10/2021","N","Y","Aleutians West Census Area",16,"Southwest Region",11,7,273,11,288,0,1,0,0
"02/11/2021","N","Y","Aleutians West Census Area",16,"Southwest Region",11,2,275,29,317,0,1,0,0
"02/12/2021","N","Y","Aleutians West Census Area",16,"Southwest Region",11,13,288,15,332,0,1,0,0
"02/13/2021","N","Y","Aleutians West Census Area",16,"Southwest Region",11,9,297,19,351,0,1,0,0
"02/14/2021","N","Y","Aleutians West Census Area",16,"Southwest Region",11,9,306,33,384,0,1,0,0
"02/15/2021","N","Y","Aleutians West Census Area",16,"Southwest Region",11,8,314,23,407,0,1,0,0
"02/16/2021","N","Y","Aleutians West Census Area",16,"Southwest Region",11,2,316,12,419,0,1,0,0
"02/17/2021","N","Y","Aleutians West Census Area",16,"Southwest Region",11,0,316,8,427,0,1,0,0
"02/18/2021","N","Y","Aleutians West Census Area",16,"Southwest Region",11,21,337,4,431,1,2,0,0
"02/19/2021","N","Y","Aleutians West Census Area",16,"Southwest Region",11,5,342,9,440,0,2,0,0
"02/20/2021","N","Y","Aleutians West Census Area",16,"Southwest Region",11,18,360,8,448,0,2,0,0
"02/21/2021","N","Y","Aleutians West Census Area",16,"Southwest Region",11,1,361,3,451,0,2,0,0
"02/22/2021","N","Y","Aleutians West Census Area",16,"Southwest Region",11,2,363,3,454,1,3,0,0
"02/23/2021","N","Y","Aleutians West Census Area",16,"Southwest Region",11,1,364,3,457,0,3,0,0
"02/24/2021","N","Y","Aleutians West Census Area",16,"Southwest Region",11,34,398,4,461,0,3,0,0
"02/25/2021","N","Y","Aleutians West Census Area",16,"Southwest Region",11,3,401,2,463,0,3,0,0
"02/26/2021","N","Y","Aleutians West Census Area",16,"Southwest Region",11,7,408,0,463,0,3,0,0
"02/27/2021","N","Y","Aleutians West Census Area",16,"Southwest Region",11,5,413,0,463,0,3,0,0
"02/28/2021","N","Y","Aleutians West Census Area",16,"Southwest Region",11,1,414,2,465,0,3,0,0
"03/01/2021","N","Y","Aleutians West Census Area",16,"Southwest Region",11,34,448,2,467,0,3,0,0
"03/02/2021","N","Y","Aleutians West Census Area",16,"Southwest Region",11,14,462,2,469,0,3,0,0
"03/03/2021","N","Y","Aleutians West Census Area",16,"Southwest Region",11,5,467,0,469,0,3,0,0
"03/04/2021","N","Y","Aleutians West Census Area",16,"Southwest Region",11,2,469,0,469,0,3,0,0
"03/06/2021","N","Y","Aleutians West Census Area",16,"Southwest Region",11,0,469,3,472,0,3,0,0
"03/07/2021","N","Y","Aleutians West Census Area",16,"Southwest Region",11,0,469,1,473,0,3,0,0
"03/08/2021","N","Y","Aleutians West Census Area",16,"Southwest Region",11,0,469,3,476,0,3,0,0
"03/09/2021","N","Y","Aleutians West Census Area",16,"Southwest Region",11,2,471,3,479,0,3,0,0
"03/10/2021","N","Y","Aleutians West Census Area",16,"Southwest Region",11,8,479,0,479,0,3,0,0
"03/12/2021","N","Y","Aleutians West Census Area",16,"Southwest Region",11,0,479,1,480,0,3,0,0
"03/15/2021","N","Y","Aleutians West Census Area",16,"Southwest Region",11,1,480,1,481,0,3,0,0
"03/16/2021","N","Y","Aleutians West Census Area",16,"Southwest Region",11,0,480,1,482,0,3,0,0
"03/17/2021","N","Y","Aleutians West Census Area",16,"Southwest Region",11,2,482,0,482,0,3,0,0
"03/28/2021","N","Y","Aleutians West Census Area",16,"Southwest Region",11,0,482,1,483,0,3,0,0
"04/02/2021","N","Y","Aleutians West Census Area",16,"Southwest Region",11,0,482,1,484,0,3,0,0
"04/05/2021","N","Y","Aleutians West Census Area",16,"Southwest Region",11,0,482,1,485,0,3,0,0
"04/06/2021","N","Y","Aleutians West Census Area",16,"Southwest Region",11,1,483,0,485,0,3,0,0
"04/08/2021","N","Y","Aleutians West Census Area",16,"Southwest Region",11,1,484,0,485,0,3,0,0
"04/09/2021","N","Y","Aleutians West Census Area",16,"Southwest Region",11,0,484,1,486,0,3,0,0
"04/10/2021","N","Y","Aleutians West Census Area",16,"Southwest Region",11,0,484,2,488,0,3,0,0
"04/11/2021","N","Y","Aleutians West Census Area",16,"Southwest Region",11,0,484,20,508,0,3,0,0
"04/12/2021","N","Y","Aleutians West Census Area",16,"Southwest Region",11,21,505,0,508,0,3,0,0
"04/15/2021","N","Y","Aleutians West Census Area",16,"Southwest Region",11,0,505,1,509,0,3,0,0
"04/16/2021","N","Y","Aleutians West Census Area",16,"Southwest Region",11,0,505,1,510,0,3,0,0
"04/17/2021","N","Y","Aleutians West Census Area",16,"Southwest Region",11,1,506,1,511,0,3,0,0
"04/18/2021","N","Y","Aleutians West Census Area",16,"Southwest Region",11,1,507,0,511,0,3,0,0
"04/19/2021","N","Y","Aleutians West Census Area",16,"Southwest Region",11,4,511,0,511,0,3,0,0
"04/28/2021","N","Y","Aleutians West Census Area",16,"Southwest Region",11,0,511,1,512,0,3,0,0
"04/29/2021","N","Y","Aleutians West Census Area",16,"Southwest Region",11,0,511,1,513,0,3,0,0
"04/30/2021","N","Y","Aleutians West Census Area",16,"Southwest Region",11,1,512,0,513,0,3,0,0
"05/03/2021","N","Y","Aleutians West Census Area",16,"Southwest Region",11,1,513,0,513,0,3,0,0
"05/18/2021","N","Y","Aleutians West Census Area",16,"Southwest Region",11,0,513,1,514,0,3,0,0
"05/20/2021","N","Y","Aleutians West Census Area",16,"Southwest Region",11,1,514,1,515,0,3,0,0
"05/21/2021","N","Y","Aleutians West Census Area",16,"Southwest Region",11,1,515,1,516,0,3,0,0
"05/22/2021","N","Y","Aleutians West Census Area",16,"Southwest Region",11,1,516,0,516,0,3,0,0
"05/30/2021","N","Y","Aleutians West Census Area",16,"Southwest Region",11,0,516,1,517,0,3,0,0
"06/01/2021","N","Y","Aleutians West Census Area",16,"Southwest Region",11,1,517,0,517,0,3,0,0
"06/15/2021","N","Y","Aleutians West Census Area",16,"Southwest Region",11,0,517,1,518,0,3,0,0
"06/16/2021","N","Y","Aleutians West Census Area",16,"Southwest Region",11,1,518,3,521,0,3,0,0
"06/18/2021","N","Y","Aleutians West Census Area",16,"Southwest Region",11,1,519,2,523,0,3,0,0
"06/19/2021","N","Y","Aleutians West Census Area",16,"Southwest Region",11,3,522,0,523,0,3,0,0
"06/21/2021","N","Y","Aleutians West Census Area",16,"Southwest Region",11,1,523,0,523,0,3,0,0
"06/22/2021","N","Y","Aleutians West Census Area",16,"Southwest Region",11,0,523,4,527,0,3,0,0
"06/26/2021","N","Y","Aleutians West Census Area",16,"Southwest Region",11,4,527,0,527,0,3,0,0
"07/02/2021","N","Y","Aleutians West Census Area",16,"Southwest Region",11,0,527,1,528,0,3,0,0
"07/06/2021","N","Y","Aleutians West Census Area",16,"Southwest Region",11,1,528,0,528,0,3,0,0
"07/20/2021","N","Y","Aleutians West Census Area",16,"Southwest Region",11,0,528,2,530,0,3,0,0
"07/21/2021","N","Y","Aleutians West Census Area",16,"Southwest Region",11,2,530,9,539,0,3,0,0
"07/22/2021","N","Y","Aleutians West Census Area",16,"Southwest Region",11,0,530,1,540,0,3,0,0
"07/25/2021","N","Y","Aleutians West Census Area",16,"Southwest Region",11,0,530,8,548,0,3,0,0
"07/26/2021","N","Y","Aleutians West Census Area",16,"Southwest Region",11,10,540,9,557,0,3,0,0
"07/27/2021","N","Y","Aleutians West Census Area",16,"Southwest Region",11,17,557,5,562,0,3,0,0
"07/29/2021","N","Y","Aleutians West Census Area",16,"Southwest Region",11,5,562,0,562,0,3,0,0
"08/02/2021","N","Y","Aleutians West Census Area",16,"Southwest Region",11,1,563,1,563,0,3,0,0
"08/09/2021","N","Y","Aleutians West Census Area",16,"Southwest Region",11,0,563,1,564,0,3,0,0
"08/12/2021","N","Y","Aleutians West Census Area",16,"Southwest Region",11,1,564,0,564,0,3,0,0
"08/27/2021","N","Y","Aleutians West Census Area",16,"Southwest Region",11,0,564,2,566,0,3,0,0
"08/30/2021","N","Y","Aleutians West Census Area",16,"Southwest Region",11,0,564,4,570,0,3,0,0
"09/01/2021","N","Y","Aleutians West Census Area",16,"Southwest Region",11,2,566,0,570,0,3,0,0
"09/04/2021","N","Y","Aleutians West Census Area",16,"Southwest Region",11,4,570,0,570,0,3,0,0
"09/11/2021","N","Y","Aleutians West Census Area",16,"Southwest Region",11,0,570,4,574,0,3,0,0
"09/12/2021","N","Y","Aleutians West Census Area",16,"Southwest Region",11,0,570,6,580,0,3,0,0
"09/14/2021","N","Y","Aleutians West Census Area",16,"Southwest Region",11,0,570,5,585,0,3,0,0
"09/17/2021","N","Y","Aleutians West Census Area",16,"Southwest Region",11,4,574,0,585,0,3,0,0
"09/18/2021","N","Y","Aleutians West Census Area",16,"Southwest Region",11,6,580,0,585,0,3,0,0
"09/20/2021","N","Y","Aleutians West Census Area",16,"Southwest Region",11,0,580,4,589,0,3,0,0
"09/22/2021","N","Y","Aleutians West Census Area",16,"Southwest Region",11,5,585,0,589,0,3,0,0
"09/23/2021","N","Y","Aleutians West Census Area",16,"Southwest Region",11,1,586,0,589,0,3,0,0
"09/24/2021","N","Y","Aleutians West Census Area",16,"Southwest Region",11,3,589,0,589,0,3,0,0
"11/01/2021","N","Y","Aleutians West Census Area",16,"Southwest Region",11,1,590,2,591,0,3,0,0
"11/02/2021","N","Y","Aleutians West Census Area",16,"Southwest Region",11,1,591,3,594,0,3,0,0
"11/03/2021","N","Y","Aleutians West Census Area",16,"Southwest Region",11,3,594,1,595,0,3,0,0
"11/04/2021","N","Y","Aleutians West Census Area",16,"Southwest Region",11,1,595,0,595,0,3,0,0
"12/29/2021","N","Y","Aleutians West Census Area",16,"Southwest Region",11,0,595,3,598,0,3,0,0
"12/31/2021","N","Y","Aleutians West Census Area",16,"Southwest Region",11,0,595,4,602,0,3,0,0
"01/02/2022","N","Y","Aleutians West Census Area",16,"Southwest Region",11,1,596,0,602,0,3,0,0
"01/03/2022","N","Y","Aleutians West Census Area",16,"Southwest Region",11,6,602,1,603,0,3,0,0
"01/04/2022","N","Y","Aleutians West Census Area",16,"Southwest Region",11,0,602,4,607,0,3,0,0
"01/05/2022","N","Y","Aleutians West Census Area",16,"Southwest Region",11,3,605,7,614,0,3,0,0
"01/06/2022","N","Y","Aleutians West Census Area",16,"Southwest Region",11,1,606,7,621,0,3,0,0
"01/07/2022","N","Y","Aleutians West Census Area",16,"Southwest Region",11,15,621,1,622,0,3,0,0
"01/08/2022","N","Y","Aleutians West Census Area",16,"Southwest Region",11,0,621,1,623,0,3,0,0
"01/10/2022","N","Y","Aleutians West Census Area",16,"Southwest Region",11,0,621,4,627,0,3,0,0
"01/11/2022","N","Y","Aleutians West Census Area",16,"Southwest Region",11,0,621,18,645,0,3,0,0
"01/12/2022","N","Y","Aleutians West Census Area",16,"Southwest Region",11,7,628,16,661,0,3,0,0
"01/13/2022","N","Y","Aleutians West Census Area",16,"Southwest Region",11,19,647,38,699,0,3,0,0
"01/14/2022","N","Y","Aleutians West Census Area",16,"Southwest Region",11,14,661,29,728,0,3,0,0
"01/15/2022","N","Y","Aleutians West Census Area",16,"Southwest Region",11,2,663,6,734,0,3,0,0
"01/16/2022","N","Y","Aleutians West Census Area",16,"Southwest Region",11,9,672,4,738,0,3,0,0
"01/17/2022","N","Y","Aleutians West Census Area",16,"Southwest Region",11,0,672,5,743,0,3,0,0
"01/18/2022","N","Y","Aleutians West Census Area",16,"Southwest Region",11,14,686,6,749,1,4,0,0
"01/19/2022","N","Y","Aleutians West Census Area",16,"Southwest Region",11,53,739,4,753,0,4,0,0
"01/20/2022","N","Y","Aleutians West Census Area",16,"Southwest Region",11,6,745,8,761,0,4,0,0
"01/21/2022","N","Y","Aleutians West Census Area",16,"Southwest Region",11,0,745,11,772,0,4,0,0
"01/22/2022","N","Y","Aleutians West Census Area",16,"Southwest Region",11,0,745,7,779,0,4,0,0
"01/24/2022","N","Y","Aleutians West Census Area",16,"Southwest Region",11,5,750,9,788,0,4,0,0
"01/25/2022","N","Y","Aleutians West Census Area",16,"Southwest Region",11,19,769,3,791,0,4,0,0
"01/26/2022","N","Y","Aleutians West Census Area",16,"Southwest Region",11,0,769,6,797,0,4,0,0
"01/27/2022","N","Y","Aleutians West Census Area",16,"Southwest Region",11,14,783,4,801,0,4,0,0
"01/28/2022","N","Y","Aleutians West Census Area",16,"Southwest Region",11,0,783,5,806,0,4,0,0
"01/29/2022","N","Y","Aleutians West Census Area",16,"Southwest Region",11,0,783,1,807,0,4,0,0
"01/31/2022","N","Y","Aleutians West Census Area",16,"Southwest Region",11,19,802,1,808,0,4,0,0
"02/01/2022","N","Y","Aleutians West Census Area",16,"Southwest Region",11,1,803,3,811,0,4,0,0
"02/02/2022","N","Y","Aleutians West Census Area",16,"Southwest Region",11,1,804,0,811,0,4,0,0
"02/03/2022","N","Y","Aleutians West Census Area",16,"Southwest Region",11,7,811,2,813,0,4,0,0
"02/04/2022","N","Y","Aleutians West Census Area",16,"Southwest Region",11,1,812,1,814,0,4,0,0
"02/05/2022","N","Y","Aleutians West Census Area",16,"Southwest Region",11,1,813,0,814,0,4,0,0
"02/06/2022","N","Y","Aleutians West Census Area",16,"Southwest Region",11,1,814,0,814,0,4,0,0
"02/07/2022","N","Y","Aleutians West Census Area",16,"Southwest Region",11,0,814,2,816,0,4,0,0
"02/08/2022","N","Y","Aleutians West Census Area",16,"Southwest Region",11,2,816,1,817,0,4,0,0
"02/12/2022","N","Y","Aleutians West Census Area",16,"Southwest Region",11,1,817,0,817,0,4,0,0
"02/15/2022","N","Y","Aleutians West Census Area",16,"Southwest Region",11,1,818,1,818,0,4,0,0
"02/23/2022","N","Y","Aleutians West Census Area",16,"Southwest Region",11,1,819,1,819,1,5,0,0
"03/04/2022","N","Y","Aleutians West Census Area",16,"Southwest Region",11,0,819,1,820,0,5,0,0
"03/06/2022","N","Y","Aleutians West Census Area",16,"Southwest Region",11,1,820,0,820,0,5,0,0
"03/11/2020","N","Y","Anchorage Municipality",20,"Anchorage Municipality",1,0,0,1,1,0,0,0,0
"03/12/2020","N","Y","Anchorage Municipality",20,"Anchorage Municipality",1,1,1,0,1,0,0,0,0
"04/03/2020","N","Y","Anchorage Municipality",20,"Anchorage Municipality",1,0,1,1,2,0,0,0,0
"04/08/2020","N","Y","Anchorage Municipality",20,"Anchorage Municipality",1,1,2,1,3,0,0,0,0
"04/10/2020","N","Y","Anchorage Municipality",20,"Anchorage Municipality",1,1,3,0,3,0,0,0,0
"05/07/2020","N","Y","Anchorage Municipality",20,"Anchorage Municipality",1,0,3,2,5,0,0,0,0
"05/08/2020","N","Y","Anchorage Municipality",20,"Anchorage Municipality",1,1,4,1,6,0,0,0,0
"05/11/2020","N","Y","Anchorage Municipality",20,"Anchorage Municipality",1,0,4,1,7,0,0,0,0
"05/14/2020","N","Y","Anchorage Municipality",20,"Anchorage Municipality",1,1,5,1,8,0,0,0,0
"05/16/2020","N","Y","Anchorage Municipality",20,"Anchorage Municipality",1,1,6,0,8,0,0,0,0
"05/19/2020","N","Y","Anchorage Municipality",20,"Anchorage Municipality",1,2,8,0,8,0,0,0,0
"05/21/2020","N","Y","Anchorage Municipality",20,"Anchorage Municipality",1,0,8,2,10,0,0,0,0
"05/25/2020","N","Y","Anchorage Municipality",20,"Anchorage Municipality",1,2,10,0,10,0,0,0,0
"05/27/2020","N","Y","Anchorage Municipality",20,"Anchorage Municipality",1,0,10,1,11,0,0,0,0
"05/29/2020","N","Y","Anchorage Municipality",20,"Anchorage Municipality",1,0,10,2,13,0,0,0,0
"06/01/2020","N","Y","Anchorage Municipality",20,"Anchorage Municipality",1,0,10,1,14,0,0,0,0
"06/02/2020","N","Y","Anchorage Municipality",20,"Anchorage Municipality",1,1,11,1,15,0,0,0,0
"06/03/2020","N","Y","Anchorage Municipality",20,"Anchorage Municipality",1,1,12,3,18,0,0,0,0
"06/04/2020","N","Y","Anchorage Municipality",20,"Anchorage Municipality",1,2,14,4,22,0,0,0,0
"06/05/2020","N","Y","Anchorage Municipality",20,"Anchorage Municipality",1,2,16,0,22,0,0,0,0
"06/06/2020","N","Y","Anchorage Municipality",20,"Anchorage Municipality",1,1,17,1,23,0,0,0,0
"06/07/2020","N","Y","Anchorage Municipality",20,"Anchorage Municipality",1,0,17,1,24,0,0,0,0
"06/08/2020","N","Y","Anchorage Municipality",20,"Anchorage Municipality",1,0,17,1,25,0,0,0,0
"06/09/2020","N","Y","Anchorage Municipality",20,"Anchorage Municipality",1,0,17,3,28,0,0,0,0
"06/10/2020","N","Y","Anchorage Municipality",20,"Anchorage Municipality",1,6,23,1,29,0,0,0,0
"06/11/2020","N","Y","Anchorage Municipality",20,"Anchorage Municipality",1,3,26,1,30,0,0,0,0
"06/12/2020","N","Y","Anchorage Municipality",20,"Anchorage Municipality",1,0,26,2,32,0,0,0,0
"06/13/2020","N","Y","Anchorage Municipality",20,"Anchorage Municipality",1,2,28,0,32,0,0,0,0
"06/15/2020","N","Y","Anchorage Municipality",20,"Anchorage Municipality",1,1,29,4,36,0,0,0,0
"06/16/2020","N","Y","Anchorage Municipality",20,"Anchorage Municipality",1,0,29,1,37,0,0,0,0
"06/17/2020","N","Y","Anchorage Municipality",20,"Anchorage Municipality",1,4,33,3,40,0,0,0,0
"06/18/2020","N","Y","Anchorage Municipality",20,"Anchorage Municipality",1,2,35,1,41,0,0,0,0
"06/20/2020","N","Y","Anchorage Municipality",20,"Anchorage Municipality",1,1,36,1,42,0,0,0,0
"06/21/2020","N","Y","Anchorage Municipality",20,"Anchorage Municipality",1,1,37,2,44,0,0,0,0
"06/22/2020","N","Y","Anchorage Municipality",20,"Anchorage Municipality",1,1,38,2,46,0,0,0,0
"06/23/2020","N","Y","Anchorage Municipality",20,"Anchorage Municipality",1,1,39,2,48,0,0,0,0
"06/24/2020","N","Y","Anchorage Municipality",20,"Anchorage Municipality",1,2,41,1,49,0,0,0,0
"06/25/2020","N","Y","Anchorage Municipality",20,"Anchorage Municipality",1,3,44,1,50,0,0,0,0
"06/26/2020","N","Y","Anchorage Municipality",20,"Anchorage Municipality",1,2,46,4,54,0,0,0,0
"06/27/2020","N","Y","Anchorage Municipality",20,"Anchorage Municipality",1,0,46,1,55,0,0,0,0
"06/28/2020","N","Y","Anchorage Municipality",20,"Anchorage Municipality",1,1,47,1,56,0,0,0,0
"06/29/2020","N","Y","Anchorage Municipality",20,"Anchorage Municipality",1,1,48,4,60,0,0,0,0
"06/30/2020","N","Y","Anchorage Municipality",20,"Anchorage Municipality",1,1,49,0,60,0,0,0,0
"07/01/2020","N","Y","Anchorage Municipality",20,"Anchorage Municipality",1,1,50,2,62,0,0,0,0
"07/02/2020","N","Y","Anchorage Municipality",20,"Anchorage Municipality",1,2,52,1,63,0,0,0,0
"07/03/2020","N","Y","Anchorage Municipality",20,"Anchorage Municipality",1,2,54,4,67,0,0,0,0
"07/04/2020","N","Y","Anchorage Municipality",20,"Anchorage Municipality",1,1,55,1,68,0,0,0,0
"07/05/2020","N","Y","Anchorage Municipality",20,"Anchorage Municipality",1,0,55,4,72,0,0,0,0
"07/06/2020","N","Y","Anchorage Municipality",20,"Anchorage Municipality",1,5,60,4,76,0,0,0,0
"07/07/2020","N","Y","Anchorage Municipality",20,"Anchorage Municipality",1,4,64,2,78,0,0,0,0
"07/08/2020","N","Y","Anchorage Municipality",20,"Anchorage Municipality",1,2,66,4,82,0,0,0,0
"07/09/2020","N","Y","Anchorage Municipality",20,"Anchorage Municipality",1,1,67,10,92,0,0,0,0
"07/10/2020","N","Y","Anchorage Municipality",20,"Anchorage Municipality",1,5,72,5,97,0,0,0,0
"07/11/2020","N","Y","Anchorage Municipality",20,"Anchorage Municipality",1,6,78,1,98,0,0,0,0
"07/12/2020","N","Y","Anchorage Municipality",20,"Anchorage Municipality",1,9,87,1,99,0,0,0,0
"07/13/2020","N","Y","Anchorage Municipality",20,"Anchorage Municipality",1,11,98,8,107,0,0,0,0
"07/14/2020","N","Y","Anchorage Municipality",20,"Anchorage Municipality",1,4,102,3,110,0,0,0,0
"07/15/2020","N","Y","Anchorage Municipality",20,"Anchorage Municipality",1,2,104,1,111,0,0,0,0
"07/16/2020","N","Y","Anchorage Municipality",20,"Anchorage Municipality",1,0,104,3,114,0,0,0,0
"07/17/2020","N","Y","Anchorage Municipality",20,"Anchorage Municipality",1,4,108,3,117,0,0,0,0
"07/18/2020","N","Y","Anchorage Municipality",20,"Anchorage Municipality",1,0,108,2,119,0,0,0,0
"07/19/2020","N","Y","Anchorage Municipality",20,"Anchorage Municipality",1,2,110,0,119,0,0,0,0
"07/20/2020","N","Y","Anchorage Municipality",20,"Anchorage Municipality",1,2,112,0,119,0,0,0,0
"07/21/2020","N","Y","Anchorage Municipality",20,"Anchorage Municipality",1,3,115,5,124,0,0,0,0
"07/22/2020","N","Y","Anchorage Municipality",20,"Anchorage Municipality",1,2,117,6,130,0,0,0,0
"07/23/2020","N","Y","Anchorage Municipality",20,"Anchorage Municipality",1,1,118,1,131,0,0,0,0
"07/24/2020","N","Y","Anchorage Municipality",20,"Anchorage Municipality",1,2,120,7,138,0,0,0,0
"07/25/2020","N","Y","Anchorage Municipality",20,"Anchorage Municipality",1,2,122,0,138,0,0,0,0
"07/26/2020","N","Y","Anchorage Municipality",20,"Anchorage Municipality",1,9,131,3,141,0,0,0,0
"07/27/2020","N","Y","Anchorage Municipality",20,"Anchorage Municipality",1,4,135,3,144,0,0,0,0
"07/28/2020","N","Y","Anchorage Municipality",20,"Anchorage Municipality",1,1,136,5,149,0,0,0,0
"07/29/2020","N","Y","Anchorage Municipality",20,"Anchorage Municipality",1,2,138,1,150,0,0,0,0
"07/30/2020","N","Y","Anchorage Municipality",20,"Anchorage Municipality",1,0,138,1,151,0,0,0,0
"07/31/2020","N","Y","Anchorage Municipality",20,"Anchorage Municipality",1,3,141,0,151,0,0,0,0
"08/01/2020","N","Y","Anchorage Municipality",20,"Anchorage Municipality",1,4,145,1,152,0,0,0,0
"08/02/2020","N","Y","Anchorage Municipality",20,"Anchorage Municipality",1,1,146,2,154,0,0,0,0
"08/03/2020","N","Y","Anchorage Municipality",20,"Anchorage Municipality",1,2,148,1,155,0,0,0,0
"08/04/2020","N","Y","Anchorage Municipality",20,"Anchorage Municipality",1,2,150,0,155,0,0,0,0
"08/05/2020","N","Y","Anchorage Municipality",20,"Anchorage Municipality",1,0,150,1,156,0,0,0,0
"08/06/2020","N","Y","Anchorage Municipality",20,"Anchorage Municipality",1,1,151,0,156,0,0,0,0
"08/07/2020","N","Y","Anchorage Municipality",20,"Anchorage Municipality",1,1,152,1,157,0,0,0,0
"08/08/2020","N","Y","Anchorage Municipality",20,"Anchorage Municipality",1,0,152,1,158,0,0,0,0
"08/10/2020","N","Y","Anchorage Municipality",20,"Anchorage Municipality",1,1,153,1,159,0,0,0,0
"08/11/2020","N","Y","Anchorage Municipality",20,"Anchorage Municipality",1,4,157,0,159,0,0,0,0
"08/12/2020","N","Y","Anchorage Municipality",20,"Anchorage Municipality",1,0,157,1,160,0,0,0,0
"08/13/2020","N","Y","Anchorage Municipality",20,"Anchorage Municipality",1,1,158,0,160,0,0,0,0
"08/18/2020","N","Y","Anchorage Municipality",20,"Anchorage Municipality",1,0,158,1,161,1,1,0,0
"08/20/2020","N","Y","Anchorage Municipality",20,"Anchorage Municipality",1,1,159,3,164,0,1,0,0
"08/21/2020","N","Y","Anchorage Municipality",20,"Anchorage Municipality",1,2,161,0,164,0,1,0,0
"08/23/2020","N","Y","Anchorage Municipality",20,"Anchorage Municipality",1,1,162,2,166,0,1,0,0
"08/25/2020","N","Y","Anchorage Municipality",20,"Anchorage Municipality",1,0,162,2,168,0,1,0,0
"08/26/2020","N","Y","Anchorage Municipality",20,"Anchorage Municipality",1,4,166,1,169,0,1,0,0
"08/27/2020","N","Y","Anchorage Municipality",20,"Anchorage Municipality",1,1,167,2,171,0,1,0,0
"08/28/2020","N","Y","Anchorage Municipality",20,"Anchorage Municipality",1,2,169,1,172,0,1,0,0
"08/29/2020","N","Y","Anchorage Municipality",20,"Anchorage Municipality",1,1,170,0,172,0,1,0,0
"08/30/2020","N","Y","Anchorage Municipality",20,"Anchorage Municipality",1,1,171,0,172,0,1,0,0
"08/31/2020","N","Y","Anchorage Municipality",20,"Anchorage Municipality",1,0,171,1,173,0,1,0,0
"09/01/2020","N","Y","Anchorage Municipality",20,"Anchorage Municipality",1,0,171,2,175,0,1,0,0
"09/03/2020","N","Y","Anchorage Municipality",20,"Anchorage Municipality",1,1,172,0,175,0,1,0,0
"09/04/2020","N","Y","Anchorage Municipality",20,"Anchorage Municipality",1,2,174,1,176,0,1,0,0
"09/08/2020","N","Y","Anchorage Municipality",20,"Anchorage Municipality",1,0,174,3,179,0,1,0,0
"09/09/2020","N","Y","Anchorage Municipality",20,"Anchorage Municipality",1,1,175,0,179,0,1,0,0
"09/10/2020","N","Y","Anchorage Municipality",20,"Anchorage Municipality",1,4,179,2,181,0,1,0,0
"09/13/2020","N","Y","Anchorage Municipality",20,"Anchorage Municipality",1,1,180,1,182,0,1,0,0
"09/17/2020","N","Y","Anchorage Municipality",20,"Anchorage Municipality",1,2,182,3,185,0,1,0,0
"09/18/2020","N","Y","Anchorage Municipality",20,"Anchorage Municipality",1,1,183,1,186,0,1,0,0
"09/19/2020","N","Y","Anchorage Municipality",20,"Anchorage Municipality",1,0,183,1,187,0,1,0,0
"09/21/2020","N","Y","Anchorage Municipality",20,"Anchorage Municipality",1,4,187,4,191,0,1,0,0
"09/22/2020","N","Y","Anchorage Municipality",20,"Anchorage Municipality",1,1,188,5,196,0,1,0,0
"09/23/2020","N","Y","Anchorage Municipality",20,"Anchorage Municipality",1,8,196,3,199,0,1,0,0
"09/24/2020","N","Y","Anchorage Municipality",20,"Anchorage Municipality",1,1,197,1,200,0,1,0,0
"09/25/2020","N","Y","Anchorage Municipality",20,"Anchorage Municipality",1,0,197,4,204,0,1,0,0
"09/26/2020","N","Y","Anchorage Municipality",20,"Anchorage Municipality",1,1,198,3,207,0,1,0,0
"09/27/2020","N","Y","Anchorage Municipality",20,"Anchorage Municipality",1,2,200,1,208,0,1,0,0
"09/28/2020","N","Y","Anchorage Municipality",20,"Anchorage Municipality",1,2,202,1,209,0,1,0,0
"09/29/2020","N","Y","Anchorage Municipality",20,"Anchorage Municipality",1,2,204,2,211,0,1,0,0
"09/30/2020","N","Y","Anchorage Municipality",20,"Anchorage Municipality",1,1,205,0,211,0,1,0,0
"10/01/2020","N","Y","Anchorage Municipality",20,"Anchorage Municipality",1,1,206,1,212,0,1,0,0
"10/02/2020","N","Y","Anchorage Municipality",20,"Anchorage Municipality",1,1,207,2,214,0,1,0,0
"10/03/2020","N","Y","Anchorage Municipality",20,"Anchorage Municipality",1,2,209,0,214,0,1,0,0
"10/04/2020","N","Y","Anchorage Municipality",20,"Anchorage Municipality",1,1,210,2,216,0,1,0,0
"10/05/2020","N","Y","Anchorage Municipality",20,"Anchorage Municipality",1,1,211,3,219,0,1,0,0
"10/06/2020","N","Y","Anchorage Municipality",20,"Anchorage Municipality",1,1,212,1,220,0,1,0,0
"10/07/2020","N","Y","Anchorage Municipality",20,"Anchorage Municipality",1,1,213,7,227,0,1,0,0
"10/08/2020","N","Y","Anchorage Municipality",20,"Anchorage Municipality",1,2,215,4,231,0,1,0,0
"10/09/2020","N","Y","Anchorage Municipality",20,"Anchorage Municipality",1,1,216,0,231,0,1,0,0
"10/10/2020","N","Y","Anchorage Municipality",20,"Anchorage Municipality",1,1,217,2,233,0,1,0,0
"10/11/2020","N","Y","Anchorage Municipality",20,"Anchorage Municipality",1,2,219,3,236,0,1,0,0
"10/12/2020","N","Y","Anchorage Municipality",20,"Anchorage Municipality",1,2,221,1,237,0,1,0,0
"10/13/2020","N","Y","Anchorage Municipality",20,"Anchorage Municipality",1,12,233,1,238,0,1,0,0
"10/14/2020","N","Y","Anchorage Municipality",20,"Anchorage Municipality",1,1,234,2,240,0,1,0,0
"10/15/2020","N","Y","Anchorage Municipality",20,"Anchorage Municipality",1,1,235,4,244,0,1,0,0
"10/16/2020","N","Y","Anchorage Municipality",20,"Anchorage Municipality",1,2,237,1,245,0,1,0,0
"10/17/2020","N","Y","Anchorage Municipality",20,"Anchorage Municipality",1,3,240,0,245,0,1,0,0
"10/18/2020","N","Y","Anchorage Municipality",20,"Anchorage Municipality",1,1,241,0,245,0,1,0,0
"10/19/2020","N","Y","Anchorage Municipality",20,"Anchorage Municipality",1,2,243,0,245,0,1,0,0
"10/21/2020","N","Y","Anchorage Municipality",20,"Anchorage Municipality",1,0,243,1,246,0,1,0,0
"10/22/2020","N","Y","Anchorage Municipality",20,"Anchorage Municipality",1,1,244,1,247,0,1,0,0
"10/23/2020","N","Y","Anchorage Municipality",20,"Anchorage Municipality",1,0,244,2,249,0,1,0,0
"10/24/2020","N","Y","Anchorage Municipality",20,"Anchorage Municipality",1,0,244,4,253,0,1,0,0
"10/25/2020","N","Y","Anchorage Municipality",20,"Anchorage Municipality",1,1,245,1,254,0,1,0,0
"10/26/2020","N","Y","Anchorage Municipality",20,"Anchorage Municipality",1,0,245,2,256,0,1,0,0
"10/27/2020","N","Y","Anchorage Municipality",20,"Anchorage Municipality",1,3,248,1,257,0,1,0,0
"10/28/2020","N","Y","Anchorage Municipality",20,"Anchorage Municipality",1,2,250,3,260,0,1,0,0
"10/29/2020","N","Y","Anchorage Municipality",20,"Anchorage Municipality",1,1,251,1,261,0,1,0,0
"10/30/2020","N","Y","Anchorage Municipality",20,"Anchorage Municipality",1,4,255,3,264,0,1,0,0
"10/31/2020","N","Y","Anchorage Municipality",20,"Anchorage Municipality",1,0,255,1,265,0,1,0,0
"11/01/2020","N","Y","Anchorage Municipality",20,"Anchorage Municipality",1,1,256,2,267,0,1,0,0
"11/02/2020","N","Y","Anchorage Municipality",20,"Anchorage Municipality",1,0,256,1,268,1,2,0,0
"11/03/2020","N","Y","Anchorage Municipality",20,"Anchorage Municipality",1,3,259,4,272,1,3,0,0
"11/04/2020","N","Y","Anchorage Municipality",20,"Anchorage Municipality",1,0,259,3,275,0,3,0,0
"11/05/2020","N","Y","Anchorage Municipality",20,"Anchorage Municipality",1,1,260,2,277,0,3,0,0
"11/06/2020","N","Y","Anchorage Municipality",20,"Anchorage Municipality",1,4,264,2,279,0,3,0,0
"11/07/2020","N","Y","Anchorage Municipality",20,"Anchorage Municipality",1,2,266,2,281,0,3,0,0
"11/08/2020","N","Y","Anchorage Municipality",20,"Anchorage Municipality",1,1,267,2,283,0,3,0,0
"11/09/2020","N","Y","Anchorage Municipality",20,"Anchorage Municipality",1,1,268,6,289,0,3,0,0
"11/10/2020","N","Y","Anchorage Municipality",20,"Anchorage Municipality",1,2,270,0,289,0,3,0,0
"11/11/2020","N","Y","Anchorage Municipality",20,"Anchorage Municipality",1,0,270,2,291,0,3,0,0
"11/12/2020","N","Y","Anchorage Municipality",20,"Anchorage Municipality",1,1,271,4,295,1,4,0,0
"11/13/2020","N","Y","Anchorage Municipality",20,"Anchorage Municipality",1,2,273,1,296,0,4,0,0
"11/14/2020","N","Y","Anchorage Municipality",20,"Anchorage Municipality",1,5,278,3,299,0,4,0,0
"11/15/2020","N","Y","Anchorage Municipality",20,"Anchorage Municipality",1,6,284,1,300,0,4,0,0
"11/16/2020","N","Y","Anchorage Municipality",20,"Anchorage Municipality",1,3,287,3,303,0,4,0,0
"11/17/2020","N","Y","Anchorage Municipality",20,"Anchorage Municipality",1,0,287,1,304,0,4,0,0
"11/18/2020","N","Y","Anchorage Municipality",20,"Anchorage Municipality",1,3,290,5,309,0,4,0,0
"11/19/2020","N","Y","Anchorage Municipality",20,"Anchorage Municipality",1,1,291,0,309,0,4,0,0
"11/20/2020","N","Y","Anchorage Municipality",20,"Anchorage Municipality",1,3,294,2,311,0,4,0,0
"11/21/2020","N","Y","Anchorage Municipality",20,"Anchorage Municipality",1,5,299,2,313,0,4,0,0
"11/22/2020","N","Y","Anchorage Municipality",20,"Anchorage Municipality",1,2,301,10,323,0,4,0,0
"11/23/2020","N","Y","Anchorage Municipality",20,"Anchorage Municipality",1,1,302,4,327,0,4,0,0
"11/24/2020","N","Y","Anchorage Municipality",20,"Anchorage Municipality",1,4,306,5,332,0,4,0,0
"11/25/2020","N","Y","Anchorage Municipality",20,"Anchorage Municipality",1,2,308,5,337,1,5,0,0
"11/26/2020","N","Y","Anchorage Municipality",20,"Anchorage Municipality",1,9,317,1,338,0,5,0,0
"11/27/2020","N","Y","Anchorage Municipality",20,"Anchorage Municipality",1,6,323,0,338,0,5,0,0
"11/28/2020","N","Y","Anchorage Municipality",20,"Anchorage Municipality",1,2,325,1,339,0,5,0,0
"11/29/2020","N","Y","Anchorage Municipality",20,"Anchorage Municipality",1,0,325,1,340,0,5,0,0
"11/30/2020","N","Y","Anchorage Municipality",20,"Anchorage Municipality",1,1,326,0,340,0,5,0,0
"12/01/2020","N","Y","Anchorage Municipality",20,"Anchorage Municipality",1,1,327,3,343,0,5,0,0
"12/02/2020","N","Y","Anchorage Municipality",20,"Anchorage Municipality",1,1,328,1,344,0,5,0,0
"12/03/2020","N","Y","Anchorage Municipality",20,"Anchorage Municipality",1,0,328,1,345,0,5,0,0
"12/04/2020","N","Y","Anchorage Municipality",20,"Anchorage Municipality",1,6,334,2,347,1,6,0,0
"12/05/2020","N","Y","Anchorage Municipality",20,"Anchorage Municipality",1,2,336,0,347,0,6,0,0
"12/06/2020","N","Y","Anchorage Municipality",20,"Anchorage Municipality",1,1,337,0,347,0,6,0,0
"12/07/2020","N","Y","Anchorage Municipality",20,"Anchorage Municipality",1,3,340,0,347,0,6,0,0
"12/08/2020","N","Y","Anchorage Municipality",20,"Anchorage Municipality",1,1,341,2,349,0,6,0,0
"12/09/2020","N","Y","Anchorage Municipality",20,"Anchorage Municipality",1,2,343,3,352,1,7,0,0
"12/11/2020","N","Y","Anchorage Municipality",20,"Anchorage Municipality",1,1,344,1,353,0,7,0,0
"12/12/2020","N","Y","Anchorage Municipality",20,"Anchorage Municipality",1,4,348,10,363,0,7,0,0
"12/13/2020","N","Y","Anchorage Municipality",20,"Anchorage Municipality",1,3,351,0,363,0,7,0,0
"12/14/2020","N","Y","Anchorage Municipality",20,"Anchorage Municipality",1,7,358,0,363,0,7,0,0
"12/15/2020","N","Y","Anchorage Municipality",20,"Anchorage Municipality",1,3,361,1,364,0,7,0,0
"12/16/2020","N","Y","Anchorage Municipality",20,"Anchorage Municipality",1,0,361,2,366,0,7,0,0
"12/17/2020","N","Y","Anchorage Municipality",20,"Anchorage Municipality",1,1,362,3,369,0,7,0,0
"12/18/2020","N","Y","Anchorage Municipality",20,"Anchorage Municipality",1,3,365,0,369,0,7,0,0
"12/19/2020","N","Y","Anchorage Municipality",20,"Anchorage Municipality",1,3,368,0,369,0,7,0,0
"12/20/2020","N","Y","Anchorage Municipality",20,"Anchorage Municipality",1,1,369,4,373,0,7,0,0
"12/21/2020","N","Y","Anchorage Municipality",20,"Anchorage Municipality",1,3,372,7,380,0,7,0,0
"12/22/2020","N","Y","Anchorage Municipality",20,"Anchorage Municipality",1,0,372,4,384,0,7,0,0
"12/23/2020","N","Y","Anchorage Municipality",20,"Anchorage Municipality",1,4,376,4,388,0,7,0,0
"12/24/2020","N","Y","Anchorage Municipality",20,"Anchorage Municipality",1,1,377,0,388,0,7,0,0
"12/26/2020","N","Y","Anchorage Municipality",20,"Anchorage Municipality",1,10,387,4,392,0,7,0,0
"12/27/2020","N","Y","Anchorage Municipality",20,"Anchorage Municipality",1,2,389,0,392,0,7,0,0
"12/28/2020","N","Y","Anchorage Municipality",20,"Anchorage Municipality",1,4,393,5,397,2,9,0,0
"12/29/2020","N","Y","Anchorage Municipality",20,"Anchorage Municipality",1,3,396,4,401,0,9,0,0
"12/30/2020","N","Y","Anchorage Municipality",20,"Anchorage Municipality",1,1,397,0,401,0,9,0,0
"12/31/2020","N","Y","Anchorage Municipality",20,"Anchorage Municipality",1,4,401,1,402,0,9,0,0
"01/01/2021","N","Y","Anchorage Municipality",20,"Anchorage Municipality",1,0,401,1,403,1,10,1,1
"01/02/2021","N","Y","Anchorage Municipality",20,"Anchorage Municipality",1,2,403,2,405,0,10,0,1
"01/03/2021","N","Y","Anchorage Municipality",20,"Anchorage Municipality",1,2,405,1,406,0,10,0,1
"01/04/2021","N","Y","Anchorage Municipality",20,"Anchorage Municipality",1,0,405,4,410,0,10,0,1
"01/05/2021","N","Y","Anchorage Municipality",20,"Anchorage Municipality",1,1,406,2,412,0,10,0,1
"01/06/2021","N","Y","Anchorage Municipality",20,"Anchorage Municipality",1,2,408,0,412,0,10,0,1
"01/07/2021","N","Y","Anchorage Municipality",20,"Anchorage Municipality",1,4,412,3,415,0,10,0,1
"01/08/2021","N","Y","Anchorage Municipality",20,"Anchorage Municipality",1,0,412,2,417,0,10,0,1
"01/09/2021","N","Y","Anchorage Municipality",20,"Anchorage Municipality",1,4,416,1,418,0,10,0,1
"01/10/2021","N","Y","Anchorage Municipality",20,"Anchorage Municipality",1,1,417,2,420,0,10,0,1
"01/11/2021","N","Y","Anchorage Municipality",20,"Anchorage Municipality",1,1,418,2,422,0,10,0,1
"01/12/2021","N","Y","Anchorage Municipality",20,"Anchorage Municipality",1,1,419,0,422,0,10,0,1
"01/13/2021","N","Y","Anchorage Municipality",20,"Anchorage Municipality",1,3,422,4,426,0,10,0,1
"01/14/2021","N","Y","Anchorage Municipality",20,"Anchorage Municipality",1,3,425,3,429,0,10,0,1
"01/15/2021","N","Y","Anchorage Municipality",20,"Anchorage Municipality",1,0,425,3,432,0,10,0,1
"01/16/2021","N","Y","Anchorage Municipality",20,"Anchorage Municipality",1,3,428,3,435,0,10,0,1
"01/17/2021","N","Y","Anchorage Municipality",20,"Anchorage Municipality",1,2,430,0,435,0,10,0,1
"01/18/2021","N","Y","Anchorage Municipality",20,"Anchorage Municipality",1,2,432,2,437,0,10,0,1
"01/19/2021","N","Y","Anchorage Municipality",20,"Anchorage Municipality",1,5,437,2,439,0,10,0,1
"01/20/2021","N","Y","Anchorage Municipality",20,"Anchorage Municipality",1,0,437,1,440,0,10,0,1
"01/21/2021","N","Y","Anchorage Municipality",20,"Anchorage Municipality",1,2,439,0,440,0,10,0,1
"01/22/2021","N","Y","Anchorage Municipality",20,"Anchorage Municipality",1,1,440,0,440,0,10,0,1
"01/23/2021","N","Y","Anchorage Municipality",20,"Anchorage Municipality",1,0,440,2,442,0,10,0,1
"01/25/2021","N","Y","Anchorage Municipality",20,"Anchorage Municipality",1,0,440,6,448,0,10,0,1
"01/26/2021","N","Y","Anchorage Municipality",20,"Anchorage Municipality",1,3,443,1,449,1,11,0,1
"01/27/2021","N","Y","Anchorage Municipality",20,"Anchorage Municipality",1,1,444,0,449,0,11,0,1
"01/28/2021","N","Y","Anchorage Municipality",20,"Anchorage Municipality",1,1,445,13,462,0,11,0,1
"01/29/2021","N","Y","Anchorage Municipality",20,"Anchorage Municipality",1,1,446,4,466,0,11,0,1
"01/30/2021","N","Y","Anchorage Municipality",20,"Anchorage Municipality",1,2,448,3,469,0,11,0,1
"01/31/2021","N","Y","Anchorage Municipality",20,"Anchorage Municipality",1,0,448,3,472,0,11,0,1
"02/01/2021","N","Y","Anchorage Municipality",20,"Anchorage Municipality",1,2,450,5,477,0,11,0,1
"02/02/2021","N","Y","Anchorage Municipality",20,"Anchorage Municipality",1,21,471,1,478,0,11,0,1
"02/03/2021","N","Y","Anchorage Municipality",20,"Anchorage Municipality",1,1,472,1,479,0,11,0,1
"02/04/2021","N","Y","Anchorage Municipality",20,"Anchorage Municipality",1,2,474,2,481,0,11,0,1
"02/05/2021","N","Y","Anchorage Municipality",20,"Anchorage Municipality",1,2,476,3,484,1,12,0,1
"02/06/2021","N","Y","Anchorage Municipality",20,"Anchorage Municipality",1,6,482,0,484,0,12,0,1
"02/07/2021","N","Y","Anchorage Municipality",20,"Anchorage Municipality",1,0,482,2,486,0,12,0,1
"02/08/2021","N","Y","Anchorage Municipality",20,"Anchorage Municipality",1,1,483,1,487,0,12,0,1
"02/09/2021","N","Y","Anchorage Municipality",20,"Anchorage Municipality",1,3,486,0,487,0,12,0,1
"02/10/2021","N","Y","Anchorage Municipality",20,"Anchorage Municipality",1,0,486,1,488,0,12,0,1
"02/12/2021","N","Y","Anchorage Municipality",20,"Anchorage Municipality",1,1,487,0,488,0,12,0,1
"02/13/2021","N","Y","Anchorage Municipality",20,"Anchorage Municipality",1,0,487,1,489,0,12,0,1
"02/15/2021","N","Y","Anchorage Municipality",20,"Anchorage Municipality",1,1,488,0,489,0,12,0,1
"02/16/2021","N","Y","Anchorage Municipality",20,"Anchorage Municipality",1,1,489,1,490,0,12,0,1
"02/18/2021","N","Y","Anchorage Municipality",20,"Anchorage Municipality",1,1,490,0,490,0,12,0,1
"02/19/2021","N","Y","Anchorage Municipality",20,"Anchorage Municipality",1,1,491,3,493,1,13,0,1
"02/20/2021","N","Y","Anchorage Municipality",20,"Anchorage Municipality",1,2,493,2,495,0,13,0,1
"02/21/2021","N","Y","Anchorage Municipality",20,"Anchorage Municipality",1,2,495,0,495,0,13,0,1
"02/22/2021","N","Y","Anchorage Municipality",20,"Anchorage Municipality",1,0,495,1,496,0,13,0,1
"02/23/2021","N","Y","Anchorage Municipality",20,"Anchorage Municipality",1,1,496,2,498,0,13,0,1
"02/24/2021","N","Y","Anchorage Municipality",20,"Anchorage Municipality",1,1,497,1,499,0,13,0,1
"02/25/2021","N","Y","Anchorage Municipality",20,"Anchorage Municipality",1,0,497,2,501,0,13,0,1
"02/26/2021","N","Y","Anchorage Municipality",20,"Anchorage Municipality",1,3,500,0,501,0,13,0,1
"03/01/2021","N","Y","Anchorage Municipality",20,"Anchorage Municipality",1,0,500,1,502,0,13,0,1
"03/02/2021","N","Y","Anchorage Municipality",20,"Anchorage Municipality",1,1,501,7,509,0,13,0,1
"03/03/2021","N","Y","Anchorage Municipality",20,"Anchorage Municipality",1,3,504,0,509,0,13,0,1
"03/04/2021","N","Y","Anchorage Municipality",20,"Anchorage Municipality",1,2,506,6,515,0,13,0,1
"03/05/2021","N","Y","Anchorage Municipality",20,"Anchorage Municipality",1,4,510,4,519,0,13,0,1
"03/06/2021","N","Y","Anchorage Municipality",20,"Anchorage Municipality",1,4,514,3,522,0,13,0,1
"03/07/2021","N","Y","Anchorage Municipality",20,"Anchorage Municipality",1,3,517,0,522,0,13,0,1
"03/08/2021","N","Y","Anchorage Municipality",20,"Anchorage Municipality",1,0,517,2,524,0,13,0,1
"03/09/2021","N","Y","Anchorage Municipality",20,"Anchorage Municipality",1,3,520,0,524,0,13,0,1
"03/10/2021","N","Y","Anchorage Municipality",20,"Anchorage Municipality",1,3,523,2,526,0,13,0,1
"03/11/2021","N","Y","Anchorage Municipality",20,"Anchorage Municipality",1,2,525,3,529,0,13,0,1
"03/12/2021","N","Y","Anchorage Municipality",20,"Anchorage Municipality",1,0,525,1,530,0,13,0,1
"03/13/2021","N","Y","Anchorage Municipality",20,"Anchorage Municipality",1,2,527,1,531,0,13,0,1
"03/14/2021","N","Y","Anchorage Municipality",20,"Anchorage Municipality",1,2,529,0,531,0,13,0,1
"03/15/2021","N","Y","Anchorage Municipality",20,"Anchorage Municipality",1,2,531,2,533,0,13,0,1
"03/16/2021","N","Y","Anchorage Municipality",20,"Anchorage Municipality",1,1,532,2,535,0,13,0,1
"03/17/2021","N","Y","Anchorage Municipality",20,"Anchorage Municipality",1,2,534,1,536,0,13,0,1
"03/18/2021","N","Y","Anchorage Municipality",20,"Anchorage Municipality",1,1,535,3,539,0,13,0,1
"03/19/2021","N","Y","Anchorage Municipality",20,"Anchorage Municipality",1,3,538,3,542,0,13,0,1
"03/20/2021","N","Y","Anchorage Municipality",20,"Anchorage Municipality",1,3,541,3,545,0,13,0,1
"03/21/2021","N","Y","Anchorage Municipality",20,"Anchorage Municipality",1,3,544,0,545,0,13,0,1
"03/22/2021","N","Y","Anchorage Municipality",20,"Anchorage Municipality",1,1,545,3,548,0,13,0,1
"03/23/2021","N","Y","Anchorage Municipality",20,"Anchorage Municipality",1,1,546,2,550,1,14,0,1
"03/24/2021","N","Y","Anchorage Municipality",20,"Anchorage Municipality",1,2,548,1,551,0,14,0,1
"03/25/2021","N","Y","Anchorage Municipality",20,"Anchorage Municipality",1,1,549,3,554,0,14,0,1
"03/26/2021","N","Y","Anchorage Municipality",20,"Anchorage Municipality",1,5,554,3,557,0,14,0,1
"03/27/2021","N","Y","Anchorage Municipality",20,"Anchorage Municipality",1,2,556,2,559,0,14,0,1
"03/28/2021","N","Y","Anchorage Municipality",20,"Anchorage Municipality",1,0,556,1,560,0,14,0,1
"03/29/2021","N","Y","Anchorage Municipality",20,"Anchorage Municipality",1,4,560,0,560,0,14,0,1
"03/31/2021","N","Y","Anchorage Municipality",20,"Anchorage Municipality",1,0,560,4,564,0,14,0,1
"04/01/2021","N","Y","Anchorage Municipality",20,"Anchorage Municipality",1,3,563,6,570,0,14,0,1
"04/02/2021","N","Y","Anchorage Municipality",20,"Anchorage Municipality",1,6,569,0,570,0,14,0,1
"04/03/2021","N","Y","Anchorage Municipality",20,"Anchorage Municipality",1,1,570,2,572,0,14,0,1
"04/04/2021","N","Y","Anchorage Municipality",20,"Anchorage Municipality",1,2,572,0,572,0,14,0,1
"04/05/2021","N","Y","Anchorage Municipality",20,"Anchorage Municipality",1,0,572,1,573,0,14,0,1
"04/06/2021","N","Y","Anchorage Municipality",20,"Anchorage Municipality",1,0,572,1,574,0,14,0,1
"04/07/2021","N","Y","Anchorage Municipality",20,"Anchorage Municipality",1,2,574,1,575,0,14,0,1
"04/08/2021","N","Y","Anchorage Municipality",20,"Anchorage Municipality",1,2,576,2,577,0,14,0,1
"04/09/2021","N","Y","Anchorage Municipality",20,"Anchorage Municipality",1,0,576,1,578,0,14,0,1
"04/10/2021","N","Y","Anchorage Municipality",20,"Anchorage Municipality",1,1,577,0,578,0,14,0,1
"04/11/2021","N","Y","Anchorage Municipality",20,"Anchorage Municipality",1,2,579,1,579,0,14,0,1
"04/12/2021","N","Y","Anchorage Municipality",20,"Anchorage Municipality",1,0,579,3,582,0,14,0,1
"04/14/2021","N","Y","Anchorage Municipality",20,"Anchorage Municipality",1,2,581,1,583,0,14,0,1
"04/15/2021","N","Y","Anchorage Municipality",20,"Anchorage Municipality",1,1,582,2,585,0,14,0,1
"04/16/2021","N","Y","Anchorage Municipality",20,"Anchorage Municipality",1,4,586,2,587,0,14,0,1
"04/17/2021","N","Y","Anchorage Municipality",20,"Anchorage Municipality",1,0,586,1,588,0,14,0,1
"04/18/2021","N","Y","Anchorage Municipality",20,"Anchorage Municipality",1,0,586,0,588,1,15,0,1
"04/20/2021","N","Y","Anchorage Municipality",20,"Anchorage Municipality",1,2,588,1,589,0,15,0,1
"04/22/2021","N","Y","Anchorage Municipality",20,"Anchorage Municipality",1,1,589,1,590,0,15,0,1
"04/23/2021","N","Y","Anchorage Municipality",20,"Anchorage Municipality",1,1,590,1,591,0,15,0,1
"04/26/2021","N","Y","Anchorage Municipality",20,"Anchorage Municipality",1,1,591,0,591,0,15,0,1
"04/28/2021","N","Y","Anchorage Municipality",20,"Anchorage Municipality",1,2,593,2,593,0,15,0,1
"04/30/2021","N","Y","Anchorage Municipality",20,"Anchorage Municipality",1,0,593,2,595,0,15,0,1
"05/01/2021","N","Y","Anchorage Municipality",20,"Anchorage Municipality",1,2,595,0,595,0,15,0,1
"05/03/2021","N","Y","Anchorage Municipality",20,"Anchorage Municipality",1,0,595,1,596,0,15,0,1
"05/05/2021","N","Y","Anchorage Municipality",20,"Anchorage Municipality",1,0,595,1,597,0,15,0,1
"05/06/2021","N","Y","Anchorage Municipality",20,"Anchorage Municipality",1,0,595,0,597,0,15,1,2
"05/07/2021","N","Y","Anchorage Municipality",20,"Anchorage Municipality",1,1,596,0,597,0,15,0,2
"05/08/2021","N","Y","Anchorage Municipality",20,"Anchorage Municipality",1,1,597,0,597,0,15,0,2
"05/09/2021","N","Y","Anchorage Municipality",20,"Anchorage Municipality",1,0,597,1,598,1,16,0,2
"05/10/2021","N","Y","Anchorage Municipality",20,"Anchorage Municipality",1,1,598,1,599,0,16,0,2
"05/12/2021","N","Y","Anchorage Municipality",20,"Anchorage Municipality",1,1,599,2,601,0,16,0,2
"05/13/2021","N","Y","Anchorage Municipality",20,"Anchorage Municipality",1,1,600,0,601,0,16,0,2
"05/14/2021","N","Y","Anchorage Municipality",20,"Anchorage Municipality",1,1,601,1,602,0,16,0,2
"05/15/2021","N","Y","Anchorage Municipality",20,"Anchorage Municipality",1,0,601,1,603,0,16,0,2
"05/16/2021","N","Y","Anchorage Municipality",20,"Anchorage Municipality",1,1,602,1,604,0,16,0,2
"05/17/2021","N","Y","Anchorage Municipality",20,"Anchorage Municipality",1,2,604,1,605,0,16,0,2
"05/18/2021","N","Y","Anchorage Municipality",20,"Anchorage Municipality",1,1,605,0,605,0,16,0,2
"05/19/2021","N","Y","Anchorage Municipality",20,"Anchorage Municipality",1,0,605,0,605,1,17,0,2
"05/20/2021","N","Y","Anchorage Municipality",20,"Anchorage Municipality",1,0,605,1,606,0,17,0,2
"05/21/2021","N","Y","Anchorage Municipality",20,"Anchorage Municipality",1,0,605,1,607,0,17,0,2
"05/22/2021","N","Y","Anchorage Municipality",20,"Anchorage Municipality",1,2,607,0,607,0,17,0,2
"05/24/2021","N","Y","Anchorage Municipality",20,"Anchorage Municipality",1,0,607,1,608,0,17,0,2
"05/25/2021","N","Y","Anchorage Municipality",20,"Anchorage Municipality",1,1,608,0,608,0,17,0,2
"05/27/2021","N","Y","Anchorage Municipality",20,"Anchorage Municipality",1,0,608,1,609,0,17,0,2
"05/28/2021","N","Y","Anchorage Municipality",20,"Anchorage Municipality",1,0,608,2,611,0,17,0,2
"05/29/2021","N","Y","Anchorage Municipality",20,"Anchorage Municipality",1,2,610,0,611,0,17,0,2
"05/30/2021","N","Y","Anchorage Municipality",20,"Anchorage Municipality",1,1,611,1,612,0,17,0,2
"05/31/2021","N","Y","Anchorage Municipality",20,"Anchorage Municipality",1,1,612,1,613,0,17,0,2
"06/02/2021","N","Y","Anchorage Municipality",20,"Anchorage Municipality",1,1,613,0,613,0,17,0,2
"06/03/2021","N","Y","Anchorage Municipality",20,"Anchorage Municipality",1,1,614,1,614,0,17,0,2
"06/08/2021","N","Y","Anchorage Municipality",20,"Anchorage Municipality",1,0,614,1,615,0,17,0,2
"06/09/2021","N","Y","Anchorage Municipality",20,"Anchorage Municipality",1,1,615,1,616,0,17,0,2
"06/10/2021","N","Y","Anchorage Municipality",20,"Anchorage Municipality",1,1,616,0,616,0,17,0,2
"06/11/2021","N","Y","Anchorage Municipality",20,"Anchorage Municipality",1,0,616,1,617,0,17,0,2
"06/14/2021","N","Y","Anchorage Municipality",20,"Anchorage Municipality",1,1,617,1,618,0,17,0,2
"06/16/2021","N","Y","Anchorage Municipality",20,"Anchorage Municipality",1,3,620,3,621,0,17,0,2
"06/17/2021","N","Y","Anchorage Municipality",20,"Anchorage Municipality",1,1,621,0,621,0,17,0,2
"06/18/2021","N","Y","Anchorage Municipality",20,"Anchorage Municipality",1,0,621,1,622,0,17,0,2
"06/20/2021","N","Y","Anchorage Municipality",20,"Anchorage Municipality",1,1,622,3,625,0,17,0,2
"06/21/2021","N","Y","Anchorage Municipality",20,"Anchorage Municipality",1,0,622,3,628,0,17,0,2
"06/23/2021","N","Y","Anchorage Municipality",20,"Anchorage Municipality",1,4,626,3,631,0,17,0,2
"06/24/2021","N","Y","Anchorage Municipality",20,"Anchorage Municipality",1,3,629,1,632,0,17,0,2
"06/25/2021","N","Y","Anchorage Municipality",20,"Anchorage Municipality",1,2,631,3,635,0,17,0,2
"06/26/2021","N","Y","Anchorage Municipality",20,"Anchorage Municipality",1,1,632,5,640,0,17,0,2
"06/27/2021","N","Y","Anchorage Municipality",20,"Anchorage Municipality",1,1,633,0,640,0,17,0,2
"06/28/2021","N","Y","Anchorage Municipality",20,"Anchorage Municipality",1,6,639,1,641,0,17,0,2
"06/29/2021","N","Y","Anchorage Municipality",20,"Anchorage Municipality",1,1,640,1,642,0,17,0,2
"06/30/2021","N","Y","Anchorage Municipality",20,"Anchorage Municipality",1,2,642,2,644,0,17,0,2
"07/01/2021","N","Y","Anchorage Municipality",20,"Anchorage Municipality",1,2,644,3,647,0,17,0,2
"07/02/2021","N","Y","Anchorage Municipality",20,"Anchorage Municipality",1,1,645,2,649,0,17,0,2
"07/03/2021","N","Y","Anchorage Municipality",20,"Anchorage Municipality",1,1,646,0,649,0,17,0,2
"07/04/2021","N","Y","Anchorage Municipality",20,"Anchorage Municipality",1,0,646,3,652,3,20,0,2
"07/05/2021","N","Y","Anchorage Municipality",20,"Anchorage Municipality",1,4,650,1,653,0,20,0,2
"07/06/2021","N","Y","Anchorage Municipality",20,"Anchorage Municipality",1,1,651,5,658,0,20,0,2
"07/07/2021","N","Y","Anchorage Municipality",20,"Anchorage Municipality",1,5,656,1,659,0,20,0,2
"07/08/2021","N","Y","Anchorage Municipality",20,"Anchorage Municipality",1,0,656,1,660,0,20,0,2
"07/09/2021","N","Y","Anchorage Municipality",20,"Anchorage Municipality",1,4,660,3,663,0,20,0,2
"07/10/2021","N","Y","Anchorage Municipality",20,"Anchorage Municipality",1,3,663,0,663,0,20,0,2
"07/12/2021","N","Y","Anchorage Municipality",20,"Anchorage Municipality",1,0,663,1,664,0,20,0,2
"07/13/2021","N","Y","Anchorage Municipality",20,"Anchorage Municipality",1,3,666,4,668,0,20,0,2
"07/14/2021","N","Y","Anchorage Municipality",20,"Anchorage Municipality",1,2,668,2,670,0,20,0,2
"07/15/2021","N","Y","Anchorage Municipality",20,"Anchorage Municipality",1,1,669,3,673,0,20,0,2
"07/16/2021","N","Y","Anchorage Municipality",20,"Anchorage Municipality",1,3,672,7,680,0,20,0,2
"07/17/2021","N","Y","Anchorage Municipality",20,"Anchorage Municipality",1,6,678,0,680,0,20,0,2
"07/18/2021","N","Y","Anchorage Municipality",20,"Anchorage Municipality",1,1,679,2,682,0,20,0,2
"07/19/2021","N","Y","Anchorage Municipality",20,"Anchorage Municipality",1,2,681,2,684,0,20,0,2
"07/20/2021","N","Y","Anchorage Municipality",20,"Anchorage Municipality",1,2,683,3,687,0,20,0,2
"07/21/2021","N","Y","Anchorage Municipality",20,"Anchorage Municipality",1,1,684,6,693,0,20,0,2
"07/22/2021","N","Y","Anchorage Municipality",20,"Anchorage Municipality",1,5,689,2,695,1,21,0,2
"07/23/2021","N","Y","Anchorage Municipality",20,"Anchorage Municipality",1,3,692,1,696,0,21,0,2
"07/24/2021","N","Y","Anchorage Municipality",20,"Anchorage Municipality",1,2,694,2,698,0,21,0,2
"07/25/2021","N","Y","Anchorage Municipality",20,"Anchorage Municipality",1,1,695,0,698,0,21,0,2
"07/26/2021","N","Y","Anchorage Municipality",20,"Anchorage Municipality",1,2,697,5,703,1,22,0,2
"07/27/2021","N","Y","Anchorage Municipality",20,"Anchorage Municipality",1,4,701,8,711,0,22,0,2
"07/28/2021","N","Y","Anchorage Municipality",20,"Anchorage Municipality",1,4,705,7,718,0,22,0,2
"07/29/2021","N","Y","Anchorage Municipality",20,"Anchorage Municipality",1,8,713,12,730,1,23,0,2
"07/30/2021","N","Y","Anchorage Municipality",20,"Anchorage Municipality",1,9,722,4,734,0,23,0,2
"07/31/2021","N","Y","Anchorage Municipality",20,"Anchorage Municipality",1,6,728,0,734,0,23,0,2
"08/01/2021","N","Y","Anchorage Municipality",20,"Anchorage Municipality",1,3,731,3,737,0,23,0,2
"08/02/2021","N","Y","Anchorage Municipality",20,"Anchorage Municipality",1,2,733,4,741,0,23,0,2
"08/03/2021","N","Y","Anchorage Municipality",20,"Anchorage Municipality",1,4,737,5,746,1,24,1,3
"08/04/2021","N","Y","Anchorage Municipality",20,"Anchorage Municipality",1,3,740,6,752,0,24,0,3
"08/05/2021","N","Y","Anchorage Municipality",20,"Anchorage Municipality",1,2,742,3,755,1,25,0,3
"08/06/2021","N","Y","Anchorage Municipality",20,"Anchorage Municipality",1,4,746,8,763,1,26,0,3
"08/07/2021","N","Y","Anchorage Municipality",20,"Anchorage Municipality",1,5,751,7,770,0,26,0,3
"08/08/2021","N","Y","Anchorage Municipality",20,"Anchorage Municipality",1,1,752,2,772,0,26,0,3
"08/09/2021","N","Y","Anchorage Municipality",20,"Anchorage Municipality",1,3,755,9,781,0,26,0,3
"08/10/2021","N","Y","Anchorage Municipality",20,"Anchorage Municipality",1,2,757,10,791,1,27,0,3
"08/11/2021","N","Y","Anchorage Municipality",20,"Anchorage Municipality",1,12,769,6,797,0,27,0,3
"08/12/2021","N","Y","Anchorage Municipality",20,"Anchorage Municipality",1,7,776,3,800,0,27,0,3
"08/13/2021","N","Y","Anchorage Municipality",20,"Anchorage Municipality",1,9,785,15,815,0,27,0,3
"08/14/2021","N","Y","Anchorage Municipality",20,"Anchorage Municipality",1,2,787,3,818,0,27,0,3
"08/15/2021","N","Y","Anchorage Municipality",20,"Anchorage Municipality",1,5,792,5,823,1,28,0,3
"08/16/2021","N","Y","Anchorage Municipality",20,"Anchorage Municipality",1,4,796,8,831,0,28,0,3
"08/17/2021","N","Y","Anchorage Municipality",20,"Anchorage Municipality",1,4,800,11,842,0,28,0,3
"08/18/2021","N","Y","Anchorage Municipality",20,"Anchorage Municipality",1,18,818,7,849,0,28,0,3
"08/19/2021","N","Y","Anchorage Municipality",20,"Anchorage Municipality",1,11,829,10,859,0,28,1,4
"08/20/2021","N","Y","Anchorage Municipality",20,"Anchorage Municipality",1,7,836,7,866,0,28,0,4
"08/21/2021","N","Y","Anchorage Municipality",20,"Anchorage Municipality",1,5,841,3,869,0,28,0,4
"08/22/2021","N","Y","Anchorage Municipality",20,"Anchorage Municipality",1,4,845,6,875,1,29,0,4
"08/23/2021","N","Y","Anchorage Municipality",20,"Anchorage Municipality",1,8,853,5,880,0,29,1,5
"08/24/2021","N","Y","Anchorage Municipality",20,"Anchorage Municipality",1,10,863,5,885,1,30,0,5
"08/25/2021","N","Y","Anchorage Municipality",20,"Anchorage Municipality",1,5,868,15,900,1,31,1,6
"08/26/2021","N","Y","Anchorage Municipality",20,"Anchorage Municipality",1,7,875,10,910,0,31,0,6
"08/27/2021","N","Y","Anchorage Municipality",20,"Anchorage Municipality",1,9,884,11,921,0,31,0,6
"08/28/2021","N","Y","Anchorage Municipality",20,"Anchorage Municipality",1,3,887,2,923,0,31,0,6
"08/29/2021","N","Y","Anchorage Municipality",20,"Anchorage Municipality",1,4,891,11,934,0,31,0,6
"08/30/2021","N","Y","Anchorage Municipality",20,"Anchorage Municipality",1,6,897,5,939,0,31,0,6
"08/31/2021","N","Y","Anchorage Municipality",20,"Anchorage Municipality",1,10,907,9,948,1,32,0,6
"09/01/2021","N","Y","Anchorage Municipality",20,"Anchorage Municipality",1,12,919,7,955,0,32,0,6
"09/02/2021","N","Y","Anchorage Municipality",20,"Anchorage Municipality",1,1,920,15,970,0,32,0,6
"09/03/2021","N","Y","Anchorage Municipality",20,"Anchorage Municipality",1,7,927,4,974,0,32,0,6
"09/04/2021","N","Y","Anchorage Municipality",20,"Anchorage Municipality",1,13,940,4,978,1,33,0,6
"09/05/2021","N","Y","Anchorage Municipality",20,"Anchorage Municipality",1,4,944,4,982,0,33,1,7
"09/06/2021","N","Y","Anchorage Municipality",20,"Anchorage Municipality",1,2,946,7,989,0,33,0,7
"09/07/2021","N","Y","Anchorage Municipality",20,"Anchorage Municipality",1,8,954,5,994,0,33,0,7
"09/08/2021","N","Y","Anchorage Municipality",20,"Anchorage Municipality",1,8,962,4,998,1,34,0,7
"09/09/2021","N","Y","Anchorage Municipality",20,"Anchorage Municipality",1,5,967,8,1006,0,34,0,7
"09/10/2021","N","Y","Anchorage Municipality",20,"Anchorage Municipality",1,10,977,3,1009,0,34,0,7
"09/11/2021","N","Y","Anchorage Municipality",20,"Anchorage Municipality",1,3,980,3,1012,0,34,0,7
"09/12/2021","N","Y","Anchorage Municipality",20,"Anchorage Municipality",1,3,983,2,1014,0,34,0,7
"09/13/2021","N","Y","Anchorage Municipality",20,"Anchorage Municipality",1,2,985,4,1018,0,34,0,7
"09/14/2021","N","Y","Anchorage Municipality",20,"Anchorage Municipality",1,7,992,6,1024,0,34,0,7
"09/15/2021","N","Y","Anchorage Municipality",20,"Anchorage Municipality",1,9,1001,10,1034,0,34,0,7
"09/16/2021","N","Y","Anchorage Municipality",20,"Anchorage Municipality",1,3,1004,9,1043,0,34,0,7
"09/17/2021","N","Y","Anchorage Municipality",20,"Anchorage Municipality",1,7,1011,4,1047,0,34,0,7
"09/18/2021","N","Y","Anchorage Municipality",20,"Anchorage Municipality",1,3,1014,3,1050,0,34,0,7
"09/19/2021","N","Y","Anchorage Municipality",20,"Anchorage Municipality",1,4,1018,5,1055,0,34,0,7
"09/20/2021","N","Y","Anchorage Municipality",20,"Anchorage Municipality",1,6,1024,8,1063,0,34,0,7
"09/21/2021","N","Y","Anchorage Municipality",20,"Anchorage Municipality",1,3,1027,2,1065,0,34,0,7
"09/22/2021","N","Y","Anchorage Municipality",20,"Anchorage Municipality",1,7,1034,3,1068,1,35,0,7
"09/23/2021","N","Y","Anchorage Municipality",20,"Anchorage Municipality",1,8,1042,11,1079,0,35,0,7
"09/24/2021","N","Y","Anchorage Municipality",20,"Anchorage Municipality",1,9,1051,1,1080,0,35,0,7
"09/25/2021","N","Y","Anchorage Municipality",20,"Anchorage Municipality",1,8,1059,5,1085,0,35,0,7
"09/26/2021","N","Y","Anchorage Municipality",20,"Anchorage Municipality",1,21,1080,5,1090,0,35,0,7
"09/27/2021","N","Y","Anchorage Municipality",20,"Anchorage Municipality",1,5,1085,4,1094,0,35,0,7
"09/28/2021","N","Y","Anchorage Municipality",20,"Anchorage Municipality",1,2,1087,8,1102,1,36,0,7
"09/29/2021","N","Y","Anchorage Municipality",20,"Anchorage Municipality",1,8,1095,4,1106,0,36,0,7
"09/30/2021","N","Y","Anchorage Municipality",20,"Anchorage Municipality",1,6,1101,4,1110,0,36,0,7
"10/01/2021","N","Y","Anchorage Municipality",20,"Anchorage Municipality",1,6,1107,6,1116,0,36,0,7
"10/02/2021","N","Y","Anchorage Municipality",20,"Anchorage Municipality",1,4,1111,3,1119,0,36,0,7
"10/03/2021","N","Y","Anchorage Municipality",20,"Anchorage Municipality",1,4,1115,4,1123,0,36,0,7
"10/04/2021","N","Y","Anchorage Municipality",20,"Anchorage Municipality",1,4,1119,8,1131,0,36,0,7
"10/05/2021","N","Y","Anchorage Municipality",20,"Anchorage Municipality",1,4,1123,4,1135,0,36,0,7
"10/06/2021","N","Y","Anchorage Municipality",20,"Anchorage Municipality",1,1,1124,8,1143,0,36,0,7
"10/07/2021","N","Y","Anchorage Municipality",20,"Anchorage Municipality",1,7,1131,1,1144,0,36,0,7
"10/08/2021","N","Y","Anchorage Municipality",20,"Anchorage Municipality",1,6,1137,1,1145,0,36,0,7
"10/09/2021","N","Y","Anchorage Municipality",20,"Anchorage Municipality",1,4,1141,4,1149,0,36,0,7
"10/10/2021","N","Y","Anchorage Municipality",20,"Anchorage Municipality",1,3,1144,4,1153,0,36,0,7
"10/11/2021","N","Y","Anchorage Municipality",20,"Anchorage Municipality",1,0,1144,6,1159,0,36,0,7
"10/12/2021","N","Y","Anchorage Municipality",20,"Anchorage Municipality",1,7,1151,5,1164,0,36,0,7
"10/13/2021","N","Y","Anchorage Municipality",20,"Anchorage Municipality",1,9,1160,4,1168,0,36,0,7
"10/14/2021","N","Y","Anchorage Municipality",20,"Anchorage Municipality",1,3,1163,6,1174,0,36,0,7
"10/15/2021","N","Y","Anchorage Municipality",20,"Anchorage Municipality",1,4,1167,4,1178,0,36,0,7
"10/16/2021","N","Y","Anchorage Municipality",20,"Anchorage Municipality",1,5,1172,1,1179,0,36,0,7
"10/17/2021","N","Y","Anchorage Municipality",20,"Anchorage Municipality",1,5,1177,4,1183,0,36,0,7
"10/18/2021","N","Y","Anchorage Municipality",20,"Anchorage Municipality",1,4,1181,4,1187,1,37,0,7
"10/19/2021","N","Y","Anchorage Municipality",20,"Anchorage Municipality",1,3,1184,4,1191,0,37,0,7
"10/20/2021","N","Y","Anchorage Municipality",20,"Anchorage Municipality",1,6,1190,5,1196,0,37,0,7
"10/21/2021","N","Y","Anchorage Municipality",20,"Anchorage Municipality",1,5,1195,6,1202,0,37,0,7
"10/22/2021","N","Y","Anchorage Municipality",20,"Anchorage Municipality",1,1,1196,3,1205,0,37,0,7
"10/23/2021","N","Y","Anchorage Municipality",20,"Anchorage Municipality",1,3,1199,1,1206,0,37,0,7
"10/24/2021","N","Y","Anchorage Municipality",20,"Anchorage Municipality",1,1,1200,3,1209,0,37,0,7
"10/25/2021","N","Y","Anchorage Municipality",20,"Anchorage Municipality",1,2,1202,1,1210,0,37,0,7
"10/26/2021","N","Y","Anchorage Municipality",20,"Anchorage Municipality",1,4,1206,3,1213,0,37,0,7
"10/27/2021","N","Y","Anchorage Municipality",20,"Anchorage Municipality",1,5,1211,3,1216,1,38,0,7
"10/28/2021","N","Y","Anchorage Municipality",20,"Anchorage Municipality",1,2,1213,2,1218,0,38,0,7
"10/29/2021","N","Y","Anchorage Municipality",20,"Anchorage Municipality",1,5,1218,3,1221,0,38,0,7
"10/30/2021","N","Y","Anchorage Municipality",20,"Anchorage Municipality",1,2,1220,0,1221,0,38,0,7
"10/31/2021","N","Y","Anchorage Municipality",20,"Anchorage Municipality",1,1,1221,2,1223,0,38,0,7
"11/01/2021","N","Y","Anchorage Municipality",20,"Anchorage Municipality",1,1,1222,0,1223,0,38,0,7
"11/02/2021","N","Y","Anchorage Municipality",20,"Anchorage Municipality",1,0,1222,1,1224,0,38,1,8
"11/03/2021","N","Y","Anchorage Municipality",20,"Anchorage Municipality",1,4,1226,4,1228,0,38,0,8
"11/04/2021","N","Y","Anchorage Municipality",20,"Anchorage Municipality",1,2,1228,3,1231,0,38,0,8
"11/05/2021","N","Y","Anchorage Municipality",20,"Anchorage Municipality",1,0,1228,1,1232,0,38,0,8
"11/06/2021","N","Y","Anchorage Municipality",20,"Anchorage Municipality",1,3,1231,2,1234,0,38,0,8
"11/08/2021","N","Y","Anchorage Municipality",20,"Anchorage Municipality",1,1,1232,3,1237,0,38,0,8
"11/09/2021","N","Y","Anchorage Municipality",20,"Anchorage Municipality",1,3,1235,1,1238,0,38,0,8
"11/10/2021","N","Y","Anchorage Municipality",20,"Anchorage Municipality",1,3,1238,3,1241,1,39,0,8
"11/11/2021","N","Y","Anchorage Municipality",20,"Anchorage Municipality",1,2,1240,0,1241,0,39,0,8
"11/12/2021","N","Y","Anchorage Municipality",20,"Anchorage Municipality",1,2,1242,3,1244,0,39,0,8
"11/13/2021","N","Y","Anchorage Municipality",20,"Anchorage Municipality",1,2,1244,1,1245,1,40,0,8
"11/14/2021","N","Y","Anchorage Municipality",20,"Anchorage Municipality",1,1,1245,2,1247,0,40,0,8
"11/15/2021","N","Y","Anchorage Municipality",20,"Anchorage Municipality",1,2,1247,0,1247,0,40,0,8
"11/16/2021","N","Y","Anchorage Municipality",20,"Anchorage Municipality",1,0,1247,1,1248,0,40,0,8
"11/17/2021","N","Y","Anchorage Municipality",20,"Anchorage Municipality",1,1,1248,2,1250,0,40,0,8
"11/18/2021","N","Y","Anchorage Municipality",20,"Anchorage Municipality",1,3,1251,3,1253,0,40,0,8
"11/19/2021","N","Y","Anchorage Municipality",20,"Anchorage Municipality",1,2,1253,2,1255,0,40,0,8
"11/20/2021","N","Y","Anchorage Municipality",20,"Anchorage Municipality",1,2,1255,1,1256,0,40,0,8
"11/22/2021","N","Y","Anchorage Municipality",20,"Anchorage Municipality",1,0,1255,5,1261,0,40,0,8
"11/23/2021","N","Y","Anchorage Municipality",20,"Anchorage Municipality",1,3,1258,1,1262,0,40,0,8
"11/24/2021","N","Y","Anchorage Municipality",20,"Anchorage Municipality",1,4,1262,2,1264,0,40,0,8
"11/25/2021","N","Y","Anchorage Municipality",20,"Anchorage Municipality",1,1,1263,2,1266,0,40,0,8
"11/26/2021","N","Y","Anchorage Municipality",20,"Anchorage Municipality",1,2,1265,0,1266,0,40,0,8
"11/27/2021","N","Y","Anchorage Municipality",20,"Anchorage Municipality",1,2,1267,2,1268,0,40,0,8
"11/29/2021","N","Y","Anchorage Municipality",20,"Anchorage Municipality",1,0,1267,1,1269,0,40,0,8
"11/30/2021","N","Y","Anchorage Municipality",20,"Anchorage Municipality",1,1,1268,1,1270,0,40,0,8
"12/01/2021","N","Y","Anchorage Municipality",20,"Anchorage Municipality",1,0,1268,1,1271,0,40,0,8
"12/02/2021","N","Y","Anchorage Municipality",20,"Anchorage Municipality",1,3,1271,2,1273,0,40,0,8
"12/03/2021","N","Y","Anchorage Municipality",20,"Anchorage Municipality",1,2,1273,2,1275,0,40,0,8
"12/06/2021","N","Y","Anchorage Municipality",20,"Anchorage Municipality",1,1,1274,0,1275,0,40,0,8
"12/07/2021","N","Y","Anchorage Municipality",20,"Anchorage Municipality",1,1,1275,1,1276,0,40,0,8
"12/08/2021","N","Y","Anchorage Municipality",20,"Anchorage Municipality",1,1,1276,1,1277,0,40,0,8
"12/10/2021","N","Y","Anchorage Municipality",20,"Anchorage Municipality",1,1,1277,1,1278,0,40,0,8
"12/13/2021","N","Y","Anchorage Municipality",20,"Anchorage Municipality",1,0,1277,1,1279,0,40,0,8
"12/14/2021","N","Y","Anchorage Municipality",20,"Anchorage Municipality",1,1,1278,0,1279,0,40,0,8
"12/15/2021","N","Y","Anchorage Municipality",20,"Anchorage Municipality",1,1,1279,2,1281,0,40,0,8
"12/16/2021","N","Y","Anchorage Municipality",20,"Anchorage Municipality",1,1,1280,1,1282,0,40,0,8
"12/17/2021","N","Y","Anchorage Municipality",20,"Anchorage Municipality",1,1,1281,1,1283,0,40,0,8
"12/18/2021","N","Y","Anchorage Municipality",20,"Anchorage Municipality",1,0,1281,1,1284,0,40,0,8
"12/19/2021","N","Y","Anchorage Municipality",20,"Anchorage Municipality",1,0,1281,1,1285,0,40,0,8
"12/20/2021","N","Y","Anchorage Municipality",20,"Anchorage Municipality",1,1,1282,3,1288,0,40,0,8
"12/21/2021","N","Y","Anchorage Municipality",20,"Anchorage Municipality",1,3,1285,7,1295,0,40,0,8
"12/22/2021","N","Y","Anchorage Municipality",20,"Anchorage Municipality",1,6,1291,10,1305,0,40,0,8
"12/23/2021","N","Y","Anchorage Municipality",20,"Anchorage Municipality",1,6,1297,11,1316,0,40,0,8
"12/24/2021","N","Y","Anchorage Municipality",20,"Anchorage Municipality",1,0,1297,4,1320,0,40,0,8
"12/26/2021","N","Y","Anchorage Municipality",20,"Anchorage Municipality",1,3,1300,5,1325,0,40,0,8
"12/27/2021","N","Y","Anchorage Municipality",20,"Anchorage Municipality",1,15,1315,11,1336,0,40,0,8
"12/28/2021","N","Y","Anchorage Municipality",20,"Anchorage Municipality",1,10,1325,15,1351,0,40,0,8
"12/29/2021","N","Y","Anchorage Municipality",20,"Anchorage Municipality",1,7,1332,21,1372,0,40,0,8
"12/30/2021","N","Y","Anchorage Municipality",20,"Anchorage Municipality",1,21,1353,17,1389,0,40,0,8
"12/31/2021","N","Y","Anchorage Municipality",20,"Anchorage Municipality",1,4,1357,24,1413,0,40,0,8
"01/01/2022","N","Y","Anchorage Municipality",20,"Anchorage Municipality",1,30,1387,3,1416,2,42,0,8
"01/02/2022","N","Y","Anchorage Municipality",20,"Anchorage Municipality",1,7,1394,14,1430,0,42,0,8
"01/03/2022","N","Y","Anchorage Municipality",20,"Anchorage Municipality",1,12,1406,33,1463,0,42,0,8
"01/04/2022","N","Y","Anchorage Municipality",20,"Anchorage Municipality",1,10,1416,22,1485,0,42,0,8
"01/05/2022","N","Y","Anchorage Municipality",20,"Anchorage Municipality",1,39,1455,18,1503,0,42,0,8
"01/06/2022","N","Y","Anchorage Municipality",20,"Anchorage Municipality",1,21,1476,17,1520,0,42,0,8
"01/07/2022","N","Y","Anchorage Municipality",20,"Anchorage Municipality",1,15,1491,15,1535,0,42,0,8
"01/08/2022","N","Y","Anchorage Municipality",20,"Anchorage Municipality",1,3,1494,22,1557,0,42,0,8
"01/09/2022","N","Y","Anchorage Municipality",20,"Anchorage Municipality",1,4,1498,13,1570,0,42,0,8
"01/10/2022","N","Y","Anchorage Municipality",20,"Anchorage Municipality",1,28,1526,36,1606,0,42,0,8
"01/11/2022","N","Y","Anchorage Municipality",20,"Anchorage Municipality",1,24,1550,25,1631,0,42,0,8
"01/12/2022","N","Y","Anchorage Municipality",20,"Anchorage Municipality",1,40,1590,22,1653,0,42,0,8
"01/13/2022","N","Y","Anchorage Municipality",20,"Anchorage Municipality",1,22,1612,13,1666,0,42,0,8
"01/14/2022","N","Y","Anchorage Municipality",20,"Anchorage Municipality",1,15,1627,8,1674,0,42,0,8
"01/15/2022","N","Y","Anchorage Municipality",20,"Anchorage Municipality",1,14,1641,9,1683,1,43,0,8
"01/16/2022","N","Y","Anchorage Municipality",20,"Anchorage Municipality",1,6,1647,11,1694,0,43,0,8
"01/17/2022","N","Y","Anchorage Municipality",20,"Anchorage Municipality",1,16,1663,19,1713,0,43,0,8
"01/18/2022","N","Y","Anchorage Municipality",20,"Anchorage Municipality",1,25,1688,34,1747,0,43,0,8
"01/19/2022","N","Y","Anchorage Municipality",20,"Anchorage Municipality",1,30,1718,15,1762,0,43,0,8
"01/20/2022","N","Y","Anchorage Municipality",20,"Anchorage Municipality",1,16,1734,21,1783,0,43,0,8
"01/21/2022","N","Y","Anchorage Municipality",20,"Anchorage Municipality",1,24,1758,9,1792,0,43,0,8
"01/22/2022","N","Y","Anchorage Municipality",20,"Anchorage Municipality",1,5,1763,7,1799,0,43,0,8
"01/23/2022","N","Y","Anchorage Municipality",20,"Anchorage Municipality",1,5,1768,11,1810,0,43,0,8
"01/24/2022","N","Y","Anchorage Municipality",20,"Anchorage Municipality",1,7,1775,26,1836,0,43,0,8
"01/25/2022","N","Y","Anchorage Municipality",20,"Anchorage Municipality",1,19,1794,13,1849,0,43,0,8
"01/26/2022","N","Y","Anchorage Municipality",20,"Anchorage Municipality",1,17,1811,12,1861,0,43,0,8
"01/27/2022","N","Y","Anchorage Municipality",20,"Anchorage Municipality",1,14,1825,12,1873,0,43,0,8
"01/28/2022","N","Y","Anchorage Municipality",20,"Anchorage Municipality",1,18,1843,4,1877,0,43,0,8
"01/29/2022","N","Y","Anchorage Municipality",20,"Anchorage Municipality",1,8,1851,5,1882,0,43,0,8
"01/30/2022","N","Y","Anchorage Municipality",20,"Anchorage Municipality",1,1,1852,4,1886,0,43,0,8
"01/31/2022","N","Y","Anchorage Municipality",20,"Anchorage Municipality",1,16,1868,5,1891,1,44,0,8
"02/01/2022","N","Y","Anchorage Municipality",20,"Anchorage Municipality",1,12,1880,5,1896,0,44,0,8
"02/02/2022","N","Y","Anchorage Municipality",20,"Anchorage Municipality",1,7,1887,6,1902,0,44,0,8
"02/03/2022","N","Y","Anchorage Municipality",20,"Anchorage Municipality",1,6,1893,6,1908,0,44,0,8
"02/04/2022","N","Y","Anchorage Municipality",20,"Anchorage Municipality",1,9,1902,4,1912,0,44,0,8
"02/05/2022","N","Y","Anchorage Municipality",20,"Anchorage Municipality",1,0,1902,3,1915,0,44,0,8
"02/06/2022","N","Y","Anchorage Municipality",20,"Anchorage Municipality",1,1,1903,2,1917,0,44,0,8
"02/07/2022","N","Y","Anchorage Municipality",20,"Anchorage Municipality",1,6,1909,4,1921,0,44,0,8
"02/08/2022","N","Y","Anchorage Municipality",20,"Anchorage Municipality",1,3,1912,3,1924,0,44,0,8
"02/09/2022","N","Y","Anchorage Municipality",20,"Anchorage Municipality",1,4,1916,4,1928,0,44,0,8
"02/10/2022","N","Y","Anchorage Municipality",20,"Anchorage Municipality",1,3,1919,2,1930,0,44,0,8
"02/11/2022","N","Y","Anchorage Municipality",20,"Anchorage Municipality",1,5,1924,3,1933,0,44,0,8
"02/12/2022","N","Y","Anchorage Municipality",20,"Anchorage Municipality",1,2,1926,0,1933,0,44,0,8
"02/13/2022","N","Y","Anchorage Municipality",20,"Anchorage Municipality",1,4,1930,0,1933,0,44,0,8
"02/14/2022","N","Y","Anchorage Municipality",20,"Anchorage Municipality",1,1,1931,2,1935,1,45,0,8
"02/15/2022","N","Y","Anchorage Municipality",20,"Anchorage Municipality",1,2,1933,2,1937,0,45,0,8
"02/16/2022","N","Y","Anchorage Municipality",20,"Anchorage Municipality",1,0,1933,1,1938,0,45,0,8
"02/17/2022","N","Y","Anchorage Municipality",20,"Anchorage Municipality",1,4,1937,5,1943,0,45,0,8
"02/18/2022","N","Y","Anchorage Municipality",20,"Anchorage Municipality",1,2,1939,4,1947,0,45,0,8
"02/19/2022","N","Y","Anchorage Municipality",20,"Anchorage Municipality",1,2,1941,1,1948,0,45,0,8
"02/20/2022","N","Y","Anchorage Municipality",20,"Anchorage Municipality",1,0,1941,1,1949,0,45,0,8
"02/21/2022","N","Y","Anchorage Municipality",20,"Anchorage Municipality",1,1,1942,0,1949,0,45,0,8
"02/22/2022","N","Y","Anchorage Municipality",20,"Anchorage Municipality",1,1,1943,1,1950,0,45,0,8
"02/23/2022","N","Y","Anchorage Municipality",20,"Anchorage Municipality",1,0,1943,2,1952,0,45,0,8
"02/24/2022","N","Y","Anchorage Municipality",20,"Anchorage Municipality",1,4,1947,2,1954,0,45,0,8
"02/25/2022","N","Y","Anchorage Municipality",20,"Anchorage Municipality",1,7,1954,1,1955,0,45,0,8
"02/28/2022","N","Y","Anchorage Municipality",20,"Anchorage Municipality",1,1,1955,0,1955,0,45,0,8
"03/01/2022","N","Y","Anchorage Municipality",20,"Anchorage Municipality",1,0,1955,1,1956,0,45,0,8
"03/02/2022","N","Y","Anchorage Municipality",20,"Anchorage Municipality",1,1,1956,1,1957,0,45,0,8
"03/03/2022","N","Y","Anchorage Municipality",20,"Anchorage Municipality",1,1,1957,0,1957,0,45,0,8
"03/04/2022","N","Y","Anchorage Municipality",20,"Anchorage Municipality",1,0,1957,1,1958,0,45,0,8
"03/05/2022","N","Y","Anchorage Municipality",20,"Anchorage Municipality",1,1,1958,0,1958,0,45,0,8
"03/06/2022","N","Y","Anchorage Municipality",20,"Anchorage Municipality",1,0,1958,2,1960,0,45,0,8
"03/07/2022","N","Y","Anchorage Municipality",20,"Anchorage Municipality",1,2,1960,1,1961,0,45,0,8
"03/08/2022","N","Y","Anchorage Municipality",20,"Anchorage Municipality",1,1,1961,0,1961,0,45,0,8
"03/11/2022","N","Y","Anchorage Municipality",20,"Anchorage Municipality",1,0,1961,1,1962,0,45,0,8
"03/12/2022","N","Y","Anchorage Municipality",20,"Anchorage Municipality",1,0,1961,1,1963,0,45,0,8
"03/13/2022","N","Y","Anchorage Municipality",20,"Anchorage Municipality",1,0,1961,2,1965,0,45,0,8
"03/14/2022","N","Y","Anchorage Municipality",20,"Anchorage Municipality",1,4,1965,0,1965,0,45,0,8
"03/15/2022","N","Y","Anchorage Municipality",20,"Anchorage Municipality",1,0,1965,1,1966,0,45,0,8
"03/16/2022","N","Y","Anchorage Municipality",20,"Anchorage Municipality",1,0,1965,2,1968,0,45,0,8
"03/17/2022","N","Y","Anchorage Municipality",20,"Anchorage Municipality",1,2,1967,1,1969,0,45,0,8
"03/18/2022","N","Y","Anchorage Municipality",20,"Anchorage Municipality",1,1,1968,1,1970,0,45,0,8
"03/19/2022","N","Y","Anchorage Municipality",20,"Anchorage Municipality",1,0,1968,1,1971,0,45,0,8
"03/20/2022","N","Y","Anchorage Municipality",20,"Anchorage Municipality",1,0,1968,1,1972,0,45,0,8
"03/21/2022","N","Y","Anchorage Municipality",20,"Anchorage Municipality",1,4,1972,2,1974,0,45,0,8
"03/22/2022","N","Y","Anchorage Municipality",20,"Anchorage Municipality",1,0,1972,3,1977,0,45,0,8
"03/23/2022","N","Y","Anchorage Municipality",20,"Anchorage Municipality",1,2,1974,0,1977,0,45,0,8
"03/24/2022","N","Y","Anchorage Municipality",20,"Anchorage Municipality",1,3,1977,1,1978,0,45,0,8
"03/25/2022","N","Y","Anchorage Municipality",20,"Anchorage Municipality",1,0,1977,1,1979,0,45,0,8
"03/27/2022","N","Y","Anchorage Municipality",20,"Anchorage Municipality",1,0,1977,1,1980,0,45,0,8
"03/28/2022","N","Y","Anchorage Municipality",20,"Anchorage Municipality",1,2,1979,3,1983,1,46,0,8
"03/29/2022","N","Y","Anchorage Municipality",20,"Anchorage Municipality",1,1,1980,0,1983,0,46,0,8
"03/30/2022","N","Y","Anchorage Municipality",20,"Anchorage Municipality",1,3,1983,1,1984,0,46,0,8
"03/31/2022","N","Y","Anchorage Municipality",20,"Anchorage Municipality",1,0,1983,2,1986,0,46,0,8
"04/01/2022","N","Y","Anchorage Municipality",20,"Anchorage Municipality",1,3,1986,0,1986,0,46,0,8
"04/02/2022","N","Y","Anchorage Municipality",20,"Anchorage Municipality",1,0,1986,1,1987,0,46,0,8
"04/04/2022","N","Y","Anchorage Municipality",20,"Anchorage Municipality",1,1,1987,1,1988,0,46,0,8
"04/05/2022","N","Y","Anchorage Municipality",20,"Anchorage Municipality",1,0,1987,1,1989,0,46,0,8
"04/06/2022","N","Y","Anchorage Municipality",20,"Anchorage Municipality",1,2,1989,1,1990,0,46,0,8
"04/07/2022","N","Y","Anchorage Municipality",20,"Anchorage Municipality",1,0,1989,1,1991,0,46,0,8
"04/08/2022","N","Y","Anchorage Municipality",20,"Anchorage Municipality",1,1,1990,3,1994,0,46,0,8
"04/09/2022","N","Y","Anchorage Municipality",20,"Anchorage Municipality",1,3,1993,0,1994,0,46,0,8
"04/11/2022","N","Y","Anchorage Municipality",20,"Anchorage Municipality",1,0,1993,1,1995,0,46,0,8
"04/13/2022","N","Y","Anchorage Municipality",20,"Anchorage Municipality",1,1,1994,2,1997,0,46,0,8
"04/14/2022","N","Y","Anchorage Municipality",20,"Anchorage Municipality",1,1,1995,0,1997,0,46,0,8
"04/15/2022","N","Y","Anchorage Municipality",20,"Anchorage Municipality",1,0,1995,2,1999,0,46,0,8
"04/16/2022","N","Y","Anchorage Municipality",20,"Anchorage Municipality",1,2,1997,1,2000,0,46,0,8
"04/17/2022","N","Y","Anchorage Municipality",20,"Anchorage Municipality",1,1,1998,0,2000,0,46,0,8
"04/18/2022","N","Y","Anchorage Municipality",20,"Anchorage Municipality",1,0,1998,1,2001,0,46,0,8
"04/19/2022","N","Y","Anchorage Municipality",20,"Anchorage Municipality",1,2,2000,3,2004,0,46,0,8
"04/20/2022","N","Y","Anchorage Municipality",20,"Anchorage Municipality",1,0,2000,3,2007,0,46,0,8
"04/21/2022","N","Y","Anchorage Municipality",20,"Anchorage Municipality",1,2,2002,6,2013,0,46,0,8
"04/22/2022","N","Y","Anchorage Municipality",20,"Anchorage Municipality",1,10,2012,0,2013,0,46,0,8
"04/24/2022","N","Y","Anchorage Municipality",20,"Anchorage Municipality",1,0,2012,1,2014,0,46,0,8
"04/25/2022","N","Y","Anchorage Municipality",20,"Anchorage Municipality",1,2,2014,1,2015,0,46,0,8
"04/26/2022","N","Y","Anchorage Municipality",20,"Anchorage Municipality",1,1,2015,0,2015,0,46,0,8
"06/05/2020","N","Y","Bethel Census Area",50,"Y-K Delta Region",10,0,0,1,1,0,0,0,0
"06/11/2020","N","Y","Bethel Census Area",50,"Y-K Delta Region",10,1,1,0,1,0,0,0,0
"06/24/2020","N","Y","Bethel Census Area",50,"Y-K Delta Region",10,0,1,1,2,0,0,0,0
"06/25/2020","N","Y","Bethel Census Area",50,"Y-K Delta Region",10,1,2,0,2,0,0,0,0
"08/06/2020","N","Y","Bethel Census Area",50,"Y-K Delta Region",10,0,2,1,3,0,0,0,0
"08/09/2020","N","Y","Bethel Census Area",50,"Y-K Delta Region",10,1,3,0,3,0,0,0,0
"08/11/2020","N","Y","Bethel Census Area",50,"Y-K Delta Region",10,0,3,2,5,0,0,0,0
"08/14/2020","N","Y","Bethel Census Area",50,"Y-K Delta Region",10,1,4,0,5,0,0,0,0
"08/28/2020","N","Y","Bethel Census Area",50,"Y-K Delta Region",10,0,4,1,6,0,0,0,0
"08/29/2020","N","Y","Bethel Census Area",50,"Y-K Delta Region",10,1,5,0,6,0,0,0,0
"08/30/2020","N","Y","Bethel Census Area",50,"Y-K Delta Region",10,1,6,0,6,0,0,0,0
"09/18/2020","N","Y","Bethel Census Area",50,"Y-K Delta Region",10,1,7,1,7,0,0,0,0
"11/21/2020","N","Y","Bethel Census Area",50,"Y-K Delta Region",10,0,7,1,8,0,0,0,0
"11/22/2020","N","Y","Bethel Census Area",50,"Y-K Delta Region",10,1,8,0,8,0,0,0,0
"01/07/2021","N","Y","Bethel Census Area",50,"Y-K Delta Region",10,0,8,1,9,0,0,0,0
"01/08/2021","N","Y","Bethel Census Area",50,"Y-K Delta Region",10,1,9,0,9,0,0,0,0
"01/10/2021","N","Y","Bethel Census Area",50,"Y-K Delta Region",10,0,9,1,10,0,0,0,0
"01/11/2021","N","Y","Bethel Census Area",50,"Y-K Delta Region",10,1,10,0,10,0,0,0,0
"06/29/2021","N","Y","Bethel Census Area",50,"Y-K Delta Region",10,0,10,1,11,0,0,0,0
"06/30/2021","N","Y","Bethel Census Area",50,"Y-K Delta Region",10,1,11,0,11,0,0,0,0
"07/06/2021","N","Y","Bethel Census Area",50,"Y-K Delta Region",10,0,11,1,12,0,0,0,0
"07/07/2021","N","Y","Bethel Census Area",50,"Y-K Delta Region",10,1,12,1,13,0,0,0,0
"07/08/2021","N","Y","Bethel Census Area",50,"Y-K Delta Region",10,1,13,0,13,0,0,0,0
"08/06/2021","N","Y","Bethel Census Area",50,"Y-K Delta Region",10,0,13,1,14,0,0,0,0
"08/12/2021","N","Y","Bethel Census Area",50,"Y-K Delta Region",10,0,13,1,15,0,0,0,0
"08/13/2021","N","Y","Bethel Census Area",50,"Y-K Delta Region",10,1,14,0,15,0,0,0,0
"08/14/2021","N","Y","Bethel Census Area",50,"Y-K Delta Region",10,1,15,0,15,0,0,0,0
"08/17/2021","N","Y","Bethel Census Area",50,"Y-K Delta Region",10,0,15,1,16,0,0,0,0
"08/21/2021","N","Y","Bethel Census Area",50,"Y-K Delta Region",10,1,16,0,16,0,0,0,0
"08/25/2021","N","Y","Bethel Census Area",50,"Y-K Delta Region",10,0,16,1,17,0,0,0,0
"08/31/2021","N","Y","Bethel Census Area",50,"Y-K Delta Region",10,1,17,0,17,0,0,0,0
"09/02/2021","N","Y","Bethel Census Area",50,"Y-K Delta Region",10,0,17,1,18,0,0,0,0
"09/05/2021","N","Y","Bethel Census Area",50,"Y-K Delta Region",10,1,18,1,19,0,0,0,0
"09/07/2021","N","Y","Bethel Census Area",50,"Y-K Delta Region",10,1,19,0,19,0,0,0,0
"09/25/2021","N","Y","Bethel Census Area",50,"Y-K Delta Region",10,0,19,1,20,0,0,0,0
"09/26/2021","N","Y","Bethel Census Area",50,"Y-K Delta Region",10,1,20,1,21,0,0,0,0
"09/27/2021","N","Y","Bethel Census Area",50,"Y-K Delta Region",10,1,21,0,21,0,0,0,0
"12/13/2021","N","Y","Bethel Census Area",50,"Y-K Delta Region",10,0,21,1,22,0,0,0,0
"12/14/2021","N","Y","Bethel Census Area",50,"Y-K Delta Region",10,1,22,0,22,0,0,0,0
"12/15/2021","N","Y","Bethel Census Area",50,"Y-K Delta Region",10,0,22,1,23,0,0,0,0
"12/16/2021","N","Y","Bethel Census Area",50,"Y-K Delta Region",10,1,23,0,23,0,0,0,0
"01/07/2022","N","Y","Bethel Census Area",50,"Y-K Delta Region",10,0,23,1,24,0,0,0,0
"01/10/2022","N","Y","Bethel Census Area",50,"Y-K Delta Region",10,0,23,1,25,0,0,0,0
"01/11/2022","N","Y","Bethel Census Area",50,"Y-K Delta Region",10,1,24,0,25,0,0,0,0
"01/12/2022","N","Y","Bethel Census Area",50,"Y-K Delta Region",10,1,25,0,25,0,0,0,0
"01/22/2022","N","Y","Bethel Census Area",50,"Y-K Delta Region",10,0,25,1,26,0,0,0,0
"01/25/2022","N","Y","Bethel Census Area",50,"Y-K Delta Region",10,1,26,0,26,0,0,0,0
"02/03/2022","N","Y","Bethel Census Area",50,"Y-K Delta Region",10,0,26,1,27,0,0,0,0
"02/22/2022","N","Y","Bethel Census Area",50,"Y-K Delta Region",10,0,26,2,29,0,0,0,0
"03/08/2022","N","Y","Bethel Census Area",50,"Y-K Delta Region",10,3,29,0,29,0,0,0,0
"05/29/2020","N","Y","Bristol Bay plus Lake and Peninsula",300,"Southwest Region",11,1,1,1,1,0,0,0,0
"06/07/2020","N","Y","Bristol Bay plus Lake and Peninsula",300,"Southwest Region",11,0,1,1,2,0,0,0,0
"06/08/2020","N","Y","Bristol Bay plus Lake and Peninsula",300,"Southwest Region",11,1,2,0,2,0,0,0,0
"06/09/2020","N","Y","Bristol Bay plus Lake and Peninsula",300,"Southwest Region",11,0,2,1,3,0,0,0,0
"06/10/2020","N","Y","Bristol Bay plus Lake and Peninsula",300,"Southwest Region",11,0,2,1,4,0,0,0,0
"06/11/2020","N","Y","Bristol Bay plus Lake and Peninsula",300,"Southwest Region",11,1,3,1,5,0,0,0,0
"06/13/2020","N","Y","Bristol Bay plus Lake and Peninsula",300,"Southwest Region",11,1,4,0,5,0,0,0,0
"06/14/2020","N","Y","Bristol Bay plus Lake and Peninsula",300,"Southwest Region",11,0,4,3,8,0,0,0,0
"06/16/2020","N","Y","Bristol Bay plus Lake and Peninsula",300,"Southwest Region",11,0,4,2,10,0,0,0,0
"06/17/2020","N","Y","Bristol Bay plus Lake and Peninsula",300,"Southwest Region",11,1,5,4,14,0,0,0,0
"06/18/2020","N","Y","Bristol Bay plus Lake and Peninsula",300,"Southwest Region",11,7,12,0,14,0,0,0,0
"06/19/2020","N","Y","Bristol Bay plus Lake and Peninsula",300,"Southwest Region",11,0,12,2,16,0,0,0,0
"06/20/2020","N","Y","Bristol Bay plus Lake and Peninsula",300,"Southwest Region",11,1,13,0,16,0,0,0,0
"06/22/2020","N","Y","Bristol Bay plus Lake and Peninsula",300,"Southwest Region",11,0,13,7,23,0,0,0,0
"06/23/2020","N","Y","Bristol Bay plus Lake and Peninsula",300,"Southwest Region",11,1,14,1,24,0,0,0,0
"06/24/2020","N","Y","Bristol Bay plus Lake and Peninsula",300,"Southwest Region",11,13,27,8,32,0,0,0,0
"06/25/2020","N","Y","Bristol Bay plus Lake and Peninsula",300,"Southwest Region",11,5,32,0,32,0,0,0,0
"06/26/2020","N","Y","Bristol Bay plus Lake and Peninsula",300,"Southwest Region",11,1,33,1,33,0,0,0,0
"06/28/2020","N","Y","Bristol Bay plus Lake and Peninsula",300,"Southwest Region",11,0,33,2,35,0,0,0,0
"06/29/2020","N","Y","Bristol Bay plus Lake and Peninsula",300,"Southwest Region",11,5,38,6,41,0,0,0,0
"07/01/2020","N","Y","Bristol Bay plus Lake and Peninsula",300,"Southwest Region",11,1,39,1,42,0,0,0,0
"07/02/2020","N","Y","Bristol Bay plus Lake and Peninsula",300,"Southwest Region",11,7,46,3,45,0,0,0,0
"07/04/2020","N","Y","Bristol Bay plus Lake and Peninsula",300,"Southwest Region",11,2,48,4,49,0,0,0,0
"07/05/2020","N","Y","Bristol Bay plus Lake and Peninsula",300,"Southwest Region",11,0,48,3,52,0,0,0,0
"07/06/2020","N","Y","Bristol Bay plus Lake and Peninsula",300,"Southwest Region",11,0,48,2,54,0,0,0,0
"07/07/2020","N","Y","Bristol Bay plus Lake and Peninsula",300,"Southwest Region",11,2,50,0,54,0,0,0,0
"07/08/2020","N","Y","Bristol Bay plus Lake and Peninsula",300,"Southwest Region",11,0,50,2,56,0,0,0,0
"07/09/2020","N","Y","Bristol Bay plus Lake and Peninsula",300,"Southwest Region",11,3,53,2,58,0,0,0,0
"07/10/2020","N","Y","Bristol Bay plus Lake and Peninsula",300,"Southwest Region",11,2,55,0,58,0,0,0,0
"07/11/2020","N","Y","Bristol Bay plus Lake and Peninsula",300,"Southwest Region",11,1,56,0,58,0,0,0,0
"07/13/2020","N","Y","Bristol Bay plus Lake and Peninsula",300,"Southwest Region",11,1,57,0,58,0,0,0,0
"07/16/2020","N","Y","Bristol Bay plus Lake and Peninsula",300,"Southwest Region",11,1,58,1,59,0,0,0,0
"07/17/2020","N","Y","Bristol Bay plus Lake and Peninsula",300,"Southwest Region",11,1,59,0,59,0,0,0,0
"07/23/2020","N","Y","Bristol Bay plus Lake and Peninsula",300,"Southwest Region",11,0,59,1,60,0,0,0,0
"07/24/2020","N","Y","Bristol Bay plus Lake and Peninsula",300,"Southwest Region",11,0,59,1,61,0,0,0,0
"07/25/2020","N","Y","Bristol Bay plus Lake and Peninsula",300,"Southwest Region",11,2,61,1,62,0,0,0,0
"07/27/2020","N","Y","Bristol Bay plus Lake and Peninsula",300,"Southwest Region",11,1,62,0,62,0,0,0,0
"07/30/2020","N","Y","Bristol Bay plus Lake and Peninsula",300,"Southwest Region",11,0,62,1,63,0,0,0,0
"08/02/2020","N","Y","Bristol Bay plus Lake and Peninsula",300,"Southwest Region",11,3,65,2,65,0,0,0,0
"09/09/2020","N","Y","Bristol Bay plus Lake and Peninsula",300,"Southwest Region",11,0,65,1,66,0,0,0,0
"09/10/2020","N","Y","Bristol Bay plus Lake and Peninsula",300,"Southwest Region",11,1,66,1,67,0,0,0,0
"09/11/2020","N","Y","Bristol Bay plus Lake and Peninsula",300,"Southwest Region",11,1,67,0,67,0,0,0,0
"10/26/2020","N","Y","Bristol Bay plus Lake and Peninsula",300,"Southwest Region",11,0,67,1,68,0,0,0,0
"10/30/2020","N","Y","Bristol Bay plus Lake and Peninsula",300,"Southwest Region",11,1,68,0,68,0,0,0,0
"03/27/2021","N","Y","Bristol Bay plus Lake and Peninsula",300,"Southwest Region",11,0,68,1,69,0,0,0,0
"03/31/2021","N","Y","Bristol Bay plus Lake and Peninsula",300,"Southwest Region",11,0,68,3,72,0,0,0,0
"04/02/2021","N","Y","Bristol Bay plus Lake and Peninsula",300,"Southwest Region",11,4,72,0,72,0,0,0,0
"04/07/2021","N","Y","Bristol Bay plus Lake and Peninsula",300,"Southwest Region",11,0,72,1,73,0,0,0,0
"04/12/2021","N","Y","Bristol Bay plus Lake and Peninsula",300,"Southwest Region",11,0,72,2,75,0,0,0,0
"04/14/2021","N","Y","Bristol Bay plus Lake and Peninsula",300,"Southwest Region",11,3,75,0,75,0,0,0,0
"06/10/2021","N","Y","Bristol Bay plus Lake and Peninsula",300,"Southwest Region",11,0,75,1,76,0,0,0,0
"06/16/2021","N","Y","Bristol Bay plus Lake and Peninsula",300,"Southwest Region",11,1,76,0,76,0,0,0,0
"06/23/2021","N","Y","Bristol Bay plus Lake and Peninsula",300,"Southwest Region",11,2,78,2,78,0,0,0,0
"07/02/2021","N","Y","Bristol Bay plus Lake and Peninsula",300,"Southwest Region",11,1,79,1,79,0,0,0,0
"07/05/2021","N","Y","Bristol Bay plus Lake and Peninsula",300,"Southwest Region",11,1,80,1,80,0,0,0,0
"07/10/2021","N","Y","Bristol Bay plus Lake and Peninsula",300,"Southwest Region",11,0,80,1,81,0,0,0,0
"07/29/2021","N","Y","Bristol Bay plus Lake and Peninsula",300,"Southwest Region",11,0,80,1,82,0,0,0,0
"08/06/2021","N","Y","Bristol Bay plus Lake and Peninsula",300,"Southwest Region",11,1,81,0,82,0,0,0,0
"08/07/2021","N","Y","Bristol Bay plus Lake and Peninsula",300,"Southwest Region",11,0,81,3,85,0,0,0,0
"08/08/2021","N","Y","Bristol Bay plus Lake and Peninsula",300,"Southwest Region",11,0,81,2,87,0,0,0,0
"08/09/2021","N","Y","Bristol Bay plus Lake and Peninsula",300,"Southwest Region",11,0,81,1,88,0,0,0,0
"08/10/2021","N","Y","Bristol Bay plus Lake and Peninsula",300,"Southwest Region",11,1,82,5,93,0,0,0,0
"08/12/2021","N","Y","Bristol Bay plus Lake and Peninsula",300,"Southwest Region",11,9,91,4,97,0,0,0,0
"08/13/2021","N","Y","Bristol Bay plus Lake and Peninsula",300,"Southwest Region",11,0,91,2,99,0,0,0,0
"08/14/2021","N","Y","Bristol Bay plus Lake and Peninsula",300,"Southwest Region",11,0,91,3,102,0,0,0,0
"08/15/2021","N","Y","Bristol Bay plus Lake and Peninsula",300,"Southwest Region",11,4,95,0,102,0,0,0,0
"08/17/2021","N","Y","Bristol Bay plus Lake and Peninsula",300,"Southwest Region",11,6,101,0,102,0,0,0,0
"08/18/2021","N","Y","Bristol Bay plus Lake and Peninsula",300,"Southwest Region",11,0,101,2,104,0,0,0,0
"08/20/2021","N","Y","Bristol Bay plus Lake and Peninsula",300,"Southwest Region",11,1,102,3,107,0,0,0,0
"08/22/2021","N","Y","Bristol Bay plus Lake and Peninsula",300,"Southwest Region",11,2,104,0,107,0,0,0,0
"08/24/2021","N","Y","Bristol Bay plus Lake and Peninsula",300,"Southwest Region",11,3,107,2,109,0,0,0,0
"08/27/2021","N","Y","Bristol Bay plus Lake and Peninsula",300,"Southwest Region",11,2,109,5,114,0,0,0,0
"09/01/2021","N","Y","Bristol Bay plus Lake and Peninsula",300,"Southwest Region",11,5,114,0,114,0,0,0,0
"09/03/2021","N","Y","Bristol Bay plus Lake and Peninsula",300,"Southwest Region",11,3,117,3,117,0,0,0,0
"09/16/2021","N","Y","Bristol Bay plus Lake and Peninsula",300,"Southwest Region",11,0,117,1,118,0,0,0,0
"09/17/2021","N","Y","Bristol Bay plus Lake and Peninsula",300,"Southwest Region",11,0,117,3,121,0,0,0,0
"09/24/2021","N","Y","Bristol Bay plus Lake and Peninsula",300,"Southwest Region",11,0,117,2,123,0,0,0,0
"09/25/2021","N","Y","Bristol Bay plus Lake and Peninsula",300,"Southwest Region",11,1,118,0,123,0,0,0,0
"09/29/2021","N","Y","Bristol Bay plus Lake and Peninsula",300,"Southwest Region",11,3,121,0,123,0,0,0,0
"10/01/2021","N","Y","Bristol Bay plus Lake and Peninsula",300,"Southwest Region",11,0,121,1,124,0,0,0,0
"10/04/2021","N","Y","Bristol Bay plus Lake and Peninsula",300,"Southwest Region",11,1,122,0,124,0,0,0,0
"10/15/2021","N","Y","Bristol Bay plus Lake and Peninsula",300,"Southwest Region",11,0,122,1,125,0,0,0,0
"10/18/2021","N","Y","Bristol Bay plus Lake and Peninsula",300,"Southwest Region",11,2,124,0,125,0,0,0,0
"10/20/2021","N","Y","Bristol Bay plus Lake and Peninsula",300,"Southwest Region",11,1,125,0,125,0,0,0,0
"01/03/2022","N","Y","Bristol Bay plus Lake and Peninsula",300,"Southwest Region",11,0,125,1,126,0,0,0,0
"01/06/2022","N","Y","Bristol Bay plus Lake and Peninsula",300,"Southwest Region",11,1,126,0,126,0,0,0,0
"01/07/2022","N","Y","Bristol Bay plus Lake and Peninsula",300,"Southwest Region",11,0,126,1,127,0,0,0,0
"01/10/2022","N","Y","Bristol Bay plus Lake and Peninsula",300,"Southwest Region",11,1,127,0,127,0,0,0,0
"01/17/2022","N","Y","Bristol Bay plus Lake and Peninsula",300,"Southwest Region",11,0,127,2,129,0,0,0,0
"01/19/2022","N","Y","Bristol Bay plus Lake and Peninsula",300,"Southwest Region",11,0,127,3,132,0,0,0,0
"01/23/2022","N","Y","Bristol Bay plus Lake and Peninsula",300,"Southwest Region",11,2,129,0,132,0,0,0,0
"01/28/2022","N","Y","Bristol Bay plus Lake and Peninsula",300,"Southwest Region",11,3,132,0,132,0,0,0,0
"05/01/2020","N","Y","Chugach Census Area",63,"Other Interior Region",7,0,0,1,1,0,0,0,0
"05/06/2020","N","Y","Chugach Census Area",63,"Other Interior Region",7,1,1,0,1,0,0,0,0
"05/20/2020","N","Y","Chugach Census Area",63,"Other Interior Region",7,0,1,1,2,0,0,0,0
"05/22/2020","N","Y","Chugach Census Area",63,"Other Interior Region",7,1,2,0,2,0,0,0,0
"05/27/2020","N","Y","Chugach Census Area",63,"Other Interior Region",7,0,2,1,3,0,0,0,0
"06/01/2020","N","Y","Chugach Census Area",63,"Other Interior Region",7,1,3,9,12,0,0,0,0
"06/03/2020","N","Y","Chugach Census Area",63,"Other Interior Region",7,10,13,1,13,0,0,0,0
"06/17/2020","N","Y","Chugach Census Area",63,"Other Interior Region",7,0,13,1,14,0,0,0,0
"06/18/2020","N","Y","Chugach Census Area",63,"Other Interior Region",7,1,14,0,14,0,0,0,0
"06/22/2020","N","Y","Chugach Census Area",63,"Other Interior Region",7,2,16,1,15,0,0,0,0
"06/24/2020","N","Y","Chugach Census Area",63,"Other Interior Region",7,1,17,1,16,0,0,0,0
"06/25/2020","N","Y","Chugach Census Area",63,"Other Interior Region",7,0,17,1,17,0,0,0,0
"06/28/2020","N","Y","Chugach Census Area",63,"Other Interior Region",7,0,17,1,18,0,0,0,0
"06/30/2020","N","Y","Chugach Census Area",63,"Other Interior Region",7,0,17,1,19,0,0,0,0
"07/01/2020","N","Y","Chugach Census Area",63,"Other Interior Region",7,0,17,2,21,0,0,0,0
"07/03/2020","N","Y","Chugach Census Area",63,"Other Interior Region",7,2,19,0,21,0,0,0,0
"07/04/2020","N","Y","Chugach Census Area",63,"Other Interior Region",7,1,20,0,21,0,0,0,0
"07/05/2020","N","Y","Chugach Census Area",63,"Other Interior Region",7,0,20,1,22,0,0,0,0
"07/07/2020","N","Y","Chugach Census Area",63,"Other Interior Region",7,0,20,11,33,0,0,0,0
"07/09/2020","N","Y","Chugach Census Area",63,"Other Interior Region",7,0,20,1,34,0,0,0,0
"07/11/2020","N","Y","Chugach Census Area",63,"Other Interior Region",7,13,33,0,34,0,0,0,0
"07/12/2020","N","Y","Chugach Census Area",63,"Other Interior Region",7,0,33,3,37,0,0,0,0
"07/16/2020","N","Y","Chugach Census Area",63,"Other Interior Region",7,3,36,0,37,0,0,0,0
"07/18/2020","N","Y","Chugach Census Area",63,"Other Interior Region",7,0,36,1,38,0,0,0,0
"07/19/2020","N","Y","Chugach Census Area",63,"Other Interior Region",7,2,38,0,38,0,0,0,0
"07/20/2020","N","Y","Chugach Census Area",63,"Other Interior Region",7,0,38,3,41,0,0,0,0
"07/22/2020","N","Y","Chugach Census Area",63,"Other Interior Region",7,0,38,0,41,1,1,0,0
"07/24/2020","N","Y","Chugach Census Area",63,"Other Interior Region",7,0,38,1,42,0,1,0,0
"07/25/2020","N","Y","Chugach Census Area",63,"Other Interior Region",7,2,40,1,43,0,1,0,0
"07/27/2020","N","Y","Chugach Census Area",63,"Other Interior Region",7,2,42,1,44,0,1,0,0
"07/28/2020","N","Y","Chugach Census Area",63,"Other Interior Region",7,1,43,0,44,0,1,0,0
"07/29/2020","N","Y","Chugach Census Area",63,"Other Interior Region",7,1,44,0,44,0,1,0,0
"07/30/2020","N","Y","Chugach Census Area",63,"Other Interior Region",7,1,45,1,45,0,1,0,0
"08/01/2020","N","Y","Chugach Census Area",63,"Other Interior Region",7,0,45,1,46,0,1,0,0
"08/07/2020","N","Y","Chugach Census Area",63,"Other Interior Region",7,1,46,0,46,0,1,0,0
"09/24/2020","N","Y","Chugach Census Area",63,"Other Interior Region",7,0,46,1,47,0,1,0,0
"09/26/2020","N","Y","Chugach Census Area",63,"Other Interior Region",7,1,47,0,47,0,1,0,0
"01/14/2021","N","Y","Chugach Census Area",63,"Other Interior Region",7,1,48,1,48,0,1,0,0
"02/24/2021","N","Y","Chugach Census Area",63,"Other Interior Region",7,0,48,1,49,0,1,0,0
"02/27/2021","N","Y","Chugach Census Area",63,"Other Interior Region",7,1,49,0,49,0,1,0,0
"03/21/2021","N","Y","Chugach Census Area",63,"Other Interior Region",7,0,49,1,50,0,1,0,0
"03/26/2021","N","Y","Chugach Census Area",63,"Other Interior Region",7,0,49,1,51,0,1,0,0
"03/27/2021","N","Y","Chugach Census Area",63,"Other Interior Region",7,1,50,0,51,0,1,0,0
"03/29/2021","N","Y","Chugach Census Area",63,"Other Interior Region",7,0,50,1,52,0,1,0,0
"04/01/2021","N","Y","Chugach Census Area",63,"Other Interior Region",7,2,52,0,52,0,1,0,0
"04/06/2021","N","Y","Chugach Census Area",63,"Other Interior Region",7,0,52,2,54,0,1,0,0
"04/07/2021","N","Y","Chugach Census Area",63,"Other Interior Region",7,1,53,1,55,0,1,0,0
"04/09/2021","N","Y","Chugach Census Area",63,"Other Interior Region",7,2,55,0,55,0,1,0,0
"04/11/2021","N","Y","Chugach Census Area",63,"Other Interior Region",7,0,55,1,56,0,1,0,0
"04/13/2021","N","Y","Chugach Census Area",63,"Other Interior Region",7,1,56,0,56,0,1,0,0
"04/16/2021","N","Y","Chugach Census Area",63,"Other Interior Region",7,0,56,1,57,0,1,0,0
"04/17/2021","N","Y","Chugach Census Area",63,"Other Interior Region",7,0,56,1,58,0,1,0,0
"04/19/2021","N","Y","Chugach Census Area",63,"Other Interior Region",7,1,57,0,58,0,1,0,0
"04/22/2021","N","Y","Chugach Census Area",63,"Other Interior Region",7,0,57,1,59,0,1,0,0
"04/25/2021","N","Y","Chugach Census Area",63,"Other Interior Region",7,2,59,0,59,0,1,0,0
"06/17/2021","N","Y","Chugach Census Area",63,"Other Interior Region",7,0,59,1,60,0,1,0,0
"06/18/2021","N","Y","Chugach Census Area",63,"Other Interior Region",7,1,60,0,60,0,1,0,0
"07/06/2021","N","Y","Chugach Census Area",63,"Other Interior Region",7,0,60,1,61,0,1,0,0
"07/07/2021","N","Y","Chugach Census Area",63,"Other Interior Region",7,1,61,0,61,0,1,0,0
"07/14/2021","N","Y","Chugach Census Area",63,"Other Interior Region",7,2,63,2,63,0,1,0,0
"07/16/2021","N","Y","Chugach Census Area",63,"Other Interior Region",7,0,63,1,64,0,1,0,0
"07/17/2021","N","Y","Chugach Census Area",63,"Other Interior Region",7,1,64,0,64,0,1,0,0
"07/19/2021","N","Y","Chugach Census Area",63,"Other Interior Region",7,0,64,7,71,0,1,0,0
"07/20/2021","N","Y","Chugach Census Area",63,"Other Interior Region",7,7,71,0,71,0,1,0,0
"07/26/2021","N","Y","Chugach Census Area",63,"Other Interior Region",7,0,71,1,72,0,1,0,0
"07/27/2021","N","Y","Chugach Census Area",63,"Other Interior Region",7,1,72,1,73,0,1,0,0
"08/04/2021","N","Y","Chugach Census Area",63,"Other Interior Region",7,1,73,0,73,0,1,0,0
"08/05/2021","N","Y","Chugach Census Area",63,"Other Interior Region",7,0,73,1,74,0,1,0,0
"08/07/2021","N","Y","Chugach Census Area",63,"Other Interior Region",7,1,74,0,74,0,1,0,0
"08/11/2021","N","Y","Chugach Census Area",63,"Other Interior Region",7,0,74,2,76,0,1,0,0
"08/12/2021","N","Y","Chugach Census Area",63,"Other Interior Region",7,2,76,0,76,1,2,0,0
"08/19/2021","N","Y","Chugach Census Area",63,"Other Interior Region",7,0,76,1,77,0,2,0,0
"08/20/2021","N","Y","Chugach Census Area",63,"Other Interior Region",7,2,78,2,79,0,2,0,0
"08/23/2021","N","Y","Chugach Census Area",63,"Other Interior Region",7,0,78,1,80,0,2,0,0
"08/24/2021","N","Y","Chugach Census Area",63,"Other Interior Region",7,2,80,0,80,0,2,0,0
"08/25/2021","N","Y","Chugach Census Area",63,"Other Interior Region",7,0,80,1,81,0,2,0,0
"08/27/2021","N","Y","Chugach Census Area",63,"Other Interior Region",7,0,80,0,81,1,3,0,0
"08/29/2021","N","Y","Chugach Census Area",63,"Other Interior Region",7,1,81,0,81,0,3,0,0
"09/05/2021","N","Y","Chugach Census Area",63,"Other Interior Region",7,1,82,1,82,1,4,0,0
"09/08/2021","N","Y","Chugach Census Area",63,"Other Interior Region",7,0,82,1,83,0,4,0,0
"09/09/2021","N","Y","Chugach Census Area",63,"Other Interior Region",7,1,83,0,83,0,4,0,0
"09/13/2021","N","Y","Chugach Census Area",63,"Other Interior Region",7,0,83,1,84,0,4,0,0
"09/15/2021","N","Y","Chugach Census Area",63,"Other Interior Region",7,0,83,0,84,0,4,1,1
"09/20/2021","N","Y","Chugach Census Area",63,"Other Interior Region",7,0,83,1,85,0,4,0,1
"09/21/2021","N","Y","Chugach Census Area",63,"Other Interior Region",7,1,84,0,85,0,4,0,1
"09/22/2021","N","Y","Chugach Census Area",63,"Other Interior Region",7,1,85,0,85,0,4,0,1
"09/23/2021","N","Y","Chugach Census Area",63,"Other Interior Region",7,0,85,1,86,0,4,0,1
"09/27/2021","N","Y","Chugach Census Area",63,"Other Interior Region",7,2,87,4,90,0,4,0,1
"09/28/2021","N","Y","Chugach Census Area",63,"Other Interior Region",7,1,88,1,91,0,4,0,1
"09/30/2021","N","Y","Chugach Census Area",63,"Other Interior Region",7,2,90,3,94,0,4,0,1
"10/04/2021","N","Y","Chugach Census Area",63,"Other Interior Region",7,1,91,2,96,0,4,0,1
"10/05/2021","N","Y","Chugach Census Area",63,"Other Interior Region",7,1,92,0,96,0,4,0,1
"10/06/2021","N","Y","Chugach Census Area",63,"Other Interior Region",7,2,94,0,96,0,4,0,1
"10/09/2021","N","Y","Chugach Census Area",63,"Other Interior Region",7,1,95,0,96,0,4,0,1
"10/14/2021","N","Y","Chugach Census Area",63,"Other Interior Region",7,1,96,0,96,0,4,0,1
"10/15/2021","N","Y","Chugach Census Area",63,"Other Interior Region",7,0,96,1,97,1,5,0,1
"10/16/2021","N","Y","Chugach Census Area",63,"Other Interior Region",7,1,97,0,97,0,5,0,1
"10/29/2021","N","Y","Chugach Census Area",63,"Other Interior Region",7,1,98,1,98,0,5,0,1
"01/11/2022","N","Y","Chugach Census Area",63,"Other Interior Region",7,0,98,1,99,0,5,0,1
"01/13/2022","N","Y","Chugach Census Area",63,"Other Interior Region",7,0,98,1,100,0,5,0,1
"01/22/2022","N","Y","Chugach Census Area",63,"Other Interior Region",7,1,99,0,100,0,5,0,1
"01/23/2022","N","Y","Chugach Census Area",63,"Other Interior Region",7,0,99,3,103,0,5,0,1
"01/28/2022","N","Y","Chugach Census Area",63,"Other Interior Region",7,5,104,1,104,0,5,0,1
"02/07/2022","N","Y","Chugach Census Area",63,"Other Interior Region",7,0,104,1,105,0,5,0,1
"02/23/2022","N","Y","Chugach Census Area",63,"Other Interior Region",7,0,104,1,106,0,5,0,1
"03/08/2022","N","Y","Chugach Census Area",63,"Other Interior Region",7,1,105,0,106,0,5,0,1
"03/09/2022","N","Y","Chugach Census Area",63,"Other Interior Region",7,1,106,0,106,0,5,0,1
"06/26/2020","N","Y","Copper River Census Area",66,"Other Interior Region",7,1,1,1,1,0,0,0,0
"07/02/2020","N","Y","Copper River Census Area",66,"Other Interior Region",7,0,1,1,2,0,0,0,0
"07/20/2020","N","Y","Copper River Census Area",66,"Other Interior Region",7,1,2,0,2,0,0,0,0
"11/09/2020","N","Y","Copper River Census Area",66,"Other Interior Region",7,0,2,1,3,0,0,0,0
"11/10/2020","N","Y","Copper River Census Area",66,"Other Interior Region",7,1,3,0,3,0,0,0,0
"07/30/2021","N","Y","Copper River Census Area",66,"Other Interior Region",7,0,3,2,5,0,0,0,0
"08/03/2021","N","Y","Copper River Census Area",66,"Other Interior Region",7,2,5,0,5,0,0,0,0
"08/20/2021","N","Y","Copper River Census Area",66,"Other Interior Region",7,1,6,1,6,0,0,0,0
"09/08/2021","N","Y","Copper River Census Area",66,"Other Interior Region",7,0,6,1,7,0,0,0,0
"09/09/2021","N","Y","Copper River Census Area",66,"Other Interior Region",7,1,7,0,7,0,0,0,0
"09/15/2021","N","Y","Copper River Census Area",66,"Other Interior Region",7,0,7,1,8,0,0,0,0
"09/16/2021","N","Y","Copper River Census Area",66,"Other Interior Region",7,0,7,1,9,0,0,0,0
"09/25/2021","N","Y","Copper River Census Area",66,"Other Interior Region",7,1,8,0,9,0,0,0,0
"09/30/2021","N","Y","Copper River Census Area",66,"Other Interior Region",7,1,9,0,9,0,0,0,0
"10/26/2021","N","Y","Copper River Census Area",66,"Other Interior Region",7,0,9,1,10,0,0,0,0
"10/29/2021","N","Y","Copper River Census Area",66,"Other Interior Region",7,1,10,0,10,0,0,0,0
"01/27/2022","N","Y","Copper River Census Area",66,"Other Interior Region",7,0,10,1,11,0,0,0,0
"01/28/2022","N","Y","Copper River Census Area",66,"Other Interior Region",7,1,11,0,11,0,0,0,0
"02/12/2022","N","Y","Copper River Census Area",66,"Other Interior Region",7,0,11,1,12,0,0,0,0
"02/14/2022","N","Y","Copper River Census Area",66,"Other Interior Region",7,1,12,0,12,0,0,0,0
"03/28/2022","N","Y","Copper River Census Area",66,"Other Interior Region",7,0,12,1,13,0,0,0,0
"03/30/2022","N","Y","Copper River Census Area",66,"Other Interior Region",7,1,13,0,13,0,0,0,0
"06/18/2020","N","Y","Denali Borough",68,"Other Interior Region",7,0,0,1,1,0,0,0,0
"06/23/2020","N","Y","Denali Borough",68,"Other Interior Region",7,1,1,0,1,0,0,0,0
"07/13/2020","N","Y","Denali Borough",68,"Other Interior Region",7,0,1,1,2,0,0,0,0
"07/15/2020","N","Y","Denali Borough",68,"Other Interior Region",7,1,2,1,3,0,0,0,0
"07/17/2020","N","Y","Denali Borough",68,"Other Interior Region",7,1,3,0,3,0,0,0,0
"08/19/2020","N","Y","Denali Borough",68,"Other Interior Region",7,0,3,1,4,0,0,0,0
"08/20/2020","N","Y","Denali Borough",68,"Other Interior Region",7,1,4,0,4,0,0,0,0
"06/05/2021","N","Y","Denali Borough",68,"Other Interior Region",7,0,4,1,5,0,0,0,0
"06/16/2021","N","Y","Denali Borough",68,"Other Interior Region",7,1,5,0,5,0,0,0,0
"06/20/2021","N","Y","Denali Borough",68,"Other Interior Region",7,0,5,1,6,0,0,0,0
"06/23/2021","N","Y","Denali Borough",68,"Other Interior Region",7,1,6,0,6,0,0,0,0
"07/02/2021","N","Y","Denali Borough",68,"Other Interior Region",7,0,6,1,7,0,0,0,0
"07/10/2021","N","Y","Denali Borough",68,"Other Interior Region",7,1,7,0,7,0,0,0,0
"07/23/2021","N","Y","Denali Borough",68,"Other Interior Region",7,0,7,1,8,0,0,0,0
"07/28/2021","N","Y","Denali Borough",68,"Other Interior Region",7,1,8,2,10,0,0,0,0
"08/01/2021","N","Y","Denali Borough",68,"Other Interior Region",7,0,8,1,11,0,0,0,0
"08/02/2021","N","Y","Denali Borough",68,"Other Interior Region",7,3,11,1,12,0,0,0,0
"08/03/2021","N","Y","Denali Borough",68,"Other Interior Region",7,0,11,2,14,0,0,0,0
"08/05/2021","N","Y","Denali Borough",68,"Other Interior Region",7,2,13,0,14,0,0,0,0
"08/06/2021","N","Y","Denali Borough",68,"Other Interior Region",7,0,13,1,15,0,0,0,0
"08/10/2021","N","Y","Denali Borough",68,"Other Interior Region",7,1,14,1,16,0,0,0,0
"08/11/2021","N","Y","Denali Borough",68,"Other Interior Region",7,1,15,0,16,0,0,0,0
"08/13/2021","N","Y","Denali Borough",68,"Other Interior Region",7,0,15,2,18,0,0,0,0
"08/14/2021","N","Y","Denali Borough",68,"Other Interior Region",7,0,15,1,19,0,0,0,0
"08/16/2021","N","Y","Denali Borough",68,"Other Interior Region",7,3,18,4,23,0,0,0,0
"08/18/2021","N","Y","Denali Borough",68,"Other Interior Region",7,1,19,2,25,0,0,0,0
"08/20/2021","N","Y","Denali Borough",68,"Other Interior Region",7,1,20,0,25,1,1,0,0
"08/21/2021","N","Y","Denali Borough",68,"Other Interior Region",7,5,25,0,25,0,1,0,0
"08/22/2021","N","Y","Denali Borough",68,"Other Interior Region",7,0,25,1,26,0,1,0,0
"08/23/2021","N","Y","Denali Borough",68,"Other Interior Region",7,0,25,2,28,0,1,0,0
"08/24/2021","N","Y","Denali Borough",68,"Other Interior Region",7,0,25,1,29,0,1,0,0
"08/25/2021","N","Y","Denali Borough",68,"Other Interior Region",7,1,26,1,30,0,1,0,0
"08/26/2021","N","Y","Denali Borough",68,"Other Interior Region",7,0,26,2,32,0,1,0,0
"08/27/2021","N","Y","Denali Borough",68,"Other Interior Region",7,0,26,1,33,0,1,0,0
"08/28/2021","N","Y","Denali Borough",68,"Other Interior Region",7,0,26,1,34,0,1,0,0
"08/29/2021","N","Y","Denali Borough",68,"Other Interior Region",7,0,26,4,38,0,1,0,0
"08/30/2021","N","Y","Denali Borough",68,"Other Interior Region",7,3,29,3,41,0,1,0,0
"08/31/2021","N","Y","Denali Borough",68,"Other Interior Region",7,3,32,4,45,0,1,1,1
"09/02/2021","N","Y","Denali Borough",68,"Other Interior Region",7,5,37,6,51,0,1,0,1
"09/03/2021","N","Y","Denali Borough",68,"Other Interior Region",7,4,41,1,52,0,1,0,1
"09/04/2021","N","Y","Denali Borough",68,"Other Interior Region",7,2,43,1,53,0,1,0,1
"09/06/2021","N","Y","Denali Borough",68,"Other Interior Region",7,1,44,2,55,0,1,0,1
"09/07/2021","N","Y","Denali Borough",68,"Other Interior Region",7,5,49,0,55,0,1,0,1
"09/08/2021","N","Y","Denali Borough",68,"Other Interior Region",7,2,51,1,56,0,1,0,1
"09/09/2021","N","Y","Denali Borough",68,"Other Interior Region",7,0,51,1,57,0,1,0,1
"09/13/2021","N","Y","Denali Borough",68,"Other Interior Region",7,3,54,0,57,0,1,0,1
"09/14/2021","N","Y","Denali Borough",68,"Other Interior Region",7,1,55,0,57,0,1,0,1
"09/15/2021","N","Y","Denali Borough",68,"Other Interior Region",7,1,56,3,60,0,1,0,1
"09/20/2021","N","Y","Denali Borough",68,"Other Interior Region",7,1,57,0,60,0,1,0,1
"09/27/2021","N","Y","Denali Borough",68,"Other Interior Region",7,3,60,0,60,0,1,0,1
"02/01/2022","N","Y","Denali Borough",68,"Other Interior Region",7,0,60,1,61,0,1,0,1
"02/04/2022","N","Y","Denali Borough",68,"Other Interior Region",7,1,61,0,61,0,1,0,1
"02/07/2022","N","Y","Denali Borough",68,"Other Interior Region",7,0,61,1,62,0,1,0,1
"02/09/2022","N","Y","Denali Borough",68,"Other Interior Region",7,1,62,0,62,0,1,0,1
"02/14/2022","N","Y","Denali Borough",68,"Other Interior Region",7,0,62,1,63,0,1,0,1
"02/15/2022","N","Y","Denali Borough",68,"Other Interior Region",7,1,63,0,63,0,1,0,1
"03/18/2022","N","Y","Denali Borough",68,"Other Interior Region",7,1,64,1,64,0,1,0,1
"05/13/2020","N","Y","Dillingham Census Area",70,"Southwest Region",11,0,0,1,1,0,0,0,0
"05/15/2020","N","Y","Dillingham Census Area",70,"Southwest Region",11,1,1,0,1,0,0,0,0
"05/28/2020","N","Y","Dillingham Census Area",70,"Southwest Region",11,0,1,1,2,0,0,0,0
"05/30/2020","N","Y","Dillingham Census Area",70,"Southwest Region",11,1,2,0,2,0,0,0,0
"06/18/2020","N","Y","Dillingham Census Area",70,"Southwest Region",11,0,2,1,3,0,0,0,0
"06/21/2020","N","Y","Dillingham Census Area",70,"Southwest Region",11,0,2,3,6,0,0,0,0
"06/22/2020","N","Y","Dillingham Census Area",70,"Southwest Region",11,11,13,7,13,0,0,0,0
"06/23/2020","N","Y","Dillingham Census Area",70,"Southwest Region",11,1,14,0,13,0,0,0,0
"06/26/2020","N","Y","Dillingham Census Area",70,"Southwest Region",11,2,16,3,16,0,0,0,0
"06/27/2020","N","Y","Dillingham Census Area",70,"Southwest Region",11,1,17,1,17,0,0,0,0
"06/28/2020","N","Y","Dillingham Census Area",70,"Southwest Region",11,0,17,1,18,0,0,0,0
"06/29/2020","N","Y","Dillingham Census Area",70,"Southwest Region",11,1,18,0,18,0,0,0,0
"07/01/2020","N","Y","Dillingham Census Area",70,"Southwest Region",11,2,20,2,20,0,0,0,0
"07/02/2020","N","Y","Dillingham Census Area",70,"Southwest Region",11,1,21,1,21,0,0,0,0
"08/04/2020","N","Y","Dillingham Census Area",70,"Southwest Region",11,0,21,1,22,0,0,0,0
"08/07/2020","N","Y","Dillingham Census Area",70,"Southwest Region",11,1,22,0,22,0,0,0,0
"10/27/2020","N","Y","Dillingham Census Area",70,"Southwest Region",11,0,22,1,23,0,0,0,0
"10/30/2020","N","Y","Dillingham Census Area",70,"Southwest Region",11,1,23,0,23,0,0,0,0
"06/22/2021","N","Y","Dillingham Census Area",70,"Southwest Region",11,0,23,1,24,0,0,0,0
"06/23/2021","N","Y","Dillingham Census Area",70,"Southwest Region",11,1,24,0,24,0,0,0,0
"08/05/2021","N","Y","Dillingham Census Area",70,"Southwest Region",11,0,24,1,25,0,0,0,0
"08/09/2021","N","Y","Dillingham Census Area",70,"Southwest Region",11,1,25,0,25,0,0,0,0
"09/21/2021","N","Y","Dillingham Census Area",70,"Southwest Region",11,0,25,1,26,0,0,0,0
"09/23/2021","N","Y","Dillingham Census Area",70,"Southwest Region",11,1,26,0,26,0,0,0,0
"09/30/2021","N","Y","Dillingham Census Area",70,"Southwest Region",11,1,27,1,27,0,0,0,0
"01/07/2022","N","Y","Dillingham Census Area",70,"Southwest Region",11,0,27,1,28,0,0,0,0
"01/09/2022","N","Y","Dillingham Census Area",70,"Southwest Region",11,0,27,1,29,0,0,0,0
"01/10/2022","N","Y","Dillingham Census Area",70,"Southwest Region",11,1,28,2,31,0,0,0,0
"01/11/2022","N","Y","Dillingham Census Area",70,"Southwest Region",11,0,28,4,35,0,0,0,0
"01/12/2022","N","Y","Dillingham Census Area",70,"Southwest Region",11,0,28,3,38,0,0,0,0
"01/14/2022","N","Y","Dillingham Census Area",70,"Southwest Region",11,2,30,5,43,0,0,0,0
"01/15/2022","N","Y","Dillingham Census Area",70,"Southwest Region",11,0,30,2,45,0,0,0,0
"01/16/2022","N","Y","Dillingham Census Area",70,"Southwest Region",11,0,30,2,47,0,0,0,0
"01/17/2022","N","Y","Dillingham Census Area",70,"Southwest Region",11,5,35,2,49,0,0,0,0
"01/18/2022","N","Y","Dillingham Census Area",70,"Southwest Region",11,0,35,2,51,0,0,0,0
"01/20/2022","N","Y","Dillingham Census Area",70,"Southwest Region",11,0,35,1,52,0,0,0,0
"01/23/2022","N","Y","Dillingham Census Area",70,"Southwest Region",11,0,35,1,53,0,0,0,0
"01/24/2022","N","Y","Dillingham Census Area",70,"Southwest Region",11,1,36,1,54,0,0,0,0
"01/25/2022","N","Y","Dillingham Census Area",70,"Southwest Region",11,1,37,0,54,0,0,0,0
"01/28/2022","N","Y","Dillingham Census Area",70,"Southwest Region",11,10,47,0,54,0,0,0,0
"01/29/2022","N","Y","Dillingham Census Area",70,"Southwest Region",11,0,47,1,55,0,0,0,0
"01/30/2022","N","Y","Dillingham Census Area",70,"Southwest Region",11,0,47,1,56,0,0,0,0
"01/31/2022","N","Y","Dillingham Census Area",70,"Southwest Region",11,0,47,1,57,0,0,0,0
"02/01/2022","N","Y","Dillingham Census Area",70,"Southwest Region",11,0,47,1,58,0,0,0,0
"02/02/2022","N","Y","Dillingham Census Area",70,"Southwest Region",11,7,54,0,58,0,0,0,0
"02/11/2022","N","Y","Dillingham Census Area",70,"Southwest Region",11,4,58,0,58,0,0,0,0
"03/11/2022","N","Y","Dillingham Census Area",70,"Southwest Region",11,0,58,1,59,0,0,0,0
"03/12/2022","N","Y","Dillingham Census Area",70,"Southwest Region",11,1,59,0,59,0,0,0,0
"03/21/2020","N","Y","Fairbanks North Star Borough",90,"Fairbanks North Star Borough",2,0,0,1,1,0,0,0,0
"04/04/2020","N","Y","Fairbanks North Star Borough",90,"Fairbanks North Star Borough",2,1,1,0,1,0,0,0,0
"06/03/2020","N","Y","Fairbanks North Star Borough",90,"Fairbanks North Star Borough",2,0,1,1,2,0,0,0,0
"06/09/2020","N","Y","Fairbanks North Star Borough",90,"Fairbanks North Star Borough",2,0,1,1,3,0,0,0,0
"06/12/2020","N","Y","Fairbanks North Star Borough",90,"Fairbanks North Star Borough",2,1,2,0,3,0,0,0,0
"06/15/2020","N","Y","Fairbanks North Star Borough",90,"Fairbanks North Star Borough",2,0,2,1,4,0,0,0,0
"06/16/2020","N","Y","Fairbanks North Star Borough",90,"Fairbanks North Star Borough",2,0,2,1,5,0,0,0,0
"06/17/2020","N","Y","Fairbanks North Star Borough",90,"Fairbanks North Star Borough",2,2,4,1,6,0,0,0,0
"06/23/2020","N","Y","Fairbanks North Star Borough",90,"Fairbanks North Star Borough",2,1,5,0,6,0,0,0,0
"06/27/2020","N","Y","Fairbanks North Star Borough",90,"Fairbanks North Star Borough",2,0,5,1,7,0,0,0,0
"06/29/2020","N","Y","Fairbanks North Star Borough",90,"Fairbanks North Star Borough",2,0,5,1,8,0,0,0,0
"06/30/2020","N","Y","Fairbanks North Star Borough",90,"Fairbanks North Star Borough",2,1,6,2,10,0,0,0,0
"07/02/2020","N","Y","Fairbanks North Star Borough",90,"Fairbanks North Star Borough",2,1,7,0,10,0,0,0,0
"07/03/2020","N","Y","Fairbanks North Star Borough",90,"Fairbanks North Star Borough",2,2,9,1,11,0,0,0,0
"07/04/2020","N","Y","Fairbanks North Star Borough",90,"Fairbanks North Star Borough",2,1,10,0,11,0,0,0,0
"07/06/2020","N","Y","Fairbanks North Star Borough",90,"Fairbanks North Star Borough",2,0,10,1,12,0,0,0,0
"07/07/2020","N","Y","Fairbanks North Star Borough",90,"Fairbanks North Star Borough",2,2,12,2,14,0,0,0,0
"07/10/2020","N","Y","Fairbanks North Star Borough",90,"Fairbanks North Star Borough",2,0,12,5,19,0,0,0,0
"07/11/2020","N","Y","Fairbanks North Star Borough",90,"Fairbanks North Star Borough",2,2,14,0,19,0,0,0,0
"07/12/2020","N","Y","Fairbanks North Star Borough",90,"Fairbanks North Star Borough",2,2,16,4,23,0,0,0,0
"07/14/2020","N","Y","Fairbanks North Star Borough",90,"Fairbanks North Star Borough",2,0,16,1,24,0,0,0,0
"07/15/2020","N","Y","Fairbanks North Star Borough",90,"Fairbanks North Star Borough",2,5,21,0,24,0,0,0,0
"07/17/2020","N","Y","Fairbanks North Star Borough",90,"Fairbanks North Star Borough",2,2,23,0,24,0,0,0,0
"07/20/2020","N","Y","Fairbanks North Star Borough",90,"Fairbanks North Star Borough",2,0,23,1,25,0,0,0,0
"07/22/2020","N","Y","Fairbanks North Star Borough",90,"Fairbanks North Star Borough",2,0,23,1,26,0,0,0,0
"07/23/2020","N","Y","Fairbanks North Star Borough",90,"Fairbanks North Star Borough",2,0,23,2,28,0,0,0,0
"07/25/2020","N","Y","Fairbanks North Star Borough",90,"Fairbanks North Star Borough",2,3,26,0,28,0,0,0,0
"07/28/2020","N","Y","Fairbanks North Star Borough",90,"Fairbanks North Star Borough",2,0,26,1,29,0,0,0,0
"07/29/2020","N","Y","Fairbanks North Star Borough",90,"Fairbanks North Star Borough",2,2,28,1,30,0,0,0,0
"07/30/2020","N","Y","Fairbanks North Star Borough",90,"Fairbanks North Star Borough",2,0,28,1,31,0,0,0,0
"08/01/2020","N","Y","Fairbanks North Star Borough",90,"Fairbanks North Star Borough",2,1,29,1,32,0,0,0,0
"08/02/2020","N","Y","Fairbanks North Star Borough",90,"Fairbanks North Star Borough",2,1,30,0,32,0,0,0,0
"08/06/2020","N","Y","Fairbanks North Star Borough",90,"Fairbanks North Star Borough",2,1,31,0,32,0,0,0,0
"08/08/2020","N","Y","Fairbanks North Star Borough",90,"Fairbanks North Star Borough",2,1,32,0,32,0,0,0,0
"08/25/2020","N","Y","Fairbanks North Star Borough",90,"Fairbanks North Star Borough",2,0,32,2,34,0,0,0,0
"08/27/2020","N","Y","Fairbanks North Star Borough",90,"Fairbanks North Star Borough",2,2,34,3,37,0,0,0,0
"08/28/2020","N","Y","Fairbanks North Star Borough",90,"Fairbanks North Star Borough",2,1,35,3,40,0,0,0,0
"08/29/2020","N","Y","Fairbanks North Star Borough",90,"Fairbanks North Star Borough",2,4,39,0,40,0,0,0,0
"09/01/2020","N","Y","Fairbanks North Star Borough",90,"Fairbanks North Star Borough",2,0,39,2,42,0,0,0,0
"09/02/2020","N","Y","Fairbanks North Star Borough",90,"Fairbanks North Star Borough",2,1,40,0,42,0,0,0,0
"09/03/2020","N","Y","Fairbanks North Star Borough",90,"Fairbanks North Star Borough",2,0,40,1,43,0,0,0,0
"09/05/2020","N","Y","Fairbanks North Star Borough",90,"Fairbanks North Star Borough",2,1,41,0,43,0,0,0,0
"09/06/2020","N","Y","Fairbanks North Star Borough",90,"Fairbanks North Star Borough",2,1,42,0,43,0,0,0,0
"09/07/2020","N","Y","Fairbanks North Star Borough",90,"Fairbanks North Star Borough",2,0,42,2,45,0,0,0,0
"09/10/2020","N","Y","Fairbanks North Star Borough",90,"Fairbanks North Star Borough",2,3,45,0,45,0,0,0,0
"09/14/2020","N","Y","Fairbanks North Star Borough",90,"Fairbanks North Star Borough",2,0,45,1,46,0,0,0,0
"09/17/2020","N","Y","Fairbanks North Star Borough",90,"Fairbanks North Star Borough",2,1,46,0,46,0,0,0,0
"09/19/2020","N","Y","Fairbanks North Star Borough",90,"Fairbanks North Star Borough",2,0,46,1,47,0,0,0,0
"09/20/2020","N","Y","Fairbanks North Star Borough",90,"Fairbanks North Star Borough",2,1,47,0,47,0,0,0,0
"09/22/2020","N","Y","Fairbanks North Star Borough",90,"Fairbanks North Star Borough",2,0,47,1,48,0,0,0,0
"09/23/2020","N","Y","Fairbanks North Star Borough",90,"Fairbanks North Star Borough",2,2,49,1,49,0,0,0,0
"09/25/2020","N","Y","Fairbanks North Star Borough",90,"Fairbanks North Star Borough",2,0,49,1,50,0,0,0,0
"09/27/2020","N","Y","Fairbanks North Star Borough",90,"Fairbanks North Star Borough",2,0,49,1,51,0,0,0,0
"09/30/2020","N","Y","Fairbanks North Star Borough",90,"Fairbanks North Star Borough",2,0,49,1,52,0,0,0,0
"10/01/2020","N","Y","Fairbanks North Star Borough",90,"Fairbanks North Star Borough",2,2,51,1,53,0,0,0,0
"10/02/2020","N","Y","Fairbanks North Star Borough",90,"Fairbanks North Star Borough",2,0,51,1,54,1,1,0,0
"10/03/2020","N","Y","Fairbanks North Star Borough",90,"Fairbanks North Star Borough",2,1,52,1,55,0,1,0,0
"10/04/2020","N","Y","Fairbanks North Star Borough",90,"Fairbanks North Star Borough",2,1,53,1,56,0,1,0,0
"10/05/2020","N","Y","Fairbanks North Star Borough",90,"Fairbanks North Star Borough",2,2,55,0,56,0,1,0,0
"10/07/2020","N","Y","Fairbanks North Star Borough",90,"Fairbanks North Star Borough",2,1,56,0,56,0,1,0,0
"10/20/2020","N","Y","Fairbanks North Star Borough",90,"Fairbanks North Star Borough",2,0,56,2,58,0,1,0,0
"10/21/2020","N","Y","Fairbanks North Star Borough",90,"Fairbanks North Star Borough",2,0,56,1,59,0,1,0,0
"10/22/2020","N","Y","Fairbanks North Star Borough",90,"Fairbanks North Star Borough",2,1,57,1,60,0,1,0,0
"10/23/2020","N","Y","Fairbanks North Star Borough",90,"Fairbanks North Star Borough",2,0,57,1,61,0,1,0,0
"10/26/2020","N","Y","Fairbanks North Star Borough",90,"Fairbanks North Star Borough",2,0,57,1,62,0,1,0,0
"10/28/2020","N","Y","Fairbanks North Star Borough",90,"Fairbanks North Star Borough",2,4,61,1,63,0,1,0,0
"10/30/2020","N","Y","Fairbanks North Star Borough",90,"Fairbanks North Star Borough",2,1,62,0,63,0,1,0,0
"11/02/2020","N","Y","Fairbanks North Star Borough",90,"Fairbanks North Star Borough",2,1,63,0,63,0,1,0,0
"11/06/2020","N","Y","Fairbanks North Star Borough",90,"Fairbanks North Star Borough",2,0,63,1,64,0,1,0,0
"11/07/2020","N","Y","Fairbanks North Star Borough",90,"Fairbanks North Star Borough",2,0,63,1,65,0,1,0,0
"11/09/2020","N","Y","Fairbanks North Star Borough",90,"Fairbanks North Star Borough",2,0,63,2,67,0,1,0,0
"11/10/2020","N","Y","Fairbanks North Star Borough",90,"Fairbanks North Star Borough",2,1,64,1,68,0,1,0,0
"11/13/2020","N","Y","Fairbanks North Star Borough",90,"Fairbanks North Star Borough",2,0,64,1,69,0,1,0,0
"11/14/2020","N","Y","Fairbanks North Star Borough",90,"Fairbanks North Star Borough",2,4,68,0,69,0,1,0,0
"11/16/2020","N","Y","Fairbanks North Star Borough",90,"Fairbanks North Star Borough",2,0,68,2,71,0,1,0,0
"11/17/2020","N","Y","Fairbanks North Star Borough",90,"Fairbanks North Star Borough",2,1,69,0,71,0,1,0,0
"11/18/2020","N","Y","Fairbanks North Star Borough",90,"Fairbanks North Star Borough",2,0,69,1,72,0,1,0,0
"11/20/2020","N","Y","Fairbanks North Star Borough",90,"Fairbanks North Star Borough",2,1,70,0,72,0,1,0,0
"11/21/2020","N","Y","Fairbanks North Star Borough",90,"Fairbanks North Star Borough",2,1,71,1,73,0,1,0,0
"11/22/2020","N","Y","Fairbanks North Star Borough",90,"Fairbanks North Star Borough",2,0,71,1,74,0,1,0,0
"11/25/2020","N","Y","Fairbanks North Star Borough",90,"Fairbanks North Star Borough",2,1,72,0,74,1,2,0,0
"11/27/2020","N","Y","Fairbanks North Star Borough",90,"Fairbanks North Star Borough",2,1,73,6,80,0,2,0,0
"11/28/2020","N","Y","Fairbanks North Star Borough",90,"Fairbanks North Star Borough",2,0,73,3,83,0,2,0,0
"12/02/2020","N","Y","Fairbanks North Star Borough",90,"Fairbanks North Star Borough",2,0,73,1,84,0,2,0,0
"12/03/2020","N","Y","Fairbanks North Star Borough",90,"Fairbanks North Star Borough",2,3,76,0,84,0,2,0,0
"12/04/2020","N","Y","Fairbanks North Star Borough",90,"Fairbanks North Star Borough",2,5,81,0,84,0,2,0,0
"12/05/2020","N","Y","Fairbanks North Star Borough",90,"Fairbanks North Star Borough",2,0,81,1,85,0,2,0,0
"12/06/2020","N","Y","Fairbanks North Star Borough",90,"Fairbanks North Star Borough",2,1,82,0,85,0,2,0,0
"12/07/2020","N","Y","Fairbanks North Star Borough",90,"Fairbanks North Star Borough",2,1,83,1,86,0,2,0,0
"12/08/2020","N","Y","Fairbanks North Star Borough",90,"Fairbanks North Star Borough",2,0,83,1,87,0,2,0,0
"12/09/2020","N","Y","Fairbanks North Star Borough",90,"Fairbanks North Star Borough",2,2,85,2,89,0,2,0,0
"12/10/2020","N","Y","Fairbanks North Star Borough",90,"Fairbanks North Star Borough",2,1,86,0,89,0,2,0,0
"12/11/2020","N","Y","Fairbanks North Star Borough",90,"Fairbanks North Star Borough",2,1,87,1,90,0,2,0,0
"12/14/2020","N","Y","Fairbanks North Star Borough",90,"Fairbanks North Star Borough",2,1,88,0,90,0,2,0,0
"12/15/2020","N","Y","Fairbanks North Star Borough",90,"Fairbanks North Star Borough",2,1,89,0,90,0,2,0,0
"12/17/2020","N","Y","Fairbanks North Star Borough",90,"Fairbanks North Star Borough",2,1,90,0,90,0,2,0,0
"12/18/2020","N","Y","Fairbanks North Star Borough",90,"Fairbanks North Star Borough",2,0,90,1,91,0,2,0,0
"12/20/2020","N","Y","Fairbanks North Star Borough",90,"Fairbanks North Star Borough",2,1,91,0,91,0,2,0,0
"12/21/2020","N","Y","Fairbanks North Star Borough",90,"Fairbanks North Star Borough",2,0,91,1,92,0,2,0,0
"12/23/2020","N","Y","Fairbanks North Star Borough",90,"Fairbanks North Star Borough",2,1,92,0,92,0,2,0,0
"12/28/2020","N","Y","Fairbanks North Star Borough",90,"Fairbanks North Star Borough",2,0,92,1,93,0,2,0,0
"12/31/2020","N","Y","Fairbanks North Star Borough",90,"Fairbanks North Star Borough",2,1,93,0,93,0,2,0,0
"01/04/2021","N","Y","Fairbanks North Star Borough",90,"Fairbanks North Star Borough",2,0,93,1,94,0,2,0,0
"01/07/2021","N","Y","Fairbanks North Star Borough",90,"Fairbanks North Star Borough",2,0,93,1,95,0,2,0,0
"01/10/2021","N","Y","Fairbanks North Star Borough",90,"Fairbanks North Star Borough",2,1,94,0,95,0,2,0,0
"01/11/2021","N","Y","Fairbanks North Star Borough",90,"Fairbanks North Star Borough",2,0,94,1,96,0,2,0,0
"01/12/2021","N","Y","Fairbanks North Star Borough",90,"Fairbanks North Star Borough",2,2,96,0,96,0,2,0,0
"01/18/2021","N","Y","Fairbanks North Star Borough",90,"Fairbanks North Star Borough",2,1,97,1,97,0,2,0,0
"01/20/2021","N","Y","Fairbanks North Star Borough",90,"Fairbanks North Star Borough",2,0,97,1,98,0,2,0,0
"01/22/2021","N","Y","Fairbanks North Star Borough",90,"Fairbanks North Star Borough",2,1,98,0,98,0,2,0,0
"01/25/2021","N","Y","Fairbanks North Star Borough",90,"Fairbanks North Star Borough",2,0,98,1,99,0,2,0,0
"01/27/2021","N","Y","Fairbanks North Star Borough",90,"Fairbanks North Star Borough",2,1,99,0,99,0,2,0,0
"02/08/2021","N","Y","Fairbanks North Star Borough",90,"Fairbanks North Star Borough",2,0,99,1,100,0,2,0,0
"02/09/2021","N","Y","Fairbanks North Star Borough",90,"Fairbanks North Star Borough",2,0,99,1,101,0,2,0,0
"02/10/2021","N","Y","Fairbanks North Star Borough",90,"Fairbanks North Star Borough",2,2,101,1,102,0,2,0,0
"02/11/2021","N","Y","Fairbanks North Star Borough",90,"Fairbanks North Star Borough",2,1,102,0,102,0,2,0,0
"02/12/2021","N","Y","Fairbanks North Star Borough",90,"Fairbanks North Star Borough",2,0,102,0,102,1,3,0,0
"02/16/2021","N","Y","Fairbanks North Star Borough",90,"Fairbanks North Star Borough",2,0,102,1,103,0,3,0,0
"02/17/2021","N","Y","Fairbanks North Star Borough",90,"Fairbanks North Star Borough",2,0,102,1,104,0,3,0,0
"02/18/2021","N","Y","Fairbanks North Star Borough",90,"Fairbanks North Star Borough",2,1,103,0,104,0,3,0,0
"02/19/2021","N","Y","Fairbanks North Star Borough",90,"Fairbanks North Star Borough",2,1,104,1,105,0,3,0,0
"02/21/2021","N","Y","Fairbanks North Star Borough",90,"Fairbanks North Star Borough",2,1,105,0,105,0,3,0,0
"02/23/2021","N","Y","Fairbanks North Star Borough",90,"Fairbanks North Star Borough",2,0,105,1,106,0,3,0,0
"02/24/2021","N","Y","Fairbanks North Star Borough",90,"Fairbanks North Star Borough",2,1,106,0,106,0,3,0,0
"03/02/2021","N","Y","Fairbanks North Star Borough",90,"Fairbanks North Star Borough",2,0,106,1,107,0,3,0,0
"03/03/2021","N","Y","Fairbanks North Star Borough",90,"Fairbanks North Star Borough",2,0,106,1,108,0,3,0,0
"03/04/2021","N","Y","Fairbanks North Star Borough",90,"Fairbanks North Star Borough",2,2,108,0,108,0,3,0,0
"03/08/2021","N","Y","Fairbanks North Star Borough",90,"Fairbanks North Star Borough",2,0,108,1,109,0,3,0,0
"03/09/2021","N","Y","Fairbanks North Star Borough",90,"Fairbanks North Star Borough",2,0,108,1,110,1,4,0,0
"03/10/2021","N","Y","Fairbanks North Star Borough",90,"Fairbanks North Star Borough",2,1,109,1,111,0,4,0,0
"03/12/2021","N","Y","Fairbanks North Star Borough",90,"Fairbanks North Star Borough",2,1,110,0,111,0,4,0,0
"03/13/2021","N","Y","Fairbanks North Star Borough",90,"Fairbanks North Star Borough",2,1,111,0,111,0,4,0,0
"03/15/2021","N","Y","Fairbanks North Star Borough",90,"Fairbanks North Star Borough",2,0,111,1,112,0,4,0,0
"03/16/2021","N","Y","Fairbanks North Star Borough",90,"Fairbanks North Star Borough",2,1,112,1,113,0,4,0,0
"03/17/2021","N","Y","Fairbanks North Star Borough",90,"Fairbanks North Star Borough",2,1,113,0,113,0,4,0,0
"03/20/2021","N","Y","Fairbanks North Star Borough",90,"Fairbanks North Star Borough",2,0,113,0,113,0,4,1,1
"03/22/2021","N","Y","Fairbanks North Star Borough",90,"Fairbanks North Star Borough",2,0,113,1,114,0,4,0,1
"03/23/2021","N","Y","Fairbanks North Star Borough",90,"Fairbanks North Star Borough",2,1,114,0,114,0,4,0,1
"03/25/2021","N","Y","Fairbanks North Star Borough",90,"Fairbanks North Star Borough",2,0,114,1,115,0,4,0,1
"03/27/2021","N","Y","Fairbanks North Star Borough",90,"Fairbanks North Star Borough",2,1,115,0,115,0,4,0,1
"03/30/2021","N","Y","Fairbanks North Star Borough",90,"Fairbanks North Star Borough",2,0,115,1,116,0,4,0,1
"04/01/2021","N","Y","Fairbanks North Star Borough",90,"Fairbanks North Star Borough",2,1,116,0,116,0,4,0,1
"04/02/2021","N","Y","Fairbanks North Star Borough",90,"Fairbanks North Star Borough",2,0,116,1,117,0,4,0,1
"04/04/2021","N","Y","Fairbanks North Star Borough",90,"Fairbanks North Star Borough",2,1,117,0,117,0,4,0,1
"04/07/2021","N","Y","Fairbanks North Star Borough",90,"Fairbanks North Star Borough",2,0,117,1,118,0,4,0,1
"04/08/2021","N","Y","Fairbanks North Star Borough",90,"Fairbanks North Star Borough",2,1,118,0,118,0,4,0,1
"04/09/2021","N","Y","Fairbanks North Star Borough",90,"Fairbanks North Star Borough",2,0,118,1,119,0,4,0,1
"04/11/2021","N","Y","Fairbanks North Star Borough",90,"Fairbanks North Star Borough",2,1,119,0,119,0,4,0,1
"04/13/2021","N","Y","Fairbanks North Star Borough",90,"Fairbanks North Star Borough",2,0,119,1,120,0,4,0,1
"04/14/2021","N","Y","Fairbanks North Star Borough",90,"Fairbanks North Star Borough",2,0,119,1,121,0,4,0,1
"04/15/2021","N","Y","Fairbanks North Star Borough",90,"Fairbanks North Star Borough",2,1,120,3,124,0,4,0,1
"04/16/2021","N","Y","Fairbanks North Star Borough",90,"Fairbanks North Star Borough",2,1,121,2,126,0,4,0,1
"04/17/2021","N","Y","Fairbanks North Star Borough",90,"Fairbanks North Star Borough",2,4,125,2,128,0,4,0,1
"04/18/2021","N","Y","Fairbanks North Star Borough",90,"Fairbanks North Star Borough",2,2,127,1,129,0,4,0,1
"04/20/2021","N","Y","Fairbanks North Star Borough",90,"Fairbanks North Star Borough",2,0,127,3,132,0,4,0,1
"04/21/2021","N","Y","Fairbanks North Star Borough",90,"Fairbanks North Star Borough",2,3,130,2,134,0,4,0,1
"04/22/2021","N","Y","Fairbanks North Star Borough",90,"Fairbanks North Star Borough",2,3,133,1,135,0,4,0,1
"04/23/2021","N","Y","Fairbanks North Star Borough",90,"Fairbanks North Star Borough",2,0,133,7,142,0,4,0,1
"04/24/2021","N","Y","Fairbanks North Star Borough",90,"Fairbanks North Star Borough",2,4,137,0,142,0,4,0,1
"04/25/2021","N","Y","Fairbanks North Star Borough",90,"Fairbanks North Star Borough",2,1,138,0,142,0,4,0,1
"04/26/2021","N","Y","Fairbanks North Star Borough",90,"Fairbanks North Star Borough",2,4,142,0,142,0,4,0,1
"04/28/2021","N","Y","Fairbanks North Star Borough",90,"Fairbanks North Star Borough",2,0,142,1,143,0,4,0,1
"04/30/2021","N","Y","Fairbanks North Star Borough",90,"Fairbanks North Star Borough",2,1,143,0,143,0,4,0,1
"05/02/2021","N","Y","Fairbanks North Star Borough",90,"Fairbanks North Star Borough",2,0,143,1,144,0,4,0,1
"05/03/2021","N","Y","Fairbanks North Star Borough",90,"Fairbanks North Star Borough",2,1,144,1,145,0,4,0,1
"05/04/2021","N","Y","Fairbanks North Star Borough",90,"Fairbanks North Star Borough",2,1,145,1,146,0,4,0,1
"05/06/2021","N","Y","Fairbanks North Star Borough",90,"Fairbanks North Star Borough",2,1,146,0,146,0,4,0,1
"05/10/2021","N","Y","Fairbanks North Star Borough",90,"Fairbanks North Star Borough",2,0,146,1,147,0,4,0,1
"05/11/2021","N","Y","Fairbanks North Star Borough",90,"Fairbanks North Star Borough",2,1,147,0,147,0,4,0,1
"05/15/2021","N","Y","Fairbanks North Star Borough",90,"Fairbanks North Star Borough",2,0,147,1,148,0,4,0,1
"05/17/2021","N","Y","Fairbanks North Star Borough",90,"Fairbanks North Star Borough",2,1,148,0,148,0,4,0,1
"05/20/2021","N","Y","Fairbanks North Star Borough",90,"Fairbanks North Star Borough",2,0,148,1,149,0,4,0,1
"05/26/2021","N","Y","Fairbanks North Star Borough",90,"Fairbanks North Star Borough",2,1,149,0,149,0,4,0,1
"06/03/2021","N","Y","Fairbanks North Star Borough",90,"Fairbanks North Star Borough",2,0,149,2,151,1,5,0,1
"06/05/2021","N","Y","Fairbanks North Star Borough",90,"Fairbanks North Star Borough",2,0,149,6,157,0,5,0,1
"06/06/2021","N","Y","Fairbanks North Star Borough",90,"Fairbanks North Star Borough",2,0,149,1,158,0,5,0,1
"06/07/2021","N","Y","Fairbanks North Star Borough",90,"Fairbanks North Star Borough",2,1,150,0,158,0,5,0,1
"06/10/2021","N","Y","Fairbanks North Star Borough",90,"Fairbanks North Star Borough",2,1,151,1,159,0,5,0,1
"06/12/2021","N","Y","Fairbanks North Star Borough",90,"Fairbanks North Star Borough",2,0,151,1,160,0,5,0,1
"06/13/2021","N","Y","Fairbanks North Star Borough",90,"Fairbanks North Star Borough",2,0,151,1,161,0,5,0,1
"06/14/2021","N","Y","Fairbanks North Star Borough",90,"Fairbanks North Star Borough",2,2,153,1,162,0,5,0,1
"06/15/2021","N","Y","Fairbanks North Star Borough",90,"Fairbanks North Star Borough",2,7,160,1,163,0,5,0,1
"06/17/2021","N","Y","Fairbanks North Star Borough",90,"Fairbanks North Star Borough",2,2,162,0,163,0,5,0,1
"06/20/2021","N","Y","Fairbanks North Star Borough",90,"Fairbanks North Star Borough",2,1,163,1,164,0,5,0,1
"06/22/2021","N","Y","Fairbanks North Star Borough",90,"Fairbanks North Star Borough",2,1,164,0,164,0,5,0,1
"06/23/2021","N","Y","Fairbanks North Star Borough",90,"Fairbanks North Star Borough",2,0,164,1,165,0,5,0,1
"06/24/2021","N","Y","Fairbanks North Star Borough",90,"Fairbanks North Star Borough",2,0,164,1,166,0,5,0,1
"06/26/2021","N","Y","Fairbanks North Star Borough",90,"Fairbanks North Star Borough",2,2,166,0,166,0,5,0,1
"07/01/2021","N","Y","Fairbanks North Star Borough",90,"Fairbanks North Star Borough",2,1,167,1,167,0,5,0,1
"07/07/2021","N","Y","Fairbanks North Star Borough",90,"Fairbanks North Star Borough",2,0,167,1,168,0,5,0,1
"07/08/2021","N","Y","Fairbanks North Star Borough",90,"Fairbanks North Star Borough",2,0,167,1,169,0,5,0,1
"07/09/2021","N","Y","Fairbanks North Star Borough",90,"Fairbanks North Star Borough",2,3,170,1,170,0,5,0,1
"07/14/2021","N","Y","Fairbanks North Star Borough",90,"Fairbanks North Star Borough",2,0,170,1,171,0,5,0,1
"07/15/2021","N","Y","Fairbanks North Star Borough",90,"Fairbanks North Star Borough",2,1,171,0,171,0,5,0,1
"07/17/2021","N","Y","Fairbanks North Star Borough",90,"Fairbanks North Star Borough",2,0,171,1,172,1,6,0,1
"07/18/2021","N","Y","Fairbanks North Star Borough",90,"Fairbanks North Star Borough",2,1,172,0,172,0,6,0,1
"07/19/2021","N","Y","Fairbanks North Star Borough",90,"Fairbanks North Star Borough",2,0,172,1,173,1,7,0,1
"07/21/2021","N","Y","Fairbanks North Star Borough",90,"Fairbanks North Star Borough",2,1,173,4,177,0,7,0,1
"07/22/2021","N","Y","Fairbanks North Star Borough",90,"Fairbanks North Star Borough",2,1,174,0,177,0,7,0,1
"07/23/2021","N","Y","Fairbanks North Star Borough",90,"Fairbanks North Star Borough",2,2,176,0,177,0,7,0,1
"07/26/2021","N","Y","Fairbanks North Star Borough",90,"Fairbanks North Star Borough",2,0,176,5,182,0,7,0,1
"07/27/2021","N","Y","Fairbanks North Star Borough",90,"Fairbanks North Star Borough",2,4,180,3,185,0,7,0,1
"07/28/2021","N","Y","Fairbanks North Star Borough",90,"Fairbanks North Star Borough",2,1,181,0,185,0,7,0,1
"07/29/2021","N","Y","Fairbanks North Star Borough",90,"Fairbanks North Star Borough",2,1,182,1,186,0,7,0,1
"07/30/2021","N","Y","Fairbanks North Star Borough",90,"Fairbanks North Star Borough",2,0,182,1,187,0,7,1,2
"07/31/2021","N","Y","Fairbanks North Star Borough",90,"Fairbanks North Star Borough",2,2,184,2,189,0,7,0,2
"08/02/2021","N","Y","Fairbanks North Star Borough",90,"Fairbanks North Star Borough",2,1,185,1,190,0,7,0,2
"08/03/2021","N","Y","Fairbanks North Star Borough",90,"Fairbanks North Star Borough",2,1,186,5,195,0,7,0,2
"08/04/2021","N","Y","Fairbanks North Star Borough",90,"Fairbanks North Star Borough",2,5,191,2,197,1,8,0,2
"08/05/2021","N","Y","Fairbanks North Star Borough",90,"Fairbanks North Star Borough",2,1,192,1,198,0,8,0,2
"08/06/2021","N","Y","Fairbanks North Star Borough",90,"Fairbanks North Star Borough",2,2,194,3,201,0,8,0,2
"08/08/2021","N","Y","Fairbanks North Star Borough",90,"Fairbanks North Star Borough",2,0,194,2,203,1,9,0,2
"08/09/2021","N","Y","Fairbanks North Star Borough",90,"Fairbanks North Star Borough",2,4,198,2,205,0,9,0,2
"08/10/2021","N","Y","Fairbanks North Star Borough",90,"Fairbanks North Star Borough",2,1,199,1,206,0,9,0,2
"08/11/2021","N","Y","Fairbanks North Star Borough",90,"Fairbanks North Star Borough",2,2,201,0,206,0,9,0,2
"08/12/2021","N","Y","Fairbanks North Star Borough",90,"Fairbanks North Star Borough",2,2,203,3,209,0,9,0,2
"08/14/2021","N","Y","Fairbanks North Star Borough",90,"Fairbanks North Star Borough",2,1,204,2,211,0,9,1,3
"08/15/2021","N","Y","Fairbanks North Star Borough",90,"Fairbanks North Star Borough",2,1,205,2,213,0,9,0,3
"08/16/2021","N","Y","Fairbanks North Star Borough",90,"Fairbanks North Star Borough",2,0,205,3,216,0,9,0,3
"08/17/2021","N","Y","Fairbanks North Star Borough",90,"Fairbanks North Star Borough",2,1,206,0,216,0,9,0,3
"08/18/2021","N","Y","Fairbanks North Star Borough",90,"Fairbanks North Star Borough",2,3,209,1,217,0,9,1,4
"08/19/2021","N","Y","Fairbanks North Star Borough",90,"Fairbanks North Star Borough",2,4,213,8,225,0,9,0,4
"08/20/2021","N","Y","Fairbanks North Star Borough",90,"Fairbanks North Star Borough",2,1,214,2,227,1,10,0,4
"08/21/2021","N","Y","Fairbanks North Star Borough",90,"Fairbanks North Star Borough",2,1,215,3,230,0,10,0,4
"08/22/2021","N","Y","Fairbanks North Star Borough",90,"Fairbanks North Star Borough",2,0,215,1,231,0,10,1,5
"08/23/2021","N","Y","Fairbanks North Star Borough",90,"Fairbanks North Star Borough",2,3,218,3,234,0,10,0,5
"08/24/2021","N","Y","Fairbanks North Star Borough",90,"Fairbanks North Star Borough",2,5,223,4,238,0,10,0,5
"08/25/2021","N","Y","Fairbanks North Star Borough",90,"Fairbanks North Star Borough",2,5,228,4,242,0,10,0,5
"08/26/2021","N","Y","Fairbanks North Star Borough",90,"Fairbanks North Star Borough",2,2,230,4,246,0,10,0,5
"08/27/2021","N","Y","Fairbanks North Star Borough",90,"Fairbanks North Star Borough",2,1,231,2,248,0,10,0,5
"08/28/2021","N","Y","Fairbanks North Star Borough",90,"Fairbanks North Star Borough",2,1,232,1,249,0,10,0,5
"08/29/2021","N","Y","Fairbanks North Star Borough",90,"Fairbanks North Star Borough",2,0,232,1,250,0,10,0,5
"08/30/2021","N","Y","Fairbanks North Star Borough",90,"Fairbanks North Star Borough",2,3,235,8,258,0,10,0,5
"08/31/2021","N","Y","Fairbanks North Star Borough",90,"Fairbanks North Star Borough",2,5,240,10,268,0,10,0,5
"09/01/2021","N","Y","Fairbanks North Star Borough",90,"Fairbanks North Star Borough",2,9,249,7,275,1,11,0,5
"09/02/2021","N","Y","Fairbanks North Star Borough",90,"Fairbanks North Star Borough",2,0,249,2,277,0,11,0,5
"09/03/2021","N","Y","Fairbanks North Star Borough",90,"Fairbanks North Star Borough",2,8,257,2,279,0,11,0,5
"09/04/2021","N","Y","Fairbanks North Star Borough",90,"Fairbanks North Star Borough",2,1,258,1,280,0,11,0,5
"09/05/2021","N","Y","Fairbanks North Star Borough",90,"Fairbanks North Star Borough",2,0,258,1,281,0,11,0,5
"09/06/2021","N","Y","Fairbanks North Star Borough",90,"Fairbanks North Star Borough",2,0,258,4,285,0,11,0,5
"09/07/2021","N","Y","Fairbanks North Star Borough",90,"Fairbanks North Star Borough",2,9,267,3,288,0,11,0,5
"09/08/2021","N","Y","Fairbanks North Star Borough",90,"Fairbanks North Star Borough",2,1,268,4,292,0,11,0,5
"09/09/2021","N","Y","Fairbanks North Star Borough",90,"Fairbanks North Star Borough",2,6,274,2,294,0,11,0,5
"09/10/2021","N","Y","Fairbanks North Star Borough",90,"Fairbanks North Star Borough",2,5,279,2,296,0,11,0,5
"09/11/2021","N","Y","Fairbanks North Star Borough",90,"Fairbanks North Star Borough",2,1,280,1,297,0,11,0,5
"09/13/2021","N","Y","Fairbanks North Star Borough",90,"Fairbanks North Star Borough",2,1,281,3,300,0,11,0,5
"09/14/2021","N","Y","Fairbanks North Star Borough",90,"Fairbanks North Star Borough",2,1,282,11,311,0,11,0,5
"09/15/2021","N","Y","Fairbanks North Star Borough",90,"Fairbanks North Star Borough",2,5,287,3,314,0,11,0,5
"09/16/2021","N","Y","Fairbanks North Star Borough",90,"Fairbanks North Star Borough",2,3,290,2,316,0,11,0,5
"09/17/2021","N","Y","Fairbanks North Star Borough",90,"Fairbanks North Star Borough",2,0,290,4,320,0,11,0,5
"09/18/2021","N","Y","Fairbanks North Star Borough",90,"Fairbanks North Star Borough",2,0,290,1,321,0,11,0,5
"09/19/2021","N","Y","Fairbanks North Star Borough",90,"Fairbanks North Star Borough",2,0,290,2,323,0,11,0,5
"09/20/2021","N","Y","Fairbanks North Star Borough",90,"Fairbanks North Star Borough",2,0,290,4,327,0,11,0,5
"09/21/2021","N","Y","Fairbanks North Star Borough",90,"Fairbanks North Star Borough",2,6,296,3,330,0,11,0,5
"09/22/2021","N","Y","Fairbanks North Star Borough",90,"Fairbanks North Star Borough",2,5,301,3,333,0,11,0,5
"09/23/2021","N","Y","Fairbanks North Star Borough",90,"Fairbanks North Star Borough",2,11,312,7,340,0,11,0,5
"09/24/2021","N","Y","Fairbanks North Star Borough",90,"Fairbanks North Star Borough",2,2,314,10,350,0,11,0,5
"09/25/2021","N","Y","Fairbanks North Star Borough",90,"Fairbanks North Star Borough",2,7,321,4,354,1,12,0,5
"09/26/2021","N","Y","Fairbanks North Star Borough",90,"Fairbanks North Star Borough",2,16,337,1,355,0,12,0,5
"09/27/2021","N","Y","Fairbanks North Star Borough",90,"Fairbanks North Star Borough",2,4,341,3,358,0,12,0,5
"09/28/2021","N","Y","Fairbanks North Star Borough",90,"Fairbanks North Star Borough",2,11,352,1,359,0,12,0,5
"09/29/2021","N","Y","Fairbanks North Star Borough",90,"Fairbanks North Star Borough",2,4,356,4,363,0,12,0,5
"09/30/2021","N","Y","Fairbanks North Star Borough",90,"Fairbanks North Star Borough",2,1,357,0,363,0,12,0,5
"10/01/2021","N","Y","Fairbanks North Star Borough",90,"Fairbanks North Star Borough",2,4,361,2,365,0,12,0,5
"10/02/2021","N","Y","Fairbanks North Star Borough",90,"Fairbanks North Star Borough",2,1,362,1,366,0,12,0,5
"10/04/2021","N","Y","Fairbanks North Star Borough",90,"Fairbanks North Star Borough",2,2,364,0,366,0,12,0,5
"10/05/2021","N","Y","Fairbanks North Star Borough",90,"Fairbanks North Star Borough",2,0,364,4,370,1,13,0,5
"10/06/2021","N","Y","Fairbanks North Star Borough",90,"Fairbanks North Star Borough",2,2,366,1,371,0,13,0,5
"10/07/2021","N","Y","Fairbanks North Star Borough",90,"Fairbanks North Star Borough",2,2,368,2,373,1,14,0,5
"10/08/2021","N","Y","Fairbanks North Star Borough",90,"Fairbanks North Star Borough",2,3,371,2,375,0,14,0,5
"10/09/2021","N","Y","Fairbanks North Star Borough",90,"Fairbanks North Star Borough",2,1,372,0,375,0,14,0,5
"10/10/2021","N","Y","Fairbanks North Star Borough",90,"Fairbanks North Star Borough",2,0,372,2,377,1,15,0,5
"10/11/2021","N","Y","Fairbanks North Star Borough",90,"Fairbanks North Star Borough",2,1,373,1,378,0,15,0,5
"10/12/2021","N","Y","Fairbanks North Star Borough",90,"Fairbanks North Star Borough",2,2,375,2,380,0,15,0,5
"10/13/2021","N","Y","Fairbanks North Star Borough",90,"Fairbanks North Star Borough",2,3,378,3,383,0,15,0,5
"10/14/2021","N","Y","Fairbanks North Star Borough",90,"Fairbanks North Star Borough",2,2,380,1,384,0,15,0,5
"10/15/2021","N","Y","Fairbanks North Star Borough",90,"Fairbanks North Star Borough",2,0,380,1,385,0,15,0,5
"10/16/2021","N","Y","Fairbanks North Star Borough",90,"Fairbanks North Star Borough",2,4,384,0,385,0,15,0,5
"10/18/2021","N","Y","Fairbanks North Star Borough",90,"Fairbanks North Star Borough",2,1,385,5,390,0,15,0,5
"10/19/2021","N","Y","Fairbanks North Star Borough",90,"Fairbanks North Star Borough",2,1,386,1,391,0,15,0,5
"10/20/2021","N","Y","Fairbanks North Star Borough",90,"Fairbanks North Star Borough",2,1,387,1,392,0,15,1,6
"10/21/2021","N","Y","Fairbanks North Star Borough",90,"Fairbanks North Star Borough",2,3,390,0,392,0,15,0,6
"10/22/2021","N","Y","Fairbanks North Star Borough",90,"Fairbanks North Star Borough",2,3,393,1,393,0,15,0,6
"10/23/2021","N","Y","Fairbanks North Star Borough",90,"Fairbanks North Star Borough",2,0,393,1,394,0,15,0,6
"10/27/2021","N","Y","Fairbanks North Star Borough",90,"Fairbanks North Star Borough",2,1,394,2,396,0,15,0,6
"10/28/2021","N","Y","Fairbanks North Star Borough",90,"Fairbanks North Star Borough",2,0,394,2,398,0,15,0,6
"10/29/2021","N","Y","Fairbanks North Star Borough",90,"Fairbanks North Star Borough",2,2,396,0,398,0,15,0,6
"10/30/2021","N","Y","Fairbanks North Star Borough",90,"Fairbanks North Star Borough",2,1,397,0,398,0,15,0,6
"11/01/2021","N","Y","Fairbanks North Star Borough",90,"Fairbanks North Star Borough",2,1,398,2,400,0,15,0,6
"11/02/2021","N","Y","Fairbanks North Star Borough",90,"Fairbanks North Star Borough",2,1,399,3,403,0,15,0,6
"11/03/2021","N","Y","Fairbanks North Star Borough",90,"Fairbanks North Star Borough",2,1,400,1,404,0,15,0,6
"11/04/2021","N","Y","Fairbanks North Star Borough",90,"Fairbanks North Star Borough",2,0,400,1,405,0,15,0,6
"11/05/2021","N","Y","Fairbanks North Star Borough",90,"Fairbanks North Star Borough",2,3,403,0,405,0,15,0,6
"11/06/2021","N","Y","Fairbanks North Star Borough",90,"Fairbanks North Star Borough",2,2,405,0,405,0,15,0,6
"11/07/2021","N","Y","Fairbanks North Star Borough",90,"Fairbanks North Star Borough",2,0,405,1,406,0,15,0,6
"11/08/2021","N","Y","Fairbanks North Star Borough",90,"Fairbanks North Star Borough",2,1,406,2,408,1,16,0,6
"11/10/2021","N","Y","Fairbanks North Star Borough",90,"Fairbanks North Star Borough",2,0,406,1,409,0,16,0,6
"11/11/2021","N","Y","Fairbanks North Star Borough",90,"Fairbanks North Star Borough",2,3,409,0,409,0,16,0,6
"11/12/2021","N","Y","Fairbanks North Star Borough",90,"Fairbanks North Star Borough",2,0,409,2,411,0,16,0,6
"11/15/2021","N","Y","Fairbanks North Star Borough",90,"Fairbanks North Star Borough",2,2,411,1,412,0,16,0,6
"11/16/2021","N","Y","Fairbanks North Star Borough",90,"Fairbanks North Star Borough",2,1,412,1,413,0,16,0,6
"11/17/2021","N","Y","Fairbanks North Star Borough",90,"Fairbanks North Star Borough",2,0,412,1,414,0,16,0,6
"11/18/2021","N","Y","Fairbanks North Star Borough",90,"Fairbanks North Star Borough",2,1,413,0,414,0,16,0,6
"11/20/2021","N","Y","Fairbanks North Star Borough",90,"Fairbanks North Star Borough",2,0,413,1,415,0,16,0,6
"11/21/2021","N","Y","Fairbanks North Star Borough",90,"Fairbanks North Star Borough",2,0,413,1,416,0,16,0,6
"11/22/2021","N","Y","Fairbanks North Star Borough",90,"Fairbanks North Star Borough",2,1,414,2,418,0,16,1,7
"11/23/2021","N","Y","Fairbanks North Star Borough",90,"Fairbanks North Star Borough",2,2,416,0,418,0,16,0,7
"11/24/2021","N","Y","Fairbanks North Star Borough",90,"Fairbanks North Star Borough",2,1,417,0,418,0,16,0,7
"11/26/2021","N","Y","Fairbanks North Star Borough",90,"Fairbanks North Star Borough",2,1,418,1,419,0,16,0,7
"11/29/2021","N","Y","Fairbanks North Star Borough",90,"Fairbanks North Star Borough",2,1,419,4,423,0,16,0,7
"11/30/2021","N","Y","Fairbanks North Star Borough",90,"Fairbanks North Star Borough",2,1,420,1,424,0,16,0,7
"12/01/2021","N","Y","Fairbanks North Star Borough",90,"Fairbanks North Star Borough",2,1,421,0,424,0,16,0,7
"12/02/2021","N","Y","Fairbanks North Star Borough",90,"Fairbanks North Star Borough",2,2,423,2,426,0,16,0,7
"12/03/2021","N","Y","Fairbanks North Star Borough",90,"Fairbanks North Star Borough",2,1,424,1,427,0,16,0,7
"12/05/2021","N","Y","Fairbanks North Star Borough",90,"Fairbanks North Star Borough",2,1,425,0,427,0,16,0,7
"12/06/2021","N","Y","Fairbanks North Star Borough",90,"Fairbanks North Star Borough",2,1,426,0,427,0,16,0,7
"12/08/2021","N","Y","Fairbanks North Star Borough",90,"Fairbanks North Star Borough",2,1,427,2,429,0,16,0,7
"12/09/2021","N","Y","Fairbanks North Star Borough",90,"Fairbanks North Star Borough",2,2,429,0,429,0,16,0,7
"12/16/2021","N","Y","Fairbanks North Star Borough",90,"Fairbanks North Star Borough",2,0,429,2,431,0,16,0,7
"12/17/2021","N","Y","Fairbanks North Star Borough",90,"Fairbanks North Star Borough",2,1,430,0,431,0,16,0,7
"12/18/2021","N","Y","Fairbanks North Star Borough",90,"Fairbanks North Star Borough",2,0,430,1,432,0,16,0,7
"12/19/2021","N","Y","Fairbanks North Star Borough",90,"Fairbanks North Star Borough",2,1,431,0,432,0,16,0,7
"12/20/2021","N","Y","Fairbanks North Star Borough",90,"Fairbanks North Star Borough",2,1,432,1,433,0,16,0,7
"12/21/2021","N","Y","Fairbanks North Star Borough",90,"Fairbanks North Star Borough",2,0,432,4,437,0,16,0,7
"12/22/2021","N","Y","Fairbanks North Star Borough",90,"Fairbanks North Star Borough",2,2,434,0,437,0,16,0,7
"12/23/2021","N","Y","Fairbanks North Star Borough",90,"Fairbanks North Star Borough",2,1,435,2,439,0,16,0,7
"12/27/2021","N","Y","Fairbanks North Star Borough",90,"Fairbanks North Star Borough",2,4,439,1,440,0,16,0,7
"12/29/2021","N","Y","Fairbanks North Star Borough",90,"Fairbanks North Star Borough",2,0,439,1,441,0,16,0,7
"12/30/2021","N","Y","Fairbanks North Star Borough",90,"Fairbanks North Star Borough",2,1,440,6,447,0,16,0,7
"12/31/2021","N","Y","Fairbanks North Star Borough",90,"Fairbanks North Star Borough",2,0,440,5,452,0,16,0,7
"01/01/2022","N","Y","Fairbanks North Star Borough",90,"Fairbanks North Star Borough",2,9,449,0,452,0,16,0,7
"01/02/2022","N","Y","Fairbanks North Star Borough",90,"Fairbanks North Star Borough",2,0,449,7,459,0,16,0,7
"01/03/2022","N","Y","Fairbanks North Star Borough",90,"Fairbanks North Star Borough",2,5,454,10,469,0,16,0,7
"01/04/2022","N","Y","Fairbanks North Star Borough",90,"Fairbanks North Star Borough",2,8,462,5,474,0,16,0,7
"01/05/2022","N","Y","Fairbanks North Star Borough",90,"Fairbanks North Star Borough",2,6,468,7,481,0,16,0,7
"01/06/2022","N","Y","Fairbanks North Star Borough",90,"Fairbanks North Star Borough",2,6,474,6,487,0,16,0,7
"01/07/2022","N","Y","Fairbanks North Star Borough",90,"Fairbanks North Star Borough",2,9,483,8,495,0,16,0,7
"01/08/2022","N","Y","Fairbanks North Star Borough",90,"Fairbanks North Star Borough",2,0,483,2,497,0,16,0,7
"01/09/2022","N","Y","Fairbanks North Star Borough",90,"Fairbanks North Star Borough",2,0,483,4,501,0,16,0,7
"01/10/2022","N","Y","Fairbanks North Star Borough",90,"Fairbanks North Star Borough",2,8,491,12,513,0,16,0,7
"01/11/2022","N","Y","Fairbanks North Star Borough",90,"Fairbanks North Star Borough",2,15,506,12,525,0,16,0,7
"01/12/2022","N","Y","Fairbanks North Star Borough",90,"Fairbanks North Star Borough",2,8,514,4,529,0,16,0,7
"01/13/2022","N","Y","Fairbanks North Star Borough",90,"Fairbanks North Star Borough",2,5,519,12,541,0,16,0,7
"01/14/2022","N","Y","Fairbanks North Star Borough",90,"Fairbanks North Star Borough",2,13,532,10,551,0,16,0,7
"01/15/2022","N","Y","Fairbanks North Star Borough",90,"Fairbanks North Star Borough",2,3,535,7,558,0,16,0,7
"01/16/2022","N","Y","Fairbanks North Star Borough",90,"Fairbanks North Star Borough",2,5,540,4,562,0,16,0,7
"01/17/2022","N","Y","Fairbanks North Star Borough",90,"Fairbanks North Star Borough",2,8,548,8,570,0,16,0,7
"01/18/2022","N","Y","Fairbanks North Star Borough",90,"Fairbanks North Star Borough",2,12,560,19,589,0,16,0,7
"01/19/2022","N","Y","Fairbanks North Star Borough",90,"Fairbanks North Star Borough",2,4,564,17,606,0,16,0,7
"01/20/2022","N","Y","Fairbanks North Star Borough",90,"Fairbanks North Star Borough",2,10,574,18,624,0,16,0,7
"01/21/2022","N","Y","Fairbanks North Star Borough",90,"Fairbanks North Star Borough",2,22,596,3,627,0,16,0,7
"01/22/2022","N","Y","Fairbanks North Star Borough",90,"Fairbanks North Star Borough",2,4,600,6,633,0,16,0,7
"01/23/2022","N","Y","Fairbanks North Star Borough",90,"Fairbanks North Star Borough",2,4,604,3,636,0,16,0,7
"01/24/2022","N","Y","Fairbanks North Star Borough",90,"Fairbanks North Star Borough",2,21,625,17,653,0,16,0,7
"01/25/2022","N","Y","Fairbanks North Star Borough",90,"Fairbanks North Star Borough",2,7,632,13,666,0,16,0,7
"01/26/2022","N","Y","Fairbanks North Star Borough",90,"Fairbanks North Star Borough",2,17,649,7,673,0,16,0,7
"01/27/2022","N","Y","Fairbanks North Star Borough",90,"Fairbanks North Star Borough",2,8,657,5,678,0,16,0,7
"01/28/2022","N","Y","Fairbanks North Star Borough",90,"Fairbanks North Star Borough",2,13,670,5,683,0,16,0,7
"01/29/2022","N","Y","Fairbanks North Star Borough",90,"Fairbanks North Star Borough",2,3,673,3,686,0,16,0,7
"01/30/2022","N","Y","Fairbanks North Star Borough",90,"Fairbanks North Star Borough",2,0,673,5,691,0,16,0,7
"01/31/2022","N","Y","Fairbanks North Star Borough",90,"Fairbanks North Star Borough",2,8,681,9,700,0,16,0,7
"02/01/2022","N","Y","Fairbanks North Star Borough",90,"Fairbanks North Star Borough",2,7,688,5,705,0,16,0,7
"02/02/2022","N","Y","Fairbanks North Star Borough",90,"Fairbanks North Star Borough",2,9,697,6,711,0,16,0,7
"02/03/2022","N","Y","Fairbanks North Star Borough",90,"Fairbanks North Star Borough",2,7,704,2,713,0,16,0,7
"02/04/2022","N","Y","Fairbanks North Star Borough",90,"Fairbanks North Star Borough",2,4,708,1,714,0,16,0,7
"02/07/2022","N","Y","Fairbanks North Star Borough",90,"Fairbanks North Star Borough",2,2,710,1,715,0,16,0,7
"02/08/2022","N","Y","Fairbanks North Star Borough",90,"Fairbanks North Star Borough",2,2,712,1,716,0,16,0,7
"02/10/2022","N","Y","Fairbanks North Star Borough",90,"Fairbanks North Star Borough",2,1,713,1,717,0,16,0,7
"02/11/2022","N","Y","Fairbanks North Star Borough",90,"Fairbanks North Star Borough",2,2,715,0,717,0,16,0,7
"02/12/2022","N","Y","Fairbanks North Star Borough",90,"Fairbanks North Star Borough",2,2,717,1,718,0,16,0,7
"02/15/2022","N","Y","Fairbanks North Star Borough",90,"Fairbanks North Star Borough",2,0,717,1,719,0,16,0,7
"02/16/2022","N","Y","Fairbanks North Star Borough",90,"Fairbanks North Star Borough",2,1,718,3,722,0,16,0,7
"02/17/2022","N","Y","Fairbanks North Star Borough",90,"Fairbanks North Star Borough",2,3,721,0,722,0,16,0,7
"02/18/2022","N","Y","Fairbanks North Star Borough",90,"Fairbanks North Star Borough",2,1,722,0,722,0,16,0,7
"02/23/2022","N","Y","Fairbanks North Star Borough",90,"Fairbanks North Star Borough",2,0,722,1,723,0,16,0,7
"02/24/2022","N","Y","Fairbanks North Star Borough",90,"Fairbanks North Star Borough",2,1,723,2,725,0,16,0,7
"02/25/2022","N","Y","Fairbanks North Star Borough",90,"Fairbanks North Star Borough",2,2,725,0,725,0,16,0,7
"02/28/2022","N","Y","Fairbanks North Star Borough",90,"Fairbanks North Star Borough",2,0,725,2,727,0,16,0,7
"03/01/2022","N","Y","Fairbanks North Star Borough",90,"Fairbanks North Star Borough",2,2,727,0,727,0,16,0,7
"03/11/2022","N","Y","Fairbanks North Star Borough",90,"Fairbanks North Star Borough",2,0,727,1,728,0,16,0,7
"03/15/2022","N","Y","Fairbanks North Star Borough",90,"Fairbanks North Star Borough",2,1,728,1,729,0,16,0,7
"03/16/2022","N","Y","Fairbanks North Star Borough",90,"Fairbanks North Star Borough",2,0,728,1,730,0,16,0,7
"03/17/2022","N","Y","Fairbanks North Star Borough",90,"Fairbanks North Star Borough",2,2,730,1,731,0,16,0,7
"03/18/2022","N","Y","Fairbanks North Star Borough",90,"Fairbanks North Star Borough",2,1,731,3,734,0,16,0,7
"03/19/2022","N","Y","Fairbanks North Star Borough",90,"Fairbanks North Star Borough",2,0,731,4,738,0,16,0,7
"03/20/2022","N","Y","Fairbanks North Star Borough",90,"Fairbanks North Star Borough",2,0,731,2,740,0,16,0,7
"03/21/2022","N","Y","Fairbanks North Star Borough",90,"Fairbanks North Star Borough",2,9,740,2,742,0,16,0,7
"03/22/2022","N","Y","Fairbanks North Star Borough",90,"Fairbanks North Star Borough",2,2,742,0,742,0,16,0,7
"03/24/2022","N","Y","Fairbanks North Star Borough",90,"Fairbanks North Star Borough",2,0,742,1,743,0,16,0,7
"03/27/2022","N","Y","Fairbanks North Star Borough",90,"Fairbanks North Star Borough",2,0,742,1,744,0,16,0,7
"03/29/2022","N","Y","Fairbanks North Star Borough",90,"Fairbanks North Star Borough",2,1,743,0,744,0,16,0,7
"03/30/2022","N","Y","Fairbanks North Star Borough",90,"Fairbanks North Star Borough",2,1,744,0,744,0,16,0,7
"04/01/2022","N","Y","Fairbanks North Star Borough",90,"Fairbanks North Star Borough",2,0,744,1,745,0,16,0,7
"04/05/2022","N","Y","Fairbanks North Star Borough",90,"Fairbanks North Star Borough",2,1,745,0,745,0,16,0,7
"04/07/2022","N","Y","Fairbanks North Star Borough",90,"Fairbanks North Star Borough",2,0,745,1,746,0,16,0,7
"04/08/2022","N","Y","Fairbanks North Star Borough",90,"Fairbanks North Star Borough",2,1,746,0,746,0,16,0,7
"04/12/2022","N","Y","Fairbanks North Star Borough",90,"Fairbanks North Star Borough",2,0,746,1,747,0,16,0,7
"04/13/2022","N","Y","Fairbanks North Star Borough",90,"Fairbanks North Star Borough",2,0,746,1,748,0,16,0,7
"04/14/2022","N","Y","Fairbanks North Star Borough",90,"Fairbanks North Star Borough",2,0,746,2,750,0,16,0,7
"04/15/2022","N","Y","Fairbanks North Star Borough",90,"Fairbanks North Star Borough",2,2,748,0,750,0,16,0,7
"04/16/2022","N","Y","Fairbanks North Star Borough",90,"Fairbanks North Star Borough",2,2,750,0,750,0,16,0,7
"04/18/2022","N","Y","Fairbanks North Star Borough",90,"Fairbanks North Star Borough",2,0,750,1,751,0,16,0,7
"04/19/2022","N","Y","Fairbanks North Star Borough",90,"Fairbanks North Star Borough",2,1,751,1,752,0,16,0,7
"04/20/2022","N","Y","Fairbanks North Star Borough",90,"Fairbanks North Star Borough",2,1,752,1,753,0,16,0,7
"04/22/2022","N","Y","Fairbanks North Star Borough",90,"Fairbanks North Star Borough",2,1,753,4,757,0,16,0,7
"04/23/2022","N","Y","Fairbanks North Star Borough",90,"Fairbanks North Star Borough",2,1,754,0,757,0,16,0,7
"04/25/2022","N","Y","Fairbanks North Star Borough",90,"Fairbanks North Star Borough",2,3,757,0,757,0,16,0,7
"06/21/2020","N","Y","Haines Borough",100,"Other Southeast Region - Northern",8,3,3,3,3,0,0,0,0
"06/29/2020","N","Y","Haines Borough",100,"Other Southeast Region - Northern",8,0,3,1,4,0,0,0,0
"07/01/2020","N","Y","Haines Borough",100,"Other Southeast Region - Northern",8,1,4,0,4,0,0,0,0
"07/08/2020","N","Y","Haines Borough",100,"Other Southeast Region - Northern",8,0,4,2,6,0,0,0,0
"07/13/2020","N","Y","Haines Borough",100,"Other Southeast Region - Northern",8,1,5,0,6,0,0,0,0
"07/15/2020","N","Y","Haines Borough",100,"Other Southeast Region - Northern",8,1,6,0,6,0,0,0,0
"10/07/2020","N","Y","Haines Borough",100,"Other Southeast Region - Northern",8,0,6,1,7,0,0,0,0
"10/11/2020","N","Y","Haines Borough",100,"Other Southeast Region - Northern",8,1,7,0,7,0,0,0,0
"08/11/2021","N","Y","Haines Borough",100,"Other Southeast Region - Northern",8,0,7,1,8,0,0,0,0
"08/16/2021","N","Y","Haines Borough",100,"Other Southeast Region - Northern",8,1,8,0,8,0,0,0,0
"06/06/2020","N","Y","Juneau City and Borough",110,"Juneau City and Borough",3,0,0,1,1,0,0,0,0
"06/09/2020","N","Y","Juneau City and Borough",110,"Juneau City and Borough",3,1,1,2,3,0,0,0,0
"06/12/2020","N","Y","Juneau City and Borough",110,"Juneau City and Borough",3,2,3,0,3,0,0,0,0
"06/23/2020","N","Y","Juneau City and Borough",110,"Juneau City and Borough",3,0,3,1,4,0,0,0,0
"06/24/2020","N","Y","Juneau City and Borough",110,"Juneau City and Borough",3,0,3,1,5,0,0,0,0
"06/26/2020","N","Y","Juneau City and Borough",110,"Juneau City and Borough",3,1,4,0,5,0,0,0,0
"07/02/2020","N","Y","Juneau City and Borough",110,"Juneau City and Borough",3,0,4,1,6,0,0,0,0
"07/05/2020","N","Y","Juneau City and Borough",110,"Juneau City and Borough",3,1,5,0,6,0,0,0,0
"07/07/2020","N","Y","Juneau City and Borough",110,"Juneau City and Borough",3,1,6,1,7,0,0,0,0
"07/08/2020","N","Y","Juneau City and Borough",110,"Juneau City and Borough",3,0,6,1,8,0,0,0,0
"07/10/2020","N","Y","Juneau City and Borough",110,"Juneau City and Borough",3,0,6,1,9,0,0,0,0
"07/12/2020","N","Y","Juneau City and Borough",110,"Juneau City and Borough",3,0,6,4,13,0,0,0,0
"07/13/2020","N","Y","Juneau City and Borough",110,"Juneau City and Borough",3,0,6,1,14,0,0,0,0
"07/15/2020","N","Y","Juneau City and Borough",110,"Juneau City and Borough",3,0,6,27,41,0,0,0,0
"07/16/2020","N","Y","Juneau City and Borough",110,"Juneau City and Borough",3,3,9,2,43,0,0,0,0
"07/17/2020","N","Y","Juneau City and Borough",110,"Juneau City and Borough",3,1,10,0,43,0,0,0,0
"07/18/2020","N","Y","Juneau City and Borough",110,"Juneau City and Borough",3,1,11,0,43,0,0,0,0
"07/19/2020","N","Y","Juneau City and Borough",110,"Juneau City and Borough",3,21,32,1,44,0,0,0,0
"07/20/2020","N","Y","Juneau City and Borough",110,"Juneau City and Borough",3,6,38,0,44,0,0,0,0
"07/21/2020","N","Y","Juneau City and Borough",110,"Juneau City and Borough",3,1,39,2,46,0,0,0,0
"07/22/2020","N","Y","Juneau City and Borough",110,"Juneau City and Borough",3,1,40,14,60,0,0,0,0
"07/23/2020","N","Y","Juneau City and Borough",110,"Juneau City and Borough",3,0,40,1,61,0,0,0,0
"07/25/2020","N","Y","Juneau City and Borough",110,"Juneau City and Borough",3,1,41,2,63,0,0,0,0
"07/27/2020","N","Y","Juneau City and Borough",110,"Juneau City and Borough",3,10,51,1,64,0,0,0,0
"07/28/2020","N","Y","Juneau City and Borough",110,"Juneau City and Borough",3,6,57,1,65,0,0,0,0
"07/29/2020","N","Y","Juneau City and Borough",110,"Juneau City and Borough",3,4,61,0,65,0,0,0,0
"07/30/2020","N","Y","Juneau City and Borough",110,"Juneau City and Borough",3,1,62,1,66,0,0,0,0
"07/31/2020","N","Y","Juneau City and Borough",110,"Juneau City and Borough",3,2,64,2,68,0,0,0,0
"08/01/2020","N","Y","Juneau City and Borough",110,"Juneau City and Borough",3,0,64,2,70,0,0,0,0
"08/02/2020","N","Y","Juneau City and Borough",110,"Juneau City and Borough",3,1,65,0,70,0,0,0,0
"08/04/2020","N","Y","Juneau City and Borough",110,"Juneau City and Borough",3,1,66,0,70,0,0,0,0
"08/05/2020","N","Y","Juneau City and Borough",110,"Juneau City and Borough",3,3,69,0,70,0,0,0,0
"08/06/2020","N","Y","Juneau City and Borough",110,"Juneau City and Borough",3,0,69,3,73,0,0,0,0
"08/07/2020","N","Y","Juneau City and Borough",110,"Juneau City and Borough",3,1,70,1,74,0,0,0,0
"08/10/2020","N","Y","Juneau City and Borough",110,"Juneau City and Borough",3,4,74,8,82,0,0,0,0
"08/11/2020","N","Y","Juneau City and Borough",110,"Juneau City and Borough",3,1,75,1,83,0,0,0,0
"08/12/2020","N","Y","Juneau City and Borough",110,"Juneau City and Borough",3,7,82,2,85,0,0,0,0
"08/13/2020","N","Y","Juneau City and Borough",110,"Juneau City and Borough",3,1,83,2,87,0,0,0,0
"08/17/2020","N","Y","Juneau City and Borough",110,"Juneau City and Borough",3,1,84,1,88,0,0,0,0
"08/18/2020","N","Y","Juneau City and Borough",110,"Juneau City and Borough",3,1,85,0,88,0,0,0,0
"08/19/2020","N","Y","Juneau City and Borough",110,"Juneau City and Borough",3,2,87,0,88,0,0,0,0
"08/20/2020","N","Y","Juneau City and Borough",110,"Juneau City and Borough",3,1,88,0,88,0,0,0,0
"08/24/2020","N","Y","Juneau City and Borough",110,"Juneau City and Borough",3,0,88,2,90,0,0,0,0
"08/25/2020","N","Y","Juneau City and Borough",110,"Juneau City and Borough",3,1,89,0,90,0,0,0,0
"08/31/2020","N","Y","Juneau City and Borough",110,"Juneau City and Borough",3,1,90,0,90,0,0,0,0
"09/03/2020","N","Y","Juneau City and Borough",110,"Juneau City and Borough",3,0,90,1,91,0,0,0,0
"09/16/2020","N","Y","Juneau City and Borough",110,"Juneau City and Borough",3,1,91,0,91,0,0,0,0
"10/01/2020","N","Y","Juneau City and Borough",110,"Juneau City and Borough",3,0,91,1,92,0,0,0,0
"10/02/2020","N","Y","Juneau City and Borough",110,"Juneau City and Borough",3,1,92,0,92,0,0,0,0
"10/20/2020","N","Y","Juneau City and Borough",110,"Juneau City and Borough",3,0,92,1,93,0,0,0,0
"10/23/2020","N","Y","Juneau City and Borough",110,"Juneau City and Borough",3,2,94,1,94,0,0,0,0
"11/08/2020","N","Y","Juneau City and Borough",110,"Juneau City and Borough",3,0,94,1,95,0,0,0,0
"11/09/2020","N","Y","Juneau City and Borough",110,"Juneau City and Borough",3,0,94,1,96,0,0,0,0
"11/10/2020","N","Y","Juneau City and Borough",110,"Juneau City and Borough",3,2,96,0,96,0,0,0,0
"11/19/2020","N","Y","Juneau City and Borough",110,"Juneau City and Borough",3,1,97,1,97,0,0,0,0
"11/22/2020","N","Y","Juneau City and Borough",110,"Juneau City and Borough",3,0,97,1,98,0,0,0,0
"11/24/2020","N","Y","Juneau City and Borough",110,"Juneau City and Borough",3,1,98,0,98,0,0,0,0
"12/02/2020","N","Y","Juneau City and Borough",110,"Juneau City and Borough",3,0,98,1,99,0,0,0,0
"12/06/2020","N","Y","Juneau City and Borough",110,"Juneau City and Borough",3,1,99,0,99,0,0,0,0
"12/10/2020","N","Y","Juneau City and Borough",110,"Juneau City and Borough",3,1,100,2,101,0,0,0,0
"12/11/2020","N","Y","Juneau City and Borough",110,"Juneau City and Borough",3,1,101,0,101,0,0,0,0
"12/20/2020","N","Y","Juneau City and Borough",110,"Juneau City and Borough",3,0,101,2,103,0,0,0,0
"12/22/2020","N","Y","Juneau City and Borough",110,"Juneau City and Borough",3,2,103,0,103,0,0,0,0
"12/24/2020","N","Y","Juneau City and Borough",110,"Juneau City and Borough",3,1,104,1,104,0,0,0,0
"12/29/2020","N","Y","Juneau City and Borough",110,"Juneau City and Borough",3,0,104,1,105,0,0,0,0
"12/31/2020","N","Y","Juneau City and Borough",110,"Juneau City and Borough",3,1,105,1,106,0,0,0,0
"01/02/2021","N","Y","Juneau City and Borough",110,"Juneau City and Borough",3,0,105,2,108,0,0,0,0
"01/06/2021","N","Y","Juneau City and Borough",110,"Juneau City and Borough",3,0,105,1,109,0,0,0,0
"01/07/2021","N","Y","Juneau City and Borough",110,"Juneau City and Borough",3,1,106,0,109,0,0,0,0
"01/11/2021","N","Y","Juneau City and Borough",110,"Juneau City and Borough",3,0,106,1,110,0,0,0,0
"01/12/2021","N","Y","Juneau City and Borough",110,"Juneau City and Borough",3,3,109,0,110,0,0,0,0
"01/15/2021","N","Y","Juneau City and Borough",110,"Juneau City and Borough",3,1,110,1,111,0,0,0,0
"01/17/2021","N","Y","Juneau City and Borough",110,"Juneau City and Borough",3,1,111,0,111,0,0,0,0
"01/29/2021","N","Y","Juneau City and Borough",110,"Juneau City and Borough",3,0,111,2,113,0,0,0,0
"02/01/2021","N","Y","Juneau City and Borough",110,"Juneau City and Borough",3,1,112,0,113,0,0,0,0
"02/04/2021","N","Y","Juneau City and Borough",110,"Juneau City and Borough",3,1,113,1,114,0,0,0,0
"02/05/2021","N","Y","Juneau City and Borough",110,"Juneau City and Borough",3,1,114,0,114,0,0,0,0
"02/08/2021","N","Y","Juneau City and Borough",110,"Juneau City and Borough",3,0,114,1,115,0,0,0,0
"02/13/2021","N","Y","Juneau City and Borough",110,"Juneau City and Borough",3,1,115,0,115,0,0,0,0
"02/15/2021","N","Y","Juneau City and Borough",110,"Juneau City and Borough",3,0,115,1,116,0,0,0,0
"02/17/2021","N","Y","Juneau City and Borough",110,"Juneau City and Borough",3,0,115,1,117,0,0,0,0
"02/18/2021","N","Y","Juneau City and Borough",110,"Juneau City and Borough",3,1,116,0,117,0,0,0,0
"02/24/2021","N","Y","Juneau City and Borough",110,"Juneau City and Borough",3,1,117,0,117,0,0,0,0
"02/25/2021","N","Y","Juneau City and Borough",110,"Juneau City and Borough",3,1,118,1,118,0,0,0,0
"03/01/2021","N","Y","Juneau City and Borough",110,"Juneau City and Borough",3,0,118,1,119,0,0,0,0
"03/04/2021","N","Y","Juneau City and Borough",110,"Juneau City and Borough",3,1,119,0,119,0,0,0,0
"03/22/2021","N","Y","Juneau City and Borough",110,"Juneau City and Borough",3,0,119,1,120,0,0,0,0
"03/25/2021","N","Y","Juneau City and Borough",110,"Juneau City and Borough",3,0,119,1,121,0,0,0,0
"03/30/2021","N","Y","Juneau City and Borough",110,"Juneau City and Borough",3,1,120,0,121,0,0,0,0
"04/01/2021","N","Y","Juneau City and Borough",110,"Juneau City and Borough",3,0,120,2,123,0,0,0,0
"04/03/2021","N","Y","Juneau City and Borough",110,"Juneau City and Borough",3,0,120,1,124,0,0,0,0
"04/04/2021","N","Y","Juneau City and Borough",110,"Juneau City and Borough",3,1,121,0,124,0,0,0,0
"04/06/2021","N","Y","Juneau City and Borough",110,"Juneau City and Borough",3,3,124,1,125,0,0,0,0
"04/07/2021","N","Y","Juneau City and Borough",110,"Juneau City and Borough",3,1,125,0,125,0,0,0,0
"04/09/2021","N","Y","Juneau City and Borough",110,"Juneau City and Borough",3,0,125,1,126,0,0,0,0
"04/12/2021","N","Y","Juneau City and Borough",110,"Juneau City and Borough",3,0,125,2,128,0,0,0,0
"04/13/2021","N","Y","Juneau City and Borough",110,"Juneau City and Borough",3,2,127,0,128,0,0,0,0
"04/14/2021","N","Y","Juneau City and Borough",110,"Juneau City and Borough",3,1,128,1,129,0,0,0,0
"04/17/2021","N","Y","Juneau City and Borough",110,"Juneau City and Borough",3,1,129,0,129,0,0,0,0
"04/20/2021","N","Y","Juneau City and Borough",110,"Juneau City and Borough",3,0,129,1,130,0,0,0,0
"04/21/2021","N","Y","Juneau City and Borough",110,"Juneau City and Borough",3,1,130,0,130,0,0,0,0
"04/26/2021","N","Y","Juneau City and Borough",110,"Juneau City and Borough",3,0,130,1,131,0,0,0,0
"04/28/2021","N","Y","Juneau City and Borough",110,"Juneau City and Borough",3,1,131,1,132,0,0,0,0
"04/29/2021","N","Y","Juneau City and Borough",110,"Juneau City and Borough",3,1,132,0,132,0,0,0,0
"05/13/2021","N","Y","Juneau City and Borough",110,"Juneau City and Borough",3,0,132,1,133,0,0,0,0
"05/14/2021","N","Y","Juneau City and Borough",110,"Juneau City and Borough",3,0,132,1,134,0,0,0,0
"05/17/2021","N","Y","Juneau City and Borough",110,"Juneau City and Borough",3,1,133,0,134,0,0,0,0
"05/18/2021","N","Y","Juneau City and Borough",110,"Juneau City and Borough",3,1,134,0,134,0,0,0,0
"05/27/2021","N","Y","Juneau City and Borough",110,"Juneau City and Borough",3,1,135,3,137,0,0,0,0
"05/28/2021","N","Y","Juneau City and Borough",110,"Juneau City and Borough",3,1,136,0,137,0,0,0,0
"05/29/2021","N","Y","Juneau City and Borough",110,"Juneau City and Borough",3,1,137,1,138,0,0,0,0
"06/01/2021","N","Y","Juneau City and Borough",110,"Juneau City and Borough",3,1,138,0,138,0,0,0,0
"06/02/2021","N","Y","Juneau City and Borough",110,"Juneau City and Borough",3,0,138,1,139,0,0,0,0
"06/03/2021","N","Y","Juneau City and Borough",110,"Juneau City and Borough",3,1,139,0,139,0,0,0,0
"06/09/2021","N","Y","Juneau City and Borough",110,"Juneau City and Borough",3,0,139,1,140,0,0,0,0
"06/10/2021","N","Y","Juneau City and Borough",110,"Juneau City and Borough",3,0,139,1,141,0,0,0,0
"06/11/2021","N","Y","Juneau City and Borough",110,"Juneau City and Borough",3,1,140,0,141,0,0,0,0
"06/16/2021","N","Y","Juneau City and Borough",110,"Juneau City and Borough",3,1,141,0,141,0,0,0,0
"07/01/2021","N","Y","Juneau City and Borough",110,"Juneau City and Borough",3,0,141,1,142,0,0,0,0
"07/02/2021","N","Y","Juneau City and Borough",110,"Juneau City and Borough",3,1,142,0,142,0,0,0,0
"07/05/2021","N","Y","Juneau City and Borough",110,"Juneau City and Borough",3,0,142,0,142,1,1,0,0
"07/10/2021","N","Y","Juneau City and Borough",110,"Juneau City and Borough",3,0,142,1,143,0,1,0,0
"07/11/2021","N","Y","Juneau City and Borough",110,"Juneau City and Borough",3,0,142,1,144,0,1,0,0
"07/12/2021","N","Y","Juneau City and Borough",110,"Juneau City and Borough",3,2,144,0,144,0,1,0,0
"07/13/2021","N","Y","Juneau City and Borough",110,"Juneau City and Borough",3,0,144,2,146,0,1,0,0
"07/14/2021","N","Y","Juneau City and Borough",110,"Juneau City and Borough",3,2,146,0,146,0,1,0,0
"07/15/2021","N","Y","Juneau City and Borough",110,"Juneau City and Borough",3,0,146,5,151,0,1,0,0
"07/17/2021","N","Y","Juneau City and Borough",110,"Juneau City and Borough",3,5,151,1,152,0,1,0,0
"07/18/2021","N","Y","Juneau City and Borough",110,"Juneau City and Borough",3,2,153,1,153,0,1,0,0
"07/21/2021","N","Y","Juneau City and Borough",110,"Juneau City and Borough",3,1,154,2,155,0,1,0,0
"07/23/2021","N","Y","Juneau City and Borough",110,"Juneau City and Borough",3,2,156,2,157,0,1,0,0
"07/24/2021","N","Y","Juneau City and Borough",110,"Juneau City and Borough",3,1,157,0,157,0,1,0,0
"07/25/2021","N","Y","Juneau City and Borough",110,"Juneau City and Borough",3,0,157,2,159,0,1,0,0
"07/26/2021","N","Y","Juneau City and Borough",110,"Juneau City and Borough",3,0,157,2,161,0,1,0,0
"07/27/2021","N","Y","Juneau City and Borough",110,"Juneau City and Borough",3,3,160,0,161,0,1,0,0
"07/28/2021","N","Y","Juneau City and Borough",110,"Juneau City and Borough",3,1,161,1,162,0,1,0,0
"07/29/2021","N","Y","Juneau City and Borough",110,"Juneau City and Borough",3,0,161,1,163,0,1,0,0
"07/30/2021","N","Y","Juneau City and Borough",110,"Juneau City and Borough",3,1,162,1,164,0,1,0,0
"07/31/2021","N","Y","Juneau City and Borough",110,"Juneau City and Borough",3,1,163,3,167,0,1,0,0
"08/01/2021","N","Y","Juneau City and Borough",110,"Juneau City and Borough",3,2,165,4,171,0,1,0,0
"08/02/2021","N","Y","Juneau City and Borough",110,"Juneau City and Borough",3,3,168,0,171,0,1,0,0
"08/03/2021","N","Y","Juneau City and Borough",110,"Juneau City and Borough",3,2,170,1,172,1,2,0,0
"08/04/2021","N","Y","Juneau City and Borough",110,"Juneau City and Borough",3,1,171,0,172,0,2,0,0
"08/06/2021","N","Y","Juneau City and Borough",110,"Juneau City and Borough",3,0,171,3,175,0,2,0,0
"08/07/2021","N","Y","Juneau City and Borough",110,"Juneau City and Borough",3,0,171,1,176,0,2,0,0
"08/08/2021","N","Y","Juneau City and Borough",110,"Juneau City and Borough",3,0,171,1,177,0,2,0,0
"08/09/2021","N","Y","Juneau City and Borough",110,"Juneau City and Borough",3,2,173,1,178,0,2,0,0
"08/10/2021","N","Y","Juneau City and Borough",110,"Juneau City and Borough",3,1,174,2,180,0,2,0,0
"08/11/2021","N","Y","Juneau City and Borough",110,"Juneau City and Borough",3,3,177,5,185,1,3,0,0
"08/12/2021","N","Y","Juneau City and Borough",110,"Juneau City and Borough",3,1,178,0,185,0,3,0,0
"08/14/2021","N","Y","Juneau City and Borough",110,"Juneau City and Borough",3,1,179,2,187,0,3,0,0
"08/15/2021","N","Y","Juneau City and Borough",110,"Juneau City and Borough",3,2,181,0,187,0,3,0,0
"08/16/2021","N","Y","Juneau City and Borough",110,"Juneau City and Borough",3,3,184,4,191,0,3,0,0
"08/17/2021","N","Y","Juneau City and Borough",110,"Juneau City and Borough",3,0,184,2,193,0,3,0,0
"08/18/2021","N","Y","Juneau City and Borough",110,"Juneau City and Borough",3,4,188,5,198,0,3,0,0
"08/19/2021","N","Y","Juneau City and Borough",110,"Juneau City and Borough",3,3,191,2,200,0,3,0,0
"08/20/2021","N","Y","Juneau City and Borough",110,"Juneau City and Borough",3,4,195,1,201,0,3,0,0
"08/21/2021","N","Y","Juneau City and Borough",110,"Juneau City and Borough",3,1,196,13,214,0,3,0,0
"08/22/2021","N","Y","Juneau City and Borough",110,"Juneau City and Borough",3,1,197,0,214,0,3,0,0
"08/23/2021","N","Y","Juneau City and Borough",110,"Juneau City and Borough",3,2,199,1,215,0,3,0,0
"08/24/2021","N","Y","Juneau City and Borough",110,"Juneau City and Borough",3,12,211,5,220,0,3,0,0
"08/25/2021","N","Y","Juneau City and Borough",110,"Juneau City and Borough",3,2,213,4,224,0,3,0,0
"08/26/2021","N","Y","Juneau City and Borough",110,"Juneau City and Borough",3,0,213,3,227,1,4,0,0
"08/27/2021","N","Y","Juneau City and Borough",110,"Juneau City and Borough",3,1,214,2,229,0,4,0,0
"08/28/2021","N","Y","Juneau City and Borough",110,"Juneau City and Borough",3,0,214,1,230,0,4,0,0
"08/29/2021","N","Y","Juneau City and Borough",110,"Juneau City and Borough",3,0,214,2,232,0,4,0,0
"08/30/2021","N","Y","Juneau City and Borough",110,"Juneau City and Borough",3,10,224,1,233,0,4,0,0
"08/31/2021","N","Y","Juneau City and Borough",110,"Juneau City and Borough",3,4,228,1,234,0,4,0,0
"09/01/2021","N","Y","Juneau City and Borough",110,"Juneau City and Borough",3,2,230,7,241,0,4,0,0
"09/02/2021","N","Y","Juneau City and Borough",110,"Juneau City and Borough",3,3,233,1,242,0,4,0,0
"09/03/2021","N","Y","Juneau City and Borough",110,"Juneau City and Borough",3,0,233,2,244,0,4,0,0
"09/04/2021","N","Y","Juneau City and Borough",110,"Juneau City and Borough",3,1,234,5,249,0,4,0,0
"09/05/2021","N","Y","Juneau City and Borough",110,"Juneau City and Borough",3,1,235,2,251,0,4,0,0
"09/06/2021","N","Y","Juneau City and Borough",110,"Juneau City and Borough",3,0,235,2,253,0,4,0,0
"09/07/2021","N","Y","Juneau City and Borough",110,"Juneau City and Borough",3,2,237,0,253,0,4,0,0
"09/08/2021","N","Y","Juneau City and Borough",110,"Juneau City and Borough",3,6,243,1,254,0,4,0,0
"09/09/2021","N","Y","Juneau City and Borough",110,"Juneau City and Borough",3,1,244,0,254,0,4,0,0
"09/10/2021","N","Y","Juneau City and Borough",110,"Juneau City and Borough",3,3,247,1,255,0,4,1,1
"09/12/2021","N","Y","Juneau City and Borough",110,"Juneau City and Borough",3,0,247,1,256,0,4,0,1
"09/13/2021","N","Y","Juneau City and Borough",110,"Juneau City and Borough",3,1,248,2,258,0,4,0,1
"09/14/2021","N","Y","Juneau City and Borough",110,"Juneau City and Borough",3,3,251,3,261,0,4,0,1
"09/15/2021","N","Y","Juneau City and Borough",110,"Juneau City and Borough",3,2,253,0,261,0,4,0,1
"09/16/2021","N","Y","Juneau City and Borough",110,"Juneau City and Borough",3,1,254,0,261,0,4,0,1
"09/17/2021","N","Y","Juneau City and Borough",110,"Juneau City and Borough",3,0,254,1,262,0,4,0,1
"09/20/2021","N","Y","Juneau City and Borough",110,"Juneau City and Borough",3,1,255,0,262,0,4,0,1
"09/22/2021","N","Y","Juneau City and Borough",110,"Juneau City and Borough",3,3,258,0,262,0,4,0,1
"09/23/2021","N","Y","Juneau City and Borough",110,"Juneau City and Borough",3,2,260,1,263,0,4,0,1
"09/24/2021","N","Y","Juneau City and Borough",110,"Juneau City and Borough",3,1,261,0,263,0,4,0,1
"09/26/2021","N","Y","Juneau City and Borough",110,"Juneau City and Borough",3,1,262,0,263,0,4,0,1
"09/29/2021","N","Y","Juneau City and Borough",110,"Juneau City and Borough",3,0,262,5,268,0,4,0,1
"09/30/2021","N","Y","Juneau City and Borough",110,"Juneau City and Borough",3,2,264,5,273,0,4,0,1
"10/02/2021","N","Y","Juneau City and Borough",110,"Juneau City and Borough",3,0,264,0,273,1,5,0,1
"10/03/2021","N","Y","Juneau City and Borough",110,"Juneau City and Borough",3,4,268,1,274,0,5,0,1
"10/04/2021","N","Y","Juneau City and Borough",110,"Juneau City and Borough",3,5,273,0,274,0,5,0,1
"10/05/2021","N","Y","Juneau City and Borough",110,"Juneau City and Borough",3,0,273,1,275,0,5,0,1
"10/06/2021","N","Y","Juneau City and Borough",110,"Juneau City and Borough",3,0,273,6,281,0,5,0,1
"10/09/2021","N","Y","Juneau City and Borough",110,"Juneau City and Borough",3,2,275,1,282,0,5,0,1
"10/10/2021","N","Y","Juneau City and Borough",110,"Juneau City and Borough",3,1,276,1,283,0,5,0,1
"10/11/2021","N","Y","Juneau City and Borough",110,"Juneau City and Borough",3,7,283,0,283,0,5,0,1
"10/13/2021","N","Y","Juneau City and Borough",110,"Juneau City and Borough",3,0,283,3,286,0,5,0,1
"10/14/2021","N","Y","Juneau City and Borough",110,"Juneau City and Borough",3,2,285,1,287,0,5,0,1
"10/15/2021","N","Y","Juneau City and Borough",110,"Juneau City and Borough",3,1,286,0,287,0,5,0,1
"10/17/2021","N","Y","Juneau City and Borough",110,"Juneau City and Borough",3,1,287,0,287,0,5,0,1
"10/18/2021","N","Y","Juneau City and Borough",110,"Juneau City and Borough",3,0,287,1,288,0,5,0,1
"10/19/2021","N","Y","Juneau City and Borough",110,"Juneau City and Borough",3,1,288,0,288,0,5,0,1
"10/20/2021","N","Y","Juneau City and Borough",110,"Juneau City and Borough",3,0,288,1,289,0,5,0,1
"10/21/2021","N","Y","Juneau City and Borough",110,"Juneau City and Borough",3,1,289,1,290,0,5,0,1
"10/22/2021","N","Y","Juneau City and Borough",110,"Juneau City and Borough",3,1,290,0,290,0,5,0,1
"10/25/2021","N","Y","Juneau City and Borough",110,"Juneau City and Borough",3,0,290,1,291,0,5,0,1
"10/26/2021","N","Y","Juneau City and Borough",110,"Juneau City and Borough",3,0,290,1,292,0,5,0,1
"10/27/2021","N","Y","Juneau City and Borough",110,"Juneau City and Borough",3,1,291,0,292,0,5,0,1
"10/29/2021","N","Y","Juneau City and Borough",110,"Juneau City and Borough",3,0,291,1,293,0,5,0,1
"10/31/2021","N","Y","Juneau City and Borough",110,"Juneau City and Borough",3,1,292,0,293,0,5,0,1
"11/01/2021","N","Y","Juneau City and Borough",110,"Juneau City and Borough",3,0,292,1,294,0,5,0,1
"11/02/2021","N","Y","Juneau City and Borough",110,"Juneau City and Borough",3,2,294,1,295,0,5,0,1
"11/03/2021","N","Y","Juneau City and Borough",110,"Juneau City and Borough",3,1,295,0,295,0,5,0,1
"11/09/2021","N","Y","Juneau City and Borough",110,"Juneau City and Borough",3,0,295,1,296,0,5,0,1
"11/11/2021","N","Y","Juneau City and Borough",110,"Juneau City and Borough",3,1,296,1,297,0,5,0,1
"11/13/2021","N","Y","Juneau City and Borough",110,"Juneau City and Borough",3,1,297,0,297,0,5,0,1
"11/14/2021","N","Y","Juneau City and Borough",110,"Juneau City and Borough",3,0,297,1,298,0,5,0,1
"11/15/2021","N","Y","Juneau City and Borough",110,"Juneau City and Borough",3,0,297,1,299,0,5,0,1
"11/18/2021","N","Y","Juneau City and Borough",110,"Juneau City and Borough",3,2,299,0,299,0,5,0,1
"12/02/2021","N","Y","Juneau City and Borough",110,"Juneau City and Borough",3,0,299,1,300,0,5,0,1
"12/03/2021","N","Y","Juneau City and Borough",110,"Juneau City and Borough",3,1,300,0,300,0,5,0,1
"12/09/2021","N","Y","Juneau City and Borough",110,"Juneau City and Borough",3,0,300,1,301,0,5,0,1
"12/10/2021","N","Y","Juneau City and Borough",110,"Juneau City and Borough",3,1,301,0,301,0,5,0,1
"12/17/2021","N","Y","Juneau City and Borough",110,"Juneau City and Borough",3,0,301,1,302,0,5,0,1
"12/18/2021","N","Y","Juneau City and Borough",110,"Juneau City and Borough",3,0,301,1,303,0,5,0,1
"12/19/2021","N","Y","Juneau City and Borough",110,"Juneau City and Borough",3,1,302,0,303,0,5,0,1
"12/21/2021","N","Y","Juneau City and Borough",110,"Juneau City and Borough",3,1,303,0,303,0,5,0,1
"12/22/2021","N","Y","Juneau City and Borough",110,"Juneau City and Borough",3,0,303,1,304,0,5,0,1
"12/23/2021","N","Y","Juneau City and Borough",110,"Juneau City and Borough",3,2,305,2,306,0,5,0,1
"12/26/2021","N","Y","Juneau City and Borough",110,"Juneau City and Borough",3,2,307,4,310,0,5,0,1
"12/27/2021","N","Y","Juneau City and Borough",110,"Juneau City and Borough",3,2,309,4,314,0,5,0,1
"12/28/2021","N","Y","Juneau City and Borough",110,"Juneau City and Borough",3,2,311,1,315,0,5,0,1
"12/29/2021","N","Y","Juneau City and Borough",110,"Juneau City and Borough",3,1,312,0,315,0,5,0,1
"12/30/2021","N","Y","Juneau City and Borough",110,"Juneau City and Borough",3,3,315,4,319,0,5,0,1
"12/31/2021","N","Y","Juneau City and Borough",110,"Juneau City and Borough",3,2,317,0,319,0,5,0,1
"01/01/2022","N","Y","Juneau City and Borough",110,"Juneau City and Borough",3,0,317,1,320,0,5,0,1
"01/02/2022","N","Y","Juneau City and Borough",110,"Juneau City and Borough",3,0,317,5,325,0,5,0,1
"01/03/2022","N","Y","Juneau City and Borough",110,"Juneau City and Borough",3,6,323,0,325,0,5,0,1
"01/05/2022","N","Y","Juneau City and Borough",110,"Juneau City and Borough",3,1,324,2,327,0,5,0,1
"01/06/2022","N","Y","Juneau City and Borough",110,"Juneau City and Borough",3,2,326,4,331,0,5,0,1
"01/07/2022","N","Y","Juneau City and Borough",110,"Juneau City and Borough",3,1,327,1,332,0,5,0,1
"01/09/2022","N","Y","Juneau City and Borough",110,"Juneau City and Borough",3,2,329,3,335,0,5,0,1
"01/10/2022","N","Y","Juneau City and Borough",110,"Juneau City and Borough",3,2,331,1,336,0,5,0,1
"01/11/2022","N","Y","Juneau City and Borough",110,"Juneau City and Borough",3,2,333,1,337,0,5,0,1
"01/12/2022","N","Y","Juneau City and Borough",110,"Juneau City and Borough",3,0,333,4,341,0,5,0,1
"01/13/2022","N","Y","Juneau City and Borough",110,"Juneau City and Borough",3,1,334,3,344,0,5,0,1
"01/14/2022","N","Y","Juneau City and Borough",110,"Juneau City and Borough",3,0,334,2,346,0,5,0,1
"01/15/2022","N","Y","Juneau City and Borough",110,"Juneau City and Borough",3,13,347,5,351,0,5,0,1
"01/16/2022","N","Y","Juneau City and Borough",110,"Juneau City and Borough",3,0,347,1,352,0,5,0,1
"01/17/2022","N","Y","Juneau City and Borough",110,"Juneau City and Borough",3,0,347,2,354,0,5,0,1
"01/18/2022","N","Y","Juneau City and Borough",110,"Juneau City and Borough",3,1,348,6,360,0,5,0,1
"01/19/2022","N","Y","Juneau City and Borough",110,"Juneau City and Borough",3,2,350,3,363,0,5,0,1
"01/20/2022","N","Y","Juneau City and Borough",110,"Juneau City and Borough",3,1,351,2,365,0,5,0,1
"01/21/2022","N","Y","Juneau City and Borough",110,"Juneau City and Borough",3,6,357,2,367,0,5,0,1
"01/22/2022","N","Y","Juneau City and Borough",110,"Juneau City and Borough",3,2,359,1,368,0,5,0,1
"01/23/2022","N","Y","Juneau City and Borough",110,"Juneau City and Borough",3,4,363,1,369,0,5,0,1
"01/24/2022","N","Y","Juneau City and Borough",110,"Juneau City and Borough",3,2,365,2,371,0,5,0,1
"01/25/2022","N","Y","Juneau City and Borough",110,"Juneau City and Borough",3,0,365,2,373,0,5,0,1
"01/26/2022","N","Y","Juneau City and Borough",110,"Juneau City and Borough",3,3,368,1,374,0,5,0,1
"01/27/2022","N","Y","Juneau City and Borough",110,"Juneau City and Borough",3,2,370,3,377,0,5,0,1
"01/28/2022","N","Y","Juneau City and Borough",110,"Juneau City and Borough",3,2,372,0,377,0,5,0,1
"01/30/2022","N","Y","Juneau City and Borough",110,"Juneau City and Borough",3,0,372,1,378,0,5,0,1
"01/31/2022","N","Y","Juneau City and Borough",110,"Juneau City and Borough",3,3,375,1,379,0,5,0,1
"02/01/2022","N","Y","Juneau City and Borough",110,"Juneau City and Borough",3,1,376,0,379,0,5,0,1
"02/02/2022","N","Y","Juneau City and Borough",110,"Juneau City and Borough",3,1,377,1,380,0,5,0,1
"02/03/2022","N","Y","Juneau City and Borough",110,"Juneau City and Borough",3,3,380,0,380,0,5,0,1
"02/04/2022","N","Y","Juneau City and Borough",110,"Juneau City and Borough",3,0,380,1,381,0,5,0,1
"02/05/2022","N","Y","Juneau City and Borough",110,"Juneau City and Borough",3,1,381,1,382,0,5,0,1
"02/08/2022","N","Y","Juneau City and Borough",110,"Juneau City and Borough",3,1,382,1,383,0,5,0,1
"02/09/2022","N","Y","Juneau City and Borough",110,"Juneau City and Borough",3,1,383,0,383,0,5,0,1
"02/14/2022","N","Y","Juneau City and Borough",110,"Juneau City and Borough",3,0,383,1,384,0,5,0,1
"02/15/2022","N","Y","Juneau City and Borough",110,"Juneau City and Borough",3,1,384,1,385,0,5,0,1
"02/17/2022","N","Y","Juneau City and Borough",110,"Juneau City and Borough",3,1,385,0,385,0,5,0,1
"02/22/2022","N","Y","Juneau City and Borough",110,"Juneau City and Borough",3,0,385,2,387,0,5,0,1
"02/23/2022","N","Y","Juneau City and Borough",110,"Juneau City and Borough",3,2,387,1,388,0,5,0,1
"02/24/2022","N","Y","Juneau City and Borough",110,"Juneau City and Borough",3,1,388,0,388,0,5,0,1
"03/21/2022","N","Y","Juneau City and Borough",110,"Juneau City and Borough",3,0,388,1,389,0,5,0,1
"03/22/2022","N","Y","Juneau City and Borough",110,"Juneau City and Borough",3,1,389,0,389,0,5,0,1
"03/29/2022","N","Y","Juneau City and Borough",110,"Juneau City and Borough",3,0,389,1,390,0,5,0,1
"03/30/2022","N","Y","Juneau City and Borough",110,"Juneau City and Borough",3,1,390,0,390,0,5,0,1
"04/07/2022","N","Y","Juneau City and Borough",110,"Juneau City and Borough",3,0,390,1,391,0,5,0,1
"04/08/2022","N","Y","Juneau City and Borough",110,"Juneau City and Borough",3,1,391,0,391,0,5,0,1
"04/12/2022","N","Y","Juneau City and Borough",110,"Juneau City and Borough",3,0,391,2,393,0,5,0,1
"04/14/2022","N","Y","Juneau City and Borough",110,"Juneau City and Borough",3,0,391,2,395,0,5,0,1
"04/15/2022","N","Y","Juneau City and Borough",110,"Juneau City and Borough",3,2,393,1,396,0,5,0,1
"04/16/2022","N","Y","Juneau City and Borough",110,"Juneau City and Borough",3,3,396,0,396,0,5,0,1
"04/21/2022","N","Y","Juneau City and Borough",110,"Juneau City and Borough",3,0,396,1,397,0,5,0,1
"04/22/2022","N","Y","Juneau City and Borough",110,"Juneau City and Borough",3,1,397,1,398,1,6,0,1
"04/23/2022","N","Y","Juneau City and Borough",110,"Juneau City and Borough",3,1,398,0,398,0,6,0,1
"05/22/2020","N","Y","Kenai Peninsula Borough",122,"Kenai Peninsula Borough",4,0,0,2,2,0,0,0,0
"05/24/2020","N","Y","Kenai Peninsula Borough",122,"Kenai Peninsula Borough",4,2,2,0,2,0,0,0,0
"05/26/2020","N","Y","Kenai Peninsula Borough",122,"Kenai Peninsula Borough",4,0,2,1,3,0,0,0,0
"05/28/2020","N","Y","Kenai Peninsula Borough",122,"Kenai Peninsula Borough",4,1,3,1,4,0,0,0,0
"05/29/2020","N","Y","Kenai Peninsula Borough",122,"Kenai Peninsula Borough",4,1,4,0,4,0,0,0,0
"06/02/2020","N","Y","Kenai Peninsula Borough",122,"Kenai Peninsula Borough",4,0,4,2,6,0,0,0,0
"06/03/2020","N","Y","Kenai Peninsula Borough",122,"Kenai Peninsula Borough",4,2,6,1,7,0,0,0,0
"06/07/2020","N","Y","Kenai Peninsula Borough",122,"Kenai Peninsula Borough",4,1,7,0,7,0,0,0,0
"06/09/2020","N","Y","Kenai Peninsula Borough",122,"Kenai Peninsula Borough",4,1,8,1,8,0,0,0,0
"06/17/2020","N","Y","Kenai Peninsula Borough",122,"Kenai Peninsula Borough",4,0,8,1,9,0,0,0,0
"06/22/2020","N","Y","Kenai Peninsula Borough",122,"Kenai Peninsula Borough",4,0,8,1,10,0,0,0,0
"06/24/2020","N","Y","Kenai Peninsula Borough",122,"Kenai Peninsula Borough",4,1,9,0,10,0,0,0,0
"06/26/2020","N","Y","Kenai Peninsula Borough",122,"Kenai Peninsula Borough",4,0,9,1,11,0,0,0,0
"06/27/2020","N","Y","Kenai Peninsula Borough",122,"Kenai Peninsula Borough",4,0,9,3,14,0,0,0,0
"06/28/2020","N","Y","Kenai Peninsula Borough",122,"Kenai Peninsula Borough",4,2,11,2,16,0,0,0,0
"06/29/2020","N","Y","Kenai Peninsula Borough",122,"Kenai Peninsula Borough",4,3,14,1,17,0,0,0,0
"07/01/2020","N","Y","Kenai Peninsula Borough",122,"Kenai Peninsula Borough",4,3,17,2,19,0,0,0,0
"07/02/2020","N","Y","Kenai Peninsula Borough",122,"Kenai Peninsula Borough",4,3,20,2,21,0,0,0,0
"07/05/2020","N","Y","Kenai Peninsula Borough",122,"Kenai Peninsula Borough",4,0,20,1,22,0,0,0,0
"07/06/2020","N","Y","Kenai Peninsula Borough",122,"Kenai Peninsula Borough",4,1,21,1,23,0,0,0,0
"07/07/2020","N","Y","Kenai Peninsula Borough",122,"Kenai Peninsula Borough",4,1,22,1,24,0,0,0,0
"07/08/2020","N","Y","Kenai Peninsula Borough",122,"Kenai Peninsula Borough",4,0,22,1,25,0,0,0,0
"07/10/2020","N","Y","Kenai Peninsula Borough",122,"Kenai Peninsula Borough",4,0,22,1,26,0,0,0,0
"07/11/2020","N","Y","Kenai Peninsula Borough",122,"Kenai Peninsula Borough",4,1,23,0,26,0,0,0,0
"07/12/2020","N","Y","Kenai Peninsula Borough",122,"Kenai Peninsula Borough",4,1,24,0,26,0,0,0,0
"07/13/2020","N","Y","Kenai Peninsula Borough",122,"Kenai Peninsula Borough",4,1,25,1,27,0,0,0,0
"07/14/2020","N","Y","Kenai Peninsula Borough",122,"Kenai Peninsula Borough",4,0,25,1,28,0,0,0,0
"07/15/2020","N","Y","Kenai Peninsula Borough",122,"Kenai Peninsula Borough",4,2,27,2,30,0,0,0,0
"07/16/2020","N","Y","Kenai Peninsula Borough",122,"Kenai Peninsula Borough",4,1,28,1,31,0,0,0,0
"07/19/2020","N","Y","Kenai Peninsula Borough",122,"Kenai Peninsula Borough",4,1,29,1,32,0,0,0,0
"07/20/2020","N","Y","Kenai Peninsula Borough",122,"Kenai Peninsula Borough",4,2,31,79,111,0,0,0,0
"07/21/2020","N","Y","Kenai Peninsula Borough",122,"Kenai Peninsula Borough",4,8,39,2,113,0,0,0,0
"07/22/2020","N","Y","Kenai Peninsula Borough",122,"Kenai Peninsula Borough",4,10,49,2,115,0,0,0,0
"07/23/2020","N","Y","Kenai Peninsula Borough",122,"Kenai Peninsula Borough",4,6,55,35,150,0,0,0,0
"07/24/2020","N","Y","Kenai Peninsula Borough",122,"Kenai Peninsula Borough",4,25,80,0,150,0,0,0,0
"07/25/2020","N","Y","Kenai Peninsula Borough",122,"Kenai Peninsula Borough",4,36,116,1,151,1,1,0,0
"07/26/2020","N","Y","Kenai Peninsula Borough",122,"Kenai Peninsula Borough",4,8,124,9,160,0,1,0,0
"07/27/2020","N","Y","Kenai Peninsula Borough",122,"Kenai Peninsula Borough",4,3,127,3,163,0,1,0,0
"07/28/2020","N","Y","Kenai Peninsula Borough",122,"Kenai Peninsula Borough",4,14,141,2,165,0,1,0,0
"07/29/2020","N","Y","Kenai Peninsula Borough",122,"Kenai Peninsula Borough",4,24,165,6,171,0,1,0,0
"07/30/2020","N","Y","Kenai Peninsula Borough",122,"Kenai Peninsula Borough",4,1,166,0,171,0,1,0,0
"07/31/2020","N","Y","Kenai Peninsula Borough",122,"Kenai Peninsula Borough",4,0,166,1,172,0,1,0,0
"08/01/2020","N","Y","Kenai Peninsula Borough",122,"Kenai Peninsula Borough",4,0,166,3,175,0,1,0,0
"08/02/2020","N","Y","Kenai Peninsula Borough",122,"Kenai Peninsula Borough",4,5,171,0,175,0,1,0,0
"08/03/2020","N","Y","Kenai Peninsula Borough",122,"Kenai Peninsula Borough",4,2,173,0,175,0,1,0,0
"08/04/2020","N","Y","Kenai Peninsula Borough",122,"Kenai Peninsula Borough",4,0,173,2,177,0,1,0,0
"08/05/2020","N","Y","Kenai Peninsula Borough",122,"Kenai Peninsula Borough",4,2,175,0,177,0,1,0,0
"08/06/2020","N","Y","Kenai Peninsula Borough",122,"Kenai Peninsula Borough",4,2,177,0,177,0,1,0,0
"08/12/2020","N","Y","Kenai Peninsula Borough",122,"Kenai Peninsula Borough",4,0,177,1,178,0,1,0,0
"08/17/2020","N","Y","Kenai Peninsula Borough",122,"Kenai Peninsula Borough",4,1,178,0,178,0,1,0,0
"09/02/2020","N","Y","Kenai Peninsula Borough",122,"Kenai Peninsula Borough",4,0,178,1,179,0,1,0,0
"09/05/2020","N","Y","Kenai Peninsula Borough",122,"Kenai Peninsula Borough",4,1,179,0,179,0,1,0,0
"09/09/2020","N","Y","Kenai Peninsula Borough",122,"Kenai Peninsula Borough",4,1,180,1,180,0,1,0,0
"09/30/2020","N","Y","Kenai Peninsula Borough",122,"Kenai Peninsula Borough",4,0,180,1,181,0,1,0,0
"10/05/2020","N","Y","Kenai Peninsula Borough",122,"Kenai Peninsula Borough",4,1,181,0,181,0,1,0,0
"10/06/2020","N","Y","Kenai Peninsula Borough",122,"Kenai Peninsula Borough",4,0,181,1,182,0,1,0,0
"10/09/2020","N","Y","Kenai Peninsula Borough",122,"Kenai Peninsula Borough",4,1,182,1,183,0,1,0,0
"10/12/2020","N","Y","Kenai Peninsula Borough",122,"Kenai Peninsula Borough",4,1,183,0,183,0,1,0,0
"10/15/2020","N","Y","Kenai Peninsula Borough",122,"Kenai Peninsula Borough",4,0,183,1,184,0,1,0,0
"10/24/2020","N","Y","Kenai Peninsula Borough",122,"Kenai Peninsula Borough",4,1,184,0,184,0,1,0,0
"10/28/2020","N","Y","Kenai Peninsula Borough",122,"Kenai Peninsula Borough",4,0,184,2,186,0,1,0,0
"10/29/2020","N","Y","Kenai Peninsula Borough",122,"Kenai Peninsula Borough",4,2,186,0,186,0,1,0,0
"11/03/2020","N","Y","Kenai Peninsula Borough",122,"Kenai Peninsula Borough",4,1,187,0,186,0,1,0,0
"11/08/2020","N","Y","Kenai Peninsula Borough",122,"Kenai Peninsula Borough",4,0,187,1,187,1,2,0,0
"11/10/2020","N","Y","Kenai Peninsula Borough",122,"Kenai Peninsula Borough",4,0,187,2,189,0,2,0,0
"11/11/2020","N","Y","Kenai Peninsula Borough",122,"Kenai Peninsula Borough",4,0,187,0,189,0,2,1,1
"11/12/2020","N","Y","Kenai Peninsula Borough",122,"Kenai Peninsula Borough",4,0,187,2,191,0,2,0,1
"11/13/2020","N","Y","Kenai Peninsula Borough",122,"Kenai Peninsula Borough",4,0,187,1,192,0,2,0,1
"11/15/2020","N","Y","Kenai Peninsula Borough",122,"Kenai Peninsula Borough",4,1,188,0,192,0,2,0,1
"11/16/2020","N","Y","Kenai Peninsula Borough",122,"Kenai Peninsula Borough",4,0,188,2,194,0,2,0,1
"11/18/2020","N","Y","Kenai Peninsula Borough",122,"Kenai Peninsula Borough",4,1,189,0,194,0,2,0,1
"11/19/2020","N","Y","Kenai Peninsula Borough",122,"Kenai Peninsula Borough",4,1,190,0,194,0,2,0,1
"11/21/2020","N","Y","Kenai Peninsula Borough",122,"Kenai Peninsula Borough",4,1,191,0,194,0,2,0,1
"11/24/2020","N","Y","Kenai Peninsula Borough",122,"Kenai Peninsula Borough",4,0,191,1,195,0,2,0,1
"11/25/2020","N","Y","Kenai Peninsula Borough",122,"Kenai Peninsula Borough",4,0,191,1,196,0,2,0,1
"11/28/2020","N","Y","Kenai Peninsula Borough",122,"Kenai Peninsula Borough",4,2,193,1,197,0,2,0,1
"11/30/2020","N","Y","Kenai Peninsula Borough",122,"Kenai Peninsula Borough",4,1,194,0,197,0,2,0,1
"12/01/2020","N","Y","Kenai Peninsula Borough",122,"Kenai Peninsula Borough",4,1,195,0,197,0,2,0,1
"12/02/2020","N","Y","Kenai Peninsula Borough",122,"Kenai Peninsula Borough",4,1,196,0,197,0,2,0,1
"12/04/2020","N","Y","Kenai Peninsula Borough",122,"Kenai Peninsula Borough",4,1,197,0,197,0,2,0,1
"12/12/2020","N","Y","Kenai Peninsula Borough",122,"Kenai Peninsula Borough",4,0,197,1,198,0,2,0,1
"12/13/2020","N","Y","Kenai Peninsula Borough",122,"Kenai Peninsula Borough",4,1,198,0,198,0,2,0,1
"12/28/2020","N","Y","Kenai Peninsula Borough",122,"Kenai Peninsula Borough",4,0,198,1,199,0,2,0,1
"12/29/2020","N","Y","Kenai Peninsula Borough",122,"Kenai Peninsula Borough",4,1,199,0,199,0,2,0,1
"01/03/2021","N","Y","Kenai Peninsula Borough",122,"Kenai Peninsula Borough",4,0,199,1,200,0,2,0,1
"01/04/2021","N","Y","Kenai Peninsula Borough",122,"Kenai Peninsula Borough",4,0,199,1,201,0,2,0,1
"01/05/2021","N","Y","Kenai Peninsula Borough",122,"Kenai Peninsula Borough",4,1,200,0,201,0,2,0,1
"01/07/2021","N","Y","Kenai Peninsula Borough",122,"Kenai Peninsula Borough",4,1,201,0,201,0,2,0,1
"01/11/2021","N","Y","Kenai Peninsula Borough",122,"Kenai Peninsula Borough",4,0,201,1,202,0,2,0,1
"01/12/2021","N","Y","Kenai Peninsula Borough",122,"Kenai Peninsula Borough",4,1,202,0,202,0,2,0,1
"01/17/2021","N","Y","Kenai Peninsula Borough",122,"Kenai Peninsula Borough",4,0,202,1,203,0,2,0,1
"01/19/2021","N","Y","Kenai Peninsula Borough",122,"Kenai Peninsula Borough",4,1,203,1,204,0,2,0,1
"01/21/2021","N","Y","Kenai Peninsula Borough",122,"Kenai Peninsula Borough",4,1,204,0,204,0,2,0,1
"02/25/2021","N","Y","Kenai Peninsula Borough",122,"Kenai Peninsula Borough",4,0,204,1,205,0,2,0,1
"03/09/2021","N","Y","Kenai Peninsula Borough",122,"Kenai Peninsula Borough",4,1,205,0,205,0,2,0,1
"03/11/2021","N","Y","Kenai Peninsula Borough",122,"Kenai Peninsula Borough",4,0,205,1,206,0,2,0,1
"03/12/2021","N","Y","Kenai Peninsula Borough",122,"Kenai Peninsula Borough",4,1,206,0,206,0,2,0,1
"04/04/2021","N","Y","Kenai Peninsula Borough",122,"Kenai Peninsula Borough",4,0,206,1,207,0,2,0,1
"04/05/2021","N","Y","Kenai Peninsula Borough",122,"Kenai Peninsula Borough",4,1,207,0,207,0,2,0,1
"04/07/2021","N","Y","Kenai Peninsula Borough",122,"Kenai Peninsula Borough",4,0,207,1,208,0,2,0,1
"04/08/2021","N","Y","Kenai Peninsula Borough",122,"Kenai Peninsula Borough",4,1,208,1,209,0,2,0,1
"04/12/2021","N","Y","Kenai Peninsula Borough",122,"Kenai Peninsula Borough",4,1,209,0,209,0,2,0,1
"04/20/2021","N","Y","Kenai Peninsula Borough",122,"Kenai Peninsula Borough",4,0,209,1,210,0,2,0,1
"04/21/2021","N","Y","Kenai Peninsula Borough",122,"Kenai Peninsula Borough",4,1,210,0,210,0,2,0,1
"05/08/2021","N","Y","Kenai Peninsula Borough",122,"Kenai Peninsula Borough",4,0,210,1,211,0,2,0,1
"05/10/2021","N","Y","Kenai Peninsula Borough",122,"Kenai Peninsula Borough",4,1,211,0,211,0,2,0,1
"05/20/2021","N","Y","Kenai Peninsula Borough",122,"Kenai Peninsula Borough",4,1,212,1,212,0,2,0,1
"05/24/2021","N","Y","Kenai Peninsula Borough",122,"Kenai Peninsula Borough",4,0,212,1,213,0,2,0,1
"05/29/2021","N","Y","Kenai Peninsula Borough",122,"Kenai Peninsula Borough",4,1,213,0,213,0,2,0,1
"06/11/2021","N","Y","Kenai Peninsula Borough",122,"Kenai Peninsula Borough",4,0,213,1,214,0,2,0,1
"06/12/2021","N","Y","Kenai Peninsula Borough",122,"Kenai Peninsula Borough",4,1,214,0,214,0,2,0,1
"06/17/2021","N","Y","Kenai Peninsula Borough",122,"Kenai Peninsula Borough",4,0,214,1,215,0,2,0,1
"06/18/2021","N","Y","Kenai Peninsula Borough",122,"Kenai Peninsula Borough",4,1,215,0,215,0,2,0,1
"06/21/2021","N","Y","Kenai Peninsula Borough",122,"Kenai Peninsula Borough",4,0,215,1,216,0,2,0,1
"06/22/2021","N","Y","Kenai Peninsula Borough",122,"Kenai Peninsula Borough",4,1,216,0,216,0,2,0,1
"06/24/2021","N","Y","Kenai Peninsula Borough",122,"Kenai Peninsula Borough",4,1,217,1,217,0,2,0,1
"06/27/2021","N","Y","Kenai Peninsula Borough",122,"Kenai Peninsula Borough",4,0,217,1,218,0,2,0,1
"06/28/2021","N","Y","Kenai Peninsula Borough",122,"Kenai Peninsula Borough",4,1,218,0,218,0,2,0,1
"07/04/2021","N","Y","Kenai Peninsula Borough",122,"Kenai Peninsula Borough",4,0,218,1,219,0,2,0,1
"07/05/2021","N","Y","Kenai Peninsula Borough",122,"Kenai Peninsula Borough",4,1,219,0,219,0,2,0,1
"07/07/2021","N","Y","Kenai Peninsula Borough",122,"Kenai Peninsula Borough",4,0,219,1,220,0,2,0,1
"07/08/2021","N","Y","Kenai Peninsula Borough",122,"Kenai Peninsula Borough",4,1,220,0,220,0,2,0,1
"07/09/2021","N","Y","Kenai Peninsula Borough",122,"Kenai Peninsula Borough",4,0,220,1,221,0,2,0,1
"07/11/2021","N","Y","Kenai Peninsula Borough",122,"Kenai Peninsula Borough",4,1,221,0,221,0,2,0,1
"07/12/2021","N","Y","Kenai Peninsula Borough",122,"Kenai Peninsula Borough",4,0,221,1,222,1,3,0,1
"07/13/2021","N","Y","Kenai Peninsula Borough",122,"Kenai Peninsula Borough",4,0,221,2,224,0,3,0,1
"07/14/2021","N","Y","Kenai Peninsula Borough",122,"Kenai Peninsula Borough",4,5,226,5,229,1,4,0,1
"07/15/2021","N","Y","Kenai Peninsula Borough",122,"Kenai Peninsula Borough",4,3,229,0,229,0,4,0,1
"07/17/2021","N","Y","Kenai Peninsula Borough",122,"Kenai Peninsula Borough",4,0,229,1,230,0,4,0,1
"07/18/2021","N","Y","Kenai Peninsula Borough",122,"Kenai Peninsula Borough",4,1,230,2,232,0,4,0,1
"07/19/2021","N","Y","Kenai Peninsula Borough",122,"Kenai Peninsula Borough",4,2,232,2,234,0,4,0,1
"07/20/2021","N","Y","Kenai Peninsula Borough",122,"Kenai Peninsula Borough",4,1,233,1,235,0,4,0,1
"07/21/2021","N","Y","Kenai Peninsula Borough",122,"Kenai Peninsula Borough",4,0,233,1,236,0,4,0,1
"07/22/2021","N","Y","Kenai Peninsula Borough",122,"Kenai Peninsula Borough",4,0,233,3,239,0,4,0,1
"07/23/2021","N","Y","Kenai Peninsula Borough",122,"Kenai Peninsula Borough",4,4,237,2,241,0,4,0,1
"07/24/2021","N","Y","Kenai Peninsula Borough",122,"Kenai Peninsula Borough",4,0,237,4,245,1,5,0,1
"07/25/2021","N","Y","Kenai Peninsula Borough",122,"Kenai Peninsula Borough",4,2,239,5,250,1,6,0,1
"07/26/2021","N","Y","Kenai Peninsula Borough",122,"Kenai Peninsula Borough",4,2,241,2,252,0,6,0,1
"07/27/2021","N","Y","Kenai Peninsula Borough",122,"Kenai Peninsula Borough",4,2,243,4,256,0,6,0,1
"07/28/2021","N","Y","Kenai Peninsula Borough",122,"Kenai Peninsula Borough",4,4,247,3,259,1,7,0,1
"07/29/2021","N","Y","Kenai Peninsula Borough",122,"Kenai Peninsula Borough",4,4,251,5,264,0,7,0,1
"07/30/2021","N","Y","Kenai Peninsula Borough",122,"Kenai Peninsula Borough",4,1,252,1,265,0,7,1,2
"07/31/2021","N","Y","Kenai Peninsula Borough",122,"Kenai Peninsula Borough",4,2,254,3,268,0,7,0,2
"08/01/2021","N","Y","Kenai Peninsula Borough",122,"Kenai Peninsula Borough",4,1,255,3,271,0,7,0,2
"08/02/2021","N","Y","Kenai Peninsula Borough",122,"Kenai Peninsula Borough",4,10,265,8,279,0,7,0,2
"08/03/2021","N","Y","Kenai Peninsula Borough",122,"Kenai Peninsula Borough",4,1,266,4,283,0,7,0,2
"08/04/2021","N","Y","Kenai Peninsula Borough",122,"Kenai Peninsula Borough",4,11,277,1,284,0,7,0,2
"08/05/2021","N","Y","Kenai Peninsula Borough",122,"Kenai Peninsula Borough",4,5,282,6,290,0,7,0,2
"08/06/2021","N","Y","Kenai Peninsula Borough",122,"Kenai Peninsula Borough",4,3,285,2,292,0,7,1,3
"08/07/2021","N","Y","Kenai Peninsula Borough",122,"Kenai Peninsula Borough",4,3,288,0,292,0,7,0,3
"08/08/2021","N","Y","Kenai Peninsula Borough",122,"Kenai Peninsula Borough",4,2,290,5,297,0,7,0,3
"08/09/2021","N","Y","Kenai Peninsula Borough",122,"Kenai Peninsula Borough",4,1,291,9,306,0,7,0,3
"08/10/2021","N","Y","Kenai Peninsula Borough",122,"Kenai Peninsula Borough",4,4,295,6,312,1,8,1,4
"08/11/2021","N","Y","Kenai Peninsula Borough",122,"Kenai Peninsula Borough",4,3,298,3,315,0,8,0,4
"08/12/2021","N","Y","Kenai Peninsula Borough",122,"Kenai Peninsula Borough",4,3,301,3,318,0,8,0,4
"08/13/2021","N","Y","Kenai Peninsula Borough",122,"Kenai Peninsula Borough",4,5,306,2,320,0,8,0,4
"08/14/2021","N","Y","Kenai Peninsula Borough",122,"Kenai Peninsula Borough",4,6,312,0,320,0,8,0,4
"08/15/2021","N","Y","Kenai Peninsula Borough",122,"Kenai Peninsula Borough",4,2,314,2,322,0,8,0,4
"08/16/2021","N","Y","Kenai Peninsula Borough",122,"Kenai Peninsula Borough",4,2,316,3,325,0,8,0,4
"08/17/2021","N","Y","Kenai Peninsula Borough",122,"Kenai Peninsula Borough",4,5,321,6,331,0,8,0,4
"08/18/2021","N","Y","Kenai Peninsula Borough",122,"Kenai Peninsula Borough",4,4,325,1,332,0,8,0,4
"08/19/2021","N","Y","Kenai Peninsula Borough",122,"Kenai Peninsula Borough",4,1,326,3,335,1,9,0,4
"08/20/2021","N","Y","Kenai Peninsula Borough",122,"Kenai Peninsula Borough",4,0,326,3,338,0,9,0,4
"08/21/2021","N","Y","Kenai Peninsula Borough",122,"Kenai Peninsula Borough",4,3,329,4,342,0,9,0,4
"08/22/2021","N","Y","Kenai Peninsula Borough",122,"Kenai Peninsula Borough",4,1,330,0,342,0,9,0,4
"08/23/2021","N","Y","Kenai Peninsula Borough",122,"Kenai Peninsula Borough",4,6,336,6,348,0,9,0,4
"08/24/2021","N","Y","Kenai Peninsula Borough",122,"Kenai Peninsula Borough",4,2,338,6,354,0,9,0,4
"08/25/2021","N","Y","Kenai Peninsula Borough",122,"Kenai Peninsula Borough",4,4,342,1,355,0,9,0,4
"08/26/2021","N","Y","Kenai Peninsula Borough",122,"Kenai Peninsula Borough",4,4,346,1,356,0,9,0,4
"08/27/2021","N","Y","Kenai Peninsula Borough",122,"Kenai Peninsula Borough",4,2,348,0,356,0,9,0,4
"08/28/2021","N","Y","Kenai Peninsula Borough",122,"Kenai Peninsula Borough",4,2,350,4,360,0,9,0,4
"08/30/2021","N","Y","Kenai Peninsula Borough",122,"Kenai Peninsula Borough",4,2,352,2,362,0,9,0,4
"08/31/2021","N","Y","Kenai Peninsula Borough",122,"Kenai Peninsula Borough",4,1,353,5,367,0,9,0,4
"09/01/2021","N","Y","Kenai Peninsula Borough",122,"Kenai Peninsula Borough",4,3,356,1,368,0,9,0,4
"09/02/2021","N","Y","Kenai Peninsula Borough",122,"Kenai Peninsula Borough",4,0,356,7,375,1,10,0,4
"09/03/2021","N","Y","Kenai Peninsula Borough",122,"Kenai Peninsula Borough",4,3,359,1,376,0,10,0,4
"09/04/2021","N","Y","Kenai Peninsula Borough",122,"Kenai Peninsula Borough",4,3,362,2,378,0,10,0,4
"09/05/2021","N","Y","Kenai Peninsula Borough",122,"Kenai Peninsula Borough",4,1,363,1,379,0,10,0,4
"09/06/2021","N","Y","Kenai Peninsula Borough",122,"Kenai Peninsula Borough",4,4,367,1,380,0,10,0,4
"09/07/2021","N","Y","Kenai Peninsula Borough",122,"Kenai Peninsula Borough",4,2,369,4,384,0,10,0,4
"09/08/2021","N","Y","Kenai Peninsula Borough",122,"Kenai Peninsula Borough",4,1,370,2,386,0,10,0,4
"09/09/2021","N","Y","Kenai Peninsula Borough",122,"Kenai Peninsula Borough",4,6,376,1,387,0,10,0,4
"09/10/2021","N","Y","Kenai Peninsula Borough",122,"Kenai Peninsula Borough",4,1,377,1,388,0,10,0,4
"09/13/2021","N","Y","Kenai Peninsula Borough",122,"Kenai Peninsula Borough",4,1,378,5,393,0,10,0,4
"09/14/2021","N","Y","Kenai Peninsula Borough",122,"Kenai Peninsula Borough",4,2,380,0,393,0,10,0,4
"09/15/2021","N","Y","Kenai Peninsula Borough",122,"Kenai Peninsula Borough",4,0,380,1,394,0,10,0,4
"09/16/2021","N","Y","Kenai Peninsula Borough",122,"Kenai Peninsula Borough",4,3,383,3,397,0,10,0,4
"09/17/2021","N","Y","Kenai Peninsula Borough",122,"Kenai Peninsula Borough",4,3,386,0,397,0,10,0,4
"09/18/2021","N","Y","Kenai Peninsula Borough",122,"Kenai Peninsula Borough",4,1,387,0,397,0,10,0,4
"09/19/2021","N","Y","Kenai Peninsula Borough",122,"Kenai Peninsula Borough",4,1,388,0,397,0,10,0,4
"09/20/2021","N","Y","Kenai Peninsula Borough",122,"Kenai Peninsula Borough",4,0,388,1,398,0,10,0,4
"09/21/2021","N","Y","Kenai Peninsula Borough",122,"Kenai Peninsula Borough",4,1,389,0,398,0,10,0,4
"09/22/2021","N","Y","Kenai Peninsula Borough",122,"Kenai Peninsula Borough",4,2,391,1,399,0,10,0,4
"09/23/2021","N","Y","Kenai Peninsula Borough",122,"Kenai Peninsula Borough",4,2,393,1,400,0,10,0,4
"09/24/2021","N","Y","Kenai Peninsula Borough",122,"Kenai Peninsula Borough",4,2,395,2,402,0,10,0,4
"09/25/2021","N","Y","Kenai Peninsula Borough",122,"Kenai Peninsula Borough",4,2,397,0,402,0,10,0,4
"09/27/2021","N","Y","Kenai Peninsula Borough",122,"Kenai Peninsula Borough",4,1,398,2,404,0,10,0,4
"09/28/2021","N","Y","Kenai Peninsula Borough",122,"Kenai Peninsula Borough",4,2,400,0,404,0,10,0,4
"09/29/2021","N","Y","Kenai Peninsula Borough",122,"Kenai Peninsula Borough",4,3,403,0,404,0,10,0,4
"10/01/2021","N","Y","Kenai Peninsula Borough",122,"Kenai Peninsula Borough",4,0,403,2,406,0,10,0,4
"10/02/2021","N","Y","Kenai Peninsula Borough",122,"Kenai Peninsula Borough",4,1,404,0,406,0,10,0,4
"10/03/2021","N","Y","Kenai Peninsula Borough",122,"Kenai Peninsula Borough",4,0,404,2,408,0,10,0,4
"10/04/2021","N","Y","Kenai Peninsula Borough",122,"Kenai Peninsula Borough",4,1,405,4,412,0,10,0,4
"10/05/2021","N","Y","Kenai Peninsula Borough",122,"Kenai Peninsula Borough",4,1,406,0,412,0,10,0,4
"10/06/2021","N","Y","Kenai Peninsula Borough",122,"Kenai Peninsula Borough",4,3,409,0,412,0,10,0,4
"10/07/2021","N","Y","Kenai Peninsula Borough",122,"Kenai Peninsula Borough",4,3,412,1,413,0,10,0,4
"10/08/2021","N","Y","Kenai Peninsula Borough",122,"Kenai Peninsula Borough",4,1,413,0,413,0,10,0,4
"10/10/2021","N","Y","Kenai Peninsula Borough",122,"Kenai Peninsula Borough",4,2,415,2,415,0,10,0,4
"10/11/2021","N","Y","Kenai Peninsula Borough",122,"Kenai Peninsula Borough",4,0,415,2,417,0,10,0,4
"10/12/2021","N","Y","Kenai Peninsula Borough",122,"Kenai Peninsula Borough",4,1,416,2,419,0,10,0,4
"10/13/2021","N","Y","Kenai Peninsula Borough",122,"Kenai Peninsula Borough",4,0,416,1,420,0,10,0,4
"10/14/2021","N","Y","Kenai Peninsula Borough",122,"Kenai Peninsula Borough",4,1,417,2,422,0,10,0,4
"10/15/2021","N","Y","Kenai Peninsula Borough",122,"Kenai Peninsula Borough",4,0,417,1,423,0,10,0,4
"10/16/2021","N","Y","Kenai Peninsula Borough",122,"Kenai Peninsula Borough",4,3,420,0,423,0,10,0,4
"10/18/2021","N","Y","Kenai Peninsula Borough",122,"Kenai Peninsula Borough",4,1,421,2,425,0,10,0,4
"10/19/2021","N","Y","Kenai Peninsula Borough",122,"Kenai Peninsula Borough",4,2,423,1,426,0,10,0,4
"10/20/2021","N","Y","Kenai Peninsula Borough",122,"Kenai Peninsula Borough",4,1,424,1,427,0,10,0,4
"10/21/2021","N","Y","Kenai Peninsula Borough",122,"Kenai Peninsula Borough",4,2,426,0,427,0,10,0,4
"10/25/2021","N","Y","Kenai Peninsula Borough",122,"Kenai Peninsula Borough",4,0,426,1,428,0,10,0,4
"10/26/2021","N","Y","Kenai Peninsula Borough",122,"Kenai Peninsula Borough",4,1,427,2,430,0,10,0,4
"10/27/2021","N","Y","Kenai Peninsula Borough",122,"Kenai Peninsula Borough",4,3,430,2,432,0,10,0,4
"10/28/2021","N","Y","Kenai Peninsula Borough",122,"Kenai Peninsula Borough",4,1,431,1,433,0,10,0,4
"10/29/2021","N","Y","Kenai Peninsula Borough",122,"Kenai Peninsula Borough",4,1,432,2,435,0,10,0,4
"10/30/2021","N","Y","Kenai Peninsula Borough",122,"Kenai Peninsula Borough",4,1,433,1,436,0,10,0,4
"11/01/2021","N","Y","Kenai Peninsula Borough",122,"Kenai Peninsula Borough",4,2,435,0,436,0,10,0,4
"11/02/2021","N","Y","Kenai Peninsula Borough",122,"Kenai Peninsula Borough",4,2,437,1,437,0,10,0,4
"11/03/2021","N","Y","Kenai Peninsula Borough",122,"Kenai Peninsula Borough",4,0,437,1,438,0,10,0,4
"11/04/2021","N","Y","Kenai Peninsula Borough",122,"Kenai Peninsula Borough",4,1,438,0,438,0,10,0,4
"11/08/2021","N","Y","Kenai Peninsula Borough",122,"Kenai Peninsula Borough",4,0,438,1,439,0,10,0,4
"11/09/2021","N","Y","Kenai Peninsula Borough",122,"Kenai Peninsula Borough",4,1,439,0,439,0,10,0,4
"11/12/2021","N","Y","Kenai Peninsula Borough",122,"Kenai Peninsula Borough",4,1,440,1,440,0,10,0,4
"11/19/2021","N","Y","Kenai Peninsula Borough",122,"Kenai Peninsula Borough",4,0,440,1,441,0,10,0,4
"11/22/2021","N","Y","Kenai Peninsula Borough",122,"Kenai Peninsula Borough",4,1,441,2,443,0,10,0,4
"11/23/2021","N","Y","Kenai Peninsula Borough",122,"Kenai Peninsula Borough",4,2,443,0,443,0,10,0,4
"12/02/2021","N","Y","Kenai Peninsula Borough",122,"Kenai Peninsula Borough",4,0,443,2,445,0,10,0,4
"12/03/2021","N","Y","Kenai Peninsula Borough",122,"Kenai Peninsula Borough",4,2,445,2,447,0,10,0,4
"12/05/2021","N","Y","Kenai Peninsula Borough",122,"Kenai Peninsula Borough",4,2,447,0,447,0,10,0,4
"12/06/2021","N","Y","Kenai Peninsula Borough",122,"Kenai Peninsula Borough",4,0,447,1,448,0,10,0,4
"12/07/2021","N","Y","Kenai Peninsula Borough",122,"Kenai Peninsula Borough",4,1,448,0,448,0,10,0,4
"12/08/2021","N","Y","Kenai Peninsula Borough",122,"Kenai Peninsula Borough",4,0,448,1,449,0,10,0,4
"12/09/2021","N","Y","Kenai Peninsula Borough",122,"Kenai Peninsula Borough",4,1,449,0,449,0,10,0,4
"12/13/2021","N","Y","Kenai Peninsula Borough",122,"Kenai Peninsula Borough",4,0,449,1,450,0,10,0,4
"12/14/2021","N","Y","Kenai Peninsula Borough",122,"Kenai Peninsula Borough",4,1,450,0,450,0,10,0,4
"12/20/2021","N","Y","Kenai Peninsula Borough",122,"Kenai Peninsula Borough",4,0,450,1,451,0,10,0,4
"12/21/2021","N","Y","Kenai Peninsula Borough",122,"Kenai Peninsula Borough",4,1,451,0,451,0,10,0,4
"12/22/2021","N","Y","Kenai Peninsula Borough",122,"Kenai Peninsula Borough",4,1,452,1,452,0,10,0,4
"12/23/2021","N","Y","Kenai Peninsula Borough",122,"Kenai Peninsula Borough",4,1,453,1,453,0,10,0,4
"12/26/2021","N","Y","Kenai Peninsula Borough",122,"Kenai Peninsula Borough",4,0,453,1,454,0,10,0,4
"12/27/2021","N","Y","Kenai Peninsula Borough",122,"Kenai Peninsula Borough",4,2,455,2,456,0,10,0,4
"12/28/2021","N","Y","Kenai Peninsula Borough",122,"Kenai Peninsula Borough",4,0,455,1,457,0,10,0,4
"12/29/2021","N","Y","Kenai Peninsula Borough",122,"Kenai Peninsula Borough",4,2,457,1,458,0,10,0,4
"12/30/2021","N","Y","Kenai Peninsula Borough",122,"Kenai Peninsula Borough",4,1,458,3,461,0,10,0,4
"12/31/2021","N","Y","Kenai Peninsula Borough",122,"Kenai Peninsula Borough",4,1,459,0,461,0,10,0,4
"01/02/2022","N","Y","Kenai Peninsula Borough",122,"Kenai Peninsula Borough",4,2,461,0,461,0,10,0,4
"01/03/2022","N","Y","Kenai Peninsula Borough",122,"Kenai Peninsula Borough",4,0,461,2,463,0,10,0,4
"01/04/2022","N","Y","Kenai Peninsula Borough",122,"Kenai Peninsula Borough",4,2,463,1,464,0,10,0,4
"01/07/2022","N","Y","Kenai Peninsula Borough",122,"Kenai Peninsula Borough",4,3,466,2,466,0,10,0,4
"01/10/2022","N","Y","Kenai Peninsula Borough",122,"Kenai Peninsula Borough",4,2,468,3,469,0,10,0,4
"01/11/2022","N","Y","Kenai Peninsula Borough",122,"Kenai Peninsula Borough",4,1,469,1,470,0,10,0,4
"01/12/2022","N","Y","Kenai Peninsula Borough",122,"Kenai Peninsula Borough",4,1,470,4,474,0,10,0,4
"01/13/2022","N","Y","Kenai Peninsula Borough",122,"Kenai Peninsula Borough",4,4,474,4,478,0,10,0,4
"01/14/2022","N","Y","Kenai Peninsula Borough",122,"Kenai Peninsula Borough",4,2,476,0,478,0,10,0,4
"01/16/2022","N","Y","Kenai Peninsula Borough",122,"Kenai Peninsula Borough",4,0,476,1,479,0,10,0,4
"01/17/2022","N","Y","Kenai Peninsula Borough",122,"Kenai Peninsula Borough",4,1,477,0,479,0,10,0,4
"01/18/2022","N","Y","Kenai Peninsula Borough",122,"Kenai Peninsula Borough",4,0,477,4,483,0,10,0,4
"01/19/2022","N","Y","Kenai Peninsula Borough",122,"Kenai Peninsula Borough",4,4,481,1,484,0,10,0,4
"01/20/2022","N","Y","Kenai Peninsula Borough",122,"Kenai Peninsula Borough",4,3,484,0,484,0,10,0,4
"01/21/2022","N","Y","Kenai Peninsula Borough",122,"Kenai Peninsula Borough",4,0,484,3,487,0,10,0,4
"01/22/2022","N","Y","Kenai Peninsula Borough",122,"Kenai Peninsula Borough",4,1,485,0,487,0,10,0,4
"01/25/2022","N","Y","Kenai Peninsula Borough",122,"Kenai Peninsula Borough",4,1,486,0,487,0,10,0,4
"01/26/2022","N","Y","Kenai Peninsula Borough",122,"Kenai Peninsula Borough",4,1,487,4,491,0,10,0,4
"01/27/2022","N","Y","Kenai Peninsula Borough",122,"Kenai Peninsula Borough",4,3,490,2,493,0,10,0,4
"01/28/2022","N","Y","Kenai Peninsula Borough",122,"Kenai Peninsula Borough",4,1,491,3,496,0,10,0,4
"01/29/2022","N","Y","Kenai Peninsula Borough",122,"Kenai Peninsula Borough",4,5,496,1,497,0,10,0,4
"01/30/2022","N","Y","Kenai Peninsula Borough",122,"Kenai Peninsula Borough",4,1,497,0,497,0,10,0,4
"01/31/2022","N","Y","Kenai Peninsula Borough",122,"Kenai Peninsula Borough",4,0,497,2,499,0,10,0,4
"02/01/2022","N","Y","Kenai Peninsula Borough",122,"Kenai Peninsula Borough",4,2,499,0,499,0,10,0,4
"02/03/2022","N","Y","Kenai Peninsula Borough",122,"Kenai Peninsula Borough",4,2,501,3,502,0,10,0,4
"02/08/2022","N","Y","Kenai Peninsula Borough",122,"Kenai Peninsula Borough",4,1,502,0,502,0,10,0,4
"02/11/2022","N","Y","Kenai Peninsula Borough",122,"Kenai Peninsula Borough",4,1,503,1,503,0,10,0,4
"02/15/2022","N","Y","Kenai Peninsula Borough",122,"Kenai Peninsula Borough",4,0,503,2,505,0,10,0,4
"02/16/2022","N","Y","Kenai Peninsula Borough",122,"Kenai Peninsula Borough",4,1,504,1,506,0,10,0,4
"02/17/2022","N","Y","Kenai Peninsula Borough",122,"Kenai Peninsula Borough",4,0,504,1,507,0,10,0,4
"02/19/2022","N","Y","Kenai Peninsula Borough",122,"Kenai Peninsula Borough",4,2,506,0,507,0,10,0,4
"02/24/2022","N","Y","Kenai Peninsula Borough",122,"Kenai Peninsula Borough",4,1,507,1,508,0,10,0,4
"02/25/2022","N","Y","Kenai Peninsula Borough",122,"Kenai Peninsula Borough",4,1,508,0,508,0,10,0,4
"03/02/2022","N","Y","Kenai Peninsula Borough",122,"Kenai Peninsula Borough",4,0,508,1,509,0,10,0,4
"03/04/2022","N","Y","Kenai Peninsula Borough",122,"Kenai Peninsula Borough",4,1,509,0,509,0,10,0,4
"03/19/2022","N","Y","Kenai Peninsula Borough",122,"Kenai Peninsula Borough",4,0,509,1,510,0,10,0,4
"03/20/2022","N","Y","Kenai Peninsula Borough",122,"Kenai Peninsula Borough",4,1,510,0,510,0,10,0,4
"04/18/2022","N","Y","Kenai Peninsula Borough",122,"Kenai Peninsula Borough",4,1,511,1,511,0,10,0,4
"04/20/2022","N","Y","Kenai Peninsula Borough",122,"Kenai Peninsula Borough",4,0,511,1,512,0,10,0,4
"04/21/2022","N","Y","Kenai Peninsula Borough",122,"Kenai Peninsula Borough",4,2,513,3,515,0,10,0,4
"04/22/2022","N","Y","Kenai Peninsula Borough",122,"Kenai Peninsula Borough",4,2,515,0,515,0,10,0,4
"04/23/2022","N","Y","Kenai Peninsula Borough",122,"Kenai Peninsula Borough",4,1,516,1,516,0,10,0,4
"04/25/2022","N","Y","Kenai Peninsula Borough",122,"Kenai Peninsula Borough",4,0,516,1,517,0,10,0,4
"04/26/2022","N","Y","Kenai Peninsula Borough",122,"Kenai Peninsula Borough",4,1,517,0,517,0,10,0,4
"06/01/2020","N","Y","Ketchikan Gateway Borough",130,"Other Southeast Region - Southern",9,0,0,1,1,0,0,0,0
"06/07/2020","N","Y","Ketchikan Gateway Borough",130,"Other Southeast Region - Southern",9,0,0,1,2,0,0,0,0
"06/10/2020","N","Y","Ketchikan Gateway Borough",130,"Other Southeast Region - Southern",9,1,1,2,4,0,0,0,0
"06/12/2020","N","Y","Ketchikan Gateway Borough",130,"Other Southeast Region - Southern",9,3,4,0,4,0,0,0,0
"06/16/2020","N","Y","Ketchikan Gateway Borough",130,"Other Southeast Region - Southern",9,1,5,1,5,0,0,0,0
"06/20/2020","N","Y","Ketchikan Gateway Borough",130,"Other Southeast Region - Southern",9,0,5,1,6,0,0,0,0
"06/22/2020","N","Y","Ketchikan Gateway Borough",130,"Other Southeast Region - Southern",9,2,7,2,8,0,0,0,0
"06/25/2020","N","Y","Ketchikan Gateway Borough",130,"Other Southeast Region - Southern",9,1,8,0,8,0,0,0,0
"07/06/2020","N","Y","Ketchikan Gateway Borough",130,"Other Southeast Region - Southern",9,0,8,1,9,0,0,0,0
"07/07/2020","N","Y","Ketchikan Gateway Borough",130,"Other Southeast Region - Southern",9,1,9,0,9,0,0,0,0
"07/11/2020","N","Y","Ketchikan Gateway Borough",130,"Other Southeast Region - Southern",9,0,9,2,11,0,0,0,0
"07/14/2020","N","Y","Ketchikan Gateway Borough",130,"Other Southeast Region - Southern",9,2,11,0,11,0,0,0,0
"07/16/2020","N","Y","Ketchikan Gateway Borough",130,"Other Southeast Region - Southern",9,0,11,1,12,0,0,0,0
"07/20/2020","N","Y","Ketchikan Gateway Borough",130,"Other Southeast Region - Southern",9,1,12,0,12,0,0,0,0
"07/24/2020","N","Y","Ketchikan Gateway Borough",130,"Other Southeast Region - Southern",9,0,12,1,13,0,0,0,0
"07/25/2020","N","Y","Ketchikan Gateway Borough",130,"Other Southeast Region - Southern",9,1,13,0,13,0,0,0,0
"07/27/2020","N","Y","Ketchikan Gateway Borough",130,"Other Southeast Region - Southern",9,0,13,1,14,0,0,0,0
"07/30/2020","N","Y","Ketchikan Gateway Borough",130,"Other Southeast Region - Southern",9,1,14,1,15,0,0,0,0
"08/02/2020","N","Y","Ketchikan Gateway Borough",130,"Other Southeast Region - Southern",9,0,14,1,16,0,0,0,0
"08/03/2020","N","Y","Ketchikan Gateway Borough",130,"Other Southeast Region - Southern",9,1,15,0,16,0,0,0,0
"08/04/2020","N","Y","Ketchikan Gateway Borough",130,"Other Southeast Region - Southern",9,1,16,0,16,0,0,0,0
"08/08/2020","N","Y","Ketchikan Gateway Borough",130,"Other Southeast Region - Southern",9,1,17,1,17,0,0,0,0
"08/18/2020","N","Y","Ketchikan Gateway Borough",130,"Other Southeast Region - Southern",9,0,17,1,18,0,0,0,0
"08/24/2020","N","Y","Ketchikan Gateway Borough",130,"Other Southeast Region - Southern",9,1,18,0,18,0,0,0,0
"08/31/2020","N","Y","Ketchikan Gateway Borough",130,"Other Southeast Region - Southern",9,0,18,1,19,0,0,0,0
"09/01/2020","N","Y","Ketchikan Gateway Borough",130,"Other Southeast Region - Southern",9,1,19,0,19,0,0,0,0
"09/11/2020","N","Y","Ketchikan Gateway Borough",130,"Other Southeast Region - Southern",9,0,19,1,20,0,0,0,0
"09/14/2020","N","Y","Ketchikan Gateway Borough",130,"Other Southeast Region - Southern",9,1,20,0,20,0,0,0,0
"10/06/2020","N","Y","Ketchikan Gateway Borough",130,"Other Southeast Region - Southern",9,0,20,1,21,0,0,0,0
"10/08/2020","N","Y","Ketchikan Gateway Borough",130,"Other Southeast Region - Southern",9,1,21,0,21,0,0,0,0
"10/27/2020","N","Y","Ketchikan Gateway Borough",130,"Other Southeast Region - Southern",9,0,21,1,22,0,0,0,0
"10/29/2020","N","Y","Ketchikan Gateway Borough",130,"Other Southeast Region - Southern",9,1,22,0,22,0,0,0,0
"12/08/2020","N","Y","Ketchikan Gateway Borough",130,"Other Southeast Region - Southern",9,0,22,1,23,0,0,0,0
"12/14/2020","N","Y","Ketchikan Gateway Borough",130,"Other Southeast Region - Southern",9,1,23,0,23,0,0,0,0
"02/23/2021","N","Y","Ketchikan Gateway Borough",130,"Other Southeast Region - Southern",9,0,23,1,24,0,0,0,0
"02/26/2021","N","Y","Ketchikan Gateway Borough",130,"Other Southeast Region - Southern",9,1,24,0,24,0,0,0,0
"04/14/2021","N","Y","Ketchikan Gateway Borough",130,"Other Southeast Region - Southern",9,0,24,1,25,0,0,0,0
"04/17/2021","N","Y","Ketchikan Gateway Borough",130,"Other Southeast Region - Southern",9,0,24,1,26,0,0,0,0
"04/19/2021","N","Y","Ketchikan Gateway Borough",130,"Other Southeast Region - Southern",9,1,25,0,26,0,0,0,0
"04/20/2021","N","Y","Ketchikan Gateway Borough",130,"Other Southeast Region - Southern",9,1,26,0,26,0,0,0,0
"04/28/2021","N","Y","Ketchikan Gateway Borough",130,"Other Southeast Region - Southern",9,0,26,1,27,0,0,0,0
"05/05/2021","N","Y","Ketchikan Gateway Borough",130,"Other Southeast Region - Southern",9,0,26,1,28,0,0,0,0
"05/06/2021","N","Y","Ketchikan Gateway Borough",130,"Other Southeast Region - Southern",9,0,26,1,29,0,0,0,0
"05/07/2021","N","Y","Ketchikan Gateway Borough",130,"Other Southeast Region - Southern",9,2,28,0,29,0,0,0,0
"05/12/2021","N","Y","Ketchikan Gateway Borough",130,"Other Southeast Region - Southern",9,0,28,1,30,0,0,0,0
"05/17/2021","N","Y","Ketchikan Gateway Borough",130,"Other Southeast Region - Southern",9,1,29,0,30,0,0,0,0
"05/18/2021","N","Y","Ketchikan Gateway Borough",130,"Other Southeast Region - Southern",9,1,30,0,30,0,0,0,0
"06/04/2021","N","Y","Ketchikan Gateway Borough",130,"Other Southeast Region - Southern",9,0,30,1,31,0,0,0,0
"06/08/2021","N","Y","Ketchikan Gateway Borough",130,"Other Southeast Region - Southern",9,1,31,0,31,0,0,0,0
"06/20/2021","N","Y","Ketchikan Gateway Borough",130,"Other Southeast Region - Southern",9,0,31,1,32,0,0,0,0
"06/22/2021","N","Y","Ketchikan Gateway Borough",130,"Other Southeast Region - Southern",9,1,32,0,32,0,0,0,0
"07/01/2021","N","Y","Ketchikan Gateway Borough",130,"Other Southeast Region - Southern",9,0,32,1,33,0,0,0,0
"07/02/2021","N","Y","Ketchikan Gateway Borough",130,"Other Southeast Region - Southern",9,1,33,0,33,0,0,0,0
"07/19/2021","N","Y","Ketchikan Gateway Borough",130,"Other Southeast Region - Southern",9,1,34,3,36,0,0,0,0
"07/22/2021","N","Y","Ketchikan Gateway Borough",130,"Other Southeast Region - Southern",9,2,36,3,39,0,0,0,0
"07/23/2021","N","Y","Ketchikan Gateway Borough",130,"Other Southeast Region - Southern",9,3,39,3,42,0,0,0,0
"07/24/2021","N","Y","Ketchikan Gateway Borough",130,"Other Southeast Region - Southern",9,0,39,1,43,0,0,0,0
"07/25/2021","N","Y","Ketchikan Gateway Borough",130,"Other Southeast Region - Southern",9,0,39,1,44,0,0,0,0
"07/26/2021","N","Y","Ketchikan Gateway Borough",130,"Other Southeast Region - Southern",9,1,40,0,44,0,0,0,0
"07/27/2021","N","Y","Ketchikan Gateway Borough",130,"Other Southeast Region - Southern",9,2,42,0,44,0,0,0,0
"07/28/2021","N","Y","Ketchikan Gateway Borough",130,"Other Southeast Region - Southern",9,1,43,0,44,0,0,0,0
"08/02/2021","N","Y","Ketchikan Gateway Borough",130,"Other Southeast Region - Southern",9,0,43,1,45,0,0,0,0
"08/03/2021","N","Y","Ketchikan Gateway Borough",130,"Other Southeast Region - Southern",9,0,43,1,46,0,0,0,0
"08/04/2021","N","Y","Ketchikan Gateway Borough",130,"Other Southeast Region - Southern",9,2,45,2,48,0,0,0,0
"08/05/2021","N","Y","Ketchikan Gateway Borough",130,"Other Southeast Region - Southern",9,0,45,3,51,0,0,0,0
"08/07/2021","N","Y","Ketchikan Gateway Borough",130,"Other Southeast Region - Southern",9,1,46,3,54,0,0,0,0
"08/09/2021","N","Y","Ketchikan Gateway Borough",130,"Other Southeast Region - Southern",9,0,46,12,66,0,0,0,0
"08/10/2021","N","Y","Ketchikan Gateway Borough",130,"Other Southeast Region - Southern",9,3,49,0,66,0,0,0,0
"08/11/2021","N","Y","Ketchikan Gateway Borough",130,"Other Southeast Region - Southern",9,0,49,2,68,0,0,0,0
"08/12/2021","N","Y","Ketchikan Gateway Borough",130,"Other Southeast Region - Southern",9,1,50,3,71,0,0,0,0
"08/13/2021","N","Y","Ketchikan Gateway Borough",130,"Other Southeast Region - Southern",9,3,53,5,76,0,0,0,0
"08/14/2021","N","Y","Ketchikan Gateway Borough",130,"Other Southeast Region - Southern",9,5,58,0,76,0,0,0,0
"08/15/2021","N","Y","Ketchikan Gateway Borough",130,"Other Southeast Region - Southern",9,0,58,1,77,0,0,0,0
"08/16/2021","N","Y","Ketchikan Gateway Borough",130,"Other Southeast Region - Southern",9,3,61,0,77,0,0,0,0
"08/17/2021","N","Y","Ketchikan Gateway Borough",130,"Other Southeast Region - Southern",9,0,61,2,79,0,0,0,0
"08/18/2021","N","Y","Ketchikan Gateway Borough",130,"Other Southeast Region - Southern",9,4,65,1,80,0,0,0,0
"08/19/2021","N","Y","Ketchikan Gateway Borough",130,"Other Southeast Region - Southern",9,1,66,1,81,0,0,0,0
"08/20/2021","N","Y","Ketchikan Gateway Borough",130,"Other Southeast Region - Southern",9,0,66,1,82,0,0,0,0
"08/21/2021","N","Y","Ketchikan Gateway Borough",130,"Other Southeast Region - Southern",9,1,67,1,83,0,0,0,0
"08/22/2021","N","Y","Ketchikan Gateway Borough",130,"Other Southeast Region - Southern",9,0,67,3,86,0,0,0,0
"08/23/2021","N","Y","Ketchikan Gateway Borough",130,"Other Southeast Region - Southern",9,1,68,0,86,0,0,0,0
"08/24/2021","N","Y","Ketchikan Gateway Borough",130,"Other Southeast Region - Southern",9,7,75,0,86,0,0,0,0
"08/25/2021","N","Y","Ketchikan Gateway Borough",130,"Other Southeast Region - Southern",9,7,82,0,86,0,0,0,0
"08/26/2021","N","Y","Ketchikan Gateway Borough",130,"Other Southeast Region - Southern",9,1,83,6,92,0,0,0,0
"08/28/2021","N","Y","Ketchikan Gateway Borough",130,"Other Southeast Region - Southern",9,0,83,2,94,0,0,0,0
"08/30/2021","N","Y","Ketchikan Gateway Borough",130,"Other Southeast Region - Southern",9,2,85,0,94,0,0,0,0
"08/31/2021","N","Y","Ketchikan Gateway Borough",130,"Other Southeast Region - Southern",9,2,87,2,96,0,0,0,0
"09/01/2021","N","Y","Ketchikan Gateway Borough",130,"Other Southeast Region - Southern",9,8,95,0,96,0,0,0,0
"09/02/2021","N","Y","Ketchikan Gateway Borough",130,"Other Southeast Region - Southern",9,0,95,7,103,0,0,0,0
"09/05/2021","N","Y","Ketchikan Gateway Borough",130,"Other Southeast Region - Southern",9,0,95,1,104,0,0,0,0
"09/06/2021","N","Y","Ketchikan Gateway Borough",130,"Other Southeast Region - Southern",9,0,95,1,105,0,0,0,0
"09/07/2021","N","Y","Ketchikan Gateway Borough",130,"Other Southeast Region - Southern",9,1,96,0,105,0,0,0,0
"09/08/2021","N","Y","Ketchikan Gateway Borough",130,"Other Southeast Region - Southern",9,8,104,0,105,0,0,0,0
"09/09/2021","N","Y","Ketchikan Gateway Borough",130,"Other Southeast Region - Southern",9,1,105,3,108,0,0,0,0
"09/16/2021","N","Y","Ketchikan Gateway Borough",130,"Other Southeast Region - Southern",9,1,106,5,113,0,0,0,0
"09/17/2021","N","Y","Ketchikan Gateway Borough",130,"Other Southeast Region - Southern",9,0,106,2,115,0,0,0,0
"09/19/2021","N","Y","Ketchikan Gateway Borough",130,"Other Southeast Region - Southern",9,2,108,1,116,0,0,0,0
"09/20/2021","N","Y","Ketchikan Gateway Borough",130,"Other Southeast Region - Southern",9,0,108,2,118,0,0,0,0
"09/21/2021","N","Y","Ketchikan Gateway Borough",130,"Other Southeast Region - Southern",9,1,109,1,119,0,0,0,0
"09/23/2021","N","Y","Ketchikan Gateway Borough",130,"Other Southeast Region - Southern",9,0,109,2,121,0,0,0,0
"09/24/2021","N","Y","Ketchikan Gateway Borough",130,"Other Southeast Region - Southern",9,0,109,1,122,0,0,0,0
"09/25/2021","N","Y","Ketchikan Gateway Borough",130,"Other Southeast Region - Southern",9,1,110,1,123,0,0,0,0
"09/27/2021","N","Y","Ketchikan Gateway Borough",130,"Other Southeast Region - Southern",9,6,116,2,125,0,0,0,0
"09/28/2021","N","Y","Ketchikan Gateway Borough",130,"Other Southeast Region - Southern",9,1,117,0,125,0,0,0,0
"09/29/2021","N","Y","Ketchikan Gateway Borough",130,"Other Southeast Region - Southern",9,2,119,0,125,0,0,0,0
"09/30/2021","N","Y","Ketchikan Gateway Borough",130,"Other Southeast Region - Southern",9,3,122,2,127,0,0,0,0
"10/01/2021","N","Y","Ketchikan Gateway Borough",130,"Other Southeast Region - Southern",9,1,123,1,128,0,0,0,0
"10/04/2021","N","Y","Ketchikan Gateway Borough",130,"Other Southeast Region - Southern",9,5,128,0,128,0,0,0,0
"10/07/2021","N","Y","Ketchikan Gateway Borough",130,"Other Southeast Region - Southern",9,0,128,1,129,0,0,0,0
"10/11/2021","N","Y","Ketchikan Gateway Borough",130,"Other Southeast Region - Southern",9,1,129,0,129,0,0,0,0
"10/15/2021","N","Y","Ketchikan Gateway Borough",130,"Other Southeast Region - Southern",9,0,129,2,131,0,0,0,0
"10/16/2021","N","Y","Ketchikan Gateway Borough",130,"Other Southeast Region - Southern",9,1,130,1,132,0,0,0,0
"10/17/2021","N","Y","Ketchikan Gateway Borough",130,"Other Southeast Region - Southern",9,1,131,0,132,0,0,0,0
"10/21/2021","N","Y","Ketchikan Gateway Borough",130,"Other Southeast Region - Southern",9,1,132,0,132,0,0,0,0
"11/03/2021","N","Y","Ketchikan Gateway Borough",130,"Other Southeast Region - Southern",9,0,132,1,133,0,0,0,0
"11/04/2021","N","Y","Ketchikan Gateway Borough",130,"Other Southeast Region - Southern",9,1,133,2,135,0,0,0,0
"11/05/2021","N","Y","Ketchikan Gateway Borough",130,"Other Southeast Region - Southern",9,2,135,0,135,0,0,0,0
"11/18/2021","N","Y","Ketchikan Gateway Borough",130,"Other Southeast Region - Southern",9,1,136,1,136,0,0,0,0
"11/23/2021","N","Y","Ketchikan Gateway Borough",130,"Other Southeast Region - Southern",9,0,136,1,137,0,0,0,0
"11/24/2021","N","Y","Ketchikan Gateway Borough",130,"Other Southeast Region - Southern",9,1,137,0,137,0,0,0,0
"12/07/2021","N","Y","Ketchikan Gateway Borough",130,"Other Southeast Region - Southern",9,0,137,1,138,0,0,0,0
"12/14/2021","N","Y","Ketchikan Gateway Borough",130,"Other Southeast Region - Southern",9,0,137,1,139,0,0,0,0
"12/15/2021","N","Y","Ketchikan Gateway Borough",130,"Other Southeast Region - Southern",9,2,139,0,139,0,0,0,0
"12/27/2021","N","Y","Ketchikan Gateway Borough",130,"Other Southeast Region - Southern",9,0,139,2,141,0,0,0,0
"12/30/2021","N","Y","Ketchikan Gateway Borough",130,"Other Southeast Region - Southern",9,2,141,0,141,0,0,0,0
"01/03/2022","N","Y","Ketchikan Gateway Borough",130,"Other Southeast Region - Southern",9,0,141,1,142,0,0,0,0
"01/04/2022","N","Y","Ketchikan Gateway Borough",130,"Other Southeast Region - Southern",9,0,141,1,143,0,0,0,0
"01/05/2022","N","Y","Ketchikan Gateway Borough",130,"Other Southeast Region - Southern",9,1,142,0,143,0,0,0,0
"01/06/2022","N","Y","Ketchikan Gateway Borough",130,"Other Southeast Region - Southern",9,0,142,1,144,0,0,0,0
"01/09/2022","N","Y","Ketchikan Gateway Borough",130,"Other Southeast Region - Southern",9,1,143,0,144,0,0,0,0
"01/10/2022","N","Y","Ketchikan Gateway Borough",130,"Other Southeast Region - Southern",9,0,143,1,145,0,0,0,0
"01/11/2022","N","Y","Ketchikan Gateway Borough",130,"Other Southeast Region - Southern",9,1,144,1,146,0,0,0,0
"01/13/2022","N","Y","Ketchikan Gateway Borough",130,"Other Southeast Region - Southern",9,1,145,0,146,0,0,0,0
"01/16/2022","N","Y","Ketchikan Gateway Borough",130,"Other Southeast Region - Southern",9,1,146,0,146,0,0,0,0
"01/17/2022","N","Y","Ketchikan Gateway Borough",130,"Other Southeast Region - Southern",9,0,146,1,147,0,0,0,0
"01/18/2022","N","Y","Ketchikan Gateway Borough",130,"Other Southeast Region - Southern",9,0,146,1,148,0,0,0,0
"01/19/2022","N","Y","Ketchikan Gateway Borough",130,"Other Southeast Region - Southern",9,1,147,0,148,0,0,0,0
"01/20/2022","N","Y","Ketchikan Gateway Borough",130,"Other Southeast Region - Southern",9,0,147,1,149,0,0,0,0
"01/21/2022","N","Y","Ketchikan Gateway Borough",130,"Other Southeast Region - Southern",9,1,148,1,150,0,0,0,0
"01/22/2022","N","Y","Ketchikan Gateway Borough",130,"Other Southeast Region - Southern",9,0,148,2,152,0,0,0,0
"01/23/2022","N","Y","Ketchikan Gateway Borough",130,"Other Southeast Region - Southern",9,2,150,1,153,0,0,0,0
"01/24/2022","N","Y","Ketchikan Gateway Borough",130,"Other Southeast Region - Southern",9,2,152,0,153,0,0,0,0
"01/25/2022","N","Y","Ketchikan Gateway Borough",130,"Other Southeast Region - Southern",9,0,152,1,154,0,0,0,0
"01/26/2022","N","Y","Ketchikan Gateway Borough",130,"Other Southeast Region - Southern",9,1,153,1,155,0,0,0,0
"01/27/2022","N","Y","Ketchikan Gateway Borough",130,"Other Southeast Region - Southern",9,1,154,0,155,0,0,0,0
"02/02/2022","N","Y","Ketchikan Gateway Borough",130,"Other Southeast Region - Southern",9,1,155,1,156,0,0,0,0
"02/03/2022","N","Y","Ketchikan Gateway Borough",130,"Other Southeast Region - Southern",9,1,156,0,156,0,0,0,0
"02/25/2022","N","Y","Ketchikan Gateway Borough",130,"Other Southeast Region - Southern",9,0,156,1,157,0,0,0,0
"02/28/2022","N","Y","Ketchikan Gateway Borough",130,"Other Southeast Region - Southern",9,1,157,0,157,0,0,0,0
"03/19/2022","N","Y","Ketchikan Gateway Borough",130,"Other Southeast Region - Southern",9,0,157,1,158,0,0,0,0
"03/21/2022","N","Y","Ketchikan Gateway Borough",130,"Other Southeast Region - Southern",9,1,158,0,158,0,0,0,0
"04/11/2022","N","Y","Ketchikan Gateway Borough",130,"Other Southeast Region - Southern",9,0,158,1,159,0,0,0,0
"04/12/2022","N","Y","Ketchikan Gateway Borough",130,"Other Southeast Region - Southern",9,1,159,0,159,0,0,0,0
"04/18/2022","N","Y","Ketchikan Gateway Borough",130,"Other Southeast Region - Southern",9,0,159,1,160,0,0,0,0
"04/19/2022","N","Y","Ketchikan Gateway Borough",130,"Other Southeast Region - Southern",9,1,160,0,160,0,0,0,0
"06/02/2020","N","Y","Kodiak Island Borough",150,"Southwest Region",11,0,0,1,1,0,0,0,0
"06/03/2020","N","Y","Kodiak Island Borough",150,"Southwest Region",11,1,1,0,1,0,0,0,0
"06/09/2020","N","Y","Kodiak Island Borough",150,"Southwest Region",11,0,1,1,2,0,0,0,0
"06/12/2020","N","Y","Kodiak Island Borough",150,"Southwest Region",11,1,2,0,2,0,0,0,0
"06/18/2020","N","Y","Kodiak Island Borough",150,"Southwest Region",11,1,3,1,3,0,0,0,0
"06/19/2020","N","Y","Kodiak Island Borough",150,"Southwest Region",11,0,3,1,4,0,0,0,0
"06/23/2020","N","Y","Kodiak Island Borough",150,"Southwest Region",11,1,4,0,4,0,0,0,0
"06/24/2020","N","Y","Kodiak Island Borough",150,"Southwest Region",11,0,4,1,5,0,0,0,0
"06/26/2020","N","Y","Kodiak Island Borough",150,"Southwest Region",11,0,4,1,6,0,0,0,0
"07/01/2020","N","Y","Kodiak Island Borough",150,"Southwest Region",11,2,6,0,6,0,0,0,0
"07/02/2020","N","Y","Kodiak Island Borough",150,"Southwest Region",11,0,6,1,7,0,0,0,0
"07/08/2020","N","Y","Kodiak Island Borough",150,"Southwest Region",11,1,7,0,7,0,0,0,0
"07/10/2020","N","Y","Kodiak Island Borough",150,"Southwest Region",11,0,7,1,8,0,0,0,0
"07/11/2020","N","Y","Kodiak Island Borough",150,"Southwest Region",11,0,7,1,9,0,0,0,0
"07/13/2020","N","Y","Kodiak Island Borough",150,"Southwest Region",11,1,8,0,9,0,0,0,0
"07/15/2020","N","Y","Kodiak Island Borough",150,"Southwest Region",11,1,9,0,9,0,0,0,0
"07/29/2020","N","Y","Kodiak Island Borough",150,"Southwest Region",11,0,9,1,10,0,0,0,0
"07/30/2020","N","Y","Kodiak Island Borough",150,"Southwest Region",11,0,9,3,13,0,0,0,0
"07/31/2020","N","Y","Kodiak Island Borough",150,"Southwest Region",11,1,10,0,13,0,0,0,0
"08/01/2020","N","Y","Kodiak Island Borough",150,"Southwest Region",11,3,13,7,20,0,0,0,0
"08/02/2020","N","Y","Kodiak Island Borough",150,"Southwest Region",11,7,20,8,28,1,1,0,0
"08/03/2020","N","Y","Kodiak Island Borough",150,"Southwest Region",11,0,20,12,40,0,1,0,0
"08/04/2020","N","Y","Kodiak Island Borough",150,"Southwest Region",11,0,20,1,41,0,1,0,0
"08/05/2020","N","Y","Kodiak Island Borough",150,"Southwest Region",11,0,20,1,42,0,1,0,0
"08/06/2020","N","Y","Kodiak Island Borough",150,"Southwest Region",11,8,28,0,42,0,1,0,0
"08/08/2020","N","Y","Kodiak Island Borough",150,"Southwest Region",11,1,29,1,43,0,1,0,0
"08/12/2020","N","Y","Kodiak Island Borough",150,"Southwest Region",11,12,41,0,43,0,1,0,0
"08/17/2020","N","Y","Kodiak Island Borough",150,"Southwest Region",11,2,43,0,43,0,1,0,0
"08/31/2020","N","Y","Kodiak Island Borough",150,"Southwest Region",11,0,43,1,44,0,1,0,0
"09/02/2020","N","Y","Kodiak Island Borough",150,"Southwest Region",11,1,44,0,44,0,1,0,0
"11/19/2020","N","Y","Kodiak Island Borough",150,"Southwest Region",11,1,45,1,45,0,1,0,0
"11/30/2020","N","Y","Kodiak Island Borough",150,"Southwest Region",11,0,45,1,46,0,1,0,0
"12/03/2020","N","Y","Kodiak Island Borough",150,"Southwest Region",11,1,46,0,46,0,1,0,0
"12/09/2020","N","Y","Kodiak Island Borough",150,"Southwest Region",11,0,46,3,49,0,1,0,0
"12/12/2020","N","Y","Kodiak Island Borough",150,"Southwest Region",11,1,47,0,49,0,1,0,0
"12/15/2020","N","Y","Kodiak Island Borough",150,"Southwest Region",11,0,47,1,50,0,1,0,0
"12/16/2020","N","Y","Kodiak Island Borough",150,"Southwest Region",11,1,48,0,50,0,1,0,0
"12/18/2020","N","Y","Kodiak Island Borough",150,"Southwest Region",11,1,49,1,51,0,1,0,0
"12/19/2020","N","Y","Kodiak Island Borough",150,"Southwest Region",11,1,50,0,51,0,1,0,0
"12/20/2020","N","Y","Kodiak Island Borough",150,"Southwest Region",11,1,51,0,51,0,1,0,0
"01/05/2021","N","Y","Kodiak Island Borough",150,"Southwest Region",11,0,51,1,52,0,1,0,0
"01/07/2021","N","Y","Kodiak Island Borough",150,"Southwest Region",11,1,52,0,52,0,1,0,0
"01/30/2021","N","Y","Kodiak Island Borough",150,"Southwest Region",11,0,52,1,53,0,1,0,0
"02/02/2021","N","Y","Kodiak Island Borough",150,"Southwest Region",11,1,53,0,53,0,1,0,0
"02/12/2021","N","Y","Kodiak Island Borough",150,"Southwest Region",11,0,53,1,54,0,1,0,0
"02/14/2021","N","Y","Kodiak Island Borough",150,"Southwest Region",11,1,54,0,54,0,1,0,0
"03/08/2021","N","Y","Kodiak Island Borough",150,"Southwest Region",11,0,54,1,55,0,1,0,0
"03/12/2021","N","Y","Kodiak Island Borough",150,"Southwest Region",11,1,55,0,55,0,1,0,0
"03/24/2021","N","Y","Kodiak Island Borough",150,"Southwest Region",11,0,55,2,57,0,1,0,0
"03/25/2021","N","Y","Kodiak Island Borough",150,"Southwest Region",11,2,57,0,57,0,1,0,0
"03/26/2021","N","Y","Kodiak Island Borough",150,"Southwest Region",11,0,57,2,59,0,1,0,0
"03/27/2021","N","Y","Kodiak Island Borough",150,"Southwest Region",11,2,59,0,59,0,1,0,0
"03/31/2021","N","Y","Kodiak Island Borough",150,"Southwest Region",11,0,59,1,60,0,1,0,0
"04/02/2021","N","Y","Kodiak Island Borough",150,"Southwest Region",11,1,60,0,60,0,1,0,0
"04/03/2021","N","Y","Kodiak Island Borough",150,"Southwest Region",11,0,60,1,61,0,1,0,0
"04/04/2021","N","Y","Kodiak Island Borough",150,"Southwest Region",11,1,61,0,61,0,1,0,0
"04/08/2021","N","Y","Kodiak Island Borough",150,"Southwest Region",11,0,61,1,62,0,1,0,0
"04/10/2021","N","Y","Kodiak Island Borough",150,"Southwest Region",11,1,62,0,62,0,1,0,0
"04/15/2021","N","Y","Kodiak Island Borough",150,"Southwest Region",11,0,62,1,63,0,1,0,0
"04/17/2021","N","Y","Kodiak Island Borough",150,"Southwest Region",11,1,63,0,63,0,1,0,0
"04/29/2021","N","Y","Kodiak Island Borough",150,"Southwest Region",11,0,63,1,64,0,1,0,0
"05/01/2021","N","Y","Kodiak Island Borough",150,"Southwest Region",11,1,64,0,64,0,1,0,0
"05/05/2021","N","Y","Kodiak Island Borough",150,"Southwest Region",11,0,64,1,65,0,1,0,0
"05/07/2021","N","Y","Kodiak Island Borough",150,"Southwest Region",11,1,65,0,65,0,1,0,0
"06/01/2021","N","Y","Kodiak Island Borough",150,"Southwest Region",11,1,66,1,66,0,1,0,0
"07/03/2021","N","Y","Kodiak Island Borough",150,"Southwest Region",11,0,66,1,67,0,1,0,0
"07/07/2021","N","Y","Kodiak Island Borough",150,"Southwest Region",11,0,66,2,69,0,1,0,0
"07/09/2021","N","Y","Kodiak Island Borough",150,"Southwest Region",11,1,67,0,69,0,1,0,0
"07/15/2021","N","Y","Kodiak Island Borough",150,"Southwest Region",11,2,69,0,69,0,1,0,0
"07/21/2021","N","Y","Kodiak Island Borough",150,"Southwest Region",11,0,69,4,73,0,1,0,0
"07/22/2021","N","Y","Kodiak Island Borough",150,"Southwest Region",11,2,71,0,73,0,1,0,0
"07/23/2021","N","Y","Kodiak Island Borough",150,"Southwest Region",11,2,73,0,73,0,1,0,0
"07/28/2021","N","Y","Kodiak Island Borough",150,"Southwest Region",11,0,73,1,74,0,1,0,0
"07/29/2021","N","Y","Kodiak Island Borough",150,"Southwest Region",11,2,75,1,75,0,1,0,0
"07/30/2021","N","Y","Kodiak Island Borough",150,"Southwest Region",11,0,75,1,76,0,1,0,0
"08/02/2021","N","Y","Kodiak Island Borough",150,"Southwest Region",11,1,76,0,76,0,1,0,0
"08/04/2021","N","Y","Kodiak Island Borough",150,"Southwest Region",11,0,76,1,77,0,1,0,0
"08/05/2021","N","Y","Kodiak Island Borough",150,"Southwest Region",11,1,77,3,80,0,1,0,0
"08/06/2021","N","Y","Kodiak Island Borough",150,"Southwest Region",11,0,77,1,81,0,1,0,0
"08/07/2021","N","Y","Kodiak Island Borough",150,"Southwest Region",11,2,79,0,81,0,1,0,0
"08/09/2021","N","Y","Kodiak Island Borough",150,"Southwest Region",11,0,79,1,82,0,1,0,0
"08/10/2021","N","Y","Kodiak Island Borough",150,"Southwest Region",11,2,81,4,86,0,1,0,0
"08/11/2021","N","Y","Kodiak Island Borough",150,"Southwest Region",11,4,85,0,86,0,1,0,0
"08/12/2021","N","Y","Kodiak Island Borough",150,"Southwest Region",11,0,85,0,86,1,2,0,0
"08/13/2021","N","Y","Kodiak Island Borough",150,"Southwest Region",11,0,85,1,87,0,2,0,0
"08/16/2021","N","Y","Kodiak Island Borough",150,"Southwest Region",11,1,86,1,88,0,2,0,0
"08/17/2021","N","Y","Kodiak Island Borough",150,"Southwest Region",11,1,87,5,93,0,2,0,0
"08/18/2021","N","Y","Kodiak Island Borough",150,"Southwest Region",11,2,89,1,94,0,2,0,0
"08/20/2021","N","Y","Kodiak Island Borough",150,"Southwest Region",11,3,92,2,96,0,2,0,0
"08/22/2021","N","Y","Kodiak Island Borough",150,"Southwest Region",11,2,94,0,96,0,2,0,0
"08/23/2021","N","Y","Kodiak Island Borough",150,"Southwest Region",11,2,96,1,97,0,2,0,0
"08/24/2021","N","Y","Kodiak Island Borough",150,"Southwest Region",11,0,96,2,99,0,2,0,0
"08/26/2021","N","Y","Kodiak Island Borough",150,"Southwest Region",11,0,96,1,100,0,2,0,0
"08/28/2021","N","Y","Kodiak Island Borough",150,"Southwest Region",11,2,98,2,102,0,2,0,0
"08/29/2021","N","Y","Kodiak Island Borough",150,"Southwest Region",11,1,99,0,102,0,2,0,0
"08/30/2021","N","Y","Kodiak Island Borough",150,"Southwest Region",11,3,102,0,102,0,2,0,0
"09/03/2021","N","Y","Kodiak Island Borough",150,"Southwest Region",11,0,102,3,105,0,2,0,0
"09/04/2021","N","Y","Kodiak Island Borough",150,"Southwest Region",11,1,103,1,106,0,2,0,0
"09/05/2021","N","Y","Kodiak Island Borough",150,"Southwest Region",11,1,104,0,106,0,2,0,0
"09/07/2021","N","Y","Kodiak Island Borough",150,"Southwest Region",11,0,104,2,108,0,2,0,0
"09/08/2021","N","Y","Kodiak Island Borough",150,"Southwest Region",11,4,108,2,110,0,2,0,0
"09/09/2021","N","Y","Kodiak Island Borough",150,"Southwest Region",11,0,108,1,111,0,2,0,0
"09/10/2021","N","Y","Kodiak Island Borough",150,"Southwest Region",11,1,109,1,112,0,2,0,0
"09/13/2021","N","Y","Kodiak Island Borough",150,"Southwest Region",11,0,109,2,114,0,2,0,0
"09/17/2021","N","Y","Kodiak Island Borough",150,"Southwest Region",11,0,109,2,116,0,2,0,0
"09/18/2021","N","Y","Kodiak Island Borough",150,"Southwest Region",11,2,111,0,116,1,3,0,0
"09/19/2021","N","Y","Kodiak Island Borough",150,"Southwest Region",11,1,112,2,118,0,3,0,0
"09/21/2021","N","Y","Kodiak Island Borough",150,"Southwest Region",11,3,115,3,121,0,3,0,0
"09/22/2021","N","Y","Kodiak Island Borough",150,"Southwest Region",11,1,116,0,121,0,3,0,0
"09/23/2021","N","Y","Kodiak Island Borough",150,"Southwest Region",11,0,116,1,122,0,3,0,0
"09/24/2021","N","Y","Kodiak Island Borough",150,"Southwest Region",11,0,116,1,123,0,3,0,0
"09/26/2021","N","Y","Kodiak Island Borough",150,"Southwest Region",11,1,117,0,123,0,3,0,0
"09/27/2021","N","Y","Kodiak Island Borough",150,"Southwest Region",11,1,118,1,124,0,3,0,0
"09/29/2021","N","Y","Kodiak Island Borough",150,"Southwest Region",11,0,118,2,126,0,3,0,0
"09/30/2021","N","Y","Kodiak Island Borough",150,"Southwest Region",11,2,120,0,126,0,3,0,0
"10/01/2021","N","Y","Kodiak Island Borough",150,"Southwest Region",11,2,122,0,126,0,3,0,0
"10/02/2021","N","Y","Kodiak Island Borough",150,"Southwest Region",11,0,122,1,127,0,3,0,0
"10/03/2021","N","Y","Kodiak Island Borough",150,"Southwest Region",11,1,123,0,127,0,3,0,0
"10/04/2021","N","Y","Kodiak Island Borough",150,"Southwest Region",11,0,123,3,130,0,3,0,0
"10/05/2021","N","Y","Kodiak Island Borough",150,"Southwest Region",11,1,124,0,130,0,3,0,0
"10/06/2021","N","Y","Kodiak Island Borough",150,"Southwest Region",11,4,128,1,131,0,3,0,0
"10/08/2021","N","Y","Kodiak Island Borough",150,"Southwest Region",11,2,130,1,132,0,3,0,0
"10/12/2021","N","Y","Kodiak Island Borough",150,"Southwest Region",11,0,130,2,134,0,3,0,0
"10/13/2021","N","Y","Kodiak Island Borough",150,"Southwest Region",11,2,132,0,134,0,3,0,0
"10/14/2021","N","Y","Kodiak Island Borough",150,"Southwest Region",11,1,133,1,135,0,3,0,0
"10/15/2021","N","Y","Kodiak Island Borough",150,"Southwest Region",11,1,134,0,135,0,3,0,0
"10/17/2021","N","Y","Kodiak Island Borough",150,"Southwest Region",11,1,135,0,135,0,3,0,0
"10/18/2021","N","Y","Kodiak Island Borough",150,"Southwest Region",11,0,135,1,136,0,3,0,0
"10/20/2021","N","Y","Kodiak Island Borough",150,"Southwest Region",11,1,136,0,136,0,3,0,0
"10/22/2021","N","Y","Kodiak Island Borough",150,"Southwest Region",11,0,136,1,137,0,3,0,0
"10/23/2021","N","Y","Kodiak Island Borough",150,"Southwest Region",11,1,137,0,137,0,3,0,0
"11/17/2021","N","Y","Kodiak Island Borough",150,"Southwest Region",11,1,138,1,138,0,3,0,0
"12/07/2021","N","Y","Kodiak Island Borough",150,"Southwest Region",11,0,138,1,139,0,3,0,0
"12/08/2021","N","Y","Kodiak Island Borough",150,"Southwest Region",11,1,139,0,139,0,3,0,0
"12/14/2021","N","Y","Kodiak Island Borough",150,"Southwest Region",11,0,139,1,140,0,3,0,0
"12/21/2021","N","Y","Kodiak Island Borough",150,"Southwest Region",11,0,139,11,151,0,3,0,0
"12/22/2021","N","Y","Kodiak Island Borough",150,"Southwest Region",11,11,150,0,151,0,3,0,0
"12/27/2021","N","Y","Kodiak Island Borough",150,"Southwest Region",11,0,150,2,153,0,3,0,0
"12/28/2021","N","Y","Kodiak Island Borough",150,"Southwest Region",11,2,152,0,153,0,3,0,0
"12/29/2021","N","Y","Kodiak Island Borough",150,"Southwest Region",11,0,152,9,162,0,3,0,0
"12/30/2021","N","Y","Kodiak Island Borough",150,"Southwest Region",11,9,161,0,162,0,3,0,0
"01/03/2022","N","Y","Kodiak Island Borough",150,"Southwest Region",11,0,161,2,164,0,3,0,0
"01/04/2022","N","Y","Kodiak Island Borough",150,"Southwest Region",11,0,161,3,167,0,3,0,0
"01/06/2022","N","Y","Kodiak Island Borough",150,"Southwest Region",11,2,163,0,167,0,3,0,0
"01/07/2022","N","Y","Kodiak Island Borough",150,"Southwest Region",11,2,165,0,167,0,3,0,0
"01/08/2022","N","Y","Kodiak Island Borough",150,"Southwest Region",11,0,165,2,169,0,3,0,0
"01/09/2022","N","Y","Kodiak Island Borough",150,"Southwest Region",11,1,166,0,169,0,3,0,0
"01/13/2022","N","Y","Kodiak Island Borough",150,"Southwest Region",11,2,168,0,169,0,3,0,0
"01/15/2022","N","Y","Kodiak Island Borough",150,"Southwest Region",11,0,168,1,170,0,3,0,0
"01/16/2022","N","Y","Kodiak Island Borough",150,"Southwest Region",11,1,169,0,170,0,3,0,0
"01/18/2022","N","Y","Kodiak Island Borough",150,"Southwest Region",11,1,170,1,171,0,3,0,0
"01/19/2022","N","Y","Kodiak Island Borough",150,"Southwest Region",11,0,170,1,172,0,3,0,0
"01/20/2022","N","Y","Kodiak Island Borough",150,"Southwest Region",11,1,171,1,173,0,3,0,0
"01/21/2022","N","Y","Kodiak Island Borough",150,"Southwest Region",11,2,173,0,173,0,3,0,0
"01/24/2022","N","Y","Kodiak Island Borough",150,"Southwest Region",11,0,173,1,174,0,3,0,0
"01/25/2022","N","Y","Kodiak Island Borough",150,"Southwest Region",11,0,173,1,175,0,3,0,0
"01/26/2022","N","Y","Kodiak Island Borough",150,"Southwest Region",11,1,174,1,176,0,3,0,0
"01/27/2022","N","Y","Kodiak Island Borough",150,"Southwest Region",11,1,175,0,176,0,3,0,0
"01/28/2022","N","Y","Kodiak Island Borough",150,"Southwest Region",11,1,176,0,176,0,3,0,0
"01/29/2022","N","Y","Kodiak Island Borough",150,"Southwest Region",11,0,176,1,177,0,3,0,0
"01/30/2022","N","Y","Kodiak Island Borough",150,"Southwest Region",11,0,176,2,179,0,3,0,0
"02/01/2022","N","Y","Kodiak Island Borough",150,"Southwest Region",11,0,176,1,180,0,3,0,0
"02/02/2022","N","Y","Kodiak Island Borough",150,"Southwest Region",11,0,176,1,181,0,3,0,0
"02/05/2022","N","Y","Kodiak Island Borough",150,"Southwest Region",11,3,179,0,181,0,3,0,0
"02/07/2022","N","Y","Kodiak Island Borough",150,"Southwest Region",11,2,181,0,181,0,3,0,0
"02/08/2022","N","Y","Kodiak Island Borough",150,"Southwest Region",11,0,181,1,182,0,3,0,0
"02/11/2022","N","Y","Kodiak Island Borough",150,"Southwest Region",11,1,182,0,182,0,3,0,0
"02/17/2022","N","Y","Kodiak Island Borough",150,"Southwest Region",11,0,182,2,184,0,3,0,0
"02/19/2022","N","Y","Kodiak Island Borough",150,"Southwest Region",11,2,184,0,184,0,3,0,0
"03/07/2022","N","Y","Kodiak Island Borough",150,"Southwest Region",11,0,184,2,186,0,3,0,0
"03/08/2022","N","Y","Kodiak Island Borough",150,"Southwest Region",11,1,185,0,186,0,3,0,0
"03/09/2022","N","Y","Kodiak Island Borough",150,"Southwest Region",11,0,185,1,187,0,3,0,0
"03/10/2022","N","Y","Kodiak Island Borough",150,"Southwest Region",11,2,187,0,187,0,3,0,0
"03/29/2022","N","Y","Kodiak Island Borough",150,"Southwest Region",11,0,187,1,188,0,3,0,0
"03/31/2022","N","Y","Kodiak Island Borough",150,"Southwest Region",11,1,188,0,188,0,3,0,0
"06/05/2020","N","Y","Matanuska-Susitna Borough",170,"Matanuska-Susitna Borough",5,0,0,1,1,0,0,0,0
"06/10/2020","N","Y","Matanuska-Susitna Borough",170,"Matanuska-Susitna Borough",5,1,1,0,1,0,0,0,0
"06/23/2020","N","Y","Matanuska-Susitna Borough",170,"Matanuska-Susitna Borough",5,1,2,1,2,0,0,0,0
"06/25/2020","N","Y","Matanuska-Susitna Borough",170,"Matanuska-Susitna Borough",5,0,2,1,3,0,0,0,0
"06/28/2020","N","Y","Matanuska-Susitna Borough",170,"Matanuska-Susitna Borough",5,1,3,0,3,0,0,0,0
"07/08/2020","N","Y","Matanuska-Susitna Borough",170,"Matanuska-Susitna Borough",5,0,3,1,4,0,0,0,0
"07/11/2020","N","Y","Matanuska-Susitna Borough",170,"Matanuska-Susitna Borough",5,0,3,1,5,0,0,0,0
"07/13/2020","N","Y","Matanuska-Susitna Borough",170,"Matanuska-Susitna Borough",5,1,4,1,6,0,0,0,0
"07/17/2020","N","Y","Matanuska-Susitna Borough",170,"Matanuska-Susitna Borough",5,0,4,1,7,0,0,0,0
"07/18/2020","N","Y","Matanuska-Susitna Borough",170,"Matanuska-Susitna Borough",5,0,4,1,8,0,0,0,0
"07/20/2020","N","Y","Matanuska-Susitna Borough",170,"Matanuska-Susitna Borough",5,1,5,0,8,0,0,0,0
"07/21/2020","N","Y","Matanuska-Susitna Borough",170,"Matanuska-Susitna Borough",5,1,6,3,11,0,0,0,0
"07/22/2020","N","Y","Matanuska-Susitna Borough",170,"Matanuska-Susitna Borough",5,0,6,1,12,0,0,0,0
"07/23/2020","N","Y","Matanuska-Susitna Borough",170,"Matanuska-Susitna Borough",5,0,6,1,13,0,0,0,0
"07/25/2020","N","Y","Matanuska-Susitna Borough",170,"Matanuska-Susitna Borough",5,0,6,1,14,0,0,0,0
"07/27/2020","N","Y","Matanuska-Susitna Borough",170,"Matanuska-Susitna Borough",5,4,10,0,14,0,0,0,0
"07/28/2020","N","Y","Matanuska-Susitna Borough",170,"Matanuska-Susitna Borough",5,2,12,0,14,0,0,0,0
"07/29/2020","N","Y","Matanuska-Susitna Borough",170,"Matanuska-Susitna Borough",5,1,13,0,14,0,0,0,0
"07/30/2020","N","Y","Matanuska-Susitna Borough",170,"Matanuska-Susitna Borough",5,1,14,0,14,0,0,0,0
"08/18/2020","N","Y","Matanuska-Susitna Borough",170,"Matanuska-Susitna Borough",5,0,14,1,15,0,0,0,0
"08/22/2020","N","Y","Matanuska-Susitna Borough",170,"Matanuska-Susitna Borough",5,1,15,0,15,0,0,0,0
"09/11/2020","N","Y","Matanuska-Susitna Borough",170,"Matanuska-Susitna Borough",5,1,16,1,16,0,0,0,0
"09/16/2020","N","Y","Matanuska-Susitna Borough",170,"Matanuska-Susitna Borough",5,0,16,1,17,0,0,0,0
"09/23/2020","N","Y","Matanuska-Susitna Borough",170,"Matanuska-Susitna Borough",5,1,17,0,17,0,0,0,0
"10/01/2020","N","Y","Matanuska-Susitna Borough",170,"Matanuska-Susitna Borough",5,0,17,1,18,0,0,0,0
"10/02/2020","N","Y","Matanuska-Susitna Borough",170,"Matanuska-Susitna Borough",5,0,17,3,21,0,0,0,0
"10/04/2020","N","Y","Matanuska-Susitna Borough",170,"Matanuska-Susitna Borough",5,1,18,0,21,0,0,0,0
"10/07/2020","N","Y","Matanuska-Susitna Borough",170,"Matanuska-Susitna Borough",5,3,21,0,21,0,0,0,0
"10/13/2020","N","Y","Matanuska-Susitna Borough",170,"Matanuska-Susitna Borough",5,0,21,1,22,0,0,0,0
"10/16/2020","N","Y","Matanuska-Susitna Borough",170,"Matanuska-Susitna Borough",5,1,22,0,22,0,0,0,0
"10/19/2020","N","Y","Matanuska-Susitna Borough",170,"Matanuska-Susitna Borough",5,0,22,2,24,0,0,0,0
"10/20/2020","N","Y","Matanuska-Susitna Borough",170,"Matanuska-Susitna Borough",5,0,22,1,25,0,0,0,0
"10/24/2020","N","Y","Matanuska-Susitna Borough",170,"Matanuska-Susitna Borough",5,0,22,3,28,0,0,0,0
"10/26/2020","N","Y","Matanuska-Susitna Borough",170,"Matanuska-Susitna Borough",5,2,24,0,28,0,0,0,0
"10/28/2020","N","Y","Matanuska-Susitna Borough",170,"Matanuska-Susitna Borough",5,1,25,0,28,0,0,0,0
"10/29/2020","N","Y","Matanuska-Susitna Borough",170,"Matanuska-Susitna Borough",5,3,28,2,30,0,0,0,0
"10/30/2020","N","Y","Matanuska-Susitna Borough",170,"Matanuska-Susitna Borough",5,0,28,1,31,0,0,0,0
"10/31/2020","N","Y","Matanuska-Susitna Borough",170,"Matanuska-Susitna Borough",5,1,29,0,31,0,0,0,0
"11/04/2020","N","Y","Matanuska-Susitna Borough",170,"Matanuska-Susitna Borough",5,1,30,0,31,0,0,0,0
"11/12/2020","N","Y","Matanuska-Susitna Borough",170,"Matanuska-Susitna Borough",5,0,30,1,32,0,0,0,0
"11/13/2020","N","Y","Matanuska-Susitna Borough",170,"Matanuska-Susitna Borough",5,0,30,1,33,0,0,0,0
"11/17/2020","N","Y","Matanuska-Susitna Borough",170,"Matanuska-Susitna Borough",5,0,30,1,34,0,0,0,0
"11/19/2020","N","Y","Matanuska-Susitna Borough",170,"Matanuska-Susitna Borough",5,0,30,4,38,0,0,0,0
"11/22/2020","N","Y","Matanuska-Susitna Borough",170,"Matanuska-Susitna Borough",5,0,30,2,40,0,0,0,0
"11/25/2020","N","Y","Matanuska-Susitna Borough",170,"Matanuska-Susitna Borough",5,0,30,1,41,0,0,0,0
"11/26/2020","N","Y","Matanuska-Susitna Borough",170,"Matanuska-Susitna Borough",5,2,32,0,41,0,0,0,0
"11/27/2020","N","Y","Matanuska-Susitna Borough",170,"Matanuska-Susitna Borough",5,1,33,1,42,0,0,0,0
"11/28/2020","N","Y","Matanuska-Susitna Borough",170,"Matanuska-Susitna Borough",5,3,36,0,42,0,0,0,0
"11/30/2020","N","Y","Matanuska-Susitna Borough",170,"Matanuska-Susitna Borough",5,2,38,0,42,0,0,0,0
"12/01/2020","N","Y","Matanuska-Susitna Borough",170,"Matanuska-Susitna Borough",5,2,40,0,42,0,0,0,0
"12/03/2020","N","Y","Matanuska-Susitna Borough",170,"Matanuska-Susitna Borough",5,1,41,0,42,0,0,0,0
"12/06/2020","N","Y","Matanuska-Susitna Borough",170,"Matanuska-Susitna Borough",5,1,42,0,42,0,0,0,0
"12/09/2020","N","Y","Matanuska-Susitna Borough",170,"Matanuska-Susitna Borough",5,0,42,1,43,0,0,0,0
"12/12/2020","N","Y","Matanuska-Susitna Borough",170,"Matanuska-Susitna Borough",5,1,43,1,44,0,0,0,0
"12/14/2020","N","Y","Matanuska-Susitna Borough",170,"Matanuska-Susitna Borough",5,0,43,1,45,0,0,0,0
"12/15/2020","N","Y","Matanuska-Susitna Borough",170,"Matanuska-Susitna Borough",5,1,44,0,45,0,0,0,0
"12/16/2020","N","Y","Matanuska-Susitna Borough",170,"Matanuska-Susitna Borough",5,1,45,0,45,0,0,0,0
"12/25/2020","N","Y","Matanuska-Susitna Borough",170,"Matanuska-Susitna Borough",5,1,46,1,46,0,0,0,0
"12/30/2020","N","Y","Matanuska-Susitna Borough",170,"Matanuska-Susitna Borough",5,0,46,2,48,0,0,0,0
"12/31/2020","N","Y","Matanuska-Susitna Borough",170,"Matanuska-Susitna Borough",5,2,48,0,48,0,0,0,0
"01/01/2021","N","Y","Matanuska-Susitna Borough",170,"Matanuska-Susitna Borough",5,0,48,1,49,0,0,0,0
"01/02/2021","N","Y","Matanuska-Susitna Borough",170,"Matanuska-Susitna Borough",5,1,49,0,49,0,0,0,0
"01/07/2021","N","Y","Matanuska-Susitna Borough",170,"Matanuska-Susitna Borough",5,0,49,1,50,0,0,0,0
"01/09/2021","N","Y","Matanuska-Susitna Borough",170,"Matanuska-Susitna Borough",5,1,50,0,50,0,0,0,0
"01/13/2021","N","Y","Matanuska-Susitna Borough",170,"Matanuska-Susitna Borough",5,0,50,2,52,0,0,0,0
"01/14/2021","N","Y","Matanuska-Susitna Borough",170,"Matanuska-Susitna Borough",5,1,51,2,54,0,0,0,0
"01/15/2021","N","Y","Matanuska-Susitna Borough",170,"Matanuska-Susitna Borough",5,2,53,0,54,0,0,0,0
"01/16/2021","N","Y","Matanuska-Susitna Borough",170,"Matanuska-Susitna Borough",5,1,54,0,54,0,0,0,0
"01/17/2021","N","Y","Matanuska-Susitna Borough",170,"Matanuska-Susitna Borough",5,0,54,1,55,0,0,0,0
"01/18/2021","N","Y","Matanuska-Susitna Borough",170,"Matanuska-Susitna Borough",5,0,54,1,56,0,0,0,0
"01/19/2021","N","Y","Matanuska-Susitna Borough",170,"Matanuska-Susitna Borough",5,1,55,0,56,0,0,0,0
"01/20/2021","N","Y","Matanuska-Susitna Borough",170,"Matanuska-Susitna Borough",5,0,55,1,57,0,0,0,0
"01/21/2021","N","Y","Matanuska-Susitna Borough",170,"Matanuska-Susitna Borough",5,2,57,1,58,0,0,0,0
"01/22/2021","N","Y","Matanuska-Susitna Borough",170,"Matanuska-Susitna Borough",5,1,58,0,58,0,0,0,0
"02/10/2021","N","Y","Matanuska-Susitna Borough",170,"Matanuska-Susitna Borough",5,0,58,1,59,0,0,0,0
"02/11/2021","N","Y","Matanuska-Susitna Borough",170,"Matanuska-Susitna Borough",5,1,59,0,59,0,0,0,0
"02/20/2021","N","Y","Matanuska-Susitna Borough",170,"Matanuska-Susitna Borough",5,0,59,1,60,0,0,0,0
"02/23/2021","N","Y","Matanuska-Susitna Borough",170,"Matanuska-Susitna Borough",5,0,59,1,61,0,0,0,0
"02/24/2021","N","Y","Matanuska-Susitna Borough",170,"Matanuska-Susitna Borough",5,1,60,1,62,0,0,0,0
"02/25/2021","N","Y","Matanuska-Susitna Borough",170,"Matanuska-Susitna Borough",5,1,61,1,63,0,0,0,0
"02/26/2021","N","Y","Matanuska-Susitna Borough",170,"Matanuska-Susitna Borough",5,1,62,1,64,0,0,0,0
"02/27/2021","N","Y","Matanuska-Susitna Borough",170,"Matanuska-Susitna Borough",5,2,64,0,64,0,0,0,0
"03/05/2021","N","Y","Matanuska-Susitna Borough",170,"Matanuska-Susitna Borough",5,2,66,2,66,0,0,0,0
"03/09/2021","N","Y","Matanuska-Susitna Borough",170,"Matanuska-Susitna Borough",5,0,66,1,67,0,0,0,0
"03/10/2021","N","Y","Matanuska-Susitna Borough",170,"Matanuska-Susitna Borough",5,1,67,0,67,0,0,0,0
"03/13/2021","N","Y","Matanuska-Susitna Borough",170,"Matanuska-Susitna Borough",5,0,67,1,68,0,0,0,0
"03/14/2021","N","Y","Matanuska-Susitna Borough",170,"Matanuska-Susitna Borough",5,1,68,0,68,0,0,0,0
"04/01/2021","N","Y","Matanuska-Susitna Borough",170,"Matanuska-Susitna Borough",5,0,68,2,70,0,0,0,0
"04/02/2021","N","Y","Matanuska-Susitna Borough",170,"Matanuska-Susitna Borough",5,2,70,0,70,0,0,0,0
"04/04/2021","N","Y","Matanuska-Susitna Borough",170,"Matanuska-Susitna Borough",5,0,70,1,71,0,0,0,0
"04/06/2021","N","Y","Matanuska-Susitna Borough",170,"Matanuska-Susitna Borough",5,0,70,1,72,0,0,0,0
"04/07/2021","N","Y","Matanuska-Susitna Borough",170,"Matanuska-Susitna Borough",5,1,71,2,74,0,0,0,0
"04/08/2021","N","Y","Matanuska-Susitna Borough",170,"Matanuska-Susitna Borough",5,3,74,0,74,0,0,0,0
"04/09/2021","N","Y","Matanuska-Susitna Borough",170,"Matanuska-Susitna Borough",5,1,75,1,75,0,0,0,0
"04/13/2021","N","Y","Matanuska-Susitna Borough",170,"Matanuska-Susitna Borough",5,0,75,2,77,0,0,0,0
"04/14/2021","N","Y","Matanuska-Susitna Borough",170,"Matanuska-Susitna Borough",5,2,77,1,78,0,0,0,0
"04/15/2021","N","Y","Matanuska-Susitna Borough",170,"Matanuska-Susitna Borough",5,0,77,1,79,0,0,0,0
"04/16/2021","N","Y","Matanuska-Susitna Borough",170,"Matanuska-Susitna Borough",5,2,79,0,79,0,0,0,0
"04/23/2021","N","Y","Matanuska-Susitna Borough",170,"Matanuska-Susitna Borough",5,0,79,1,80,0,0,0,0
"04/24/2021","N","Y","Matanuska-Susitna Borough",170,"Matanuska-Susitna Borough",5,1,80,0,80,0,0,0,0
"04/25/2021","N","Y","Matanuska-Susitna Borough",170,"Matanuska-Susitna Borough",5,0,80,1,81,0,0,0,0
"04/26/2021","N","Y","Matanuska-Susitna Borough",170,"Matanuska-Susitna Borough",5,1,81,1,82,0,0,0,0
"04/28/2021","N","Y","Matanuska-Susitna Borough",170,"Matanuska-Susitna Borough",5,1,82,0,82,0,0,0,0
"05/18/2021","N","Y","Matanuska-Susitna Borough",170,"Matanuska-Susitna Borough",5,1,83,1,83,0,0,0,0
"05/21/2021","N","Y","Matanuska-Susitna Borough",170,"Matanuska-Susitna Borough",5,0,83,1,84,0,0,0,0
"05/26/2021","N","Y","Matanuska-Susitna Borough",170,"Matanuska-Susitna Borough",5,1,84,0,84,0,0,0,0
"06/01/2021","N","Y","Matanuska-Susitna Borough",170,"Matanuska-Susitna Borough",5,0,84,1,85,0,0,0,0
"06/02/2021","N","Y","Matanuska-Susitna Borough",170,"Matanuska-Susitna Borough",5,1,85,0,85,0,0,0,0
"06/04/2021","N","Y","Matanuska-Susitna Borough",170,"Matanuska-Susitna Borough",5,0,85,1,86,0,0,0,0
"06/06/2021","N","Y","Matanuska-Susitna Borough",170,"Matanuska-Susitna Borough",5,0,85,1,87,0,0,0,0
"06/07/2021","N","Y","Matanuska-Susitna Borough",170,"Matanuska-Susitna Borough",5,1,86,0,87,0,0,0,0
"06/09/2021","N","Y","Matanuska-Susitna Borough",170,"Matanuska-Susitna Borough",5,1,87,0,87,0,0,0,0
"06/17/2021","N","Y","Matanuska-Susitna Borough",170,"Matanuska-Susitna Borough",5,0,87,1,88,0,0,0,0
"06/22/2021","N","Y","Matanuska-Susitna Borough",170,"Matanuska-Susitna Borough",5,1,88,0,88,0,0,0,0
"06/23/2021","N","Y","Matanuska-Susitna Borough",170,"Matanuska-Susitna Borough",5,0,88,0,88,1,1,0,0
"07/03/2021","N","Y","Matanuska-Susitna Borough",170,"Matanuska-Susitna Borough",5,0,88,1,89,0,1,0,0
"07/05/2021","N","Y","Matanuska-Susitna Borough",170,"Matanuska-Susitna Borough",5,0,88,4,93,0,1,0,0
"07/06/2021","N","Y","Matanuska-Susitna Borough",170,"Matanuska-Susitna Borough",5,4,92,1,94,0,1,0,0
"07/07/2021","N","Y","Matanuska-Susitna Borough",170,"Matanuska-Susitna Borough",5,3,95,2,96,0,1,0,0
"07/16/2021","N","Y","Matanuska-Susitna Borough",170,"Matanuska-Susitna Borough",5,1,96,2,98,0,1,0,0
"07/18/2021","N","Y","Matanuska-Susitna Borough",170,"Matanuska-Susitna Borough",5,0,96,3,101,0,1,0,0
"07/19/2021","N","Y","Matanuska-Susitna Borough",170,"Matanuska-Susitna Borough",5,5,101,1,102,1,2,0,0
"07/20/2021","N","Y","Matanuska-Susitna Borough",170,"Matanuska-Susitna Borough",5,1,102,1,103,0,2,0,0
"07/22/2021","N","Y","Matanuska-Susitna Borough",170,"Matanuska-Susitna Borough",5,0,102,1,104,0,2,0,0
"07/23/2021","N","Y","Matanuska-Susitna Borough",170,"Matanuska-Susitna Borough",5,1,103,0,104,0,2,0,0
"07/24/2021","N","Y","Matanuska-Susitna Borough",170,"Matanuska-Susitna Borough",5,0,103,4,108,0,2,0,0
"07/28/2021","N","Y","Matanuska-Susitna Borough",170,"Matanuska-Susitna Borough",5,5,108,1,109,0,2,0,0
"07/29/2021","N","Y","Matanuska-Susitna Borough",170,"Matanuska-Susitna Borough",5,0,108,2,111,0,2,0,0
"07/30/2021","N","Y","Matanuska-Susitna Borough",170,"Matanuska-Susitna Borough",5,1,109,0,111,0,2,0,0
"07/31/2021","N","Y","Matanuska-Susitna Borough",170,"Matanuska-Susitna Borough",5,2,111,1,112,0,2,0,0
"08/01/2021","N","Y","Matanuska-Susitna Borough",170,"Matanuska-Susitna Borough",5,0,111,1,113,0,2,0,0
"08/02/2021","N","Y","Matanuska-Susitna Borough",170,"Matanuska-Susitna Borough",5,0,111,4,117,0,2,0,0
"08/03/2021","N","Y","Matanuska-Susitna Borough",170,"Matanuska-Susitna Borough",5,2,113,3,120,0,2,0,0
"08/04/2021","N","Y","Matanuska-Susitna Borough",170,"Matanuska-Susitna Borough",5,0,113,2,122,0,2,0,0
"08/05/2021","N","Y","Matanuska-Susitna Borough",170,"Matanuska-Susitna Borough",5,4,117,2,124,0,2,0,0
"08/06/2021","N","Y","Matanuska-Susitna Borough",170,"Matanuska-Susitna Borough",5,4,121,2,126,0,2,0,0
"08/07/2021","N","Y","Matanuska-Susitna Borough",170,"Matanuska-Susitna Borough",5,1,122,2,128,0,2,0,0
"08/08/2021","N","Y","Matanuska-Susitna Borough",170,"Matanuska-Susitna Borough",5,1,123,0,128,0,2,0,0
"08/09/2021","N","Y","Matanuska-Susitna Borough",170,"Matanuska-Susitna Borough",5,0,123,2,130,0,2,0,0
"08/10/2021","N","Y","Matanuska-Susitna Borough",170,"Matanuska-Susitna Borough",5,1,124,1,131,0,2,0,0
"08/11/2021","N","Y","Matanuska-Susitna Borough",170,"Matanuska-Susitna Borough",5,1,125,1,132,0,2,0,0
"08/12/2021","N","Y","Matanuska-Susitna Borough",170,"Matanuska-Susitna Borough",5,1,126,3,135,0,2,0,0
"08/13/2021","N","Y","Matanuska-Susitna Borough",170,"Matanuska-Susitna Borough",5,1,127,2,137,1,3,0,0
"08/14/2021","N","Y","Matanuska-Susitna Borough",170,"Matanuska-Susitna Borough",5,1,128,1,138,0,3,0,0
"08/15/2021","N","Y","Matanuska-Susitna Borough",170,"Matanuska-Susitna Borough",5,0,128,2,140,0,3,0,0
"08/16/2021","N","Y","Matanuska-Susitna Borough",170,"Matanuska-Susitna Borough",5,3,131,0,140,0,3,0,0
"08/17/2021","N","Y","Matanuska-Susitna Borough",170,"Matanuska-Susitna Borough",5,4,135,1,141,0,3,0,0
"08/18/2021","N","Y","Matanuska-Susitna Borough",170,"Matanuska-Susitna Borough",5,1,136,2,143,0,3,0,0
"08/19/2021","N","Y","Matanuska-Susitna Borough",170,"Matanuska-Susitna Borough",5,0,136,3,146,0,3,0,0
"08/20/2021","N","Y","Matanuska-Susitna Borough",170,"Matanuska-Susitna Borough",5,2,138,2,148,1,4,0,0
"08/21/2021","N","Y","Matanuska-Susitna Borough",170,"Matanuska-Susitna Borough",5,0,138,3,151,0,4,0,0
"08/23/2021","N","Y","Matanuska-Susitna Borough",170,"Matanuska-Susitna Borough",5,2,140,5,156,1,5,0,0
"08/24/2021","N","Y","Matanuska-Susitna Borough",170,"Matanuska-Susitna Borough",5,3,143,2,158,0,5,0,0
"08/25/2021","N","Y","Matanuska-Susitna Borough",170,"Matanuska-Susitna Borough",5,3,146,1,159,0,5,0,0
"08/26/2021","N","Y","Matanuska-Susitna Borough",170,"Matanuska-Susitna Borough",5,2,148,0,159,1,6,0,0
"08/27/2021","N","Y","Matanuska-Susitna Borough",170,"Matanuska-Susitna Borough",5,3,151,3,162,0,6,0,0
"08/28/2021","N","Y","Matanuska-Susitna Borough",170,"Matanuska-Susitna Borough",5,0,151,1,163,0,6,0,0
"08/29/2021","N","Y","Matanuska-Susitna Borough",170,"Matanuska-Susitna Borough",5,2,153,1,164,0,6,0,0
"08/30/2021","N","Y","Matanuska-Susitna Borough",170,"Matanuska-Susitna Borough",5,2,155,0,164,0,6,0,0
"08/31/2021","N","Y","Matanuska-Susitna Borough",170,"Matanuska-Susitna Borough",5,3,158,3,167,0,6,1,1
"09/01/2021","N","Y","Matanuska-Susitna Borough",170,"Matanuska-Susitna Borough",5,0,158,9,176,0,6,0,1
"09/02/2021","N","Y","Matanuska-Susitna Borough",170,"Matanuska-Susitna Borough",5,1,159,2,178,0,6,0,1
"09/03/2021","N","Y","Matanuska-Susitna Borough",170,"Matanuska-Susitna Borough",5,1,160,3,181,1,7,1,2
"09/04/2021","N","Y","Matanuska-Susitna Borough",170,"Matanuska-Susitna Borough",5,4,164,3,184,0,7,0,2
"09/05/2021","N","Y","Matanuska-Susitna Borough",170,"Matanuska-Susitna Borough",5,0,164,1,185,0,7,0,2
"09/06/2021","N","Y","Matanuska-Susitna Borough",170,"Matanuska-Susitna Borough",5,0,164,5,190,0,7,0,2
"09/07/2021","N","Y","Matanuska-Susitna Borough",170,"Matanuska-Susitna Borough",5,3,167,3,193,0,7,0,2
"09/08/2021","N","Y","Matanuska-Susitna Borough",170,"Matanuska-Susitna Borough",5,1,168,0,193,0,7,1,3
"09/09/2021","N","Y","Matanuska-Susitna Borough",170,"Matanuska-Susitna Borough",5,2,170,6,199,0,7,0,3
"09/10/2021","N","Y","Matanuska-Susitna Borough",170,"Matanuska-Susitna Borough",5,5,175,7,206,0,7,0,3
"09/11/2021","N","Y","Matanuska-Susitna Borough",170,"Matanuska-Susitna Borough",5,6,181,5,211,0,7,0,3
"09/12/2021","N","Y","Matanuska-Susitna Borough",170,"Matanuska-Susitna Borough",5,0,181,1,212,0,7,0,3
"09/13/2021","N","Y","Matanuska-Susitna Borough",170,"Matanuska-Susitna Borough",5,3,184,4,216,0,7,0,3
"09/14/2021","N","Y","Matanuska-Susitna Borough",170,"Matanuska-Susitna Borough",5,3,187,4,220,0,7,0,3
"09/15/2021","N","Y","Matanuska-Susitna Borough",170,"Matanuska-Susitna Borough",5,1,188,1,221,0,7,0,3
"09/16/2021","N","Y","Matanuska-Susitna Borough",170,"Matanuska-Susitna Borough",5,1,189,4,225,0,7,0,3
"09/17/2021","N","Y","Matanuska-Susitna Borough",170,"Matanuska-Susitna Borough",5,0,189,0,225,0,7,1,4
"09/18/2021","N","Y","Matanuska-Susitna Borough",170,"Matanuska-Susitna Borough",5,0,189,3,228,0,7,0,4
"09/19/2021","N","Y","Matanuska-Susitna Borough",170,"Matanuska-Susitna Borough",5,2,191,1,229,0,7,0,4
"09/20/2021","N","Y","Matanuska-Susitna Borough",170,"Matanuska-Susitna Borough",5,1,192,5,234,0,7,0,4
"09/21/2021","N","Y","Matanuska-Susitna Borough",170,"Matanuska-Susitna Borough",5,4,196,2,236,0,7,0,4
"09/22/2021","N","Y","Matanuska-Susitna Borough",170,"Matanuska-Susitna Borough",5,2,198,1,237,0,7,0,4
"09/23/2021","N","Y","Matanuska-Susitna Borough",170,"Matanuska-Susitna Borough",5,19,217,6,243,0,7,0,4
"09/24/2021","N","Y","Matanuska-Susitna Borough",170,"Matanuska-Susitna Borough",5,4,221,0,243,0,7,0,4
"09/25/2021","N","Y","Matanuska-Susitna Borough",170,"Matanuska-Susitna Borough",5,8,229,3,246,0,7,0,4
"09/26/2021","N","Y","Matanuska-Susitna Borough",170,"Matanuska-Susitna Borough",5,10,239,2,248,0,7,0,4
"09/27/2021","N","Y","Matanuska-Susitna Borough",170,"Matanuska-Susitna Borough",5,0,239,3,251,0,7,0,4
"09/28/2021","N","Y","Matanuska-Susitna Borough",170,"Matanuska-Susitna Borough",5,2,241,2,253,0,7,0,4
"09/29/2021","N","Y","Matanuska-Susitna Borough",170,"Matanuska-Susitna Borough",5,4,245,1,254,0,7,0,4
"09/30/2021","N","Y","Matanuska-Susitna Borough",170,"Matanuska-Susitna Borough",5,4,249,5,259,0,7,0,4
"10/01/2021","N","Y","Matanuska-Susitna Borough",170,"Matanuska-Susitna Borough",5,4,253,5,264,0,7,0,4
"10/02/2021","N","Y","Matanuska-Susitna Borough",170,"Matanuska-Susitna Borough",5,2,255,4,268,0,7,0,4
"10/04/2021","N","Y","Matanuska-Susitna Borough",170,"Matanuska-Susitna Borough",5,9,264,4,272,0,7,0,4
"10/05/2021","N","Y","Matanuska-Susitna Borough",170,"Matanuska-Susitna Borough",5,0,264,2,274,0,7,0,4
"10/06/2021","N","Y","Matanuska-Susitna Borough",170,"Matanuska-Susitna Borough",5,2,266,1,275,0,7,0,4
"10/07/2021","N","Y","Matanuska-Susitna Borough",170,"Matanuska-Susitna Borough",5,1,267,1,276,0,7,0,4
"10/08/2021","N","Y","Matanuska-Susitna Borough",170,"Matanuska-Susitna Borough",5,0,267,1,277,0,7,0,4
"10/09/2021","N","Y","Matanuska-Susitna Borough",170,"Matanuska-Susitna Borough",5,6,273,2,279,0,7,0,4
"10/10/2021","N","Y","Matanuska-Susitna Borough",170,"Matanuska-Susitna Borough",5,5,278,1,280,0,7,0,4
"10/11/2021","N","Y","Matanuska-Susitna Borough",170,"Matanuska-Susitna Borough",5,1,279,4,284,0,7,0,4
"10/12/2021","N","Y","Matanuska-Susitna Borough",170,"Matanuska-Susitna Borough",5,1,280,1,285,0,7,0,4
"10/13/2021","N","Y","Matanuska-Susitna Borough",170,"Matanuska-Susitna Borough",5,3,283,4,289,0,7,0,4
"10/14/2021","N","Y","Matanuska-Susitna Borough",170,"Matanuska-Susitna Borough",5,0,283,5,294,0,7,0,4
"10/15/2021","N","Y","Matanuska-Susitna Borough",170,"Matanuska-Susitna Borough",5,2,285,6,300,0,7,0,4
"10/16/2021","N","Y","Matanuska-Susitna Borough",170,"Matanuska-Susitna Borough",5,9,294,1,301,0,7,0,4
"10/17/2021","N","Y","Matanuska-Susitna Borough",170,"Matanuska-Susitna Borough",5,4,298,1,302,0,7,0,4
"10/18/2021","N","Y","Matanuska-Susitna Borough",170,"Matanuska-Susitna Borough",5,2,300,0,302,0,7,0,4
"10/20/2021","N","Y","Matanuska-Susitna Borough",170,"Matanuska-Susitna Borough",5,0,300,1,303,1,8,0,4
"10/21/2021","N","Y","Matanuska-Susitna Borough",170,"Matanuska-Susitna Borough",5,1,301,1,304,0,8,0,4
"10/22/2021","N","Y","Matanuska-Susitna Borough",170,"Matanuska-Susitna Borough",5,1,302,1,305,0,8,0,4
"10/23/2021","N","Y","Matanuska-Susitna Borough",170,"Matanuska-Susitna Borough",5,1,303,2,307,0,8,0,4
"10/24/2021","N","Y","Matanuska-Susitna Borough",170,"Matanuska-Susitna Borough",5,3,306,0,307,0,8,0,4
"10/26/2021","N","Y","Matanuska-Susitna Borough",170,"Matanuska-Susitna Borough",5,0,306,2,309,0,8,0,4
"10/28/2021","N","Y","Matanuska-Susitna Borough",170,"Matanuska-Susitna Borough",5,3,309,2,311,0,8,0,4
"10/29/2021","N","Y","Matanuska-Susitna Borough",170,"Matanuska-Susitna Borough",5,0,309,2,313,0,8,0,4
"10/30/2021","N","Y","Matanuska-Susitna Borough",170,"Matanuska-Susitna Borough",5,1,310,0,313,0,8,0,4
"10/31/2021","N","Y","Matanuska-Susitna Borough",170,"Matanuska-Susitna Borough",5,2,312,2,315,0,8,0,4
"11/01/2021","N","Y","Matanuska-Susitna Borough",170,"Matanuska-Susitna Borough",5,1,313,2,317,0,8,0,4
"11/02/2021","N","Y","Matanuska-Susitna Borough",170,"Matanuska-Susitna Borough",5,2,315,0,317,0,8,0,4
"11/03/2021","N","Y","Matanuska-Susitna Borough",170,"Matanuska-Susitna Borough",5,1,316,0,317,0,8,0,4
"11/04/2021","N","Y","Matanuska-Susitna Borough",170,"Matanuska-Susitna Borough",5,1,317,1,318,0,8,0,4
"11/05/2021","N","Y","Matanuska-Susitna Borough",170,"Matanuska-Susitna Borough",5,0,317,1,319,0,8,0,4
"11/06/2021","N","Y","Matanuska-Susitna Borough",170,"Matanuska-Susitna Borough",5,1,318,0,319,0,8,1,5
"11/09/2021","N","Y","Matanuska-Susitna Borough",170,"Matanuska-Susitna Borough",5,0,318,1,320,0,8,0,5
"11/10/2021","N","Y","Matanuska-Susitna Borough",170,"Matanuska-Susitna Borough",5,0,318,1,321,0,8,0,5
"11/11/2021","N","Y","Matanuska-Susitna Borough",170,"Matanuska-Susitna Borough",5,2,320,2,323,0,8,0,5
"11/12/2021","N","Y","Matanuska-Susitna Borough",170,"Matanuska-Susitna Borough",5,2,322,2,325,0,8,0,5
"11/13/2021","N","Y","Matanuska-Susitna Borough",170,"Matanuska-Susitna Borough",5,2,324,0,325,0,8,0,5
"11/15/2021","N","Y","Matanuska-Susitna Borough",170,"Matanuska-Susitna Borough",5,2,326,4,329,0,8,0,5
"11/16/2021","N","Y","Matanuska-Susitna Borough",170,"Matanuska-Susitna Borough",5,3,329,1,330,0,8,0,5
"11/17/2021","N","Y","Matanuska-Susitna Borough",170,"Matanuska-Susitna Borough",5,1,330,0,330,0,8,0,5
"11/21/2021","N","Y","Matanuska-Susitna Borough",170,"Matanuska-Susitna Borough",5,0,330,1,331,0,8,0,5
"11/22/2021","N","Y","Matanuska-Susitna Borough",170,"Matanuska-Susitna Borough",5,1,331,0,331,0,8,0,5
"11/23/2021","N","Y","Matanuska-Susitna Borough",170,"Matanuska-Susitna Borough",5,0,331,1,332,0,8,0,5
"11/24/2021","N","Y","Matanuska-Susitna Borough",170,"Matanuska-Susitna Borough",5,0,331,2,334,0,8,0,5
"11/25/2021","N","Y","Matanuska-Susitna Borough",170,"Matanuska-Susitna Borough",5,0,331,1,335,0,8,0,5
"11/26/2021","N","Y","Matanuska-Susitna Borough",170,"Matanuska-Susitna Borough",5,4,335,5,340,0,8,0,5
"11/27/2021","N","Y","Matanuska-Susitna Borough",170,"Matanuska-Susitna Borough",5,4,339,2,342,0,8,0,5
"11/28/2021","N","Y","Matanuska-Susitna Borough",170,"Matanuska-Susitna Borough",5,1,340,0,342,0,8,0,5
"11/29/2021","N","Y","Matanuska-Susitna Borough",170,"Matanuska-Susitna Borough",5,2,342,1,343,0,8,0,5
"11/30/2021","N","Y","Matanuska-Susitna Borough",170,"Matanuska-Susitna Borough",5,1,343,0,343,0,8,0,5
"12/06/2021","N","Y","Matanuska-Susitna Borough",170,"Matanuska-Susitna Borough",5,0,343,3,346,0,8,0,5
"12/07/2021","N","Y","Matanuska-Susitna Borough",170,"Matanuska-Susitna Borough",5,3,346,0,346,0,8,0,5
"12/09/2021","N","Y","Matanuska-Susitna Borough",170,"Matanuska-Susitna Borough",5,0,346,2,348,0,8,0,5
"12/11/2021","N","Y","Matanuska-Susitna Borough",170,"Matanuska-Susitna Borough",5,2,348,0,348,0,8,0,5
"12/17/2021","N","Y","Matanuska-Susitna Borough",170,"Matanuska-Susitna Borough",5,0,348,1,349,0,8,0,5
"12/19/2021","N","Y","Matanuska-Susitna Borough",170,"Matanuska-Susitna Borough",5,1,349,0,349,0,8,0,5
"12/21/2021","N","Y","Matanuska-Susitna Borough",170,"Matanuska-Susitna Borough",5,0,349,2,351,0,8,0,5
"12/22/2021","N","Y","Matanuska-Susitna Borough",170,"Matanuska-Susitna Borough",5,1,350,6,357,0,8,0,5
"12/23/2021","N","Y","Matanuska-Susitna Borough",170,"Matanuska-Susitna Borough",5,5,355,2,359,0,8,0,5
"12/24/2021","N","Y","Matanuska-Susitna Borough",170,"Matanuska-Susitna Borough",5,0,355,3,362,0,8,0,5
"12/25/2021","N","Y","Matanuska-Susitna Borough",170,"Matanuska-Susitna Borough",5,1,356,0,362,0,8,0,5
"12/26/2021","N","Y","Matanuska-Susitna Borough",170,"Matanuska-Susitna Borough",5,0,356,3,365,0,8,0,5
"12/27/2021","N","Y","Matanuska-Susitna Borough",170,"Matanuska-Susitna Borough",5,6,362,5,370,0,8,0,5
"12/28/2021","N","Y","Matanuska-Susitna Borough",170,"Matanuska-Susitna Borough",5,5,367,5,375,0,8,0,5
"12/29/2021","N","Y","Matanuska-Susitna Borough",170,"Matanuska-Susitna Borough",5,5,372,2,377,0,8,0,5
"12/30/2021","N","Y","Matanuska-Susitna Borough",170,"Matanuska-Susitna Borough",5,4,376,6,383,0,8,0,5
"12/31/2021","N","Y","Matanuska-Susitna Borough",170,"Matanuska-Susitna Borough",5,0,376,4,387,0,8,0,5
"01/01/2022","N","Y","Matanuska-Susitna Borough",170,"Matanuska-Susitna Borough",5,7,383,0,387,0,8,0,5
"01/02/2022","N","Y","Matanuska-Susitna Borough",170,"Matanuska-Susitna Borough",5,1,384,2,389,0,8,0,5
"01/03/2022","N","Y","Matanuska-Susitna Borough",170,"Matanuska-Susitna Borough",5,3,387,1,390,0,8,0,5
"01/05/2022","N","Y","Matanuska-Susitna Borough",170,"Matanuska-Susitna Borough",5,0,387,1,391,0,8,0,5
"01/06/2022","N","Y","Matanuska-Susitna Borough",170,"Matanuska-Susitna Borough",5,3,390,1,392,0,8,0,5
"01/07/2022","N","Y","Matanuska-Susitna Borough",170,"Matanuska-Susitna Borough",5,0,390,2,394,0,8,0,5
"01/08/2022","N","Y","Matanuska-Susitna Borough",170,"Matanuska-Susitna Borough",5,0,390,2,396,0,8,0,5
"01/09/2022","N","Y","Matanuska-Susitna Borough",170,"Matanuska-Susitna Borough",5,1,391,1,397,0,8,0,5
"01/10/2022","N","Y","Matanuska-Susitna Borough",170,"Matanuska-Susitna Borough",5,4,395,3,400,0,8,0,5
"01/11/2022","N","Y","Matanuska-Susitna Borough",170,"Matanuska-Susitna Borough",5,2,397,2,402,0,8,0,5
"01/12/2022","N","Y","Matanuska-Susitna Borough",170,"Matanuska-Susitna Borough",5,2,399,2,404,0,8,0,5
"01/13/2022","N","Y","Matanuska-Susitna Borough",170,"Matanuska-Susitna Borough",5,1,400,2,406,0,8,0,5
"01/14/2022","N","Y","Matanuska-Susitna Borough",170,"Matanuska-Susitna Borough",5,4,404,2,408,0,8,0,5
"01/15/2022","N","Y","Matanuska-Susitna Borough",170,"Matanuska-Susitna Borough",5,2,406,4,412,0,8,0,5
"01/16/2022","N","Y","Matanuska-Susitna Borough",170,"Matanuska-Susitna Borough",5,2,408,0,412,0,8,0,5
"01/17/2022","N","Y","Matanuska-Susitna Borough",170,"Matanuska-Susitna Borough",5,3,411,3,415,0,8,0,5
"01/18/2022","N","Y","Matanuska-Susitna Borough",170,"Matanuska-Susitna Borough",5,0,411,4,419,0,8,0,5
"01/19/2022","N","Y","Matanuska-Susitna Borough",170,"Matanuska-Susitna Borough",5,5,416,3,422,0,8,0,5
"01/20/2022","N","Y","Matanuska-Susitna Borough",170,"Matanuska-Susitna Borough",5,2,418,1,423,0,8,0,5
"01/21/2022","N","Y","Matanuska-Susitna Borough",170,"Matanuska-Susitna Borough",5,1,419,14,437,0,8,0,5
"01/22/2022","N","Y","Matanuska-Susitna Borough",170,"Matanuska-Susitna Borough",5,2,421,2,439,0,8,0,5
"01/24/2022","N","Y","Matanuska-Susitna Borough",170,"Matanuska-Susitna Borough",5,6,427,0,439,0,8,0,5
"01/25/2022","N","Y","Matanuska-Susitna Borough",170,"Matanuska-Susitna Borough",5,6,433,2,441,0,8,0,5
"01/26/2022","N","Y","Matanuska-Susitna Borough",170,"Matanuska-Susitna Borough",5,6,439,1,442,0,8,0,5
"01/27/2022","N","Y","Matanuska-Susitna Borough",170,"Matanuska-Susitna Borough",5,1,440,4,446,0,8,0,5
"01/28/2022","N","Y","Matanuska-Susitna Borough",170,"Matanuska-Susitna Borough",5,2,442,1,447,0,8,0,5
"01/29/2022","N","Y","Matanuska-Susitna Borough",170,"Matanuska-Susitna Borough",5,2,444,0,447,0,8,0,5
"01/30/2022","N","Y","Matanuska-Susitna Borough",170,"Matanuska-Susitna Borough",5,0,444,2,449,0,8,0,5
"01/31/2022","N","Y","Matanuska-Susitna Borough",170,"Matanuska-Susitna Borough",5,3,447,0,449,0,8,0,5
"02/01/2022","N","Y","Matanuska-Susitna Borough",170,"Matanuska-Susitna Borough",5,1,448,1,450,0,8,0,5
"02/02/2022","N","Y","Matanuska-Susitna Borough",170,"Matanuska-Susitna Borough",5,1,449,2,452,0,8,0,5
"02/03/2022","N","Y","Matanuska-Susitna Borough",170,"Matanuska-Susitna Borough",5,2,451,1,453,0,8,0,5
"02/04/2022","N","Y","Matanuska-Susitna Borough",170,"Matanuska-Susitna Borough",5,2,453,1,454,0,8,0,5
"02/06/2022","N","Y","Matanuska-Susitna Borough",170,"Matanuska-Susitna Borough",5,0,453,1,455,0,8,0,5
"02/07/2022","N","Y","Matanuska-Susitna Borough",170,"Matanuska-Susitna Borough",5,2,455,1,456,0,8,0,5
"02/09/2022","N","Y","Matanuska-Susitna Borough",170,"Matanuska-Susitna Borough",5,1,456,0,456,0,8,0,5
"02/10/2022","N","Y","Matanuska-Susitna Borough",170,"Matanuska-Susitna Borough",5,0,456,1,457,0,8,0,5
"02/11/2022","N","Y","Matanuska-Susitna Borough",170,"Matanuska-Susitna Borough",5,2,458,1,458,0,8,0,5
"02/12/2022","N","Y","Matanuska-Susitna Borough",170,"Matanuska-Susitna Borough",5,0,458,1,459,0,8,0,5
"02/13/2022","N","Y","Matanuska-Susitna Borough",170,"Matanuska-Susitna Borough",5,1,459,0,459,0,8,0,5
"02/14/2022","N","Y","Matanuska-Susitna Borough",170,"Matanuska-Susitna Borough",5,0,459,2,461,0,8,0,5
"02/15/2022","N","Y","Matanuska-Susitna Borough",170,"Matanuska-Susitna Borough",5,1,460,1,462,0,8,0,5
"02/16/2022","N","Y","Matanuska-Susitna Borough",170,"Matanuska-Susitna Borough",5,1,461,0,462,0,8,0,5
"02/17/2022","N","Y","Matanuska-Susitna Borough",170,"Matanuska-Susitna Borough",5,1,462,1,463,0,8,0,5
"02/18/2022","N","Y","Matanuska-Susitna Borough",170,"Matanuska-Susitna Borough",5,0,462,3,466,0,8,0,5
"02/19/2022","N","Y","Matanuska-Susitna Borough",170,"Matanuska-Susitna Borough",5,0,462,1,467,0,8,0,5
"02/21/2022","N","Y","Matanuska-Susitna Borough",170,"Matanuska-Susitna Borough",5,5,467,0,467,0,8,0,5
"02/23/2022","N","Y","Matanuska-Susitna Borough",170,"Matanuska-Susitna Borough",5,0,467,1,468,0,8,0,5
"02/25/2022","N","Y","Matanuska-Susitna Borough",170,"Matanuska-Susitna Borough",5,1,468,0,468,0,8,0,5
"02/28/2022","N","Y","Matanuska-Susitna Borough",170,"Matanuska-Susitna Borough",5,0,468,1,469,0,8,0,5
"03/02/2022","N","Y","Matanuska-Susitna Borough",170,"Matanuska-Susitna Borough",5,1,469,0,469,0,8,0,5
"03/05/2022","N","Y","Matanuska-Susitna Borough",170,"Matanuska-Susitna Borough",5,0,469,3,472,0,8,0,5
"03/07/2022","N","Y","Matanuska-Susitna Borough",170,"Matanuska-Susitna Borough",5,3,472,1,473,0,8,0,5
"03/08/2022","N","Y","Matanuska-Susitna Borough",170,"Matanuska-Susitna Borough",5,1,473,0,473,0,8,0,5
"03/10/2022","N","Y","Matanuska-Susitna Borough",170,"Matanuska-Susitna Borough",5,0,473,1,474,0,8,0,5
"03/11/2022","N","Y","Matanuska-Susitna Borough",170,"Matanuska-Susitna Borough",5,0,473,1,475,0,8,0,5
"03/12/2022","N","Y","Matanuska-Susitna Borough",170,"Matanuska-Susitna Borough",5,1,474,0,475,0,8,0,5
"03/13/2022","N","Y","Matanuska-Susitna Borough",170,"Matanuska-Susitna Borough",5,1,475,1,476,0,8,0,5
"03/14/2022","N","Y","Matanuska-Susitna Borough",170,"Matanuska-Susitna Borough",5,1,476,0,476,0,8,0,5
"03/17/2022","N","Y","Matanuska-Susitna Borough",170,"Matanuska-Susitna Borough",5,0,476,1,477,0,8,0,5
"03/21/2022","N","Y","Matanuska-Susitna Borough",170,"Matanuska-Susitna Borough",5,1,477,0,477,0,8,0,5
"03/29/2022","N","Y","Matanuska-Susitna Borough",170,"Matanuska-Susitna Borough",5,0,477,1,478,0,8,0,5
"03/30/2022","N","Y","Matanuska-Susitna Borough",170,"Matanuska-Susitna Borough",5,1,478,0,478,0,8,0,5
"04/04/2022","N","Y","Matanuska-Susitna Borough",170,"Matanuska-Susitna Borough",5,0,478,1,479,0,8,0,5
"04/05/2022","N","Y","Matanuska-Susitna Borough",170,"Matanuska-Susitna Borough",5,1,479,0,479,0,8,0,5
"04/18/2022","N","Y","Matanuska-Susitna Borough",170,"Matanuska-Susitna Borough",5,0,479,1,480,0,8,0,5
"04/19/2022","N","Y","Matanuska-Susitna Borough",170,"Matanuska-Susitna Borough",5,1,480,0,480,0,8,0,5
"04/20/2022","N","Y","Matanuska-Susitna Borough",170,"Matanuska-Susitna Borough",5,2,482,2,482,0,8,0,5
"06/16/2020","N","Y","Nome Census Area",180,"Northwest Region",6,1,1,1,1,0,0,0,0
"06/25/2020","N","Y","Nome Census Area",180,"Northwest Region",6,1,2,1,2,0,0,0,0
"07/09/2020","N","Y","Nome Census Area",180,"Northwest Region",6,0,2,1,3,0,0,0,0
"07/10/2020","N","Y","Nome Census Area",180,"Northwest Region",6,1,3,0,3,0,0,0,0
"08/18/2020","N","Y","Nome Census Area",180,"Northwest Region",6,0,3,1,4,0,0,0,0
"08/24/2020","N","Y","Nome Census Area",180,"Northwest Region",6,1,4,0,4,0,0,0,0
"01/15/2021","N","Y","Nome Census Area",180,"Northwest Region",6,0,4,1,5,0,0,0,0
"01/16/2021","N","Y","Nome Census Area",180,"Northwest Region",6,0,4,1,6,0,0,0,0
"01/17/2021","N","Y","Nome Census Area",180,"Northwest Region",6,1,5,0,6,0,0,0,0
"01/18/2021","N","Y","Nome Census Area",180,"Northwest Region",6,1,6,0,6,0,0,0,0
"01/27/2021","N","Y","Nome Census Area",180,"Northwest Region",6,0,6,1,7,0,0,0,0
"01/29/2021","N","Y","Nome Census Area",180,"Northwest Region",6,1,7,0,7,0,0,0,0
"08/12/2021","N","Y","Nome Census Area",180,"Northwest Region",6,0,7,1,8,0,0,0,0
"08/13/2021","N","Y","Nome Census Area",180,"Northwest Region",6,1,8,0,8,0,0,0,0
"08/27/2021","N","Y","Nome Census Area",180,"Northwest Region",6,0,8,1,9,0,0,0,0
"08/30/2021","N","Y","Nome Census Area",180,"Northwest Region",6,0,8,1,10,0,0,0,0
"09/01/2021","N","Y","Nome Census Area",180,"Northwest Region",6,1,9,0,10,0,0,0,0
"09/02/2021","N","Y","Nome Census Area",180,"Northwest Region",6,1,10,0,10,0,0,0,0
"09/05/2021","N","Y","Nome Census Area",180,"Northwest Region",6,0,10,0,10,1,1,0,0
"09/08/2021","N","Y","Nome Census Area",180,"Northwest Region",6,0,10,1,11,0,1,0,0
"09/09/2021","N","Y","Nome Census Area",180,"Northwest Region",6,0,10,2,13,0,1,0,0
"09/10/2021","N","Y","Nome Census Area",180,"Northwest Region",6,1,11,0,13,0,1,0,0
"09/11/2021","N","Y","Nome Census Area",180,"Northwest Region",6,2,13,0,13,0,1,0,0
"09/13/2021","N","Y","Nome Census Area",180,"Northwest Region",6,0,13,1,14,0,1,0,0
"09/17/2021","N","Y","Nome Census Area",180,"Northwest Region",6,0,13,1,15,0,1,0,0
"09/18/2021","N","Y","Nome Census Area",180,"Northwest Region",6,1,14,0,15,0,1,0,0
"09/19/2021","N","Y","Nome Census Area",180,"Northwest Region",6,1,15,0,15,0,1,0,0
"09/27/2021","N","Y","Nome Census Area",180,"Northwest Region",6,0,15,1,16,0,1,0,0
"09/29/2021","N","Y","Nome Census Area",180,"Northwest Region",6,1,16,1,17,0,1,0,0
"10/01/2021","N","Y","Nome Census Area",180,"Northwest Region",6,1,17,0,17,0,1,0,0
"10/14/2021","N","Y","Nome Census Area",180,"Northwest Region",6,0,17,1,18,0,1,0,0
"10/15/2021","N","Y","Nome Census Area",180,"Northwest Region",6,1,18,0,18,0,1,0,0
"10/29/2021","N","Y","Nome Census Area",180,"Northwest Region",6,0,18,1,19,0,1,0,0
"10/31/2021","N","Y","Nome Census Area",180,"Northwest Region",6,1,19,0,19,0,1,0,0
"11/03/2021","N","Y","Nome Census Area",180,"Northwest Region",6,0,19,1,20,0,1,0,0
"11/04/2021","N","Y","Nome Census Area",180,"Northwest Region",6,1,20,0,20,0,1,0,0
"11/08/2021","N","Y","Nome Census Area",180,"Northwest Region",6,0,20,1,21,0,1,0,0
"11/09/2021","N","Y","Nome Census Area",180,"Northwest Region",6,1,21,0,21,0,1,0,0
"11/11/2021","N","Y","Nome Census Area",180,"Northwest Region",6,0,21,1,22,0,1,0,0
"11/21/2021","N","Y","Nome Census Area",180,"Northwest Region",6,1,22,0,22,0,1,0,0
"11/24/2021","N","Y","Nome Census Area",180,"Northwest Region",6,0,22,1,23,0,1,0,0
"11/26/2021","N","Y","Nome Census Area",180,"Northwest Region",6,1,23,0,23,0,1,0,0
"11/27/2021","N","Y","Nome Census Area",180,"Northwest Region",6,0,23,1,24,0,1,0,0
"11/29/2021","N","Y","Nome Census Area",180,"Northwest Region",6,1,24,0,24,0,1,0,0
"01/03/2022","N","Y","Nome Census Area",180,"Northwest Region",6,0,24,2,26,0,1,0,0
"01/04/2022","N","Y","Nome Census Area",180,"Northwest Region",6,2,26,0,26,0,1,0,0
"01/08/2022","N","Y","Nome Census Area",180,"Northwest Region",6,0,26,1,27,0,1,0,0
"01/09/2022","N","Y","Nome Census Area",180,"Northwest Region",6,1,27,1,28,0,1,0,0
"01/10/2022","N","Y","Nome Census Area",180,"Northwest Region",6,1,28,0,28,0,1,0,0
"01/12/2022","N","Y","Nome Census Area",180,"Northwest Region",6,0,28,1,29,0,1,0,0
"01/13/2022","N","Y","Nome Census Area",180,"Northwest Region",6,0,28,1,30,0,1,0,0
"01/14/2022","N","Y","Nome Census Area",180,"Northwest Region",6,2,30,0,30,0,1,0,0
"01/17/2022","N","Y","Nome Census Area",180,"Northwest Region",6,0,30,1,31,0,1,0,0
"01/18/2022","N","Y","Nome Census Area",180,"Northwest Region",6,1,31,0,31,0,1,0,0
"01/20/2022","N","Y","Nome Census Area",180,"Northwest Region",6,0,31,1,32,0,1,0,0
"01/21/2022","N","Y","Nome Census Area",180,"Northwest Region",6,1,32,0,32,0,1,0,0
"01/28/2022","N","Y","Nome Census Area",180,"Northwest Region",6,0,32,1,33,0,1,0,0
"01/30/2022","N","Y","Nome Census Area",180,"Northwest Region",6,1,33,0,33,0,1,0,0
"01/31/2022","N","Y","Nome Census Area",180,"Northwest Region",6,0,33,1,34,0,1,0,0
"02/02/2022","N","Y","Nome Census Area",180,"Northwest Region",6,1,34,0,34,0,1,0,0
"02/04/2022","N","Y","Nome Census Area",180,"Northwest Region",6,0,34,1,35,0,1,0,0
"02/05/2022","N","Y","Nome Census Area",180,"Northwest Region",6,0,34,1,36,0,1,0,0
"02/06/2022","N","Y","Nome Census Area",180,"Northwest Region",6,1,35,0,36,0,1,0,0
"02/07/2022","N","Y","Nome Census Area",180,"Northwest Region",6,1,36,0,36,0,1,0,0
"02/08/2022","N","Y","Nome Census Area",180,"Northwest Region",6,0,36,1,37,0,1,0,0
"02/09/2022","N","Y","Nome Census Area",180,"Northwest Region",6,1,37,2,39,0,1,0,0
"02/10/2022","N","Y","Nome Census Area",180,"Northwest Region",6,0,37,2,41,0,1,0,0
"02/11/2022","N","Y","Nome Census Area",180,"Northwest Region",6,2,39,0,41,0,1,0,0
"02/12/2022","N","Y","Nome Census Area",180,"Northwest Region",6,2,41,0,41,0,1,0,0
"02/13/2022","N","Y","Nome Census Area",180,"Northwest Region",6,0,41,1,42,0,1,0,0
"02/15/2022","N","Y","Nome Census Area",180,"Northwest Region",6,1,42,0,42,0,1,0,0
"02/25/2022","N","Y","Nome Census Area",180,"Northwest Region",6,0,42,1,43,0,1,0,0
"02/26/2022","N","Y","Nome Census Area",180,"Northwest Region",6,1,43,0,43,0,1,0,0
"02/27/2022","N","Y","Nome Census Area",180,"Northwest Region",6,0,43,1,44,0,1,0,0
"02/28/2022","N","Y","Nome Census Area",180,"Northwest Region",6,1,44,0,44,0,1,0,0
"03/04/2022","N","Y","Nome Census Area",180,"Northwest Region",6,0,44,1,45,0,1,0,0
"03/06/2022","N","Y","Nome Census Area",180,"Northwest Region",6,1,45,0,45,0,1,0,0
"03/09/2022","N","Y","Nome Census Area",180,"Northwest Region",6,0,45,1,46,0,1,0,0
"03/10/2022","N","Y","Nome Census Area",180,"Northwest Region",6,1,46,2,48,0,1,0,0
"03/11/2022","N","Y","Nome Census Area",180,"Northwest Region",6,2,48,0,48,0,1,0,0
"03/12/2022","N","Y","Nome Census Area",180,"Northwest Region",6,0,48,1,49,0,1,0,0
"03/13/2022","N","Y","Nome Census Area",180,"Northwest Region",6,1,49,0,49,0,1,0,0
"03/21/2022","N","Y","Nome Census Area",180,"Northwest Region",6,0,49,2,51,0,1,0,0
"03/22/2022","N","Y","Nome Census Area",180,"Northwest Region",6,2,51,2,53,0,1,0,0
"03/23/2022","N","Y","Nome Census Area",180,"Northwest Region",6,2,53,1,54,0,1,0,0
"03/24/2022","N","Y","Nome Census Area",180,"Northwest Region",6,1,54,0,54,0,1,0,0
"03/25/2022","N","Y","Nome Census Area",180,"Northwest Region",6,0,54,2,56,0,1,0,0
"03/26/2022","N","Y","Nome Census Area",180,"Northwest Region",6,2,56,0,56,0,1,0,0
"03/28/2022","N","Y","Nome Census Area",180,"Northwest Region",6,0,56,1,57,0,1,0,0
"03/30/2022","N","Y","Nome Census Area",180,"Northwest Region",6,1,57,0,57,0,1,0,0
"04/21/2022","N","Y","Nome Census Area",180,"Northwest Region",6,0,57,1,58,0,1,0,0
"04/22/2022","N","Y","Nome Census Area",180,"Northwest Region",6,1,58,0,58,0,1,0,0
"07/09/2020","N","Y","North Slope Borough",185,"Northwest Region",6,0,0,1,1,0,0,0,0
"07/11/2020","N","Y","North Slope Borough",185,"Northwest Region",6,1,1,0,1,0,0,0,0
"07/24/2020","N","Y","North Slope Borough",185,"Northwest Region",6,0,1,1,2,0,0,0,0
"07/27/2020","N","Y","North Slope Borough",185,"Northwest Region",6,1,2,1,3,0,0,0,0
"08/02/2020","N","Y","North Slope Borough",185,"Northwest Region",6,1,3,0,3,0,0,0,0
"08/05/2020","N","Y","North Slope Borough",185,"Northwest Region",6,0,3,1,4,0,0,0,0
"08/07/2020","N","Y","North Slope Borough",185,"Northwest Region",6,1,4,0,4,0,0,0,0
"08/10/2020","N","Y","North Slope Borough",185,"Northwest Region",6,0,4,2,6,0,0,0,0
"08/11/2020","N","Y","North Slope Borough",185,"Northwest Region",6,0,4,1,7,0,0,0,0
"08/13/2020","N","Y","North Slope Borough",185,"Northwest Region",6,3,7,0,7,0,0,0,0
"08/30/2020","N","Y","North Slope Borough",185,"Northwest Region",6,0,7,1,8,0,0,0,0
"09/03/2020","N","Y","North Slope Borough",185,"Northwest Region",6,0,7,1,9,0,0,0,0
"09/08/2020","N","Y","North Slope Borough",185,"Northwest Region",6,1,8,0,9,0,0,0,0
"09/14/2020","N","Y","North Slope Borough",185,"Northwest Region",6,0,8,1,10,0,0,0,0
"09/16/2020","N","Y","North Slope Borough",185,"Northwest Region",6,2,10,0,10,0,0,0,0
"09/22/2020","N","Y","North Slope Borough",185,"Northwest Region",6,0,10,1,11,0,0,0,0
"09/23/2020","N","Y","North Slope Borough",185,"Northwest Region",6,1,11,0,11,0,0,0,0
"10/13/2020","N","Y","North Slope Borough",185,"Northwest Region",6,1,12,2,13,0,0,0,0
"10/14/2020","N","Y","North Slope Borough",185,"Northwest Region",6,0,12,2,15,0,0,0,0
"10/15/2020","N","Y","North Slope Borough",185,"Northwest Region",6,1,13,0,15,0,0,0,0
"10/17/2020","N","Y","North Slope Borough",185,"Northwest Region",6,1,14,1,16,0,0,0,0
"10/21/2020","N","Y","North Slope Borough",185,"Northwest Region",6,0,14,1,17,0,0,0,0
"10/24/2020","N","Y","North Slope Borough",185,"Northwest Region",6,2,16,0,17,0,0,0,0
"10/26/2020","N","Y","North Slope Borough",185,"Northwest Region",6,1,17,0,17,0,0,0,0
"10/29/2020","N","Y","North Slope Borough",185,"Northwest Region",6,1,18,2,19,0,0,0,0
"10/31/2020","N","Y","North Slope Borough",185,"Northwest Region",6,0,18,1,20,0,0,0,0
"11/01/2020","N","Y","North Slope Borough",185,"Northwest Region",6,0,18,1,21,0,0,0,0
"11/02/2020","N","Y","North Slope Borough",185,"Northwest Region",6,0,18,1,22,0,0,0,0
"11/03/2020","N","Y","North Slope Borough",185,"Northwest Region",6,1,19,0,22,0,0,0,0
"11/04/2020","N","Y","North Slope Borough",185,"Northwest Region",6,1,20,0,22,0,0,0,0
"11/09/2020","N","Y","North Slope Borough",185,"Northwest Region",6,2,22,0,22,0,0,0,0
"11/11/2020","N","Y","North Slope Borough",185,"Northwest Region",6,0,22,1,23,0,0,0,0
"11/14/2020","N","Y","North Slope Borough",185,"Northwest Region",6,1,23,0,23,0,0,0,0
"11/15/2020","N","Y","North Slope Borough",185,"Northwest Region",6,0,23,1,24,0,0,0,0
"11/21/2020","N","Y","North Slope Borough",185,"Northwest Region",6,1,24,0,24,0,0,0,0
"11/27/2020","N","Y","North Slope Borough",185,"Northwest Region",6,0,24,1,25,0,0,0,0
"11/29/2020","N","Y","North Slope Borough",185,"Northwest Region",6,2,26,1,26,0,0,0,0
"11/30/2020","N","Y","North Slope Borough",185,"Northwest Region",6,0,26,1,27,0,0,0,0
"12/01/2020","N","Y","North Slope Borough",185,"Northwest Region",6,0,26,2,29,0,0,0,0
"12/02/2020","N","Y","North Slope Borough",185,"Northwest Region",6,2,28,0,29,0,0,0,0
"12/03/2020","N","Y","North Slope Borough",185,"Northwest Region",6,0,28,1,30,0,0,0,0
"12/04/2020","N","Y","North Slope Borough",185,"Northwest Region",6,2,30,0,30,0,0,0,0
"12/16/2020","N","Y","North Slope Borough",185,"Northwest Region",6,0,30,1,31,0,0,0,0
"12/17/2020","N","Y","North Slope Borough",185,"Northwest Region",6,1,31,1,32,0,0,0,0
"12/18/2020","N","Y","North Slope Borough",185,"Northwest Region",6,1,32,0,32,0,0,0,0
"12/28/2020","N","Y","North Slope Borough",185,"Northwest Region",6,0,32,1,33,0,0,0,0
"12/30/2020","N","Y","North Slope Borough",185,"Northwest Region",6,1,33,0,33,0,0,0,0
"01/17/2021","N","Y","North Slope Borough",185,"Northwest Region",6,0,33,1,34,0,0,0,0
"01/21/2021","N","Y","North Slope Borough",185,"Northwest Region",6,1,34,0,34,0,0,0,0
"01/28/2021","N","Y","North Slope Borough",185,"Northwest Region",6,0,34,1,35,0,0,0,0
"02/01/2021","N","Y","North Slope Borough",185,"Northwest Region",6,0,34,1,36,0,0,0,0
"02/02/2021","N","Y","North Slope Borough",185,"Northwest Region",6,1,35,1,37,0,0,0,0
"02/03/2021","N","Y","North Slope Borough",185,"Northwest Region",6,0,35,2,39,0,0,0,0
"02/04/2021","N","Y","North Slope Borough",185,"Northwest Region",6,0,35,1,40,0,0,0,0
"02/06/2021","N","Y","North Slope Borough",185,"Northwest Region",6,4,39,0,40,0,0,0,0
"02/07/2021","N","Y","North Slope Borough",185,"Northwest Region",6,0,39,2,42,0,0,0,0
"02/08/2021","N","Y","North Slope Borough",185,"Northwest Region",6,2,41,0,42,0,0,0,0
"02/11/2021","N","Y","North Slope Borough",185,"Northwest Region",6,0,41,4,46,0,0,0,0
"02/13/2021","N","Y","North Slope Borough",185,"Northwest Region",6,5,46,0,46,0,0,0,0
"02/18/2021","N","Y","North Slope Borough",185,"Northwest Region",6,0,46,1,47,0,0,0,0
"02/19/2021","N","Y","North Slope Borough",185,"Northwest Region",6,1,47,0,47,0,0,0,0
"02/24/2021","N","Y","North Slope Borough",185,"Northwest Region",6,0,47,2,49,0,0,0,0
"02/27/2021","N","Y","North Slope Borough",185,"Northwest Region",6,3,50,5,54,0,0,0,0
"02/28/2021","N","Y","North Slope Borough",185,"Northwest Region",6,2,52,0,54,0,0,0,0
"03/03/2021","N","Y","North Slope Borough",185,"Northwest Region",6,0,52,1,55,0,0,0,0
"03/04/2021","N","Y","North Slope Borough",185,"Northwest Region",6,2,54,0,55,0,0,0,0
"03/05/2021","N","Y","North Slope Borough",185,"Northwest Region",6,1,55,0,55,0,0,0,0
"03/13/2021","N","Y","North Slope Borough",185,"Northwest Region",6,0,55,1,56,0,0,0,0
"03/15/2021","N","Y","North Slope Borough",185,"Northwest Region",6,0,55,2,58,0,0,0,0
"03/16/2021","N","Y","North Slope Borough",185,"Northwest Region",6,3,58,0,58,0,0,0,0
"03/18/2021","N","Y","North Slope Borough",185,"Northwest Region",6,2,60,2,60,0,0,0,0
"03/19/2021","N","Y","North Slope Borough",185,"Northwest Region",6,0,60,4,64,0,0,0,0
"03/20/2021","N","Y","North Slope Borough",185,"Northwest Region",6,1,61,3,67,0,0,0,0
"03/21/2021","N","Y","North Slope Borough",185,"Northwest Region",6,0,61,1,68,0,0,0,0
"03/22/2021","N","Y","North Slope Borough",185,"Northwest Region",6,3,64,3,71,0,0,0,0
"03/24/2021","N","Y","North Slope Borough",185,"Northwest Region",6,0,64,0,71,1,1,0,0
"03/25/2021","N","Y","North Slope Borough",185,"Northwest Region",6,0,64,2,73,0,1,0,0
"03/26/2021","N","Y","North Slope Borough",185,"Northwest Region",6,2,66,0,73,0,1,0,0
"03/27/2021","N","Y","North Slope Borough",185,"Northwest Region",6,6,72,1,74,0,1,0,0
"04/01/2021","N","Y","North Slope Borough",185,"Northwest Region",6,1,73,0,74,0,1,0,0
"04/05/2021","N","Y","North Slope Borough",185,"Northwest Region",6,1,74,1,75,0,1,0,0
"04/11/2021","N","Y","North Slope Borough",185,"Northwest Region",6,1,75,1,76,0,1,0,0
"04/16/2021","N","Y","North Slope Borough",185,"Northwest Region",6,0,75,1,77,0,1,0,0
"04/19/2021","N","Y","North Slope Borough",185,"Northwest Region",6,1,76,0,77,0,1,0,0
"04/23/2021","N","Y","North Slope Borough",185,"Northwest Region",6,1,77,1,78,0,1,0,0
"04/28/2021","N","Y","North Slope Borough",185,"Northwest Region",6,0,77,1,79,0,1,0,0
"04/29/2021","N","Y","North Slope Borough",185,"Northwest Region",6,1,78,0,79,0,1,0,0
"04/30/2021","N","Y","North Slope Borough",185,"Northwest Region",6,2,80,2,81,0,1,0,0
"05/05/2021","N","Y","North Slope Borough",185,"Northwest Region",6,0,80,1,82,0,1,0,0
"05/07/2021","N","Y","North Slope Borough",185,"Northwest Region",6,1,81,1,83,0,1,0,0
"05/09/2021","N","Y","North Slope Borough",185,"Northwest Region",6,1,82,0,83,0,1,0,0
"05/10/2021","N","Y","North Slope Borough",185,"Northwest Region",6,1,83,0,83,0,1,0,0
"05/15/2021","N","Y","North Slope Borough",185,"Northwest Region",6,0,83,1,84,0,1,0,0
"05/16/2021","N","Y","North Slope Borough",185,"Northwest Region",6,1,84,0,84,0,1,0,0
"06/05/2021","N","Y","North Slope Borough",185,"Northwest Region",6,0,84,1,85,0,1,0,0
"06/06/2021","N","Y","North Slope Borough",185,"Northwest Region",6,1,85,0,85,0,1,0,0
"06/28/2021","N","Y","North Slope Borough",185,"Northwest Region",6,0,85,1,86,0,1,0,0
"06/30/2021","N","Y","North Slope Borough",185,"Northwest Region",6,0,85,1,87,0,1,0,0
"07/06/2021","N","Y","North Slope Borough",185,"Northwest Region",6,1,86,0,87,0,1,0,0
"07/27/2021","N","Y","North Slope Borough",185,"Northwest Region",6,0,86,1,88,0,1,0,0
"07/28/2021","N","Y","North Slope Borough",185,"Northwest Region",6,1,87,1,89,0,1,0,0
"07/29/2021","N","Y","North Slope Borough",185,"Northwest Region",6,1,88,1,90,0,1,0,0
"07/30/2021","N","Y","North Slope Borough",185,"Northwest Region",6,1,89,0,90,0,1,0,0
"08/02/2021","N","Y","North Slope Borough",185,"Northwest Region",6,0,89,1,91,0,1,0,0
"08/03/2021","N","Y","North Slope Borough",185,"Northwest Region",6,0,89,1,92,0,1,0,0
"08/04/2021","N","Y","North Slope Borough",185,"Northwest Region",6,0,89,2,94,0,1,0,0
"08/05/2021","N","Y","North Slope Borough",185,"Northwest Region",6,2,91,1,95,0,1,0,0
"08/06/2021","N","Y","North Slope Borough",185,"Northwest Region",6,2,93,2,97,0,1,0,0
"08/07/2021","N","Y","North Slope Borough",185,"Northwest Region",6,1,94,2,99,0,1,0,0
"08/09/2021","N","Y","North Slope Borough",185,"Northwest Region",6,2,96,1,100,0,1,0,0
"08/10/2021","N","Y","North Slope Borough",185,"Northwest Region",6,1,97,1,101,0,1,0,0
"08/11/2021","N","Y","North Slope Borough",185,"Northwest Region",6,0,97,1,102,0,1,0,0
"08/12/2021","N","Y","North Slope Borough",185,"Northwest Region",6,0,97,1,103,0,1,0,0
"08/13/2021","N","Y","North Slope Borough",185,"Northwest Region",6,1,98,2,105,0,1,0,0
"08/14/2021","N","Y","North Slope Borough",185,"Northwest Region",6,3,101,1,106,0,1,0,0
"08/15/2021","N","Y","North Slope Borough",185,"Northwest Region",6,2,103,0,106,0,1,0,0
"08/16/2021","N","Y","North Slope Borough",185,"Northwest Region",6,0,103,3,109,0,1,0,0
"08/17/2021","N","Y","North Slope Borough",185,"Northwest Region",6,0,103,3,112,0,1,0,0
"08/18/2021","N","Y","North Slope Borough",185,"Northwest Region",6,4,107,1,113,0,1,0,0
"08/19/2021","N","Y","North Slope Borough",185,"Northwest Region",6,2,109,0,113,0,1,0,0
"08/20/2021","N","Y","North Slope Borough",185,"Northwest Region",6,0,109,3,116,0,1,0,0
"08/21/2021","N","Y","North Slope Borough",185,"Northwest Region",6,1,110,0,116,0,1,0,0
"08/22/2021","N","Y","North Slope Borough",185,"Northwest Region",6,2,112,1,117,0,1,0,0
"08/23/2021","N","Y","North Slope Borough",185,"Northwest Region",6,0,112,2,119,0,1,0,0
"08/24/2021","N","Y","North Slope Borough",185,"Northwest Region",6,1,113,2,121,1,2,0,0
"08/25/2021","N","Y","North Slope Borough",185,"Northwest Region",6,5,118,0,121,0,2,0,0
"08/26/2021","N","Y","North Slope Borough",185,"Northwest Region",6,1,119,1,122,0,2,0,0
"08/27/2021","N","Y","North Slope Borough",185,"Northwest Region",6,1,120,0,122,0,2,0,0
"08/31/2021","N","Y","North Slope Borough",185,"Northwest Region",6,1,121,1,123,0,2,0,0
"09/02/2021","N","Y","North Slope Borough",185,"Northwest Region",6,0,121,3,126,0,2,0,0
"09/03/2021","N","Y","North Slope Borough",185,"Northwest Region",6,0,121,3,129,1,3,0,0
"09/04/2021","N","Y","North Slope Borough",185,"Northwest Region",6,0,121,1,130,1,4,0,0
"09/05/2021","N","Y","North Slope Borough",185,"Northwest Region",6,0,121,2,132,0,4,0,0
"09/06/2021","N","Y","North Slope Borough",185,"Northwest Region",6,0,121,5,137,0,4,0,0
"09/07/2021","N","Y","North Slope Borough",185,"Northwest Region",6,1,122,1,138,0,4,0,0
"09/08/2021","N","Y","North Slope Borough",185,"Northwest Region",6,4,126,3,141,0,4,0,0
"09/09/2021","N","Y","North Slope Borough",185,"Northwest Region",6,1,127,0,141,0,4,0,0
"09/10/2021","N","Y","North Slope Borough",185,"Northwest Region",6,1,128,1,142,0,4,1,1
"09/11/2021","N","Y","North Slope Borough",185,"Northwest Region",6,1,129,1,143,0,4,0,1
"09/12/2021","N","Y","North Slope Borough",185,"Northwest Region",6,0,129,1,144,0,4,0,1
"09/13/2021","N","Y","North Slope Borough",185,"Northwest Region",6,1,130,4,148,0,4,0,1
"09/14/2021","N","Y","North Slope Borough",185,"Northwest Region",6,2,132,11,159,0,4,0,1
"09/15/2021","N","Y","North Slope Borough",185,"Northwest Region",6,6,138,0,159,0,4,0,1
"09/16/2021","N","Y","North Slope Borough",185,"Northwest Region",6,1,139,2,161,0,4,0,1
"09/17/2021","N","Y","North Slope Borough",185,"Northwest Region",6,0,139,3,164,0,4,0,1
"09/18/2021","N","Y","North Slope Borough",185,"Northwest Region",6,0,139,5,169,0,4,0,1
"09/19/2021","N","Y","North Slope Borough",185,"Northwest Region",6,1,140,1,170,0,4,0,1
"09/20/2021","N","Y","North Slope Borough",185,"Northwest Region",6,1,141,2,172,0,4,0,1
"09/21/2021","N","Y","North Slope Borough",185,"Northwest Region",6,1,142,3,175,0,4,0,1
"09/22/2021","N","Y","North Slope Borough",185,"Northwest Region",6,4,146,6,181,0,4,0,1
"09/23/2021","N","Y","North Slope Borough",185,"Northwest Region",6,3,149,3,184,0,4,0,1
"09/24/2021","N","Y","North Slope Borough",185,"Northwest Region",6,6,155,3,187,0,4,0,1
"09/25/2021","N","Y","North Slope Borough",185,"Northwest Region",6,15,170,8,195,0,4,0,1
"09/26/2021","N","Y","North Slope Borough",185,"Northwest Region",6,13,183,4,199,0,4,0,1
"09/27/2021","N","Y","North Slope Borough",185,"Northwest Region",6,4,187,0,199,0,4,0,1
"09/28/2021","N","Y","North Slope Borough",185,"Northwest Region",6,2,189,0,199,0,4,0,1
"09/29/2021","N","Y","North Slope Borough",185,"Northwest Region",6,2,191,7,206,0,4,0,1
"09/30/2021","N","Y","North Slope Borough",185,"Northwest Region",6,4,195,1,207,0,4,0,1
"10/01/2021","N","Y","North Slope Borough",185,"Northwest Region",6,7,202,2,209,0,4,0,1
"10/02/2021","N","Y","North Slope Borough",185,"Northwest Region",6,5,207,0,209,0,4,0,1
"10/03/2021","N","Y","North Slope Borough",185,"Northwest Region",6,1,208,1,210,0,4,0,1
"10/05/2021","N","Y","North Slope Borough",185,"Northwest Region",6,1,209,3,213,0,4,0,1
"10/06/2021","N","Y","North Slope Borough",185,"Northwest Region",6,1,210,0,213,0,4,0,1
"10/08/2021","N","Y","North Slope Borough",185,"Northwest Region",6,4,214,4,217,0,4,0,1
"10/09/2021","N","Y","North Slope Borough",185,"Northwest Region",6,1,215,0,217,0,4,1,2
"10/10/2021","N","Y","North Slope Borough",185,"Northwest Region",6,1,216,1,218,0,4,0,2
"10/11/2021","N","Y","North Slope Borough",185,"Northwest Region",6,1,217,1,219,0,4,0,2
"10/12/2021","N","Y","North Slope Borough",185,"Northwest Region",6,1,218,3,222,0,4,0,2
"10/13/2021","N","Y","North Slope Borough",185,"Northwest Region",6,2,220,1,223,0,4,0,2
"10/14/2021","N","Y","North Slope Borough",185,"Northwest Region",6,0,220,2,225,0,4,0,2
"10/15/2021","N","Y","North Slope Borough",185,"Northwest Region",6,1,221,1,226,0,4,0,2
"10/16/2021","N","Y","North Slope Borough",185,"Northwest Region",6,1,222,0,226,0,4,0,2
"10/17/2021","N","Y","North Slope Borough",185,"Northwest Region",6,1,223,0,226,0,4,0,2
"10/18/2021","N","Y","North Slope Borough",185,"Northwest Region",6,0,223,2,228,0,4,0,2
"10/19/2021","N","Y","North Slope Borough",185,"Northwest Region",6,1,224,1,229,0,4,0,2
"10/20/2021","N","Y","North Slope Borough",185,"Northwest Region",6,2,226,1,230,0,4,0,2
"10/22/2021","N","Y","North Slope Borough",185,"Northwest Region",6,0,226,3,233,0,4,0,2
"10/23/2021","N","Y","North Slope Borough",185,"Northwest Region",6,5,231,1,234,0,4,0,2
"10/24/2021","N","Y","North Slope Borough",185,"Northwest Region",6,1,232,0,234,0,4,0,2
"10/25/2021","N","Y","North Slope Borough",185,"Northwest Region",6,2,234,0,234,0,4,0,2
"10/26/2021","N","Y","North Slope Borough",185,"Northwest Region",6,1,235,1,235,0,4,0,2
"10/29/2021","N","Y","North Slope Borough",185,"Northwest Region",6,0,235,1,236,0,4,0,2
"10/30/2021","N","Y","North Slope Borough",185,"Northwest Region",6,0,235,1,237,0,4,0,2
"10/31/2021","N","Y","North Slope Borough",185,"Northwest Region",6,2,237,0,237,0,4,0,2
"11/03/2021","N","Y","North Slope Borough",185,"Northwest Region",6,0,237,1,238,0,4,0,2
"11/04/2021","N","Y","North Slope Borough",185,"Northwest Region",6,1,238,1,239,0,4,0,2
"11/06/2021","N","Y","North Slope Borough",185,"Northwest Region",6,1,239,0,239,0,4,0,2
"11/15/2021","N","Y","North Slope Borough",185,"Northwest Region",6,0,239,1,240,0,4,0,2
"11/18/2021","N","Y","North Slope Borough",185,"Northwest Region",6,0,239,2,242,0,4,0,2
"11/19/2021","N","Y","North Slope Borough",185,"Northwest Region",6,1,240,1,243,0,4,0,2
"11/20/2021","N","Y","North Slope Borough",185,"Northwest Region",6,1,241,0,243,0,4,0,2
"11/22/2021","N","Y","North Slope Borough",185,"Northwest Region",6,1,242,1,244,0,4,0,2
"11/23/2021","N","Y","North Slope Borough",185,"Northwest Region",6,2,244,0,244,0,4,0,2
"12/09/2021","N","Y","North Slope Borough",185,"Northwest Region",6,0,244,1,245,0,4,0,2
"12/10/2021","N","Y","North Slope Borough",185,"Northwest Region",6,1,245,0,245,0,4,0,2
"12/11/2021","N","Y","North Slope Borough",185,"Northwest Region",6,0,245,1,246,0,4,0,2
"12/12/2021","N","Y","North Slope Borough",185,"Northwest Region",6,1,246,0,246,0,4,0,2
"12/24/2021","N","Y","North Slope Borough",185,"Northwest Region",6,0,246,1,247,0,4,0,2
"12/25/2021","N","Y","North Slope Borough",185,"Northwest Region",6,0,246,1,248,0,4,0,2
"12/27/2021","N","Y","North Slope Borough",185,"Northwest Region",6,2,248,0,248,0,4,0,2
"12/28/2021","N","Y","North Slope Borough",185,"Northwest Region",6,0,248,1,249,0,4,0,2
"12/29/2021","N","Y","North Slope Borough",185,"Northwest Region",6,1,249,0,249,0,4,0,2
"01/02/2022","N","Y","North Slope Borough",185,"Northwest Region",6,0,249,5,254,0,4,0,2
"01/03/2022","N","Y","North Slope Borough",185,"Northwest Region",6,5,254,3,257,0,4,0,2
"01/04/2022","N","Y","North Slope Borough",185,"Northwest Region",6,3,257,4,261,0,4,0,2
"01/05/2022","N","Y","North Slope Borough",185,"Northwest Region",6,3,260,5,266,0,4,0,2
"01/06/2022","N","Y","North Slope Borough",185,"Northwest Region",6,5,265,0,266,0,4,0,2
"01/07/2022","N","Y","North Slope Borough",185,"Northwest Region",6,2,267,4,270,0,4,0,2
"01/08/2022","N","Y","North Slope Borough",185,"Northwest Region",6,4,271,4,274,0,4,0,2
"01/09/2022","N","Y","North Slope Borough",185,"Northwest Region",6,1,272,10,284,0,4,0,2
"01/10/2022","N","Y","North Slope Borough",185,"Northwest Region",6,10,282,7,291,0,4,0,2
"01/11/2022","N","Y","North Slope Borough",185,"Northwest Region",6,1,283,6,297,0,4,0,2
"01/12/2022","N","Y","North Slope Borough",185,"Northwest Region",6,8,291,7,304,0,4,0,2
"01/13/2022","N","Y","North Slope Borough",185,"Northwest Region",6,8,299,5,309,0,4,0,2
"01/14/2022","N","Y","North Slope Borough",185,"Northwest Region",6,3,302,3,312,0,4,0,2
"01/15/2022","N","Y","North Slope Borough",185,"Northwest Region",6,1,303,1,313,0,4,0,2
"01/16/2022","N","Y","North Slope Borough",185,"Northwest Region",6,1,304,4,317,0,4,0,2
"01/17/2022","N","Y","North Slope Borough",185,"Northwest Region",6,4,308,2,319,0,4,0,2
"01/18/2022","N","Y","North Slope Borough",185,"Northwest Region",6,7,315,5,324,0,4,0,2
"01/19/2022","N","Y","North Slope Borough",185,"Northwest Region",6,5,320,8,332,0,4,0,2
"01/20/2022","N","Y","North Slope Borough",185,"Northwest Region",6,6,326,1,333,0,4,0,2
"01/21/2022","N","Y","North Slope Borough",185,"Northwest Region",6,5,331,3,336,0,4,0,2
"01/22/2022","N","Y","North Slope Borough",185,"Northwest Region",6,0,331,1,337,0,4,0,2
"01/23/2022","N","Y","North Slope Borough",185,"Northwest Region",6,2,333,4,341,0,4,0,2
"01/24/2022","N","Y","North Slope Borough",185,"Northwest Region",6,4,337,1,342,0,4,0,2
"01/25/2022","N","Y","North Slope Borough",185,"Northwest Region",6,2,339,1,343,0,4,0,2
"01/26/2022","N","Y","North Slope Borough",185,"Northwest Region",6,1,340,3,346,0,4,0,2
"01/27/2022","N","Y","North Slope Borough",185,"Northwest Region",6,1,341,1,347,0,4,0,2
"01/28/2022","N","Y","North Slope Borough",185,"Northwest Region",6,5,346,2,349,0,4,0,2
"01/29/2022","N","Y","North Slope Borough",185,"Northwest Region",6,0,346,2,351,0,4,0,2
"01/30/2022","N","Y","North Slope Borough",185,"Northwest Region",6,1,347,2,353,0,4,0,2
"01/31/2022","N","Y","North Slope Borough",185,"Northwest Region",6,4,351,2,355,0,4,0,2
"02/01/2022","N","Y","North Slope Borough",185,"Northwest Region",6,1,352,2,357,0,4,0,2
"02/02/2022","N","Y","North Slope Borough",185,"Northwest Region",6,3,355,0,357,0,4,0,2
"02/03/2022","N","Y","North Slope Borough",185,"Northwest Region",6,0,355,1,358,0,4,0,2
"02/04/2022","N","Y","North Slope Borough",185,"Northwest Region",6,1,356,3,361,0,4,0,2
"02/05/2022","N","Y","North Slope Borough",185,"Northwest Region",6,1,357,1,362,0,4,0,2
"02/06/2022","N","Y","North Slope Borough",185,"Northwest Region",6,2,359,1,363,0,4,0,2
"02/07/2022","N","Y","North Slope Borough",185,"Northwest Region",6,2,361,0,363,0,4,0,2
"02/09/2022","N","Y","North Slope Borough",185,"Northwest Region",6,0,361,2,365,0,4,0,2
"02/10/2022","N","Y","North Slope Borough",185,"Northwest Region",6,0,361,6,371,0,4,0,2
"02/11/2022","N","Y","North Slope Borough",185,"Northwest Region",6,1,362,0,371,0,4,0,2
"02/13/2022","N","Y","North Slope Borough",185,"Northwest Region",6,3,365,0,371,0,4,0,2
"02/14/2022","N","Y","North Slope Borough",185,"Northwest Region",6,2,367,1,372,0,4,0,2
"02/15/2022","N","Y","North Slope Borough",185,"Northwest Region",6,1,368,0,372,0,4,0,2
"02/16/2022","N","Y","North Slope Borough",185,"Northwest Region",6,0,368,1,373,0,4,0,2
"02/17/2022","N","Y","North Slope Borough",185,"Northwest Region",6,5,373,1,374,0,4,0,2
"02/18/2022","N","Y","North Slope Borough",185,"Northwest Region",6,1,374,0,374,0,4,0,2
"02/19/2022","N","Y","North Slope Borough",185,"Northwest Region",6,0,374,1,375,0,4,0,2
"02/20/2022","N","Y","North Slope Borough",185,"Northwest Region",6,0,374,1,376,0,4,0,2
"02/21/2022","N","Y","North Slope Borough",185,"Northwest Region",6,1,375,0,376,0,4,0,2
"02/22/2022","N","Y","North Slope Borough",185,"Northwest Region",6,1,376,0,376,0,4,0,2
"03/09/2022","N","Y","North Slope Borough",185,"Northwest Region",6,0,376,1,377,0,4,0,2
"03/11/2022","N","Y","North Slope Borough",185,"Northwest Region",6,1,377,0,377,0,4,0,2
"03/31/2022","N","Y","North Slope Borough",185,"Northwest Region",6,0,377,1,378,0,4,0,2
"04/02/2022","N","Y","North Slope Borough",185,"Northwest Region",6,1,378,1,379,0,4,0,2
"04/04/2022","N","Y","North Slope Borough",185,"Northwest Region",6,1,379,0,379,0,4,0,2
"04/08/2022","N","Y","North Slope Borough",185,"Northwest Region",6,0,379,1,380,0,4,0,2
"04/09/2022","N","Y","North Slope Borough",185,"Northwest Region",6,0,379,1,381,0,4,0,2
"04/10/2022","N","Y","North Slope Borough",185,"Northwest Region",6,1,380,1,382,0,4,0,2
"04/11/2022","N","Y","North Slope Borough",185,"Northwest Region",6,1,381,0,382,0,4,0,2
"04/12/2022","N","Y","North Slope Borough",185,"Northwest Region",6,1,382,0,382,0,4,0,2
"04/15/2022","N","Y","North Slope Borough",185,"Northwest Region",6,0,382,1,383,0,4,0,2
"04/19/2022","N","Y","North Slope Borough",185,"Northwest Region",6,1,383,0,383,0,4,0,2
"04/21/2022","N","Y","North Slope Borough",185,"Northwest Region",6,0,383,1,384,0,4,0,2
"04/22/2022","N","Y","North Slope Borough",185,"Northwest Region",6,1,384,0,384,0,4,0,2
"04/23/2022","N","Y","North Slope Borough",185,"Northwest Region",6,0,384,1,385,0,4,0,2
"04/25/2022","N","Y","North Slope Borough",185,"Northwest Region",6,1,385,0,385,0,4,0,2
"09/12/2020","N","Y","Northwest Arctic Borough",188,"Northwest Region",6,0,0,1,1,0,0,0,0
"09/14/2020","N","Y","Northwest Arctic Borough",188,"Northwest Region",6,0,0,1,2,0,0,0,0
"09/15/2020","N","Y","Northwest Arctic Borough",188,"Northwest Region",6,1,1,0,2,0,0,0,0
"09/16/2020","N","Y","Northwest Arctic Borough",188,"Northwest Region",6,1,2,0,2,0,0,0,0
"09/22/2020","N","Y","Northwest Arctic Borough",188,"Northwest Region",6,0,2,1,3,0,0,0,0
"09/23/2020","N","Y","Northwest Arctic Borough",188,"Northwest Region",6,0,2,2,5,0,0,0,0
"09/25/2020","N","Y","Northwest Arctic Borough",188,"Northwest Region",6,0,2,6,11,0,0,0,0
"09/27/2020","N","Y","Northwest Arctic Borough",188,"Northwest Region",6,1,3,0,11,0,0,0,0
"09/30/2020","N","Y","Northwest Arctic Borough",188,"Northwest Region",6,8,11,0,11,0,0,0,0
"11/03/2020","N","Y","Northwest Arctic Borough",188,"Northwest Region",6,0,11,1,12,0,0,0,0
"11/06/2020","N","Y","Northwest Arctic Borough",188,"Northwest Region",6,0,11,2,14,0,0,0,0
"11/09/2020","N","Y","Northwest Arctic Borough",188,"Northwest Region",6,2,13,0,14,0,0,0,0
"11/12/2020","N","Y","Northwest Arctic Borough",188,"Northwest Region",6,1,14,0,14,0,0,0,0
"11/13/2020","N","Y","Northwest Arctic Borough",188,"Northwest Region",6,0,14,1,15,0,0,0,0
"11/15/2020","N","Y","Northwest Arctic Borough",188,"Northwest Region",6,0,14,1,16,0,0,0,0
"11/19/2020","N","Y","Northwest Arctic Borough",188,"Northwest Region",6,1,15,0,16,0,0,0,0
"11/23/2020","N","Y","Northwest Arctic Borough",188,"Northwest Region",6,1,16,1,17,0,0,0,0
"11/24/2020","N","Y","Northwest Arctic Borough",188,"Northwest Region",6,1,17,1,18,0,0,0,0
"12/03/2020","N","Y","Northwest Arctic Borough",188,"Northwest Region",6,1,18,0,18,0,0,0,0
"12/21/2020","N","Y","Northwest Arctic Borough",188,"Northwest Region",6,0,18,4,22,0,0,0,0
"12/24/2020","N","Y","Northwest Arctic Borough",188,"Northwest Region",6,4,22,1,23,0,0,0,0
"12/28/2020","N","Y","Northwest Arctic Borough",188,"Northwest Region",6,0,22,1,24,0,0,0,0
"12/31/2020","N","Y","Northwest Arctic Borough",188,"Northwest Region",6,2,24,0,24,0,0,0,0
"01/04/2021","N","Y","Northwest Arctic Borough",188,"Northwest Region",6,0,24,1,25,0,0,0,0
"01/06/2021","N","Y","Northwest Arctic Borough",188,"Northwest Region",6,1,25,0,25,0,0,0,0
"01/12/2021","N","Y","Northwest Arctic Borough",188,"Northwest Region",6,0,25,1,26,0,0,0,0
"01/15/2021","N","Y","Northwest Arctic Borough",188,"Northwest Region",6,1,26,0,26,0,0,0,0
"03/06/2021","N","Y","Northwest Arctic Borough",188,"Northwest Region",6,0,26,1,27,0,0,0,0
"03/08/2021","N","Y","Northwest Arctic Borough",188,"Northwest Region",6,1,27,0,27,0,0,0,0
"04/10/2021","N","Y","Northwest Arctic Borough",188,"Northwest Region",6,0,27,1,28,0,0,0,0
"04/23/2021","N","Y","Northwest Arctic Borough",188,"Northwest Region",6,1,28,0,28,0,0,0,0
"07/15/2021","N","Y","Northwest Arctic Borough",188,"Northwest Region",6,0,28,1,29,0,0,0,0
"07/17/2021","N","Y","Northwest Arctic Borough",188,"Northwest Region",6,0,28,1,30,0,0,0,0
"07/21/2021","N","Y","Northwest Arctic Borough",188,"Northwest Region",6,2,30,0,30,0,0,0,0
"07/31/2021","N","Y","Northwest Arctic Borough",188,"Northwest Region",6,0,30,1,31,0,0,0,0
"08/02/2021","N","Y","Northwest Arctic Borough",188,"Northwest Region",6,1,31,0,31,0,0,0,0
"08/23/2021","N","Y","Northwest Arctic Borough",188,"Northwest Region",6,0,31,1,32,0,0,0,0
"08/28/2021","N","Y","Northwest Arctic Borough",188,"Northwest Region",6,1,32,0,32,0,0,0,0
"09/24/2021","N","Y","Northwest Arctic Borough",188,"Northwest Region",6,0,32,1,33,0,0,0,0
"09/26/2021","N","Y","Northwest Arctic Borough",188,"Northwest Region",6,1,33,0,33,0,0,0,0
"10/01/2021","N","Y","Northwest Arctic Borough",188,"Northwest Region",6,0,33,1,34,0,0,0,0
"10/02/2021","N","Y","Northwest Arctic Borough",188,"Northwest Region",6,0,33,1,35,0,0,0,0
"10/03/2021","N","Y","Northwest Arctic Borough",188,"Northwest Region",6,0,33,1,36,0,0,0,0
"10/05/2021","N","Y","Northwest Arctic Borough",188,"Northwest Region",6,2,35,0,36,0,0,0,0
"10/06/2021","N","Y","Northwest Arctic Borough",188,"Northwest Region",6,1,36,0,36,0,0,0,0
"10/07/2021","N","Y","Northwest Arctic Borough",188,"Northwest Region",6,0,36,6,42,0,0,0,0
"10/08/2021","N","Y","Northwest Arctic Borough",188,"Northwest Region",6,0,36,1,43,0,0,0,0
"10/12/2021","N","Y","Northwest Arctic Borough",188,"Northwest Region",6,7,43,0,43,0,0,0,0
"10/25/2021","N","Y","Northwest Arctic Borough",188,"Northwest Region",6,0,43,2,45,0,0,0,0
"10/27/2021","N","Y","Northwest Arctic Borough",188,"Northwest Region",6,2,45,0,45,0,0,0,0
"12/09/2021","N","Y","Northwest Arctic Borough",188,"Northwest Region",6,0,45,1,46,0,0,0,0
"12/11/2021","N","Y","Northwest Arctic Borough",188,"Northwest Region",6,1,46,0,46,0,0,0,0
"12/16/2021","N","Y","Northwest Arctic Borough",188,"Northwest Region",6,0,46,1,47,0,0,0,0
"12/17/2021","N","Y","Northwest Arctic Borough",188,"Northwest Region",6,1,47,0,47,0,0,0,0
"12/19/2021","N","Y","Northwest Arctic Borough",188,"Northwest Region",6,0,47,1,48,0,0,0,0
"12/20/2021","N","Y","Northwest Arctic Borough",188,"Northwest Region",6,1,48,1,49,0,0,0,0
"12/21/2021","N","Y","Northwest Arctic Borough",188,"Northwest Region",6,1,49,0,49,0,0,0,0
"12/22/2021","N","Y","Northwest Arctic Borough",188,"Northwest Region",6,0,49,1,50,0,0,0,0
"12/23/2021","N","Y","Northwest Arctic Borough",188,"Northwest Region",6,0,49,1,51,0,0,0,0
"12/24/2021","N","Y","Northwest Arctic Borough",188,"Northwest Region",6,1,50,1,52,0,0,0,0
"12/26/2021","N","Y","Northwest Arctic Borough",188,"Northwest Region",6,1,51,0,52,0,0,0,0
"12/27/2021","N","Y","Northwest Arctic Borough",188,"Northwest Region",6,1,52,1,53,0,0,0,0
"12/28/2021","N","Y","Northwest Arctic Borough",188,"Northwest Region",6,0,52,1,54,0,0,0,0
"12/29/2021","N","Y","Northwest Arctic Borough",188,"Northwest Region",6,1,53,0,54,0,0,0,0
"12/30/2021","N","Y","Northwest Arctic Borough",188,"Northwest Region",6,1,54,0,54,0,0,0,0
"01/01/2022","N","Y","Northwest Arctic Borough",188,"Northwest Region",6,0,54,3,57,0,0,0,0
"01/05/2022","N","Y","Northwest Arctic Borough",188,"Northwest Region",6,0,54,1,58,0,0,0,0
"01/06/2022","N","Y","Northwest Arctic Borough",188,"Northwest Region",6,3,57,0,58,0,0,0,0
"01/07/2022","N","Y","Northwest Arctic Borough",188,"Northwest Region",6,1,58,0,58,0,0,0,0
"01/13/2022","N","Y","Northwest Arctic Borough",188,"Northwest Region",6,0,58,2,60,0,0,0,0
"01/14/2022","N","Y","Northwest Arctic Borough",188,"Northwest Region",6,0,58,1,61,0,0,0,0
"01/15/2022","N","Y","Northwest Arctic Borough",188,"Northwest Region",6,0,58,1,62,0,0,0,0
"01/16/2022","N","Y","Northwest Arctic Borough",188,"Northwest Region",6,1,59,1,63,0,0,0,0
"01/19/2022","N","Y","Northwest Arctic Borough",188,"Northwest Region",6,0,59,1,64,0,0,0,0
"01/20/2022","N","Y","Northwest Arctic Borough",188,"Northwest Region",6,1,60,1,65,0,0,0,0
"01/21/2022","N","Y","Northwest Arctic Borough",188,"Northwest Region",6,1,61,1,66,0,0,0,0
"01/22/2022","N","Y","Northwest Arctic Borough",188,"Northwest Region",6,3,64,0,66,0,0,0,0
"01/23/2022","N","Y","Northwest Arctic Borough",188,"Northwest Region",6,2,66,1,67,0,0,0,0
"01/24/2022","N","Y","Northwest Arctic Borough",188,"Northwest Region",6,0,66,3,70,0,0,0,0
"01/25/2022","N","Y","Northwest Arctic Borough",188,"Northwest Region",6,1,67,1,71,0,0,0,0
"01/26/2022","N","Y","Northwest Arctic Borough",188,"Northwest Region",6,3,70,0,71,0,0,0,0
"01/27/2022","N","Y","Northwest Arctic Borough",188,"Northwest Region",6,1,71,0,71,0,0,0,0
"02/03/2022","N","Y","Northwest Arctic Borough",188,"Northwest Region",6,0,71,2,73,0,0,0,0
"02/04/2022","N","Y","Northwest Arctic Borough",188,"Northwest Region",6,0,71,1,74,0,0,0,0
"02/05/2022","N","Y","Northwest Arctic Borough",188,"Northwest Region",6,2,73,1,75,0,0,0,0
"02/06/2022","N","Y","Northwest Arctic Borough",188,"Northwest Region",6,1,74,0,75,0,0,0,0
"02/07/2022","N","Y","Northwest Arctic Borough",188,"Northwest Region",6,1,75,0,75,0,0,0,0
"02/10/2022","N","Y","Northwest Arctic Borough",188,"Northwest Region",6,0,75,1,76,0,0,0,0
"02/11/2022","N","Y","Northwest Arctic Borough",188,"Northwest Region",6,0,75,1,77,0,0,0,0
"02/12/2022","N","Y","Northwest Arctic Borough",188,"Northwest Region",6,1,76,0,77,0,0,0,0
"02/13/2022","N","Y","Northwest Arctic Borough",188,"Northwest Region",6,1,77,0,77,0,0,0,0
"02/16/2022","N","Y","Northwest Arctic Borough",188,"Northwest Region",6,0,77,1,78,0,0,0,0
"02/18/2022","N","Y","Northwest Arctic Borough",188,"Northwest Region",6,1,78,0,78,0,0,0,0
"02/22/2022","N","Y","Northwest Arctic Borough",188,"Northwest Region",6,0,78,1,79,0,0,0,0
"02/24/2022","N","Y","Northwest Arctic Borough",188,"Northwest Region",6,1,79,0,79,0,0,0,0
"03/02/2022","N","Y","Northwest Arctic Borough",188,"Northwest Region",6,0,79,1,80,0,0,0,0
"03/03/2022","N","Y","Northwest Arctic Borough",188,"Northwest Region",6,0,79,1,81,0,0,0,0
"03/04/2022","N","Y","Northwest Arctic Borough",188,"Northwest Region",6,1,80,0,81,0,0,0,0
"03/05/2022","N","Y","Northwest Arctic Borough",188,"Northwest Region",6,1,81,0,81,0,0,0,0
"03/24/2022","N","Y","Northwest Arctic Borough",188,"Northwest Region",6,0,81,1,82,0,0,0,0
"03/26/2022","N","Y","Northwest Arctic Borough",188,"Northwest Region",6,1,82,0,82,0,0,0,0
"04/08/2022","N","Y","Northwest Arctic Borough",188,"Northwest Region",6,0,82,1,83,0,0,0,0
"04/10/2022","N","Y","Northwest Arctic Borough",188,"Northwest Region",6,1,83,0,83,0,0,0,0
"04/15/2022","N","Y","Northwest Arctic Borough",188,"Northwest Region",6,0,83,1,84,0,0,0,0
"04/17/2022","N","Y","Northwest Arctic Borough",188,"Northwest Region",6,1,84,0,84,0,0,0,0
"04/23/2022","N","Y","Northwest Arctic Borough",188,"Northwest Region",6,0,84,1,85,0,0,0,0
"04/25/2022","N","Y","Northwest Arctic Borough",188,"Northwest Region",6,1,85,0,85,0,0,0,0
"06/16/2020","N","Y","Petersburg Borough",195,"Other Southeast Region - Northern",8,0,0,1,1,0,0,0,0
"06/18/2020","N","Y","Petersburg Borough",195,"Other Southeast Region - Northern",8,1,1,0,1,0,0,0,0
"06/29/2020","N","Y","Petersburg Borough",195,"Other Southeast Region - Northern",8,0,1,1,2,0,0,0,0
"07/01/2020","N","Y","Petersburg Borough",195,"Other Southeast Region - Northern",8,1,2,0,2,0,0,0,0
"07/02/2020","N","Y","Petersburg Borough",195,"Other Southeast Region - Northern",8,0,2,1,3,0,0,0,0
"07/04/2020","N","Y","Petersburg Borough",195,"Other Southeast Region - Northern",8,1,3,0,3,0,0,0,0
"07/13/2020","N","Y","Petersburg Borough",195,"Other Southeast Region - Northern",8,1,4,1,4,0,0,0,0
"08/10/2020","N","Y","Petersburg Borough",195,"Other Southeast Region - Northern",8,0,4,1,5,0,0,0,0
"08/17/2020","N","Y","Petersburg Borough",195,"Other Southeast Region - Northern",8,1,5,0,5,0,0,0,0
"01/24/2021","N","Y","Petersburg Borough",195,"Other Southeast Region - Northern",8,0,5,1,6,0,0,0,0
"02/02/2021","N","Y","Petersburg Borough",195,"Other Southeast Region - Northern",8,1,6,0,6,0,0,0,0
"05/22/2021","N","Y","Petersburg Borough",195,"Other Southeast Region - Northern",8,0,6,1,7,0,0,0,0
"05/28/2021","N","Y","Petersburg Borough",195,"Other Southeast Region - Northern",8,1,7,0,7,0,0,0,0
"07/04/2021","N","Y","Petersburg Borough",195,"Other Southeast Region - Northern",8,0,7,1,8,0,0,0,0
"07/07/2021","N","Y","Petersburg Borough",195,"Other Southeast Region - Northern",8,1,8,0,8,0,0,0,0
"07/08/2021","N","Y","Petersburg Borough",195,"Other Southeast Region - Northern",8,0,8,1,9,0,0,0,0
"07/09/2021","N","Y","Petersburg Borough",195,"Other Southeast Region - Northern",8,1,9,1,10,0,0,0,0
"07/10/2021","N","Y","Petersburg Borough",195,"Other Southeast Region - Northern",8,1,10,1,11,0,0,0,0
"07/11/2021","N","Y","Petersburg Borough",195,"Other Southeast Region - Northern",8,1,11,0,11,0,0,0,0
"07/12/2021","N","Y","Petersburg Borough",195,"Other Southeast Region - Northern",8,0,11,1,12,0,0,0,0
"07/13/2021","N","Y","Petersburg Borough",195,"Other Southeast Region - Northern",8,1,12,0,12,0,0,0,0
"08/08/2021","N","Y","Petersburg Borough",195,"Other Southeast Region - Northern",8,0,12,8,20,0,0,0,0
"08/09/2021","N","Y","Petersburg Borough",195,"Other Southeast Region - Northern",8,5,17,0,20,0,0,0,0
"08/10/2021","N","Y","Petersburg Borough",195,"Other Southeast Region - Northern",8,1,18,0,20,0,0,0,0
"08/11/2021","N","Y","Petersburg Borough",195,"Other Southeast Region - Northern",8,2,20,0,20,0,0,0,0
"08/15/2021","N","Y","Petersburg Borough",195,"Other Southeast Region - Northern",8,0,20,1,21,0,0,0,0
"08/16/2021","N","Y","Petersburg Borough",195,"Other Southeast Region - Northern",8,0,20,2,23,0,0,0,0
"08/17/2021","N","Y","Petersburg Borough",195,"Other Southeast Region - Northern",8,1,21,0,23,0,0,0,0
"08/19/2021","N","Y","Petersburg Borough",195,"Other Southeast Region - Northern",8,2,23,2,25,0,0,0,0
"08/23/2021","N","Y","Petersburg Borough",195,"Other Southeast Region - Northern",8,1,24,0,25,0,0,0,0
"08/24/2021","N","Y","Petersburg Borough",195,"Other Southeast Region - Northern",8,1,25,0,25,0,0,0,0
"08/26/2021","N","Y","Petersburg Borough",195,"Other Southeast Region - Northern",8,0,25,2,27,0,0,0,0
"09/01/2021","N","Y","Petersburg Borough",195,"Other Southeast Region - Northern",8,2,27,0,27,0,0,0,0
"09/07/2021","N","Y","Petersburg Borough",195,"Other Southeast Region - Northern",8,0,27,1,28,0,0,0,0
"09/13/2021","N","Y","Petersburg Borough",195,"Other Southeast Region - Northern",8,1,28,0,28,0,0,0,0
"09/15/2021","N","Y","Petersburg Borough",195,"Other Southeast Region - Northern",8,0,28,1,29,0,0,0,0
"09/25/2021","N","Y","Petersburg Borough",195,"Other Southeast Region - Northern",8,1,29,0,29,0,0,0,0
"10/02/2021","N","Y","Petersburg Borough",195,"Other Southeast Region - Northern",8,0,29,1,30,0,0,0,0
"10/05/2021","N","Y","Petersburg Borough",195,"Other Southeast Region - Northern",8,1,30,0,30,0,0,0,0
"12/05/2021","N","Y","Petersburg Borough",195,"Other Southeast Region - Northern",8,0,30,1,31,0,0,0,0
"12/06/2021","N","Y","Petersburg Borough",195,"Other Southeast Region - Northern",8,1,31,0,31,0,0,0,0
"01/11/2022","N","Y","Petersburg Borough",195,"Other Southeast Region - Northern",8,0,31,2,33,0,0,0,0
"01/15/2022","N","Y","Petersburg Borough",195,"Other Southeast Region - Northern",8,2,33,0,33,0,0,0,0
"01/23/2022","N","Y","Petersburg Borough",195,"Other Southeast Region - Northern",8,0,33,1,34,0,0,0,0
"01/27/2022","N","Y","Petersburg Borough",195,"Other Southeast Region - Northern",8,1,34,0,34,0,0,0,0
"04/25/2022","N","Y","Petersburg Borough",195,"Other Southeast Region - Northern",8,0,34,1,35,0,0,0,0
"04/26/2022","N","Y","Petersburg Borough",195,"Other Southeast Region - Northern",8,1,35,0,35,0,0,0,0
"06/12/2020","N","Y","Prince of Wales-Hyder Census Area",198,"Other Southeast Region - Southern",9,0,0,1,1,0,0,0,0
"06/20/2020","N","Y","Prince of Wales-Hyder Census Area",198,"Other Southeast Region - Southern",9,1,1,0,1,0,0,0,0
"12/05/2020","N","Y","Prince of Wales-Hyder Census Area",198,"Other Southeast Region - Southern",9,0,1,1,2,0,0,0,0
"12/09/2020","N","Y","Prince of Wales-Hyder Census Area",198,"Other Southeast Region - Southern",9,1,2,0,2,0,0,0,0
"07/12/2021","N","Y","Prince of Wales-Hyder Census Area",198,"Other Southeast Region - Southern",9,1,3,1,3,0,0,0,0
"07/20/2021","N","Y","Prince of Wales-Hyder Census Area",198,"Other Southeast Region - Southern",9,1,4,1,4,0,0,0,0
"07/25/2021","N","Y","Prince of Wales-Hyder Census Area",198,"Other Southeast Region - Southern",9,0,4,1,5,0,0,0,0
"07/27/2021","N","Y","Prince of Wales-Hyder Census Area",198,"Other Southeast Region - Southern",9,1,5,0,5,0,0,0,0
"07/28/2021","N","Y","Prince of Wales-Hyder Census Area",198,"Other Southeast Region - Southern",9,0,5,5,10,0,0,0,0
"07/29/2021","N","Y","Prince of Wales-Hyder Census Area",198,"Other Southeast Region - Southern",9,5,10,0,10,0,0,0,0
"07/30/2021","N","Y","Prince of Wales-Hyder Census Area",198,"Other Southeast Region - Southern",9,0,10,2,12,0,0,0,0
"07/31/2021","N","Y","Prince of Wales-Hyder Census Area",198,"Other Southeast Region - Southern",9,2,12,0,12,0,0,0,0
"08/19/2021","N","Y","Prince of Wales-Hyder Census Area",198,"Other Southeast Region - Southern",9,0,12,2,14,0,0,0,0
"08/23/2021","N","Y","Prince of Wales-Hyder Census Area",198,"Other Southeast Region - Southern",9,2,14,0,14,0,0,0,0
"08/24/2021","N","Y","Prince of Wales-Hyder Census Area",198,"Other Southeast Region - Southern",9,0,14,1,15,0,0,0,0
"08/30/2021","N","Y","Prince of Wales-Hyder Census Area",198,"Other Southeast Region - Southern",9,0,14,1,16,0,0,0,0
"08/31/2021","N","Y","Prince of Wales-Hyder Census Area",198,"Other Southeast Region - Southern",9,1,15,1,17,0,0,0,0
"09/06/2021","N","Y","Prince of Wales-Hyder Census Area",198,"Other Southeast Region - Southern",9,1,16,0,17,0,0,0,0
"09/07/2021","N","Y","Prince of Wales-Hyder Census Area",198,"Other Southeast Region - Southern",9,1,17,0,17,0,0,0,0
"09/29/2021","N","Y","Prince of Wales-Hyder Census Area",198,"Other Southeast Region - Southern",9,0,17,1,18,0,0,0,0
"10/02/2021","N","Y","Prince of Wales-Hyder Census Area",198,"Other Southeast Region - Southern",9,1,18,0,18,0,0,0,0
"10/26/2021","N","Y","Prince of Wales-Hyder Census Area",198,"Other Southeast Region - Southern",9,0,18,1,19,0,0,0,0
"10/28/2021","N","Y","Prince of Wales-Hyder Census Area",198,"Other Southeast Region - Southern",9,1,19,0,19,0,0,0,0
"03/17/2022","N","Y","Prince of Wales-Hyder Census Area",198,"Other Southeast Region - Southern",9,2,21,2,21,0,0,0,0
"04/01/2022","N","Y","Prince of Wales-Hyder Census Area",198,"Other Southeast Region - Southern",9,0,21,1,22,0,0,0,0
"04/06/2022","N","Y","Prince of Wales-Hyder Census Area",198,"Other Southeast Region - Southern",9,1,22,0,22,0,0,0,0
"04/22/2022","N","Y","Prince of Wales-Hyder Census Area",198,"Other Southeast Region - Southern",9,1,23,1,23,0,0,0,0
"05/19/2020","N","Y","Sitka City and Borough",220,"Other Southeast Region - Northern",8,0,0,1,1,0,0,0,0
"06/03/2020","N","Y","Sitka City and Borough",220,"Other Southeast Region - Northern",8,1,1,0,1,0,0,0,0
"06/07/2020","N","Y","Sitka City and Borough",220,"Other Southeast Region - Northern",8,0,1,1,2,0,0,0,0
"06/11/2020","N","Y","Sitka City and Borough",220,"Other Southeast Region - Northern",8,1,2,0,2,0,0,0,0
"06/25/2020","N","Y","Sitka City and Borough",220,"Other Southeast Region - Northern",8,0,2,1,3,0,0,0,0
"06/29/2020","N","Y","Sitka City and Borough",220,"Other Southeast Region - Northern",8,1,3,2,5,0,0,0,0
"06/30/2020","N","Y","Sitka City and Borough",220,"Other Southeast Region - Northern",8,2,5,0,5,0,0,0,0
"07/07/2020","N","Y","Sitka City and Borough",220,"Other Southeast Region - Northern",8,0,5,1,6,0,0,0,0
"07/08/2020","N","Y","Sitka City and Borough",220,"Other Southeast Region - Northern",8,1,6,0,6,0,0,0,0
"07/13/2020","N","Y","Sitka City and Borough",220,"Other Southeast Region - Northern",8,0,6,1,7,0,0,0,0
"07/15/2020","N","Y","Sitka City and Borough",220,"Other Southeast Region - Northern",8,1,7,0,7,0,0,0,0
"07/16/2020","N","Y","Sitka City and Borough",220,"Other Southeast Region - Northern",8,2,9,2,9,0,0,0,0
"07/21/2020","N","Y","Sitka City and Borough",220,"Other Southeast Region - Northern",8,0,9,1,10,0,0,0,0
"07/26/2020","N","Y","Sitka City and Borough",220,"Other Southeast Region - Northern",8,1,10,0,10,0,0,0,0
"07/30/2020","N","Y","Sitka City and Borough",220,"Other Southeast Region - Northern",8,0,10,2,12,0,0,0,0
"07/31/2020","N","Y","Sitka City and Borough",220,"Other Southeast Region - Northern",8,0,10,1,13,0,0,0,0
"08/03/2020","N","Y","Sitka City and Borough",220,"Other Southeast Region - Northern",8,1,11,0,13,0,0,0,0
"08/05/2020","N","Y","Sitka City and Borough",220,"Other Southeast Region - Northern",8,0,11,1,14,0,0,0,0
"08/06/2020","N","Y","Sitka City and Borough",220,"Other Southeast Region - Northern",8,1,12,0,14,0,0,0,0
"08/07/2020","N","Y","Sitka City and Borough",220,"Other Southeast Region - Northern",8,2,14,0,14,0,0,0,0
"08/13/2020","N","Y","Sitka City and Borough",220,"Other Southeast Region - Northern",8,0,14,2,16,0,0,0,0
"08/15/2020","N","Y","Sitka City and Borough",220,"Other Southeast Region - Northern",8,3,17,1,17,0,0,0,0
"11/06/2020","N","Y","Sitka City and Borough",220,"Other Southeast Region - Northern",8,1,18,1,18,0,0,0,0
"11/30/2020","N","Y","Sitka City and Borough",220,"Other Southeast Region - Northern",8,0,18,1,19,0,0,0,0
"12/03/2020","N","Y","Sitka City and Borough",220,"Other Southeast Region - Northern",8,1,19,0,19,0,0,0,0
"12/23/2020","N","Y","Sitka City and Borough",220,"Other Southeast Region - Northern",8,0,19,2,21,0,0,0,0
"12/26/2020","N","Y","Sitka City and Borough",220,"Other Southeast Region - Northern",8,2,21,0,21,0,0,0,0
"01/08/2021","N","Y","Sitka City and Borough",220,"Other Southeast Region - Northern",8,0,21,1,22,0,0,0,0
"01/11/2021","N","Y","Sitka City and Borough",220,"Other Southeast Region - Northern",8,1,22,0,22,0,0,0,0
"03/31/2021","N","Y","Sitka City and Borough",220,"Other Southeast Region - Northern",8,0,22,1,23,0,0,0,0
"04/06/2021","N","Y","Sitka City and Borough",220,"Other Southeast Region - Northern",8,1,23,0,23,0,0,0,0
"04/30/2021","N","Y","Sitka City and Borough",220,"Other Southeast Region - Northern",8,0,23,2,25,0,0,0,0
"05/01/2021","N","Y","Sitka City and Borough",220,"Other Southeast Region - Northern",8,0,23,2,27,0,0,0,0
"05/03/2021","N","Y","Sitka City and Borough",220,"Other Southeast Region - Northern",8,3,26,0,27,0,0,0,0
"05/06/2021","N","Y","Sitka City and Borough",220,"Other Southeast Region - Northern",8,1,27,0,27,0,0,0,0
"05/18/2021","N","Y","Sitka City and Borough",220,"Other Southeast Region - Northern",8,0,27,1,28,0,0,0,0
"05/20/2021","N","Y","Sitka City and Borough",220,"Other Southeast Region - Northern",8,1,28,0,28,0,0,0,0
"07/06/2021","N","Y","Sitka City and Borough",220,"Other Southeast Region - Northern",8,0,28,3,31,0,0,0,0
"07/07/2021","N","Y","Sitka City and Borough",220,"Other Southeast Region - Northern",8,1,29,0,31,0,0,0,0
"07/08/2021","N","Y","Sitka City and Borough",220,"Other Southeast Region - Northern",8,2,31,0,31,0,0,0,0
"07/12/2021","N","Y","Sitka City and Borough",220,"Other Southeast Region - Northern",8,0,31,1,32,0,0,0,0
"07/15/2021","N","Y","Sitka City and Borough",220,"Other Southeast Region - Northern",8,1,32,0,32,0,0,0,0
"07/16/2021","N","Y","Sitka City and Borough",220,"Other Southeast Region - Northern",8,0,32,3,35,0,0,0,0
"07/17/2021","N","Y","Sitka City and Borough",220,"Other Southeast Region - Northern",8,0,32,1,36,0,0,0,0
"07/19/2021","N","Y","Sitka City and Borough",220,"Other Southeast Region - Northern",8,3,35,4,40,0,0,0,0
"07/20/2021","N","Y","Sitka City and Borough",220,"Other Southeast Region - Northern",8,4,39,1,41,0,0,0,0
"07/21/2021","N","Y","Sitka City and Borough",220,"Other Southeast Region - Northern",8,2,41,0,41,0,0,0,0
"07/22/2021","N","Y","Sitka City and Borough",220,"Other Southeast Region - Northern",8,0,41,1,42,0,0,0,0
"07/23/2021","N","Y","Sitka City and Borough",220,"Other Southeast Region - Northern",8,2,43,4,46,0,0,0,0
"07/25/2021","N","Y","Sitka City and Borough",220,"Other Southeast Region - Northern",8,2,45,1,47,0,0,0,0
"07/26/2021","N","Y","Sitka City and Borough",220,"Other Southeast Region - Northern",8,1,46,2,49,0,0,0,0
"07/27/2021","N","Y","Sitka City and Borough",220,"Other Southeast Region - Northern",8,1,47,0,49,0,0,0,0
"07/28/2021","N","Y","Sitka City and Borough",220,"Other Southeast Region - Northern",8,0,47,1,50,0,0,0,0
"07/29/2021","N","Y","Sitka City and Borough",220,"Other Southeast Region - Northern",8,4,51,2,52,0,0,0,0
"07/30/2021","N","Y","Sitka City and Borough",220,"Other Southeast Region - Northern",8,1,52,2,54,0,0,0,0
"07/31/2021","N","Y","Sitka City and Borough",220,"Other Southeast Region - Northern",8,2,54,1,55,0,0,0,0
"08/01/2021","N","Y","Sitka City and Borough",220,"Other Southeast Region - Northern",8,0,54,1,56,0,0,0,0
"08/02/2021","N","Y","Sitka City and Borough",220,"Other Southeast Region - Northern",8,2,56,0,56,0,0,0,0
"08/04/2021","N","Y","Sitka City and Borough",220,"Other Southeast Region - Northern",8,0,56,1,57,0,0,0,0
"08/06/2021","N","Y","Sitka City and Borough",220,"Other Southeast Region - Northern",8,1,57,1,58,0,0,0,0
"08/08/2021","N","Y","Sitka City and Borough",220,"Other Southeast Region - Northern",8,1,58,0,58,0,0,0,0
"08/09/2021","N","Y","Sitka City and Borough",220,"Other Southeast Region - Northern",8,0,58,1,59,0,0,0,0
"08/10/2021","N","Y","Sitka City and Borough",220,"Other Southeast Region - Northern",8,0,58,3,62,0,0,0,0
"08/11/2021","N","Y","Sitka City and Borough",220,"Other Southeast Region - Northern",8,1,59,0,62,0,0,0,0
"08/13/2021","N","Y","Sitka City and Borough",220,"Other Southeast Region - Northern",8,1,60,11,73,0,0,0,0
"08/14/2021","N","Y","Sitka City and Borough",220,"Other Southeast Region - Northern",8,2,62,2,75,0,0,0,0
"08/16/2021","N","Y","Sitka City and Borough",220,"Other Southeast Region - Northern",8,2,64,2,77,0,0,0,0
"08/17/2021","N","Y","Sitka City and Borough",220,"Other Southeast Region - Northern",8,1,65,2,79,0,0,0,0
"08/18/2021","N","Y","Sitka City and Borough",220,"Other Southeast Region - Northern",8,12,77,0,79,0,0,0,0
"08/19/2021","N","Y","Sitka City and Borough",220,"Other Southeast Region - Northern",8,0,77,2,81,0,0,0,0
"08/20/2021","N","Y","Sitka City and Borough",220,"Other Southeast Region - Northern",8,2,79,1,82,0,0,0,0
"08/22/2021","N","Y","Sitka City and Borough",220,"Other Southeast Region - Northern",8,1,80,0,82,0,0,0,0
"08/24/2021","N","Y","Sitka City and Borough",220,"Other Southeast Region - Northern",8,1,81,0,82,0,0,0,0
"08/25/2021","N","Y","Sitka City and Borough",220,"Other Southeast Region - Northern",8,0,81,3,85,0,0,0,0
"08/26/2021","N","Y","Sitka City and Borough",220,"Other Southeast Region - Northern",8,1,82,2,87,0,0,0,0
"08/30/2021","N","Y","Sitka City and Borough",220,"Other Southeast Region - Northern",8,0,82,3,90,0,0,0,0
"08/31/2021","N","Y","Sitka City and Borough",220,"Other Southeast Region - Northern",8,4,86,0,90,0,0,0,0
"09/01/2021","N","Y","Sitka City and Borough",220,"Other Southeast Region - Northern",8,0,86,3,93,0,0,0,0
"09/03/2021","N","Y","Sitka City and Borough",220,"Other Southeast Region - Northern",8,3,89,0,93,0,0,0,0
"09/07/2021","N","Y","Sitka City and Borough",220,"Other Southeast Region - Northern",8,2,91,1,94,0,0,0,0
"09/08/2021","N","Y","Sitka City and Borough",220,"Other Southeast Region - Northern",8,1,92,0,94,0,0,0,0
"09/15/2021","N","Y","Sitka City and Borough",220,"Other Southeast Region - Northern",8,0,92,1,95,0,0,0,0
"09/17/2021","N","Y","Sitka City and Borough",220,"Other Southeast Region - Northern",8,0,92,1,96,0,0,0,0
"09/18/2021","N","Y","Sitka City and Borough",220,"Other Southeast Region - Northern",8,1,93,0,96,0,0,0,0
"09/19/2021","N","Y","Sitka City and Borough",220,"Other Southeast Region - Northern",8,0,93,1,97,0,0,0,0
"09/20/2021","N","Y","Sitka City and Borough",220,"Other Southeast Region - Northern",8,2,95,0,97,0,0,0,0
"09/22/2021","N","Y","Sitka City and Borough",220,"Other Southeast Region - Northern",8,0,95,1,98,0,0,0,0
"09/23/2021","N","Y","Sitka City and Borough",220,"Other Southeast Region - Northern",8,0,95,1,99,0,0,0,0
"09/28/2021","N","Y","Sitka City and Borough",220,"Other Southeast Region - Northern",8,2,97,0,99,0,0,0,0
"09/30/2021","N","Y","Sitka City and Borough",220,"Other Southeast Region - Northern",8,1,98,0,99,0,0,0,0
"10/13/2021","N","Y","Sitka City and Borough",220,"Other Southeast Region - Northern",8,0,98,2,101,0,0,0,0
"10/15/2021","N","Y","Sitka City and Borough",220,"Other Southeast Region - Northern",8,1,99,0,101,0,0,0,0
"10/17/2021","N","Y","Sitka City and Borough",220,"Other Southeast Region - Northern",8,2,101,1,102,0,0,0,0
"10/18/2021","N","Y","Sitka City and Borough",220,"Other Southeast Region - Northern",8,0,101,1,103,0,0,0,0
"10/20/2021","N","Y","Sitka City and Borough",220,"Other Southeast Region - Northern",8,1,102,0,103,0,0,0,0
"10/21/2021","N","Y","Sitka City and Borough",220,"Other Southeast Region - Northern",8,1,103,1,104,0,0,0,0
"10/22/2021","N","Y","Sitka City and Borough",220,"Other Southeast Region - Northern",8,1,104,0,104,0,0,0,0
"12/28/2021","N","Y","Sitka City and Borough",220,"Other Southeast Region - Northern",8,0,104,1,105,0,0,0,0
"12/29/2021","N","Y","Sitka City and Borough",220,"Other Southeast Region - Northern",8,1,105,0,105,0,0,0,0
"12/30/2021","N","Y","Sitka City and Borough",220,"Other Southeast Region - Northern",8,0,105,1,106,0,0,0,0
"01/01/2022","N","Y","Sitka City and Borough",220,"Other Southeast Region - Northern",8,1,106,0,106,0,0,0,0
"01/04/2022","N","Y","Sitka City and Borough",220,"Other Southeast Region - Northern",8,0,106,1,107,0,0,0,0
"01/06/2022","N","Y","Sitka City and Borough",220,"Other Southeast Region - Northern",8,1,107,1,108,0,0,0,0
"01/07/2022","N","Y","Sitka City and Borough",220,"Other Southeast Region - Northern",8,0,107,3,111,0,0,0,0
"01/08/2022","N","Y","Sitka City and Borough",220,"Other Southeast Region - Northern",8,1,108,0,111,0,0,0,0
"01/10/2022","N","Y","Sitka City and Borough",220,"Other Southeast Region - Northern",8,3,111,2,113,0,0,0,0
"01/12/2022","N","Y","Sitka City and Borough",220,"Other Southeast Region - Northern",8,2,113,2,115,0,0,0,0
"01/14/2022","N","Y","Sitka City and Borough",220,"Other Southeast Region - Northern",8,2,115,0,115,0,0,0,0
"01/16/2022","N","Y","Sitka City and Borough",220,"Other Southeast Region - Northern",8,0,115,1,116,0,0,0,0
"01/17/2022","N","Y","Sitka City and Borough",220,"Other Southeast Region - Northern",8,0,115,3,119,0,0,0,0
"01/18/2022","N","Y","Sitka City and Borough",220,"Other Southeast Region - Northern",8,1,116,0,119,0,0,0,0
"01/20/2022","N","Y","Sitka City and Borough",220,"Other Southeast Region - Northern",8,3,119,2,121,0,0,0,0
"01/21/2022","N","Y","Sitka City and Borough",220,"Other Southeast Region - Northern",8,2,121,1,122,0,0,0,0
"01/26/2022","N","Y","Sitka City and Borough",220,"Other Southeast Region - Northern",8,1,122,1,123,0,0,0,0
"01/31/2022","N","Y","Sitka City and Borough",220,"Other Southeast Region - Northern",8,1,123,0,123,0,0,0,0
"02/01/2022","N","Y","Sitka City and Borough",220,"Other Southeast Region - Northern",8,0,123,1,124,0,0,0,0
"02/02/2022","N","Y","Sitka City and Borough",220,"Other Southeast Region - Northern",8,1,124,0,124,0,0,0,0
"02/17/2022","N","Y","Sitka City and Borough",220,"Other Southeast Region - Northern",8,1,125,1,125,0,0,0,0
"03/17/2022","N","Y","Sitka City and Borough",220,"Other Southeast Region - Northern",8,1,126,1,126,0,0,0,0
"03/18/2022","N","Y","Sitka City and Borough",220,"Other Southeast Region - Northern",8,1,127,1,127,0,0,0,0
"03/30/2022","N","Y","Sitka City and Borough",220,"Other Southeast Region - Northern",8,0,127,1,128,0,0,0,0
"04/02/2022","N","Y","Sitka City and Borough",220,"Other Southeast Region - Northern",8,1,128,0,128,0,0,0,0
"04/18/2022","N","Y","Sitka City and Borough",220,"Other Southeast Region - Northern",8,0,128,1,129,0,0,0,0
"04/19/2022","N","Y","Sitka City and Borough",220,"Other Southeast Region - Northern",8,0,128,1,130,0,0,0,0
"04/20/2022","N","Y","Sitka City and Borough",220,"Other Southeast Region - Northern",8,1,129,0,130,0,0,0,0
"04/21/2022","N","Y","Sitka City and Borough",220,"Other Southeast Region - Northern",8,1,130,1,131,0,0,0,0
"04/23/2022","N","Y","Sitka City and Borough",220,"Other Southeast Region - Northern",8,1,131,0,131,0,0,0,0
"07/26/2021","N","Y","Skagway Municipality",230,"Other Southeast Region - Northern",8,0,0,1,1,0,0,0,0
"07/28/2021","N","Y","Skagway Municipality",230,"Other Southeast Region - Northern",8,1,1,0,1,0,0,0,0
"08/02/2021","N","Y","Skagway Municipality",230,"Other Southeast Region - Northern",8,0,1,2,3,0,0,0,0
"08/03/2021","N","Y","Skagway Municipality",230,"Other Southeast Region - Northern",8,3,4,2,5,0,0,0,0
"08/04/2021","N","Y","Skagway Municipality",230,"Other Southeast Region - Northern",8,1,5,1,6,0,0,0,0
"08/09/2021","N","Y","Skagway Municipality",230,"Other Southeast Region - Northern",8,0,5,1,7,0,0,0,0
"08/10/2021","N","Y","Skagway Municipality",230,"Other Southeast Region - Northern",8,1,6,0,7,0,0,0,0
"08/14/2021","N","Y","Skagway Municipality",230,"Other Southeast Region - Northern",8,1,7,0,7,0,0,0,0
"08/25/2021","N","Y","Skagway Municipality",230,"Other Southeast Region - Northern",8,0,7,1,8,0,0,0,0
"08/29/2021","N","Y","Skagway Municipality",230,"Other Southeast Region - Northern",8,0,7,1,9,0,0,0,0
"08/31/2021","N","Y","Skagway Municipality",230,"Other Southeast Region - Northern",8,1,8,3,12,0,0,0,0
"09/01/2021","N","Y","Skagway Municipality",230,"Other Southeast Region - Northern",8,0,8,1,13,0,0,0,0
"09/03/2021","N","Y","Skagway Municipality",230,"Other Southeast Region - Northern",8,1,9,2,15,0,0,0,0
"09/05/2021","N","Y","Skagway Municipality",230,"Other Southeast Region - Northern",8,3,12,0,15,0,0,0,0
"09/07/2021","N","Y","Skagway Municipality",230,"Other Southeast Region - Northern",8,1,13,0,15,0,0,0,0
"09/09/2021","N","Y","Skagway Municipality",230,"Other Southeast Region - Northern",8,0,13,1,16,0,0,0,0
"09/13/2021","N","Y","Skagway Municipality",230,"Other Southeast Region - Northern",8,1,14,0,16,0,0,0,0
"09/14/2021","N","Y","Skagway Municipality",230,"Other Southeast Region - Northern",8,1,15,0,16,0,0,0,0
"09/15/2021","N","Y","Skagway Municipality",230,"Other Southeast Region - Northern",8,0,15,2,18,0,0,0,0
"09/18/2021","N","Y","Skagway Municipality",230,"Other Southeast Region - Northern",8,1,16,0,18,0,0,0,0
"09/25/2021","N","Y","Skagway Municipality",230,"Other Southeast Region - Northern",8,2,18,0,18,0,0,0,0
"04/17/2022","N","Y","Skagway Municipality",230,"Other Southeast Region - Northern",8,0,18,1,19,0,0,0,0
"04/20/2022","N","Y","Skagway Municipality",230,"Other Southeast Region - Northern",8,1,19,0,19,0,0,0,0
"04/11/2020","N","Y","Southeast Fairbanks Census Area",240,"Other Interior Region",7,0,0,1,1,0,0,0,0
"04/15/2020","N","Y","Southeast Fairbanks Census Area",240,"Other Interior Region",7,1,1,0,1,0,0,0,0
"06/14/2020","N","Y","Southeast Fairbanks Census Area",240,"Other Interior Region",7,0,1,3,4,0,0,0,0
"06/15/2020","N","Y","Southeast Fairbanks Census Area",240,"Other Interior Region",7,0,1,1,5,0,0,0,0
"06/16/2020","N","Y","Southeast Fairbanks Census Area",240,"Other Interior Region",7,3,4,1,6,0,0,0,0
"06/17/2020","N","Y","Southeast Fairbanks Census Area",240,"Other Interior Region",7,0,4,1,7,0,0,0,0
"06/18/2020","N","Y","Southeast Fairbanks Census Area",240,"Other Interior Region",7,0,4,1,8,0,0,0,0
"06/19/2020","N","Y","Southeast Fairbanks Census Area",240,"Other Interior Region",7,1,5,1,9,0,0,0,0
"06/22/2020","N","Y","Southeast Fairbanks Census Area",240,"Other Interior Region",7,2,7,2,11,0,0,0,0
"06/23/2020","N","Y","Southeast Fairbanks Census Area",240,"Other Interior Region",7,2,9,3,14,0,0,0,0
"06/24/2020","N","Y","Southeast Fairbanks Census Area",240,"Other Interior Region",7,1,10,1,15,0,0,0,0
"06/26/2020","N","Y","Southeast Fairbanks Census Area",240,"Other Interior Region",7,1,11,2,17,0,0,0,0
"06/27/2020","N","Y","Southeast Fairbanks Census Area",240,"Other Interior Region",7,2,13,0,17,0,0,0,0
"07/02/2020","N","Y","Southeast Fairbanks Census Area",240,"Other Interior Region",7,1,14,2,19,0,0,0,0
"07/08/2020","N","Y","Southeast Fairbanks Census Area",240,"Other Interior Region",7,0,14,1,20,0,0,0,0
"07/10/2020","N","Y","Southeast Fairbanks Census Area",240,"Other Interior Region",7,6,20,0,20,0,0,0,0
"07/21/2020","N","Y","Southeast Fairbanks Census Area",240,"Other Interior Region",7,0,20,1,21,0,0,0,0
"08/03/2020","N","Y","Southeast Fairbanks Census Area",240,"Other Interior Region",7,1,21,0,21,0,0,0,0
"08/18/2020","N","Y","Southeast Fairbanks Census Area",240,"Other Interior Region",7,2,23,2,23,0,0,0,0
"09/27/2020","N","Y","Southeast Fairbanks Census Area",240,"Other Interior Region",7,0,23,1,24,0,0,0,0
"10/03/2020","N","Y","Southeast Fairbanks Census Area",240,"Other Interior Region",7,1,24,0,24,0,0,0,0
"11/01/2020","N","Y","Southeast Fairbanks Census Area",240,"Other Interior Region",7,0,24,1,25,0,0,0,0
"11/03/2020","N","Y","Southeast Fairbanks Census Area",240,"Other Interior Region",7,1,25,0,25,0,0,0,0
"11/12/2020","N","Y","Southeast Fairbanks Census Area",240,"Other Interior Region",7,0,25,1,26,0,0,0,0
"11/13/2020","N","Y","Southeast Fairbanks Census Area",240,"Other Interior Region",7,1,26,0,26,0,0,0,0
"11/17/2020","N","Y","Southeast Fairbanks Census Area",240,"Other Interior Region",7,0,26,2,28,0,0,0,0
"11/20/2020","N","Y","Southeast Fairbanks Census Area",240,"Other Interior Region",7,1,27,1,29,0,0,0,0
"11/21/2020","N","Y","Southeast Fairbanks Census Area",240,"Other Interior Region",7,0,27,3,32,0,0,0,0
"11/23/2020","N","Y","Southeast Fairbanks Census Area",240,"Other Interior Region",7,0,27,1,33,0,0,0,0
"11/24/2020","N","Y","Southeast Fairbanks Census Area",240,"Other Interior Region",7,1,28,2,35,1,1,0,0
"11/25/2020","N","Y","Southeast Fairbanks Census Area",240,"Other Interior Region",7,1,29,0,35,0,1,0,0
"11/27/2020","N","Y","Southeast Fairbanks Census Area",240,"Other Interior Region",7,5,34,1,36,0,1,0,0
"11/28/2020","N","Y","Southeast Fairbanks Census Area",240,"Other Interior Region",7,1,35,1,37,0,1,0,0
"11/30/2020","N","Y","Southeast Fairbanks Census Area",240,"Other Interior Region",7,0,35,1,38,0,1,0,0
"12/01/2020","N","Y","Southeast Fairbanks Census Area",240,"Other Interior Region",7,2,37,3,41,0,1,0,0
"12/02/2020","N","Y","Southeast Fairbanks Census Area",240,"Other Interior Region",7,0,37,1,42,0,1,0,0
"12/03/2020","N","Y","Southeast Fairbanks Census Area",240,"Other Interior Region",7,1,38,0,42,0,1,0,0
"12/04/2020","N","Y","Southeast Fairbanks Census Area",240,"Other Interior Region",7,1,39,0,42,0,1,0,0
"12/06/2020","N","Y","Southeast Fairbanks Census Area",240,"Other Interior Region",7,1,40,0,42,0,1,0,0
"12/07/2020","N","Y","Southeast Fairbanks Census Area",240,"Other Interior Region",7,1,41,1,43,0,1,0,0
"12/08/2020","N","Y","Southeast Fairbanks Census Area",240,"Other Interior Region",7,0,41,1,44,0,1,0,0
"12/09/2020","N","Y","Southeast Fairbanks Census Area",240,"Other Interior Region",7,0,41,1,45,0,1,0,0
"12/10/2020","N","Y","Southeast Fairbanks Census Area",240,"Other Interior Region",7,2,43,1,46,0,1,0,0
"12/12/2020","N","Y","Southeast Fairbanks Census Area",240,"Other Interior Region",7,2,45,0,46,0,1,0,0
"12/13/2020","N","Y","Southeast Fairbanks Census Area",240,"Other Interior Region",7,1,46,0,46,0,1,0,0
"12/15/2020","N","Y","Southeast Fairbanks Census Area",240,"Other Interior Region",7,0,46,1,47,0,1,0,0
"12/16/2020","N","Y","Southeast Fairbanks Census Area",240,"Other Interior Region",7,0,46,3,50,0,1,0,0
"12/17/2020","N","Y","Southeast Fairbanks Census Area",240,"Other Interior Region",7,2,48,0,50,0,1,0,0
"12/18/2020","N","Y","Southeast Fairbanks Census Area",240,"Other Interior Region",7,1,49,0,50,0,1,0,0
"12/19/2020","N","Y","Southeast Fairbanks Census Area",240,"Other Interior Region",7,0,49,1,51,0,1,0,0
"12/20/2020","N","Y","Southeast Fairbanks Census Area",240,"Other Interior Region",7,2,51,0,51,0,1,0,0
"12/22/2020","N","Y","Southeast Fairbanks Census Area",240,"Other Interior Region",7,1,52,1,52,0,1,0,0
"01/01/2021","N","Y","Southeast Fairbanks Census Area",240,"Other Interior Region",7,0,52,1,53,0,1,0,0
"01/02/2021","N","Y","Southeast Fairbanks Census Area",240,"Other Interior Region",7,0,52,1,54,0,1,0,0
"01/05/2021","N","Y","Southeast Fairbanks Census Area",240,"Other Interior Region",7,2,54,1,55,0,1,0,0
"01/07/2021","N","Y","Southeast Fairbanks Census Area",240,"Other Interior Region",7,1,55,0,55,0,1,0,0
"02/23/2021","N","Y","Southeast Fairbanks Census Area",240,"Other Interior Region",7,1,56,2,57,0,1,0,0
"02/24/2021","N","Y","Southeast Fairbanks Census Area",240,"Other Interior Region",7,1,57,0,57,0,1,0,0
"02/26/2021","N","Y","Southeast Fairbanks Census Area",240,"Other Interior Region",7,1,58,2,59,0,1,0,0
"02/27/2021","N","Y","Southeast Fairbanks Census Area",240,"Other Interior Region",7,1,59,1,60,0,1,0,0
"02/28/2021","N","Y","Southeast Fairbanks Census Area",240,"Other Interior Region",7,1,60,0,60,0,1,0,0
"03/02/2021","N","Y","Southeast Fairbanks Census Area",240,"Other Interior Region",7,1,61,3,63,0,1,0,0
"03/03/2021","N","Y","Southeast Fairbanks Census Area",240,"Other Interior Region",7,1,62,1,64,0,1,0,0
"03/04/2021","N","Y","Southeast Fairbanks Census Area",240,"Other Interior Region",7,2,64,0,64,0,1,0,0
"03/09/2021","N","Y","Southeast Fairbanks Census Area",240,"Other Interior Region",7,0,64,1,65,0,1,0,0
"03/12/2021","N","Y","Southeast Fairbanks Census Area",240,"Other Interior Region",7,1,65,0,65,0,1,0,0
"03/18/2021","N","Y","Southeast Fairbanks Census Area",240,"Other Interior Region",7,1,66,1,66,0,1,0,0
"03/29/2021","N","Y","Southeast Fairbanks Census Area",240,"Other Interior Region",7,0,66,1,67,0,1,0,0
"03/30/2021","N","Y","Southeast Fairbanks Census Area",240,"Other Interior Region",7,1,67,0,67,0,1,0,0
"04/06/2021","N","Y","Southeast Fairbanks Census Area",240,"Other Interior Region",7,0,67,1,68,0,1,0,0
"04/13/2021","N","Y","Southeast Fairbanks Census Area",240,"Other Interior Region",7,1,68,0,68,0,1,0,0
"06/11/2021","N","Y","Southeast Fairbanks Census Area",240,"Other Interior Region",7,1,69,1,69,0,1,0,0
"07/12/2021","N","Y","Southeast Fairbanks Census Area",240,"Other Interior Region",7,0,69,1,70,0,1,0,0
"07/13/2021","N","Y","Southeast Fairbanks Census Area",240,"Other Interior Region",7,1,70,0,70,0,1,0,0
"08/04/2021","N","Y","Southeast Fairbanks Census Area",240,"Other Interior Region",7,1,71,2,72,0,1,0,0
"08/09/2021","N","Y","Southeast Fairbanks Census Area",240,"Other Interior Region",7,1,72,1,73,0,1,0,0
"08/10/2021","N","Y","Southeast Fairbanks Census Area",240,"Other Interior Region",7,1,73,0,73,0,1,0,0
"08/21/2021","N","Y","Southeast Fairbanks Census Area",240,"Other Interior Region",7,0,73,1,74,0,1,0,0
"08/22/2021","N","Y","Southeast Fairbanks Census Area",240,"Other Interior Region",7,1,74,0,74,0,1,0,0
"08/26/2021","N","Y","Southeast Fairbanks Census Area",240,"Other Interior Region",7,0,74,1,75,0,1,0,0
"09/01/2021","N","Y","Southeast Fairbanks Census Area",240,"Other Interior Region",7,1,75,1,76,0,1,0,0
"09/02/2021","N","Y","Southeast Fairbanks Census Area",240,"Other Interior Region",7,0,75,2,78,0,1,0,0
"09/03/2021","N","Y","Southeast Fairbanks Census Area",240,"Other Interior Region",7,2,77,0,78,0,1,0,0
"09/07/2021","N","Y","Southeast Fairbanks Census Area",240,"Other Interior Region",7,0,77,2,80,0,1,0,0
"09/08/2021","N","Y","Southeast Fairbanks Census Area",240,"Other Interior Region",7,2,79,0,80,0,1,0,0
"09/14/2021","N","Y","Southeast Fairbanks Census Area",240,"Other Interior Region",7,0,79,2,82,0,1,0,0
"09/15/2021","N","Y","Southeast Fairbanks Census Area",240,"Other Interior Region",7,1,80,1,83,0,1,0,0
"09/17/2021","N","Y","Southeast Fairbanks Census Area",240,"Other Interior Region",7,0,80,1,84,0,1,0,0
"09/18/2021","N","Y","Southeast Fairbanks Census Area",240,"Other Interior Region",7,1,81,1,85,0,1,0,0
"09/19/2021","N","Y","Southeast Fairbanks Census Area",240,"Other Interior Region",7,1,82,0,85,0,1,0,0
"09/21/2021","N","Y","Southeast Fairbanks Census Area",240,"Other Interior Region",7,1,83,1,86,0,1,0,0
"09/22/2021","N","Y","Southeast Fairbanks Census Area",240,"Other Interior Region",7,1,84,1,87,0,1,0,0
"09/23/2021","N","Y","Southeast Fairbanks Census Area",240,"Other Interior Region",7,1,85,0,87,0,1,0,0
"09/24/2021","N","Y","Southeast Fairbanks Census Area",240,"Other Interior Region",7,1,86,0,87,0,1,0,0
"09/27/2021","N","Y","Southeast Fairbanks Census Area",240,"Other Interior Region",7,1,87,1,88,0,1,0,0
"09/28/2021","N","Y","Southeast Fairbanks Census Area",240,"Other Interior Region",7,0,87,1,89,0,1,0,0
"09/29/2021","N","Y","Southeast Fairbanks Census Area",240,"Other Interior Region",7,1,88,0,89,0,1,0,0
"10/01/2021","N","Y","Southeast Fairbanks Census Area",240,"Other Interior Region",7,1,89,0,89,0,1,0,0
"10/13/2021","N","Y","Southeast Fairbanks Census Area",240,"Other Interior Region",7,0,89,2,91,0,1,0,0
"10/16/2021","N","Y","Southeast Fairbanks Census Area",240,"Other Interior Region",7,1,90,0,91,0,1,0,0
"11/10/2021","N","Y","Southeast Fairbanks Census Area",240,"Other Interior Region",7,1,91,0,91,0,1,0,0
"12/19/2021","N","Y","Southeast Fairbanks Census Area",240,"Other Interior Region",7,0,91,1,92,0,1,0,0
"12/21/2021","N","Y","Southeast Fairbanks Census Area",240,"Other Interior Region",7,0,91,8,100,0,1,0,0
"12/22/2021","N","Y","Southeast Fairbanks Census Area",240,"Other Interior Region",7,0,91,2,102,0,1,0,0
"12/23/2021","N","Y","Southeast Fairbanks Census Area",240,"Other Interior Region",7,11,102,1,103,0,1,0,0
"12/26/2021","N","Y","Southeast Fairbanks Census Area",240,"Other Interior Region",7,1,103,0,103,0,1,0,0
"12/27/2021","N","Y","Southeast Fairbanks Census Area",240,"Other Interior Region",7,0,103,1,104,0,1,0,0
"12/28/2021","N","Y","Southeast Fairbanks Census Area",240,"Other Interior Region",7,0,103,1,105,0,1,0,0
"12/29/2021","N","Y","Southeast Fairbanks Census Area",240,"Other Interior Region",7,1,104,0,105,0,1,0,0
"12/30/2021","N","Y","Southeast Fairbanks Census Area",240,"Other Interior Region",7,1,105,0,105,0,1,0,0
"12/31/2021","N","Y","Southeast Fairbanks Census Area",240,"Other Interior Region",7,0,105,3,108,0,1,0,0
"01/01/2022","N","Y","Southeast Fairbanks Census Area",240,"Other Interior Region",7,0,105,2,110,0,1,0,0
"01/02/2022","N","Y","Southeast Fairbanks Census Area",240,"Other Interior Region",7,2,107,3,113,0,1,0,0
"01/03/2022","N","Y","Southeast Fairbanks Census Area",240,"Other Interior Region",7,0,107,6,119,0,1,0,0
"01/04/2022","N","Y","Southeast Fairbanks Census Area",240,"Other Interior Region",7,6,113,0,119,0,1,0,0
"01/05/2022","N","Y","Southeast Fairbanks Census Area",240,"Other Interior Region",7,6,119,1,120,0,1,0,0
"01/06/2022","N","Y","Southeast Fairbanks Census Area",240,"Other Interior Region",7,1,120,0,120,0,1,0,0
"01/10/2022","N","Y","Southeast Fairbanks Census Area",240,"Other Interior Region",7,0,120,1,121,0,1,0,0
"01/17/2022","N","Y","Southeast Fairbanks Census Area",240,"Other Interior Region",7,1,121,1,122,0,1,0,0
"01/19/2022","N","Y","Southeast Fairbanks Census Area",240,"Other Interior Region",7,0,121,1,123,0,1,0,0
"01/21/2022","N","Y","Southeast Fairbanks Census Area",240,"Other Interior Region",7,2,123,0,123,0,1,0,0
"01/22/2022","N","Y","Southeast Fairbanks Census Area",240,"Other Interior Region",7,0,123,3,126,0,1,0,0
"01/23/2022","N","Y","Southeast Fairbanks Census Area",240,"Other Interior Region",7,3,126,0,126,0,1,0,0
"01/25/2022","N","Y","Southeast Fairbanks Census Area",240,"Other Interior Region",7,0,126,3,129,0,1,0,0
"01/26/2022","N","Y","Southeast Fairbanks Census Area",240,"Other Interior Region",7,2,128,1,130,0,1,0,0
"01/27/2022","N","Y","Southeast Fairbanks Census Area",240,"Other Interior Region",7,0,128,1,131,0,1,0,0
"01/28/2022","N","Y","Southeast Fairbanks Census Area",240,"Other Interior Region",7,1,129,0,131,0,1,0,0
"01/29/2022","N","Y","Southeast Fairbanks Census Area",240,"Other Interior Region",7,0,129,1,132,0,1,0,0
"01/31/2022","N","Y","Southeast Fairbanks Census Area",240,"Other Interior Region",7,1,130,1,133,0,1,0,0
"02/01/2022","N","Y","Southeast Fairbanks Census Area",240,"Other Interior Region",7,1,131,0,133,0,1,0,0
"02/02/2022","N","Y","Southeast Fairbanks Census Area",240,"Other Interior Region",7,2,133,1,134,0,1,0,0
"02/03/2022","N","Y","Southeast Fairbanks Census Area",240,"Other Interior Region",7,1,134,0,134,0,1,0,0
"02/05/2022","N","Y","Southeast Fairbanks Census Area",240,"Other Interior Region",7,0,134,1,135,0,1,0,0
"02/06/2022","N","Y","Southeast Fairbanks Census Area",240,"Other Interior Region",7,0,134,2,137,0,1,0,0
"02/07/2022","N","Y","Southeast Fairbanks Census Area",240,"Other Interior Region",7,1,135,0,137,0,1,0,0
"02/08/2022","N","Y","Southeast Fairbanks Census Area",240,"Other Interior Region",7,2,137,0,137,0,1,0,0
"02/14/2022","N","Y","Southeast Fairbanks Census Area",240,"Other Interior Region",7,0,137,1,138,0,1,0,0
"02/15/2022","N","Y","Southeast Fairbanks Census Area",240,"Other Interior Region",7,0,137,1,139,0,1,0,0
"02/17/2022","N","Y","Southeast Fairbanks Census Area",240,"Other Interior Region",7,1,138,0,139,0,1,0,0
"02/18/2022","N","Y","Southeast Fairbanks Census Area",240,"Other Interior Region",7,1,139,0,139,0,1,0,0
"02/19/2022","N","Y","Southeast Fairbanks Census Area",240,"Other Interior Region",7,0,139,1,140,0,1,0,0
"02/21/2022","N","Y","Southeast Fairbanks Census Area",240,"Other Interior Region",7,1,140,0,140,0,1,0,0
"03/21/2022","N","Y","Southeast Fairbanks Census Area",240,"Other Interior Region",7,0,140,1,141,0,1,0,0
"03/22/2022","N","Y","Southeast Fairbanks Census Area",240,"Other Interior Region",7,1,141,0,141,0,1,0,0
"03/23/2022","N","Y","Southeast Fairbanks Census Area",240,"Other Interior Region",7,0,141,3,144,0,1,0,0
"03/24/2022","N","Y","Southeast Fairbanks Census Area",240,"Other Interior Region",7,3,144,0,144,0,1,0,0
"04/21/2022","N","Y","Southeast Fairbanks Census Area",240,"Other Interior Region",7,0,144,2,146,0,1,0,0
"04/22/2022","N","Y","Southeast Fairbanks Census Area",240,"Other Interior Region",7,2,146,0,146,0,1,0,0
"04/25/2022","N","Y","Southeast Fairbanks Census Area",240,"Other Interior Region",7,1,147,1,147,0,1,0,0
"06/30/2020","N","Y","Unknown",999,"Unknown",99,0,0,1,1,0,0,0,0
"07/08/2020","N","Y","Unknown",999,"Unknown",99,1,1,0,1,0,0,0,0
"07/16/2020","N","Y","Unknown",999,"Unknown",99,0,1,1,2,0,0,0,0
"07/20/2020","N","Y","Unknown",999,"Unknown",99,2,3,3,5,0,0,0,0
"07/22/2020","N","Y","Unknown",999,"Unknown",99,1,4,4,9,0,0,0,0
"07/23/2020","N","Y","Unknown",999,"Unknown",99,2,6,0,9,0,0,0,0
"07/24/2020","N","Y","Unknown",999,"Unknown",99,2,8,3,12,0,0,0,0
"07/25/2020","N","Y","Unknown",999,"Unknown",99,1,9,2,14,0,0,0,0
"07/27/2020","N","Y","Unknown",999,"Unknown",99,2,11,3,17,0,0,0,0
"07/28/2020","N","Y","Unknown",999,"Unknown",99,1,12,2,19,0,0,0,0
"07/29/2020","N","Y","Unknown",999,"Unknown",99,3,15,2,21,0,0,0,0
"07/31/2020","N","Y","Unknown",999,"Unknown",99,0,15,1,22,0,0,0,0
"08/01/2020","N","Y","Unknown",999,"Unknown",99,4,19,0,22,0,0,0,0
"08/02/2020","N","Y","Unknown",999,"Unknown",99,1,20,0,22,0,0,0,0
"08/03/2020","N","Y","Unknown",999,"Unknown",99,2,22,0,22,0,0,0,0
"08/04/2020","N","Y","Unknown",999,"Unknown",99,0,22,2,24,0,0,0,0
"08/05/2020","N","Y","Unknown",999,"Unknown",99,0,22,1,25,0,0,0,0
"08/06/2020","N","Y","Unknown",999,"Unknown",99,0,22,1,26,0,0,0,0
"08/07/2020","N","Y","Unknown",999,"Unknown",99,1,23,0,26,0,0,0,0
"08/08/2020","N","Y","Unknown",999,"Unknown",99,0,23,1,27,0,0,0,0
"08/10/2020","N","Y","Unknown",999,"Unknown",99,1,24,1,28,0,0,0,0
"08/12/2020","N","Y","Unknown",999,"Unknown",99,1,25,1,29,0,0,0,0
"08/28/2020","N","Y","Unknown",999,"Unknown",99,1,26,0,29,0,0,0,0
"09/07/2020","N","Y","Unknown",999,"Unknown",99,0,26,1,30,0,0,0,0
"09/15/2020","N","Y","Unknown",999,"Unknown",99,1,27,0,30,0,0,0,0
"09/17/2020","N","Y","Unknown",999,"Unknown",99,1,28,1,31,0,0,0,0
"09/29/2020","N","Y","Unknown",999,"Unknown",99,0,28,1,32,0,0,0,0
"09/30/2020","N","Y","Unknown",999,"Unknown",99,0,28,1,33,0,0,0,0
"10/01/2020","N","Y","Unknown",999,"Unknown",99,0,28,1,34,0,0,0,0
"10/03/2020","N","Y","Unknown",999,"Unknown",99,0,28,1,35,0,0,0,0
"10/05/2020","N","Y","Unknown",999,"Unknown",99,1,29,0,35,0,0,0,0
"10/06/2020","N","Y","Unknown",999,"Unknown",99,0,29,2,37,0,0,0,0
"10/07/2020","N","Y","Unknown",999,"Unknown",99,1,30,1,38,0,0,0,0
"10/08/2020","N","Y","Unknown",999,"Unknown",99,2,32,1,39,0,0,0,0
"10/09/2020","N","Y","Unknown",999,"Unknown",99,1,33,1,40,0,0,0,0
"10/10/2020","N","Y","Unknown",999,"Unknown",99,0,33,1,41,0,0,0,0
"10/11/2020","N","Y","Unknown",999,"Unknown",99,3,36,0,41,0,0,0,0
"10/12/2020","N","Y","Unknown",999,"Unknown",99,1,37,1,42,0,0,0,0
"10/14/2020","N","Y","Unknown",999,"Unknown",99,3,40,0,42,0,0,0,0
"10/15/2020","N","Y","Unknown",999,"Unknown",99,1,41,1,43,0,0,0,0
"10/16/2020","N","Y","Unknown",999,"Unknown",99,0,41,1,44,0,0,0,0
"10/17/2020","N","Y","Unknown",999,"Unknown",99,0,41,2,46,0,0,0,0
"10/19/2020","N","Y","Unknown",999,"Unknown",99,0,41,1,47,0,0,0,0
"10/22/2020","N","Y","Unknown",999,"Unknown",99,1,42,1,48,0,0,0,0
"10/23/2020","N","Y","Unknown",999,"Unknown",99,1,43,0,48,0,0,0,0
"10/24/2020","N","Y","Unknown",999,"Unknown",99,3,46,1,49,0,0,0,0
"10/26/2020","N","Y","Unknown",999,"Unknown",99,0,46,1,50,0,0,0,0
"10/27/2020","N","Y","Unknown",999,"Unknown",99,1,47,1,51,0,0,0,0
"10/28/2020","N","Y","Unknown",999,"Unknown",99,1,48,0,51,0,0,0,0
"10/30/2020","N","Y","Unknown",999,"Unknown",99,1,49,3,54,0,0,0,0
"10/31/2020","N","Y","Unknown",999,"Unknown",99,1,50,1,55,0,0,0,0
"11/01/2020","N","Y","Unknown",999,"Unknown",99,0,50,1,56,0,0,0,0
"11/02/2020","N","Y","Unknown",999,"Unknown",99,1,51,2,58,0,0,0,0
"11/03/2020","N","Y","Unknown",999,"Unknown",99,1,52,1,59,0,0,0,0
"11/04/2020","N","Y","Unknown",999,"Unknown",99,3,55,1,60,0,0,0,0
"11/05/2020","N","Y","Unknown",999,"Unknown",99,2,57,2,62,0,0,0,0
"11/06/2020","N","Y","Unknown",999,"Unknown",99,0,57,0,62,1,1,0,0
"11/07/2020","N","Y","Unknown",999,"Unknown",99,1,58,5,67,0,1,0,0
"11/08/2020","N","Y","Unknown",999,"Unknown",99,1,59,2,69,0,1,0,0
"11/09/2020","N","Y","Unknown",999,"Unknown",99,0,59,1,70,0,1,0,0
"11/10/2020","N","Y","Unknown",999,"Unknown",99,0,59,5,75,0,1,0,0
"11/11/2020","N","Y","Unknown",999,"Unknown",99,1,60,2,77,0,1,0,0
"11/12/2020","N","Y","Unknown",999,"Unknown",99,2,62,0,77,0,1,0,0
"11/13/2020","N","Y","Unknown",999,"Unknown",99,8,70,2,79,0,1,0,0
"11/14/2020","N","Y","Unknown",999,"Unknown",99,1,71,0,79,0,1,0,0
"11/15/2020","N","Y","Unknown",999,"Unknown",99,1,72,0,79,0,1,0,0
"11/16/2020","N","Y","Unknown",999,"Unknown",99,1,73,4,83,0,1,0,0
"11/17/2020","N","Y","Unknown",999,"Unknown",99,0,73,2,85,0,1,0,0
"11/18/2020","N","Y","Unknown",999,"Unknown",99,1,74,3,88,0,1,0,0
"11/19/2020","N","Y","Unknown",999,"Unknown",99,0,74,2,90,0,1,0,0
"11/20/2020","N","Y","Unknown",999,"Unknown",99,1,75,1,91,0,1,0,0
"11/21/2020","N","Y","Unknown",999,"Unknown",99,0,75,1,92,0,1,0,0
"11/22/2020","N","Y","Unknown",999,"Unknown",99,1,76,3,95,0,1,0,0
"11/23/2020","N","Y","Unknown",999,"Unknown",99,4,80,6,101,0,1,0,0
"11/24/2020","N","Y","Unknown",999,"Unknown",99,5,85,3,104,1,2,0,0
"11/25/2020","N","Y","Unknown",999,"Unknown",99,4,89,0,104,0,2,0,0
"11/26/2020","N","Y","Unknown",999,"Unknown",99,2,91,0,104,0,2,0,0
"11/27/2020","N","Y","Unknown",999,"Unknown",99,3,94,1,105,0,2,0,0
"11/28/2020","N","Y","Unknown",999,"Unknown",99,1,95,1,106,0,2,0,0
"11/29/2020","N","Y","Unknown",999,"Unknown",99,1,96,1,107,0,2,0,0
"11/30/2020","N","Y","Unknown",999,"Unknown",99,0,96,1,108,0,2,0,0
"12/01/2020","N","Y","Unknown",999,"Unknown",99,2,98,3,111,0,2,0,0
"12/02/2020","N","Y","Unknown",999,"Unknown",99,2,100,6,117,0,2,0,0
"12/03/2020","N","Y","Unknown",999,"Unknown",99,3,103,4,121,0,2,0,0
"12/04/2020","N","Y","Unknown",999,"Unknown",99,3,106,5,126,0,2,0,0
"12/05/2020","N","Y","Unknown",999,"Unknown",99,0,106,1,127,0,2,0,0
"12/06/2020","N","Y","Unknown",999,"Unknown",99,6,112,2,129,0,2,0,0
"12/07/2020","N","Y","Unknown",999,"Unknown",99,5,117,7,136,1,3,0,0
"12/08/2020","N","Y","Unknown",999,"Unknown",99,1,118,1,137,0,3,0,0
"12/09/2020","N","Y","Unknown",999,"Unknown",99,11,129,0,137,0,3,0,0
"12/10/2020","N","Y","Unknown",999,"Unknown",99,3,132,7,144,1,4,0,0
"12/11/2020","N","Y","Unknown",999,"Unknown",99,2,134,1,145,0,4,0,0
"12/12/2020","N","Y","Unknown",999,"Unknown",99,2,136,0,145,0,4,0,0
"12/13/2020","N","Y","Unknown",999,"Unknown",99,3,139,1,146,0,4,0,0
"12/14/2020","N","Y","Unknown",999,"Unknown",99,0,139,2,148,0,4,0,0
"12/15/2020","N","Y","Unknown",999,"Unknown",99,3,142,0,148,0,4,0,0
"12/16/2020","N","Y","Unknown",999,"Unknown",99,2,144,3,151,0,4,0,0
"12/17/2020","N","Y","Unknown",999,"Unknown",99,3,147,1,152,0,4,0,0
"12/18/2020","N","Y","Unknown",999,"Unknown",99,2,149,1,153,0,4,0,0
"12/19/2020","N","Y","Unknown",999,"Unknown",99,1,150,0,153,0,4,0,0
"12/22/2020","N","Y","Unknown",999,"Unknown",99,1,151,0,153,0,4,0,0
"12/23/2020","N","Y","Unknown",999,"Unknown",99,0,151,0,153,1,5,0,0
"12/24/2020","N","Y","Unknown",999,"Unknown",99,1,152,3,156,0,5,0,0
"12/25/2020","N","Y","Unknown",999,"Unknown",99,3,155,0,156,0,5,0,0
"12/27/2020","N","Y","Unknown",999,"Unknown",99,0,155,4,160,0,5,0,0
"12/28/2020","N","Y","Unknown",999,"Unknown",99,2,157,2,162,0,5,0,0
"12/29/2020","N","Y","Unknown",999,"Unknown",99,3,160,1,163,0,5,0,0
"12/30/2020","N","Y","Unknown",999,"Unknown",99,0,160,2,165,0,5,0,0
"12/31/2020","N","Y","Unknown",999,"Unknown",99,3,163,3,168,0,5,0,0
"01/01/2021","N","Y","Unknown",999,"Unknown",99,0,163,2,170,0,5,0,0
"01/02/2021","N","Y","Unknown",999,"Unknown",99,0,163,2,172,0,5,0,0
"01/03/2021","N","Y","Unknown",999,"Unknown",99,2,165,2,174,0,5,0,0
"01/04/2021","N","Y","Unknown",999,"Unknown",99,3,168,5,179,0,5,0,0
"01/05/2021","N","Y","Unknown",999,"Unknown",99,5,173,1,180,0,5,0,0
"01/06/2021","N","Y","Unknown",999,"Unknown",99,1,174,4,184,0,5,0,0
"01/07/2021","N","Y","Unknown",999,"Unknown",99,2,176,4,188,0,5,0,0
"01/08/2021","N","Y","Unknown",999,"Unknown",99,7,183,1,189,0,5,0,0
"01/09/2021","N","Y","Unknown",999,"Unknown",99,1,184,0,189,0,5,0,0
"01/10/2021","N","Y","Unknown",999,"Unknown",99,1,185,2,191,0,5,0,0
"01/11/2021","N","Y","Unknown",999,"Unknown",99,0,185,3,194,0,5,0,0
"01/12/2021","N","Y","Unknown",999,"Unknown",99,1,186,2,196,0,5,0,0
"01/13/2021","N","Y","Unknown",999,"Unknown",99,5,191,4,200,0,5,0,0
"01/14/2021","N","Y","Unknown",999,"Unknown",99,4,195,0,200,0,5,0,0
"01/15/2021","N","Y","Unknown",999,"Unknown",99,1,196,3,203,0,5,0,0
"01/16/2021","N","Y","Unknown",999,"Unknown",99,3,199,2,205,0,5,0,0
"01/18/2021","N","Y","Unknown",999,"Unknown",99,1,200,0,205,0,5,0,0
"01/19/2021","N","Y","Unknown",999,"Unknown",99,3,203,0,205,0,5,0,0
"01/20/2021","N","Y","Unknown",999,"Unknown",99,1,204,1,206,0,5,0,0
"01/21/2021","N","Y","Unknown",999,"Unknown",99,2,206,1,207,0,5,0,0
"01/22/2021","N","Y","Unknown",999,"Unknown",99,0,206,1,208,0,5,0,0
"01/23/2021","N","Y","Unknown",999,"Unknown",99,0,206,1,209,0,5,0,0
"01/24/2021","N","Y","Unknown",999,"Unknown",99,1,207,1,210,0,5,0,0
"01/25/2021","N","Y","Unknown",999,"Unknown",99,0,207,1,211,0,5,0,0
"01/26/2021","N","Y","Unknown",999,"Unknown",99,2,209,1,212,0,5,0,0
"01/27/2021","N","Y","Unknown",999,"Unknown",99,0,209,2,214,0,5,0,0
"01/28/2021","N","Y","Unknown",999,"Unknown",99,2,211,0,214,0,5,0,0
"01/29/2021","N","Y","Unknown",999,"Unknown",99,1,212,3,217,0,5,0,0
"01/30/2021","N","Y","Unknown",999,"Unknown",99,1,213,0,217,0,5,0,0
"01/31/2021","N","Y","Unknown",999,"Unknown",99,3,216,1,218,0,5,0,0
"02/01/2021","N","Y","Unknown",999,"Unknown",99,0,216,5,223,0,5,0,0
"02/02/2021","N","Y","Unknown",999,"Unknown",99,2,218,0,223,0,5,0,0
"02/03/2021","N","Y","Unknown",999,"Unknown",99,0,218,2,225,0,5,0,0
"02/04/2021","N","Y","Unknown",999,"Unknown",99,0,218,1,226,0,5,0,0
"02/05/2021","N","Y","Unknown",999,"Unknown",99,1,219,0,226,0,5,0,0
"02/07/2021","N","Y","Unknown",999,"Unknown",99,7,226,1,227,0,5,0,0
"02/08/2021","N","Y","Unknown",999,"Unknown",99,0,226,1,228,0,5,0,0
"02/09/2021","N","Y","Unknown",999,"Unknown",99,2,228,1,229,0,5,0,0
"02/10/2021","N","Y","Unknown",999,"Unknown",99,0,228,2,231,1,6,0,0
"02/11/2021","N","Y","Unknown",999,"Unknown",99,3,231,1,232,0,6,0,0
"02/12/2021","N","Y","Unknown",999,"Unknown",99,1,232,0,232,0,6,0,0
"02/16/2021","N","Y","Unknown",999,"Unknown",99,0,232,1,233,0,6,0,0
"02/17/2021","N","Y","Unknown",999,"Unknown",99,0,232,1,234,0,6,0,0
"02/19/2021","N","Y","Unknown",999,"Unknown",99,0,232,1,235,0,6,0,0
"02/22/2021","N","Y","Unknown",999,"Unknown",99,0,232,1,236,0,6,0,0
"02/23/2021","N","Y","Unknown",999,"Unknown",99,1,233,0,236,0,6,0,0
"02/24/2021","N","Y","Unknown",999,"Unknown",99,2,235,2,238,0,6,0,0
"02/25/2021","N","Y","Unknown",999,"Unknown",99,1,236,5,243,0,6,0,0
"02/27/2021","N","Y","Unknown",999,"Unknown",99,6,242,0,243,0,6,0,0
"03/01/2021","N","Y","Unknown",999,"Unknown",99,0,242,1,244,0,6,0,0
"03/02/2021","N","Y","Unknown",999,"Unknown",99,0,242,1,245,0,6,0,0
"03/03/2021","N","Y","Unknown",999,"Unknown",99,2,244,0,245,0,6,0,0
"03/04/2021","N","Y","Unknown",999,"Unknown",99,1,245,0,245,0,6,0,0
"03/07/2021","N","Y","Unknown",999,"Unknown",99,1,246,1,246,0,6,0,0
"03/08/2021","N","Y","Unknown",999,"Unknown",99,0,246,1,247,0,6,0,0
"03/12/2021","N","Y","Unknown",999,"Unknown",99,0,246,1,248,0,6,0,0
"03/13/2021","N","Y","Unknown",999,"Unknown",99,1,247,0,248,0,6,0,0
"03/18/2021","N","Y","Unknown",999,"Unknown",99,0,247,1,249,0,6,0,0
"03/20/2021","N","Y","Unknown",999,"Unknown",99,0,247,2,251,0,6,0,0
"03/22/2021","N","Y","Unknown",999,"Unknown",99,1,248,0,251,0,6,0,0
"03/23/2021","N","Y","Unknown",999,"Unknown",99,1,249,1,252,0,6,0,0
"03/24/2021","N","Y","Unknown",999,"Unknown",99,0,249,1,253,0,6,0,0
"03/25/2021","N","Y","Unknown",999,"Unknown",99,1,250,2,255,0,6,0,0
"03/26/2021","N","Y","Unknown",999,"Unknown",99,5,255,2,257,0,6,0,0
"03/28/2021","N","Y","Unknown",999,"Unknown",99,2,257,0,257,0,6,0,0
"03/29/2021","N","Y","Unknown",999,"Unknown",99,0,257,1,258,0,6,0,0
"03/30/2021","N","Y","Unknown",999,"Unknown",99,1,258,1,259,0,6,0,0
"03/31/2021","N","Y","Unknown",999,"Unknown",99,1,259,0,259,0,6,0,0
"04/01/2021","N","Y","Unknown",999,"Unknown",99,0,259,1,260,0,6,0,0
"04/02/2021","N","Y","Unknown",999,"Unknown",99,0,259,0,260,1,7,0,0
"04/03/2021","N","Y","Unknown",999,"Unknown",99,0,259,1,261,0,7,0,0
"04/06/2021","N","Y","Unknown",999,"Unknown",99,1,260,1,262,0,7,0,0
"04/07/2021","N","Y","Unknown",999,"Unknown",99,1,261,0,262,0,7,0,0
"04/09/2021","N","Y","Unknown",999,"Unknown",99,2,263,1,263,0,7,0,0
"04/11/2021","N","Y","Unknown",999,"Unknown",99,1,264,1,264,0,7,0,0
"04/12/2021","N","Y","Unknown",999,"Unknown",99,0,264,2,266,0,7,0,0
"04/13/2021","N","Y","Unknown",999,"Unknown",99,0,264,2,268,0,7,0,0
"04/15/2021","N","Y","Unknown",999,"Unknown",99,2,266,0,268,0,7,0,0
"04/17/2021","N","Y","Unknown",999,"Unknown",99,0,266,0,268,1,8,0,0
"04/22/2021","N","Y","Unknown",999,"Unknown",99,0,266,2,270,0,8,0,0
"04/23/2021","N","Y","Unknown",999,"Unknown",99,1,267,0,270,0,8,0,0
"04/26/2021","N","Y","Unknown",999,"Unknown",99,2,269,0,270,0,8,0,0
"04/28/2021","N","Y","Unknown",999,"Unknown",99,0,269,1,271,0,8,0,0
"04/29/2021","N","Y","Unknown",999,"Unknown",99,1,270,1,272,0,8,0,0
"04/30/2021","N","Y","Unknown",999,"Unknown",99,0,270,2,274,0,8,0,0
"05/01/2021","N","Y","Unknown",999,"Unknown",99,2,272,0,274,0,8,0,0
"05/03/2021","N","Y","Unknown",999,"Unknown",99,2,274,1,275,0,8,0,0
"05/04/2021","N","Y","Unknown",999,"Unknown",99,1,275,0,275,0,8,0,0
"05/06/2021","N","Y","Unknown",999,"Unknown",99,0,275,2,277,0,8,0,0
"05/07/2021","N","Y","Unknown",999,"Unknown",99,1,276,1,278,0,8,0,0
"05/08/2021","N","Y","Unknown",999,"Unknown",99,1,277,0,278,0,8,0,0
"05/10/2021","N","Y","Unknown",999,"Unknown",99,1,278,1,279,0,8,0,0
"05/11/2021","N","Y","Unknown",999,"Unknown",99,1,279,0,279,0,8,0,0
"05/13/2021","N","Y","Unknown",999,"Unknown",99,0,279,1,280,0,8,0,0
"05/14/2021","N","Y","Unknown",999,"Unknown",99,1,280,0,280,0,8,0,0
"05/23/2021","N","Y","Unknown",999,"Unknown",99,0,280,1,281,0,8,0,0
"05/26/2021","N","Y","Unknown",999,"Unknown",99,1,281,0,281,0,8,0,0
"05/29/2021","N","Y","Unknown",999,"Unknown",99,0,281,1,282,0,8,0,0
"05/30/2021","N","Y","Unknown",999,"Unknown",99,1,282,0,282,0,8,0,0
"06/07/2021","N","Y","Unknown",999,"Unknown",99,1,283,1,283,0,8,0,0
"06/16/2021","N","Y","Unknown",999,"Unknown",99,0,283,1,284,0,8,0,0
"06/21/2021","N","Y","Unknown",999,"Unknown",99,1,284,1,285,0,8,0,0
"06/23/2021","N","Y","Unknown",999,"Unknown",99,1,285,0,285,0,8,0,0
"06/26/2021","N","Y","Unknown",999,"Unknown",99,1,286,1,286,0,8,0,0
"06/28/2021","N","Y","Unknown",999,"Unknown",99,0,286,1,287,0,8,0,0
"06/29/2021","N","Y","Unknown",999,"Unknown",99,0,286,1,288,0,8,0,0
"06/30/2021","N","Y","Unknown",999,"Unknown",99,0,286,2,290,0,8,0,0
"07/01/2021","N","Y","Unknown",999,"Unknown",99,2,288,0,290,0,8,0,0
"07/02/2021","N","Y","Unknown",999,"Unknown",99,1,289,1,291,0,8,0,0
"07/03/2021","N","Y","Unknown",999,"Unknown",99,1,290,0,291,0,8,0,0
"07/07/2021","N","Y","Unknown",999,"Unknown",99,0,290,2,293,0,8,0,0
"07/08/2021","N","Y","Unknown",999,"Unknown",99,0,290,1,294,0,8,0,0
"07/09/2021","N","Y","Unknown",999,"Unknown",99,2,292,0,294,0,8,0,0
"07/10/2021","N","Y","Unknown",999,"Unknown",99,0,292,1,295,0,8,0,0
"07/11/2021","N","Y","Unknown",999,"Unknown",99,0,292,2,297,0,8,0,0
"07/13/2021","N","Y","Unknown",999,"Unknown",99,4,296,0,297,0,8,0,0
"07/14/2021","N","Y","Unknown",999,"Unknown",99,1,297,1,298,0,8,0,0
"07/15/2021","N","Y","Unknown",999,"Unknown",99,0,297,2,300,0,8,0,0
"07/16/2021","N","Y","Unknown",999,"Unknown",99,0,297,2,302,0,8,0,0
"07/17/2021","N","Y","Unknown",999,"Unknown",99,2,299,2,304,0,8,0,0
"07/18/2021","N","Y","Unknown",999,"Unknown",99,0,299,4,308,0,8,0,0
"07/19/2021","N","Y","Unknown",999,"Unknown",99,10,309,4,312,0,8,0,0
"07/20/2021","N","Y","Unknown",999,"Unknown",99,0,309,5,317,0,8,0,0
"07/21/2021","N","Y","Unknown",999,"Unknown",99,5,314,0,317,0,8,0,0
"07/22/2021","N","Y","Unknown",999,"Unknown",99,2,316,4,321,0,8,0,0
"07/23/2021","N","Y","Unknown",999,"Unknown",99,2,318,1,322,0,8,0,0
"07/24/2021","N","Y","Unknown",999,"Unknown",99,0,318,2,324,0,8,0,0
"07/26/2021","N","Y","Unknown",999,"Unknown",99,1,319,3,327,0,8,0,0
"07/27/2021","N","Y","Unknown",999,"Unknown",99,4,323,0,327,0,8,0,0
"07/28/2021","N","Y","Unknown",999,"Unknown",99,0,323,2,329,0,8,0,0
"07/29/2021","N","Y","Unknown",999,"Unknown",99,1,324,4,333,0,8,0,0
"07/30/2021","N","Y","Unknown",999,"Unknown",99,0,324,7,340,0,8,0,0
"07/31/2021","N","Y","Unknown",999,"Unknown",99,2,326,2,342,0,8,0,0
"08/01/2021","N","Y","Unknown",999,"Unknown",99,10,336,0,342,0,8,0,0
"08/02/2021","N","Y","Unknown",999,"Unknown",99,0,336,2,344,0,8,0,0
"08/03/2021","N","Y","Unknown",999,"Unknown",99,1,337,3,347,0,8,0,0
"08/04/2021","N","Y","Unknown",999,"Unknown",99,7,344,4,351,0,8,0,0
"08/05/2021","N","Y","Unknown",999,"Unknown",99,4,348,2,353,0,8,0,0
"08/06/2021","N","Y","Unknown",999,"Unknown",99,1,349,2,355,0,8,0,0
"08/07/2021","N","Y","Unknown",999,"Unknown",99,1,350,0,355,0,8,0,0
"08/08/2021","N","Y","Unknown",999,"Unknown",99,0,350,1,356,0,8,0,0
"08/09/2021","N","Y","Unknown",999,"Unknown",99,3,353,3,359,0,8,0,0
"08/10/2021","N","Y","Unknown",999,"Unknown",99,1,354,1,360,0,8,0,0
"08/11/2021","N","Y","Unknown",999,"Unknown",99,0,354,1,361,0,8,0,0
"08/12/2021","N","Y","Unknown",999,"Unknown",99,0,354,2,363,0,8,0,0
"08/13/2021","N","Y","Unknown",999,"Unknown",99,1,355,4,367,0,8,0,0
"08/14/2021","N","Y","Unknown",999,"Unknown",99,0,355,1,368,0,8,0,0
"08/15/2021","N","Y","Unknown",999,"Unknown",99,2,357,3,371,0,8,0,0
"08/16/2021","N","Y","Unknown",999,"Unknown",99,1,358,2,373,0,8,0,0
"08/17/2021","N","Y","Unknown",999,"Unknown",99,7,365,7,380,0,8,0,0
"08/18/2021","N","Y","Unknown",999,"Unknown",99,2,367,0,380,0,8,0,0
"08/19/2021","N","Y","Unknown",999,"Unknown",99,5,372,5,385,0,8,0,0
"08/20/2021","N","Y","Unknown",999,"Unknown",99,3,375,5,390,0,8,0,0
"08/21/2021","N","Y","Unknown",999,"Unknown",99,0,375,1,391,0,8,0,0
"08/23/2021","N","Y","Unknown",999,"Unknown",99,2,377,6,397,0,8,0,0
"08/24/2021","N","Y","Unknown",999,"Unknown",99,2,379,2,399,0,8,0,0
"08/25/2021","N","Y","Unknown",999,"Unknown",99,1,380,1,400,0,8,0,0
"08/26/2021","N","Y","Unknown",999,"Unknown",99,10,390,1,401,0,8,0,0
"08/27/2021","N","Y","Unknown",999,"Unknown",99,8,398,1,402,0,8,0,0
"08/28/2021","N","Y","Unknown",999,"Unknown",99,1,399,1,403,0,8,0,0
"08/29/2021","N","Y","Unknown",999,"Unknown",99,0,399,2,405,0,8,0,0
"08/30/2021","N","Y","Unknown",999,"Unknown",99,1,400,11,416,1,9,0,0
"08/31/2021","N","Y","Unknown",999,"Unknown",99,3,403,5,421,0,9,0,0
"09/01/2021","N","Y","Unknown",999,"Unknown",99,2,405,2,423,0,9,0,0
"09/02/2021","N","Y","Unknown",999,"Unknown",99,2,407,2,425,1,10,0,0
"09/03/2021","N","Y","Unknown",999,"Unknown",99,10,417,1,426,0,10,0,0
"09/04/2021","N","Y","Unknown",999,"Unknown",99,1,418,2,428,0,10,0,0
"09/05/2021","N","Y","Unknown",999,"Unknown",99,0,418,3,431,0,10,0,0
"09/06/2021","N","Y","Unknown",999,"Unknown",99,3,421,2,433,0,10,0,0
"09/07/2021","N","Y","Unknown",999,"Unknown",99,2,423,2,435,0,10,0,0
"09/08/2021","N","Y","Unknown",999,"Unknown",99,1,424,7,442,0,10,0,0
"09/09/2021","N","Y","Unknown",999,"Unknown",99,1,425,3,445,0,10,0,0
"09/10/2021","N","Y","Unknown",999,"Unknown",99,0,425,12,457,0,10,0,0
"09/11/2021","N","Y","Unknown",999,"Unknown",99,1,426,14,471,0,10,0,0
"09/12/2021","N","Y","Unknown",999,"Unknown",99,0,426,1,472,0,10,0,0
"09/13/2021","N","Y","Unknown",999,"Unknown",99,4,430,6,478,0,10,0,0
"09/14/2021","N","Y","Unknown",999,"Unknown",99,6,436,7,485,0,10,0,0
"09/15/2021","N","Y","Unknown",999,"Unknown",99,1,437,12,497,2,12,0,0
"09/16/2021","N","Y","Unknown",999,"Unknown",99,4,441,5,502,0,12,0,0
"09/17/2021","N","Y","Unknown",999,"Unknown",99,7,448,5,507,0,12,0,0
"09/18/2021","N","Y","Unknown",999,"Unknown",99,3,451,0,507,0,12,0,0
"09/19/2021","N","Y","Unknown",999,"Unknown",99,0,451,2,509,0,12,0,0
"09/20/2021","N","Y","Unknown",999,"Unknown",99,13,464,6,515,0,12,0,0
"09/21/2021","N","Y","Unknown",999,"Unknown",99,7,471,1,516,0,12,0,0
"09/22/2021","N","Y","Unknown",999,"Unknown",99,14,485,3,519,0,12,0,0
"09/23/2021","N","Y","Unknown",999,"Unknown",99,12,497,4,523,0,12,0,0
"09/24/2021","N","Y","Unknown",999,"Unknown",99,8,505,2,525,0,12,0,0
"09/25/2021","N","Y","Unknown",999,"Unknown",99,2,507,1,526,0,12,0,0
"09/26/2021","N","Y","Unknown",999,"Unknown",99,1,508,3,529,0,12,0,0
"09/27/2021","N","Y","Unknown",999,"Unknown",99,1,509,2,531,0,12,0,0
"09/28/2021","N","Y","Unknown",999,"Unknown",99,10,519,5,536,0,12,0,0
"09/29/2021","N","Y","Unknown",999,"Unknown",99,4,523,2,538,0,12,0,0
"09/30/2021","N","Y","Unknown",999,"Unknown",99,6,529,0,538,0,12,0,0
"10/01/2021","N","Y","Unknown",999,"Unknown",99,8,537,0,538,0,12,0,0
"10/02/2021","N","Y","Unknown",999,"Unknown",99,1,538,1,539,0,12,0,0
"10/03/2021","N","Y","Unknown",999,"Unknown",99,0,538,4,543,0,12,0,0
"10/04/2021","N","Y","Unknown",999,"Unknown",99,4,542,9,552,0,12,0,0
"10/05/2021","N","Y","Unknown",999,"Unknown",99,3,545,1,553,0,12,1,1
"10/06/2021","N","Y","Unknown",999,"Unknown",99,4,549,0,553,0,12,0,1
"10/07/2021","N","Y","Unknown",999,"Unknown",99,2,551,1,554,0,12,0,1
"10/08/2021","N","Y","Unknown",999,"Unknown",99,0,551,1,555,0,12,0,1
"10/11/2021","N","Y","Unknown",999,"Unknown",99,0,551,1,556,0,12,0,1
"10/12/2021","N","Y","Unknown",999,"Unknown",99,0,551,1,557,0,12,0,1
"10/13/2021","N","Y","Unknown",999,"Unknown",99,2,553,1,558,0,12,0,1
"10/14/2021","N","Y","Unknown",999,"Unknown",99,4,557,0,558,0,12,0,1
"10/17/2021","N","Y","Unknown",999,"Unknown",99,0,557,2,560,0,12,0,1
"10/18/2021","N","Y","Unknown",999,"Unknown",99,0,557,7,567,0,12,0,1
"10/19/2021","N","Y","Unknown",999,"Unknown",99,1,558,1,568,0,12,0,1
"10/20/2021","N","Y","Unknown",999,"Unknown",99,9,567,2,570,0,12,0,1
"10/21/2021","N","Y","Unknown",999,"Unknown",99,1,568,0,570,0,12,0,1
"10/22/2021","N","Y","Unknown",999,"Unknown",99,1,569,0,570,0,12,0,1
"10/25/2021","N","Y","Unknown",999,"Unknown",99,1,570,4,574,0,12,0,1
"10/26/2021","N","Y","Unknown",999,"Unknown",99,2,572,1,575,0,12,0,1
"10/27/2021","N","Y","Unknown",999,"Unknown",99,1,573,0,575,0,12,0,1
"10/28/2021","N","Y","Unknown",999,"Unknown",99,2,575,0,575,0,12,0,1
"10/29/2021","N","Y","Unknown",999,"Unknown",99,0,575,1,576,0,12,0,1
"10/30/2021","N","Y","Unknown",999,"Unknown",99,1,576,0,576,0,12,0,1
"11/01/2021","N","Y","Unknown",999,"Unknown",99,0,576,1,577,0,12,0,1
"11/02/2021","N","Y","Unknown",999,"Unknown",99,0,576,1,578,0,12,0,1
"11/03/2021","N","Y","Unknown",999,"Unknown",99,1,577,1,579,0,12,0,1
"11/04/2021","N","Y","Unknown",999,"Unknown",99,0,577,2,581,0,12,0,1
"11/05/2021","N","Y","Unknown",999,"Unknown",99,1,578,0,581,0,12,0,1
"11/07/2021","N","Y","Unknown",999,"Unknown",99,1,579,0,581,0,12,0,1
"11/09/2021","N","Y","Unknown",999,"Unknown",99,1,580,1,582,0,12,0,1
"11/10/2021","N","Y","Unknown",999,"Unknown",99,2,582,1,583,0,12,0,1
"11/11/2021","N","Y","Unknown",999,"Unknown",99,1,583,0,583,0,12,0,1
"11/12/2021","N","Y","Unknown",999,"Unknown",99,0,583,1,584,0,12,0,1
"11/14/2021","N","Y","Unknown",999,"Unknown",99,1,584,0,584,0,12,0,1
"11/15/2021","N","Y","Unknown",999,"Unknown",99,1,585,1,585,0,12,0,1
"11/16/2021","N","Y","Unknown",999,"Unknown",99,1,586,1,586,0,12,0,1
"11/17/2021","N","Y","Unknown",999,"Unknown",99,0,586,2,588,0,12,0,1
"11/18/2021","N","Y","Unknown",999,"Unknown",99,1,587,1,589,0,12,0,1
"11/23/2021","N","Y","Unknown",999,"Unknown",99,2,589,0,589,0,12,0,1
"11/27/2021","N","Y","Unknown",999,"Unknown",99,0,589,1,590,0,12,0,1
"12/02/2021","N","Y","Unknown",999,"Unknown",99,1,590,0,590,0,12,0,1
"12/04/2021","N","Y","Unknown",999,"Unknown",99,0,590,1,591,0,12,0,1
"12/06/2021","N","Y","Unknown",999,"Unknown",99,1,591,0,591,0,12,0,1
"12/07/2021","N","Y","Unknown",999,"Unknown",99,0,591,1,592,0,12,0,1
"12/08/2021","N","Y","Unknown",999,"Unknown",99,1,592,0,592,0,12,0,1
"12/12/2021","N","Y","Unknown",999,"Unknown",99,0,592,1,593,0,12,0,1
"12/13/2021","N","Y","Unknown",999,"Unknown",99,1,593,0,593,0,12,0,1
"12/21/2021","N","Y","Unknown",999,"Unknown",99,0,593,1,594,0,12,0,1
"12/23/2021","N","Y","Unknown",999,"Unknown",99,0,593,3,597,0,12,0,1
"12/24/2021","N","Y","Unknown",999,"Unknown",99,1,594,0,597,0,12,0,1
"12/27/2021","N","Y","Unknown",999,"Unknown",99,2,596,0,597,0,12,0,1
"12/28/2021","N","Y","Unknown",999,"Unknown",99,0,596,8,605,0,12,0,1
"12/29/2021","N","Y","Unknown",999,"Unknown",99,0,596,4,609,0,12,0,1
"12/30/2021","N","Y","Unknown",999,"Unknown",99,1,597,2,611,0,12,0,1
"12/31/2021","N","Y","Unknown",999,"Unknown",99,0,597,2,613,0,12,0,1
"01/02/2022","N","Y","Unknown",999,"Unknown",99,2,599,3,616,0,12,0,1
"01/03/2022","N","Y","Unknown",999,"Unknown",99,2,601,3,619,0,12,0,1
"01/04/2022","N","Y","Unknown",999,"Unknown",99,16,617,3,622,0,12,0,1
"01/05/2022","N","Y","Unknown",999,"Unknown",99,0,617,2,624,0,12,0,1
"01/06/2022","N","Y","Unknown",999,"Unknown",99,0,617,13,637,0,12,0,1
"01/07/2022","N","Y","Unknown",999,"Unknown",99,1,618,5,642,0,12,0,1
"01/08/2022","N","Y","Unknown",999,"Unknown",99,1,619,3,645,0,12,0,1
"01/09/2022","N","Y","Unknown",999,"Unknown",99,0,619,3,648,0,12,0,1
"01/10/2022","N","Y","Unknown",999,"Unknown",99,2,621,6,654,0,12,0,1
"01/11/2022","N","Y","Unknown",999,"Unknown",99,15,636,24,678,0,12,0,1
"01/12/2022","N","Y","Unknown",999,"Unknown",99,14,650,15,693,0,12,0,1
"01/13/2022","N","Y","Unknown",999,"Unknown",99,5,655,13,706,0,12,0,1
"01/14/2022","N","Y","Unknown",999,"Unknown",99,6,661,13,719,0,12,0,1
"01/15/2022","N","Y","Unknown",999,"Unknown",99,8,669,11,730,0,12,0,1
"01/16/2022","N","Y","Unknown",999,"Unknown",99,4,673,6,736,0,12,0,1
"01/17/2022","N","Y","Unknown",999,"Unknown",99,1,674,7,743,0,12,0,1
"01/18/2022","N","Y","Unknown",999,"Unknown",99,13,687,21,764,0,12,0,1
"01/19/2022","N","Y","Unknown",999,"Unknown",99,43,730,11,775,1,13,0,1
"01/20/2022","N","Y","Unknown",999,"Unknown",99,8,738,9,784,0,13,0,1
"01/21/2022","N","Y","Unknown",999,"Unknown",99,2,740,14,798,0,13,0,1
"01/22/2022","N","Y","Unknown",999,"Unknown",99,3,743,5,803,0,13,0,1
"01/23/2022","N","Y","Unknown",999,"Unknown",99,2,745,4,807,0,13,0,1
"01/24/2022","N","Y","Unknown",999,"Unknown",99,7,752,10,817,0,13,0,1
"01/25/2022","N","Y","Unknown",999,"Unknown",99,7,759,5,822,0,13,0,1
"01/26/2022","N","Y","Unknown",999,"Unknown",99,13,772,3,825,0,13,0,1
"01/27/2022","N","Y","Unknown",999,"Unknown",99,35,807,10,835,0,13,0,1
"01/28/2022","N","Y","Unknown",999,"Unknown",99,3,810,10,845,0,13,0,1
"01/29/2022","N","Y","Unknown",999,"Unknown",99,1,811,3,848,0,13,0,1
"01/30/2022","N","Y","Unknown",999,"Unknown",99,1,812,3,851,0,13,0,1
"01/31/2022","N","Y","Unknown",999,"Unknown",99,13,825,5,856,0,13,0,1
"02/01/2022","N","Y","Unknown",999,"Unknown",99,7,832,3,859,0,13,0,1
"02/02/2022","N","Y","Unknown",999,"Unknown",99,2,834,1,860,0,13,0,1
"02/03/2022","N","Y","Unknown",999,"Unknown",99,11,845,2,862,0,13,0,1
"02/04/2022","N","Y","Unknown",999,"Unknown",99,6,851,3,865,0,13,0,1
"02/05/2022","N","Y","Unknown",999,"Unknown",99,10,861,1,866,0,13,0,1
"02/06/2022","N","Y","Unknown",999,"Unknown",99,2,863,0,866,0,13,0,1
"02/07/2022","N","Y","Unknown",999,"Unknown",99,0,863,1,867,0,13,0,1
"02/08/2022","N","Y","Unknown",999,"Unknown",99,0,863,1,868,0,13,0,1
"02/09/2022","N","Y","Unknown",999,"Unknown",99,2,865,1,869,0,13,0,1
"02/10/2022","N","Y","Unknown",999,"Unknown",99,1,866,0,869,0,13,0,1
"02/11/2022","N","Y","Unknown",999,"Unknown",99,0,866,3,872,0,13,0,1
"02/12/2022","N","Y","Unknown",999,"Unknown",99,1,867,0,872,0,13,0,1
"02/13/2022","N","Y","Unknown",999,"Unknown",99,3,870,0,872,0,13,0,1
"02/14/2022","N","Y","Unknown",999,"Unknown",99,2,872,0,872,0,13,0,1
"02/16/2022","N","Y","Unknown",999,"Unknown",99,0,872,1,873,0,13,0,1
"02/17/2022","N","Y","Unknown",999,"Unknown",99,1,873,0,873,0,13,0,1
"02/18/2022","N","Y","Unknown",999,"Unknown",99,0,873,1,874,0,13,0,1
"02/25/2022","N","Y","Unknown",999,"Unknown",99,1,874,1,875,0,13,0,1
"02/26/2022","N","Y","Unknown",999,"Unknown",99,1,875,0,875,0,13,0,1
"02/28/2022","N","Y","Unknown",999,"Unknown",99,1,876,1,876,0,13,0,1
"03/03/2022","N","Y","Unknown",999,"Unknown",99,0,876,1,877,0,13,0,1
"03/05/2022","N","Y","Unknown",999,"Unknown",99,1,877,0,877,0,13,0,1
"03/09/2022","N","Y","Unknown",999,"Unknown",99,0,877,1,878,0,13,0,1
"03/10/2022","N","Y","Unknown",999,"Unknown",99,0,877,8,886,0,13,0,1
"03/11/2022","N","Y","Unknown",999,"Unknown",99,2,879,2,888,0,13,0,1
"03/12/2022","N","Y","Unknown",999,"Unknown",99,8,887,0,888,0,13,0,1
"03/13/2022","N","Y","Unknown",999,"Unknown",99,1,888,0,888,0,13,0,1
"03/16/2022","N","Y","Unknown",999,"Unknown",99,0,888,1,889,0,13,0,1
"03/17/2022","N","Y","Unknown",999,"Unknown",99,0,888,1,890,0,13,0,1
"03/18/2022","N","Y","Unknown",999,"Unknown",99,1,889,0,890,0,13,0,1
"03/19/2022","N","Y","Unknown",999,"Unknown",99,0,889,1,891,0,13,0,1
"03/21/2022","N","Y","Unknown",999,"Unknown",99,1,890,0,891,0,13,0,1
"03/23/2022","N","Y","Unknown",999,"Unknown",99,2,892,3,894,0,13,0,1
"03/24/2022","N","Y","Unknown",999,"Unknown",99,2,894,3,897,0,13,0,1
"03/26/2022","N","Y","Unknown",999,"Unknown",99,3,897,0,897,0,13,0,1
"03/29/2022","N","Y","Unknown",999,"Unknown",99,0,897,2,899,0,13,0,1
"03/30/2022","N","Y","Unknown",999,"Unknown",99,1,898,2,901,0,13,0,1
"03/31/2022","N","Y","Unknown",999,"Unknown",99,1,899,1,902,0,13,0,1
"04/01/2022","N","Y","Unknown",999,"Unknown",99,2,901,0,902,0,13,0,1
"04/02/2022","N","Y","Unknown",999,"Unknown",99,1,902,0,902,0,13,0,1
"04/03/2022","N","Y","Unknown",999,"Unknown",99,0,902,1,903,0,13,0,1
"04/05/2022","N","Y","Unknown",999,"Unknown",99,1,903,1,904,0,13,0,1
"04/06/2022","N","Y","Unknown",999,"Unknown",99,1,904,0,904,0,13,0,1
"04/07/2022","N","Y","Unknown",999,"Unknown",99,0,904,1,905,0,13,0,1
"04/08/2022","N","Y","Unknown",999,"Unknown",99,1,905,0,905,0,13,0,1
"04/13/2022","N","Y","Unknown",999,"Unknown",99,0,905,1,906,0,13,0,1
"04/14/2022","N","Y","Unknown",999,"Unknown",99,1,906,0,906,0,13,0,1
"04/15/2022","N","Y","Unknown",999,"Unknown",99,0,906,2,908,0,13,0,1
"04/16/2022","N","Y","Unknown",999,"Unknown",99,2,908,0,908,0,13,0,1
"06/04/2020","N","Y","Wrangell City and Borough",275,"Other Southeast Region - Northern",8,0,0,1,1,0,0,0,0
"06/12/2020","N","Y","Wrangell City and Borough",275,"Other Southeast Region - Northern",8,1,1,0,1,0,0,0,0
"06/16/2020","N","Y","Wrangell City and Borough",275,"Other Southeast Region - Northern",8,0,1,1,2,0,0,0,0
"06/19/2020","N","Y","Wrangell City and Borough",275,"Other Southeast Region - Northern",8,1,2,0,2,0,0,0,0
"06/21/2020","N","Y","Wrangell City and Borough",275,"Other Southeast Region - Northern",8,1,3,1,3,0,0,0,0
"06/22/2020","N","Y","Wrangell City and Borough",275,"Other Southeast Region - Northern",8,0,3,1,4,0,0,0,0
"06/23/2020","N","Y","Wrangell City and Borough",275,"Other Southeast Region - Northern",8,0,3,1,5,0,0,0,0
"06/24/2020","N","Y","Wrangell City and Borough",275,"Other Southeast Region - Northern",8,2,5,0,5,0,0,0,0
"07/14/2020","N","Y","Wrangell City and Borough",275,"Other Southeast Region - Northern",8,0,5,1,6,0,0,0,0
"07/15/2020","N","Y","Wrangell City and Borough",275,"Other Southeast Region - Northern",8,1,6,0,6,0,0,0,0
"03/17/2021","N","Y","Wrangell City and Borough",275,"Other Southeast Region - Northern",8,0,6,1,7,0,0,0,0
"03/18/2021","N","Y","Wrangell City and Borough",275,"Other Southeast Region - Northern",8,1,7,0,7,0,0,0,0
"04/23/2021","N","Y","Wrangell City and Borough",275,"Other Southeast Region - Northern",8,0,7,1,8,0,0,0,0
"04/27/2021","N","Y","Wrangell City and Borough",275,"Other Southeast Region - Northern",8,1,8,0,8,0,0,0,0
"06/02/2021","N","Y","Wrangell City and Borough",275,"Other Southeast Region - Northern",8,0,8,1,9,0,0,0,0
"06/03/2021","N","Y","Wrangell City and Borough",275,"Other Southeast Region - Northern",8,1,9,0,9,0,0,0,0
"08/16/2021","N","Y","Wrangell City and Borough",275,"Other Southeast Region - Northern",8,0,9,2,11,0,0,0,0
"08/17/2021","N","Y","Wrangell City and Borough",275,"Other Southeast Region - Northern",8,1,10,1,12,0,0,0,0
"08/18/2021","N","Y","Wrangell City and Borough",275,"Other Southeast Region - Northern",8,1,11,0,12,0,0,0,0
"08/20/2021","N","Y","Wrangell City and Borough",275,"Other Southeast Region - Northern",8,1,12,0,12,0,0,0,0
"12/30/2021","N","Y","Wrangell City and Borough",275,"Other Southeast Region - Northern",8,0,12,1,13,0,0,0,0
"01/02/2022","N","Y","Wrangell City and Borough",275,"Other Southeast Region - Northern",8,1,13,0,13,0,0,0,0
"01/03/2022","N","Y","Wrangell City and Borough",275,"Other Southeast Region - Northern",8,0,13,1,14,0,0,0,0
"01/04/2022","N","Y","Wrangell City and Borough",275,"Other Southeast Region - Northern",8,1,14,0,14,0,0,0,0
"01/05/2022","N","Y","Wrangell City and Borough",275,"Other Southeast Region - Northern",8,1,15,1,15,0,0,0,0
"02/09/2022","N","Y","Wrangell City and Borough",275,"Other Southeast Region - Northern",8,0,15,2,17,0,0,0,0
"02/11/2022","N","Y","Wrangell City and Borough",275,"Other Southeast Region - Northern",8,2,17,0,17,0,0,0,0
"06/11/2020","N","Y","Yakutat plus Hoonah-Angoon",400,"Other Southeast Region - Northern",8,1,1,1,1,0,0,0,0
"07/14/2020","N","Y","Yakutat plus Hoonah-Angoon",400,"Other Southeast Region - Northern",8,0,1,1,2,0,0,0,0
"07/20/2020","N","Y","Yakutat plus Hoonah-Angoon",400,"Other Southeast Region - Northern",8,1,2,0,2,0,0,0,0
"07/23/2020","N","Y","Yakutat plus Hoonah-Angoon",400,"Other Southeast Region - Northern",8,0,2,1,3,0,0,0,0
"07/29/2020","N","Y","Yakutat plus Hoonah-Angoon",400,"Other Southeast Region - Northern",8,1,3,0,3,0,0,0,0
"07/30/2020","N","Y","Yakutat plus Hoonah-Angoon",400,"Other Southeast Region - Northern",8,0,3,0,3,1,1,0,0
"08/03/2020","N","Y","Yakutat plus Hoonah-Angoon",400,"Other Southeast Region - Northern",8,0,3,1,4,0,1,0,0
"08/05/2020","N","Y","Yakutat plus Hoonah-Angoon",400,"Other Southeast Region - Northern",8,1,4,0,4,0,1,0,0
"08/07/2020","N","Y","Yakutat plus Hoonah-Angoon",400,"Other Southeast Region - Northern",8,0,4,1,5,0,1,0,0
"08/11/2020","N","Y","Yakutat plus Hoonah-Angoon",400,"Other Southeast Region - Northern",8,1,5,0,5,0,1,0,0
"12/26/2020","N","Y","Yakutat plus Hoonah-Angoon",400,"Other Southeast Region - Northern",8,0,5,1,6,0,1,0,0
"12/28/2020","N","Y","Yakutat plus Hoonah-Angoon",400,"Other Southeast Region - Northern",8,0,5,3,9,0,1,0,0
"01/05/2021","N","Y","Yakutat plus Hoonah-Angoon",400,"Other Southeast Region - Northern",8,4,9,0,9,0,1,0,0
"03/08/2021","N","Y","Yakutat plus Hoonah-Angoon",400,"Other Southeast Region - Northern",8,0,9,1,10,0,1,0,0
"03/09/2021","N","Y","Yakutat plus Hoonah-Angoon",400,"Other Southeast Region - Northern",8,0,9,1,11,0,1,0,0
"03/12/2021","N","Y","Yakutat plus Hoonah-Angoon",400,"Other Southeast Region - Northern",8,2,11,0,11,0,1,0,0
"07/10/2021","N","Y","Yakutat plus Hoonah-Angoon",400,"Other Southeast Region - Northern",8,0,11,1,12,0,1,0,0
"07/23/2021","N","Y","Yakutat plus Hoonah-Angoon",400,"Other Southeast Region - Northern",8,0,11,1,13,0,1,0,0
"07/26/2021","N","Y","Yakutat plus Hoonah-Angoon",400,"Other Southeast Region - Northern",8,1,12,0,13,0,1,0,0
"07/27/2021","N","Y","Yakutat plus Hoonah-Angoon",400,"Other Southeast Region - Northern",8,1,13,0,13,0,1,0,0
"07/31/2021","N","Y","Yakutat plus Hoonah-Angoon",400,"Other Southeast Region - Northern",8,0,13,1,14,0,1,0,0
"08/02/2021","N","Y","Yakutat plus Hoonah-Angoon",400,"Other Southeast Region - Northern",8,1,14,0,14,0,1,0,0
"08/09/2021","N","Y","Yakutat plus Hoonah-Angoon",400,"Other Southeast Region - Northern",8,0,14,1,15,0,1,0,0
"08/11/2021","N","Y","Yakutat plus Hoonah-Angoon",400,"Other Southeast Region - Northern",8,0,14,1,16,0,1,0,0
"08/14/2021","N","Y","Yakutat plus Hoonah-Angoon",400,"Other Southeast Region - Northern",8,1,15,2,18,0,1,0,0
"08/15/2021","N","Y","Yakutat plus Hoonah-Angoon",400,"Other Southeast Region - Northern",8,1,16,2,20,0,1,0,0
"08/18/2021","N","Y","Yakutat plus Hoonah-Angoon",400,"Other Southeast Region - Northern",8,4,20,0,20,0,1,0,0
"08/19/2021","N","Y","Yakutat plus Hoonah-Angoon",400,"Other Southeast Region - Northern",8,0,20,1,21,0,1,0,0
"08/21/2021","N","Y","Yakutat plus Hoonah-Angoon",400,"Other Southeast Region - Northern",8,0,20,3,24,0,1,0,0
"08/23/2021","N","Y","Yakutat plus Hoonah-Angoon",400,"Other Southeast Region - Northern",8,3,23,0,24,0,1,0,0
"08/26/2021","N","Y","Yakutat plus Hoonah-Angoon",400,"Other Southeast Region - Northern",8,1,24,0,24,0,1,0,0
"09/02/2021","N","Y","Yakutat plus Hoonah-Angoon",400,"Other Southeast Region - Northern",8,0,24,4,28,0,1,0,0
"09/07/2021","N","Y","Yakutat plus Hoonah-Angoon",400,"Other Southeast Region - Northern",8,0,24,1,29,0,1,0,0
"09/08/2021","N","Y","Yakutat plus Hoonah-Angoon",400,"Other Southeast Region - Northern",8,4,28,0,29,0,1,0,0
"09/14/2021","N","Y","Yakutat plus Hoonah-Angoon",400,"Other Southeast Region - Northern",8,1,29,0,29,0,1,0,0
"09/21/2021","N","Y","Yakutat plus Hoonah-Angoon",400,"Other Southeast Region - Northern",8,0,29,1,30,0,1,0,0
"09/22/2021","N","Y","Yakutat plus Hoonah-Angoon",400,"Other Southeast Region - Northern",8,0,29,1,31,0,1,0,0
"09/23/2021","N","Y","Yakutat plus Hoonah-Angoon",400,"Other Southeast Region - Northern",8,1,30,0,31,0,1,0,0
"10/04/2021","N","Y","Yakutat plus Hoonah-Angoon",400,"Other Southeast Region - Northern",8,2,32,2,33,0,1,0,0
"10/06/2021","N","Y","Yakutat plus Hoonah-Angoon",400,"Other Southeast Region - Northern",8,1,33,0,33,0,1,0,0
"11/21/2021","N","Y","Yakutat plus Hoonah-Angoon",400,"Other Southeast Region - Northern",8,0,33,1,34,0,1,0,0
"11/22/2021","N","Y","Yakutat plus Hoonah-Angoon",400,"Other Southeast Region - Northern",8,1,34,0,34,0,1,0,0
"01/04/2022","N","Y","Yakutat plus Hoonah-Angoon",400,"Other Southeast Region - Northern",8,1,35,1,35,0,1,0,0
"07/22/2020","N","Y","Yukon-Koyukuk Census Area",290,"Other Interior Region",7,1,1,1,1,0,0,0,0
"08/13/2020","N","Y","Yukon-Koyukuk Census Area",290,"Other Interior Region",7,0,1,1,2,0,0,0,0
"08/18/2020","N","Y","Yukon-Koyukuk Census Area",290,"Other Interior Region",7,1,2,0,2,0,0,0,0
"03/10/2021","N","Y","Yukon-Koyukuk Census Area",290,"Other Interior Region",7,0,2,1,3,0,0,0,0
"03/11/2021","N","Y","Yukon-Koyukuk Census Area",290,"Other Interior Region",7,1,3,0,3,0,0,0,0
"08/28/2021","N","Y","Yukon-Koyukuk Census Area",290,"Other Interior Region",7,0,3,1,4,0,0,0,0
"09/03/2021","N","Y","Yukon-Koyukuk Census Area",290,"Other Interior Region",7,1,4,0,4,0,0,0,0
"10/19/2020","Y","N","Aleutians East Borough",13,"Southwest Region",11,0,0,1,1,0,0,0,0
"10/23/2020","Y","N","Aleutians East Borough",13,"Southwest Region",11,1,1,0,1,0,0,0,0
"04/12/2021","Y","N","Aleutians East Borough",13,"Southwest Region",11,0,1,1,2,0,0,0,0
"04/15/2021","Y","N","Aleutians East Borough",13,"Southwest Region",11,1,2,0,2,0,0,0,0
"11/24/2021","Y","N","Aleutians East Borough",13,"Southwest Region",11,0,2,1,3,0,0,0,0
"11/28/2021","Y","N","Aleutians East Borough",13,"Southwest Region",11,1,3,0,3,0,0,0,0
"12/18/2020","Y","N","Aleutians West Census Area",16,"Southwest Region",11,0,0,1,1,0,0,0,0
"12/22/2020","Y","N","Aleutians West Census Area",16,"Southwest Region",11,1,1,0,1,0,0,0,0
"02/02/2021","Y","N","Aleutians West Census Area",16,"Southwest Region",11,0,1,1,2,1,1,0,0
"02/05/2021","Y","N","Aleutians West Census Area",16,"Southwest Region",11,1,2,0,2,0,1,0,0
"02/14/2021","Y","N","Aleutians West Census Area",16,"Southwest Region",11,0,2,0,2,0,1,1,1
"08/07/2021","Y","N","Aleutians West Census Area",16,"Southwest Region",11,0,2,1,3,0,1,0,1
"08/09/2021","Y","N","Aleutians West Census Area",16,"Southwest Region",11,1,3,0,3,0,1,0,1
"11/28/2021","Y","N","Aleutians West Census Area",16,"Southwest Region",11,0,3,1,4,0,1,0,1
"11/30/2021","Y","N","Aleutians West Census Area",16,"Southwest Region",11,1,4,0,4,0,1,0,1
"12/23/2021","Y","N","Aleutians West Census Area",16,"Southwest Region",11,1,5,1,5,0,1,0,1
"01/11/2022","Y","N","Aleutians West Census Area",16,"Southwest Region",11,1,6,2,7,0,1,0,1
"01/18/2022","Y","N","Aleutians West Census Area",16,"Southwest Region",11,1,7,0,7,0,1,0,1
"02/01/2022","Y","N","Aleutians West Census Area",16,"Southwest Region",11,1,8,1,8,0,1,0,1
"02/02/2022","Y","N","Aleutians West Census Area",16,"Southwest Region",11,0,8,1,9,0,1,0,1
"02/26/2022","Y","N","Aleutians West Census Area",16,"Southwest Region",11,1,9,0,9,0,1,0,1
"03/03/2020","Y","N","Anchorage Municipality",20,"Anchorage Municipality",1,0,0,1,1,0,0,0,0
"03/18/2020","Y","N","Anchorage Municipality",20,"Anchorage Municipality",1,0,0,2,3,0,0,0,0
"03/28/2020","Y","N","Anchorage Municipality",20,"Anchorage Municipality",1,0,0,0,3,1,1,0,0
"03/29/2020","Y","N","Anchorage Municipality",20,"Anchorage Municipality",1,0,0,1,4,0,1,0,0
"04/07/2020","Y","N","Anchorage Municipality",20,"Anchorage Municipality",1,1,1,0,4,0,1,0,0
"04/08/2020","Y","N","Anchorage Municipality",20,"Anchorage Municipality",1,1,2,0,4,0,1,0,0
"04/13/2020","Y","N","Anchorage Municipality",20,"Anchorage Municipality",1,0,2,0,4,1,2,0,0
"04/23/2020","Y","N","Anchorage Municipality",20,"Anchorage Municipality",1,0,2,1,5,0,2,0,0
"04/28/2020","Y","N","Anchorage Municipality",20,"Anchorage Municipality",1,0,2,1,6,0,2,0,0
"04/30/2020","Y","N","Anchorage Municipality",20,"Anchorage Municipality",1,1,3,0,6,0,2,0,0
"05/06/2020","Y","N","Anchorage Municipality",20,"Anchorage Municipality",1,1,4,0,6,0,2,0,0
"05/07/2020","Y","N","Anchorage Municipality",20,"Anchorage Municipality",1,1,5,0,6,0,2,0,0
"05/12/2020","Y","N","Anchorage Municipality",20,"Anchorage Municipality",1,1,6,1,7,0,2,0,0
"05/13/2020","Y","N","Anchorage Municipality",20,"Anchorage Municipality",1,2,8,1,8,0,2,0,0
"05/29/2020","Y","N","Anchorage Municipality",20,"Anchorage Municipality",1,0,8,1,9,0,2,0,0
"05/30/2020","Y","N","Anchorage Municipality",20,"Anchorage Municipality",1,1,9,0,9,0,2,0,0
"06/03/2020","Y","N","Anchorage Municipality",20,"Anchorage Municipality",1,2,11,2,11,0,2,0,0
"06/10/2020","Y","N","Anchorage Municipality",20,"Anchorage Municipality",1,0,11,1,12,0,2,0,0
"06/15/2020","Y","N","Anchorage Municipality",20,"Anchorage Municipality",1,1,12,0,12,0,2,0,0
"06/17/2020","Y","N","Anchorage Municipality",20,"Anchorage Municipality",1,0,12,1,13,0,2,0,0
"06/18/2020","Y","N","Anchorage Municipality",20,"Anchorage Municipality",1,1,13,0,13,0,2,0,0
"06/22/2020","Y","N","Anchorage Municipality",20,"Anchorage Municipality",1,1,14,1,14,0,2,0,0
"06/30/2020","Y","N","Anchorage Municipality",20,"Anchorage Municipality",1,0,14,1,15,0,2,0,0
"07/06/2020","Y","N","Anchorage Municipality",20,"Anchorage Municipality",1,0,14,1,16,0,2,0,0
"07/08/2020","Y","N","Anchorage Municipality",20,"Anchorage Municipality",1,0,14,2,18,0,2,0,0
"07/11/2020","Y","N","Anchorage Municipality",20,"Anchorage Municipality",1,1,15,0,18,0,2,0,0
"07/13/2020","Y","N","Anchorage Municipality",20,"Anchorage Municipality",1,1,16,1,19,0,2,0,0
"07/15/2020","Y","N","Anchorage Municipality",20,"Anchorage Municipality",1,0,16,2,21,0,2,0,0
"07/16/2020","Y","N","Anchorage Municipality",20,"Anchorage Municipality",1,1,17,1,22,0,2,0,0
"07/17/2020","Y","N","Anchorage Municipality",20,"Anchorage Municipality",1,0,17,1,23,0,2,0,0
"07/18/2020","Y","N","Anchorage Municipality",20,"Anchorage Municipality",1,0,17,1,24,0,2,0,0
"07/19/2020","Y","N","Anchorage Municipality",20,"Anchorage Municipality",1,0,17,1,25,0,2,0,0
"07/24/2020","Y","N","Anchorage Municipality",20,"Anchorage Municipality",1,5,22,1,26,0,2,0,0
"07/25/2020","Y","N","Anchorage Municipality",20,"Anchorage Municipality",1,0,22,0,26,1,3,0,0
"07/29/2020","Y","N","Anchorage Municipality",20,"Anchorage Municipality",1,1,23,1,27,0,3,0,0
"07/31/2020","Y","N","Anchorage Municipality",20,"Anchorage Municipality",1,3,26,0,27,0,3,0,0
"08/01/2020","Y","N","Anchorage Municipality",20,"Anchorage Municipality",1,1,27,0,27,0,3,0,0
"08/06/2020","Y","N","Anchorage Municipality",20,"Anchorage Municipality",1,0,27,1,28,0,3,0,0
"08/11/2020","Y","N","Anchorage Municipality",20,"Anchorage Municipality",1,1,28,0,28,0,3,0,0
"08/21/2020","Y","N","Anchorage Municipality",20,"Anchorage Municipality",1,0,28,1,29,0,3,0,0
"08/25/2020","Y","N","Anchorage Municipality",20,"Anchorage Municipality",1,1,29,0,29,0,3,0,0
"08/28/2020","Y","N","Anchorage Municipality",20,"Anchorage Municipality",1,1,30,2,31,0,3,0,0
"09/02/2020","Y","N","Anchorage Municipality",20,"Anchorage Municipality",1,0,30,1,32,0,3,0,0
"09/03/2020","Y","N","Anchorage Municipality",20,"Anchorage Municipality",1,1,31,1,33,0,3,0,0
"09/04/2020","Y","N","Anchorage Municipality",20,"Anchorage Municipality",1,0,31,1,34,0,3,0,0
"09/08/2020","Y","N","Anchorage Municipality",20,"Anchorage Municipality",1,1,32,0,34,0,3,0,0
"09/11/2020","Y","N","Anchorage Municipality",20,"Anchorage Municipality",1,0,32,1,35,0,3,0,0
"09/15/2020","Y","N","Anchorage Municipality",20,"Anchorage Municipality",1,0,32,1,36,0,3,0,0
"09/16/2020","Y","N","Anchorage Municipality",20,"Anchorage Municipality",1,0,32,0,36,0,3,1,1
"09/17/2020","Y","N","Anchorage Municipality",20,"Anchorage Municipality",1,1,33,0,36,0,3,0,1
"09/19/2020","Y","N","Anchorage Municipality",20,"Anchorage Municipality",1,1,34,0,36,0,3,0,1
"09/24/2020","Y","N","Anchorage Municipality",20,"Anchorage Municipality",1,2,36,0,36,0,3,0,1
"09/25/2020","Y","N","Anchorage Municipality",20,"Anchorage Municipality",1,0,36,1,37,0,3,0,1
"09/27/2020","Y","N","Anchorage Municipality",20,"Anchorage Municipality",1,0,36,1,38,0,3,0,1
"10/01/2020","Y","N","Anchorage Municipality",20,"Anchorage Municipality",1,3,39,2,40,0,3,0,1
"10/06/2020","Y","N","Anchorage Municipality",20,"Anchorage Municipality",1,1,40,0,40,0,3,0,1
"10/09/2020","Y","N","Anchorage Municipality",20,"Anchorage Municipality",1,1,41,2,42,0,3,0,1
"10/10/2020","Y","N","Anchorage Municipality",20,"Anchorage Municipality",1,1,42,1,43,0,3,0,1
"10/13/2020","Y","N","Anchorage Municipality",20,"Anchorage Municipality",1,0,42,1,44,0,3,0,1
"10/14/2020","Y","N","Anchorage Municipality",20,"Anchorage Municipality",1,0,42,2,46,0,3,0,1
"10/15/2020","Y","N","Anchorage Municipality",20,"Anchorage Municipality",1,0,42,1,47,0,3,0,1
"10/16/2020","Y","N","Anchorage Municipality",20,"Anchorage Municipality",1,2,44,1,48,0,3,0,1
"10/17/2020","Y","N","Anchorage Municipality",20,"Anchorage Municipality",1,0,44,1,49,0,3,0,1
"10/20/2020","Y","N","Anchorage Municipality",20,"Anchorage Municipality",1,1,45,1,50,0,3,0,1
"10/21/2020","Y","N","Anchorage Municipality",20,"Anchorage Municipality",1,1,46,1,51,0,3,0,1
"10/22/2020","Y","N","Anchorage Municipality",20,"Anchorage Municipality",1,1,47,3,54,0,3,0,1
"10/23/2020","Y","N","Anchorage Municipality",20,"Anchorage Municipality",1,0,47,2,56,0,3,0,1
"10/24/2020","Y","N","Anchorage Municipality",20,"Anchorage Municipality",1,0,47,1,57,0,3,0,1
"10/25/2020","Y","N","Anchorage Municipality",20,"Anchorage Municipality",1,1,48,0,57,0,3,0,1
"10/26/2020","Y","N","Anchorage Municipality",20,"Anchorage Municipality",1,2,50,1,58,0,3,0,1
"10/27/2020","Y","N","Anchorage Municipality",20,"Anchorage Municipality",1,2,52,1,59,0,3,0,1
"10/28/2020","Y","N","Anchorage Municipality",20,"Anchorage Municipality",1,1,53,0,59,0,3,0,1
"10/29/2020","Y","N","Anchorage Municipality",20,"Anchorage Municipality",1,1,54,1,60,1,4,0,1
"10/30/2020","Y","N","Anchorage Municipality",20,"Anchorage Municipality",1,3,57,0,60,0,4,0,1
"10/31/2020","Y","N","Anchorage Municipality",20,"Anchorage Municipality",1,0,57,2,62,0,4,0,1
"11/01/2020","Y","N","Anchorage Municipality",20,"Anchorage Municipality",1,1,58,2,64,0,4,0,1
"11/02/2020","Y","N","Anchorage Municipality",20,"Anchorage Municipality",1,0,58,1,65,0,4,0,1
"11/03/2020","Y","N","Anchorage Municipality",20,"Anchorage Municipality",1,3,61,1,66,0,4,0,1
"11/04/2020","Y","N","Anchorage Municipality",20,"Anchorage Municipality",1,1,62,0,66,0,4,0,1
"11/05/2020","Y","N","Anchorage Municipality",20,"Anchorage Municipality",1,0,62,1,67,0,4,0,1
"11/06/2020","Y","N","Anchorage Municipality",20,"Anchorage Municipality",1,2,64,1,68,0,4,0,1
"11/07/2020","Y","N","Anchorage Municipality",20,"Anchorage Municipality",1,0,64,0,68,0,4,1,2
"11/08/2020","Y","N","Anchorage Municipality",20,"Anchorage Municipality",1,0,64,2,70,0,4,0,2
"11/09/2020","Y","N","Anchorage Municipality",20,"Anchorage Municipality",1,1,65,1,71,0,4,0,2
"11/10/2020","Y","N","Anchorage Municipality",20,"Anchorage Municipality",1,2,67,0,71,0,4,0,2
"11/11/2020","Y","N","Anchorage Municipality",20,"Anchorage Municipality",1,0,67,1,72,0,4,0,2
"11/12/2020","Y","N","Anchorage Municipality",20,"Anchorage Municipality",1,0,67,2,74,0,4,0,2
"11/13/2020","Y","N","Anchorage Municipality",20,"Anchorage Municipality",1,0,67,1,75,0,4,0,2
"11/14/2020","Y","N","Anchorage Municipality",20,"Anchorage Municipality",1,0,67,3,78,0,4,0,2
"11/15/2020","Y","N","Anchorage Municipality",20,"Anchorage Municipality",1,2,69,1,79,0,4,0,2
"11/16/2020","Y","N","Anchorage Municipality",20,"Anchorage Municipality",1,0,69,4,83,0,4,0,2
"11/17/2020","Y","N","Anchorage Municipality",20,"Anchorage Municipality",1,1,70,1,84,0,4,0,2
"11/18/2020","Y","N","Anchorage Municipality",20,"Anchorage Municipality",1,2,72,1,85,0,4,0,2
"11/19/2020","Y","N","Anchorage Municipality",20,"Anchorage Municipality",1,3,75,1,86,0,4,0,2
"11/20/2020","Y","N","Anchorage Municipality",20,"Anchorage Municipality",1,1,76,3,89,0,4,0,2
"11/21/2020","Y","N","Anchorage Municipality",20,"Anchorage Municipality",1,0,76,1,90,0,4,0,2
"11/22/2020","Y","N","Anchorage Municipality",20,"Anchorage Municipality",1,1,77,1,91,0,4,0,2
"11/23/2020","Y","N","Anchorage Municipality",20,"Anchorage Municipality",1,1,78,0,91,0,4,0,2
"11/25/2020","Y","N","Anchorage Municipality",20,"Anchorage Municipality",1,2,80,0,91,0,4,0,2
"11/26/2020","Y","N","Anchorage Municipality",20,"Anchorage Municipality",1,1,81,0,91,0,4,0,2
"11/27/2020","Y","N","Anchorage Municipality",20,"Anchorage Municipality",1,0,81,1,92,0,4,0,2
"11/28/2020","Y","N","Anchorage Municipality",20,"Anchorage Municipality",1,4,85,2,94,0,4,0,2
"11/30/2020","Y","N","Anchorage Municipality",20,"Anchorage Municipality",1,1,86,0,94,0,4,0,2
"12/02/2020","Y","N","Anchorage Municipality",20,"Anchorage Municipality",1,2,88,2,96,0,4,0,2
"12/07/2020","Y","N","Anchorage Municipality",20,"Anchorage Municipality",1,1,89,0,96,0,4,0,2
"12/08/2020","Y","N","Anchorage Municipality",20,"Anchorage Municipality",1,1,90,0,96,0,4,0,2
"12/09/2020","Y","N","Anchorage Municipality",20,"Anchorage Municipality",1,1,91,2,98,0,4,0,2
"12/10/2020","Y","N","Anchorage Municipality",20,"Anchorage Municipality",1,0,91,3,101,0,4,0,2
"12/11/2020","Y","N","Anchorage Municipality",20,"Anchorage Municipality",1,0,91,3,104,0,4,0,2
"12/12/2020","Y","N","Anchorage Municipality",20,"Anchorage Municipality",1,2,93,1,105,0,4,0,2
"12/13/2020","Y","N","Anchorage Municipality",20,"Anchorage Municipality",1,1,94,0,105,0,4,0,2
"12/14/2020","Y","N","Anchorage Municipality",20,"Anchorage Municipality",1,2,96,0,105,0,4,0,2
"12/15/2020","Y","N","Anchorage Municipality",20,"Anchorage Municipality",1,3,99,1,106,0,4,0,2
"12/16/2020","Y","N","Anchorage Municipality",20,"Anchorage Municipality",1,0,99,1,107,0,4,0,2
"12/17/2020","Y","N","Anchorage Municipality",20,"Anchorage Municipality",1,0,99,1,108,0,4,0,2
"12/18/2020","Y","N","Anchorage Municipality",20,"Anchorage Municipality",1,0,99,1,109,0,4,0,2
"12/21/2020","Y","N","Anchorage Municipality",20,"Anchorage Municipality",1,1,100,0,109,0,4,0,2
"12/22/2020","Y","N","Anchorage Municipality",20,"Anchorage Municipality",1,1,101,1,110,0,4,0,2
"12/23/2020","Y","N","Anchorage Municipality",20,"Anchorage Municipality",1,0,101,0,110,0,4,1,3
"12/24/2020","Y","N","Anchorage Municipality",20,"Anchorage Municipality",1,1,102,0,110,0,4,0,3
"12/25/2020","Y","N","Anchorage Municipality",20,"Anchorage Municipality",1,1,103,1,111,1,5,0,3
"12/26/2020","Y","N","Anchorage Municipality",20,"Anchorage Municipality",1,1,104,1,112,0,5,0,3
"12/27/2020","Y","N","Anchorage Municipality",20,"Anchorage Municipality",1,0,104,1,113,0,5,0,3
"12/28/2020","Y","N","Anchorage Municipality",20,"Anchorage Municipality",1,0,104,1,114,0,5,0,3
"12/29/2020","Y","N","Anchorage Municipality",20,"Anchorage Municipality",1,6,110,4,118,0,5,0,3
"12/30/2020","Y","N","Anchorage Municipality",20,"Anchorage Municipality",1,5,115,5,123,0,5,0,3
"12/31/2020","Y","N","Anchorage Municipality",20,"Anchorage Municipality",1,0,115,1,124,0,5,0,3
"01/01/2021","Y","N","Anchorage Municipality",20,"Anchorage Municipality",1,0,115,1,125,0,5,0,3
"01/02/2021","Y","N","Anchorage Municipality",20,"Anchorage Municipality",1,0,115,4,129,0,5,0,3
"01/03/2021","Y","N","Anchorage Municipality",20,"Anchorage Municipality",1,0,115,1,130,0,5,0,3
"01/04/2021","Y","N","Anchorage Municipality",20,"Anchorage Municipality",1,3,118,2,132,0,5,0,3
"01/05/2021","Y","N","Anchorage Municipality",20,"Anchorage Municipality",1,1,119,2,134,0,5,0,3
"01/07/2021","Y","N","Anchorage Municipality",20,"Anchorage Municipality",1,1,120,2,136,0,5,0,3
"01/08/2021","Y","N","Anchorage Municipality",20,"Anchorage Municipality",1,1,121,4,140,0,5,0,3
"01/09/2021","Y","N","Anchorage Municipality",20,"Anchorage Municipality",1,1,122,1,141,0,5,0,3
"01/10/2021","Y","N","Anchorage Municipality",20,"Anchorage Municipality",1,0,122,1,142,0,5,0,3
"01/11/2021","Y","N","Anchorage Municipality",20,"Anchorage Municipality",1,2,124,1,143,0,5,0,3
"01/12/2021","Y","N","Anchorage Municipality",20,"Anchorage Municipality",1,2,126,4,147,0,5,0,3
"01/13/2021","Y","N","Anchorage Municipality",20,"Anchorage Municipality",1,4,130,0,147,0,5,0,3
"01/14/2021","Y","N","Anchorage Municipality",20,"Anchorage Municipality",1,3,133,1,148,0,5,0,3
"01/15/2021","Y","N","Anchorage Municipality",20,"Anchorage Municipality",1,0,133,1,149,0,5,0,3
"01/16/2021","Y","N","Anchorage Municipality",20,"Anchorage Municipality",1,1,134,1,150,0,5,0,3
"01/17/2021","Y","N","Anchorage Municipality",20,"Anchorage Municipality",1,1,135,1,151,0,5,0,3
"01/18/2021","Y","N","Anchorage Municipality",20,"Anchorage Municipality",1,0,135,1,152,0,5,0,3
"01/19/2021","Y","N","Anchorage Municipality",20,"Anchorage Municipality",1,1,136,3,155,0,5,0,3
"01/20/2021","Y","N","Anchorage Municipality",20,"Anchorage Municipality",1,1,137,0,155,0,5,0,3
"01/21/2021","Y","N","Anchorage Municipality",20,"Anchorage Municipality",1,6,143,2,157,0,5,0,3
"01/22/2021","Y","N","Anchorage Municipality",20,"Anchorage Municipality",1,1,144,4,161,0,5,0,3
"01/23/2021","Y","N","Anchorage Municipality",20,"Anchorage Municipality",1,2,146,3,164,0,5,0,3
"01/24/2021","Y","N","Anchorage Municipality",20,"Anchorage Municipality",1,2,148,1,165,0,5,0,3
"01/25/2021","Y","N","Anchorage Municipality",20,"Anchorage Municipality",1,2,150,3,168,0,5,0,3
"01/26/2021","Y","N","Anchorage Municipality",20,"Anchorage Municipality",1,3,153,2,170,0,5,0,3
"01/27/2021","Y","N","Anchorage Municipality",20,"Anchorage Municipality",1,3,156,1,171,0,5,0,3
"01/28/2021","Y","N","Anchorage Municipality",20,"Anchorage Municipality",1,2,158,1,172,0,5,0,3
"01/29/2021","Y","N","Anchorage Municipality",20,"Anchorage Municipality",1,4,162,0,172,0,5,0,3
"01/30/2021","Y","N","Anchorage Municipality",20,"Anchorage Municipality",1,1,163,1,173,0,5,0,3
"02/01/2021","Y","N","Anchorage Municipality",20,"Anchorage Municipality",1,1,164,2,175,0,5,0,3
"02/02/2021","Y","N","Anchorage Municipality",20,"Anchorage Municipality",1,1,165,0,175,0,5,0,3
"02/03/2021","Y","N","Anchorage Municipality",20,"Anchorage Municipality",1,1,166,0,175,0,5,0,3
"02/04/2021","Y","N","Anchorage Municipality",20,"Anchorage Municipality",1,3,169,0,175,0,5,0,3
"02/05/2021","Y","N","Anchorage Municipality",20,"Anchorage Municipality",1,1,170,0,175,0,5,0,3
"02/06/2021","Y","N","Anchorage Municipality",20,"Anchorage Municipality",1,1,171,0,175,0,5,0,3
"02/08/2021","Y","N","Anchorage Municipality",20,"Anchorage Municipality",1,0,171,2,177,0,5,0,3
"02/09/2021","Y","N","Anchorage Municipality",20,"Anchorage Municipality",1,1,172,3,180,0,5,1,4
"02/10/2021","Y","N","Anchorage Municipality",20,"Anchorage Municipality",1,6,178,0,180,0,5,0,4
"02/11/2021","Y","N","Anchorage Municipality",20,"Anchorage Municipality",1,0,178,3,183,0,5,0,4
"02/12/2021","Y","N","Anchorage Municipality",20,"Anchorage Municipality",1,0,178,2,185,0,5,0,4
"02/13/2021","Y","N","Anchorage Municipality",20,"Anchorage Municipality",1,2,180,1,186,0,5,0,4
"02/15/2021","Y","N","Anchorage Municipality",20,"Anchorage Municipality",1,0,180,2,188,0,5,0,4
"02/16/2021","Y","N","Anchorage Municipality",20,"Anchorage Municipality",1,3,183,1,189,0,5,0,4
"02/17/2021","Y","N","Anchorage Municipality",20,"Anchorage Municipality",1,2,185,1,190,0,5,0,4
"02/18/2021","Y","N","Anchorage Municipality",20,"Anchorage Municipality",1,1,186,1,191,0,5,0,4
"02/19/2021","Y","N","Anchorage Municipality",20,"Anchorage Municipality",1,2,188,3,194,0,5,0,4
"02/20/2021","Y","N","Anchorage Municipality",20,"Anchorage Municipality",1,2,190,3,197,0,5,0,4
"02/22/2021","Y","N","Anchorage Municipality",20,"Anchorage Municipality",1,1,191,0,197,0,5,0,4
"02/24/2021","Y","N","Anchorage Municipality",20,"Anchorage Municipality",1,0,191,1,198,0,5,0,4
"02/25/2021","Y","N","Anchorage Municipality",20,"Anchorage Municipality",1,1,192,1,199,0,5,0,4
"03/01/2021","Y","N","Anchorage Municipality",20,"Anchorage Municipality",1,1,193,1,200,0,5,0,4
"03/02/2021","Y","N","Anchorage Municipality",20,"Anchorage Municipality",1,0,193,1,201,0,5,0,4
"03/03/2021","Y","N","Anchorage Municipality",20,"Anchorage Municipality",1,1,194,1,202,0,5,0,4
"03/04/2021","Y","N","Anchorage Municipality",20,"Anchorage Municipality",1,2,196,2,204,0,5,0,4
"03/05/2021","Y","N","Anchorage Municipality",20,"Anchorage Municipality",1,0,196,1,205,0,5,0,4
"03/06/2021","Y","N","Anchorage Municipality",20,"Anchorage Municipality",1,1,197,0,205,0,5,0,4
"03/07/2021","Y","N","Anchorage Municipality",20,"Anchorage Municipality",1,0,197,2,207,0,5,0,4
"03/10/2021","Y","N","Anchorage Municipality",20,"Anchorage Municipality",1,1,198,1,208,0,5,0,4
"03/11/2021","Y","N","Anchorage Municipality",20,"Anchorage Municipality",1,0,198,1,209,0,5,0,4
"03/12/2021","Y","N","Anchorage Municipality",20,"Anchorage Municipality",1,2,200,1,210,0,5,0,4
"03/14/2021","Y","N","Anchorage Municipality",20,"Anchorage Municipality",1,2,202,2,212,0,5,0,4
"03/15/2021","Y","N","Anchorage Municipality",20,"Anchorage Municipality",1,1,203,5,217,0,5,0,4
"03/16/2021","Y","N","Anchorage Municipality",20,"Anchorage Municipality",1,1,204,0,217,0,5,0,4
"03/17/2021","Y","N","Anchorage Municipality",20,"Anchorage Municipality",1,2,206,0,217,0,5,0,4
"03/18/2021","Y","N","Anchorage Municipality",20,"Anchorage Municipality",1,1,207,0,217,0,5,0,4
"03/19/2021","Y","N","Anchorage Municipality",20,"Anchorage Municipality",1,1,208,1,218,0,5,0,4
"03/20/2021","Y","N","Anchorage Municipality",20,"Anchorage Municipality",1,1,209,1,219,0,5,0,4
"03/21/2021","Y","N","Anchorage Municipality",20,"Anchorage Municipality",1,1,210,0,219,0,5,1,5
"03/23/2021","Y","N","Anchorage Municipality",20,"Anchorage Municipality",1,7,217,1,220,0,5,0,5
"03/25/2021","Y","N","Anchorage Municipality",20,"Anchorage Municipality",1,0,217,1,221,0,5,0,5
"03/26/2021","Y","N","Anchorage Municipality",20,"Anchorage Municipality",1,2,219,1,222,0,5,0,5
"03/27/2021","Y","N","Anchorage Municipality",20,"Anchorage Municipality",1,0,219,1,223,0,5,0,5
"03/30/2021","Y","N","Anchorage Municipality",20,"Anchorage Municipality",1,1,220,0,223,0,5,0,5
"04/01/2021","Y","N","Anchorage Municipality",20,"Anchorage Municipality",1,0,220,2,225,0,5,0,5
"04/02/2021","Y","N","Anchorage Municipality",20,"Anchorage Municipality",1,1,221,0,225,0,5,1,6
"04/06/2021","Y","N","Anchorage Municipality",20,"Anchorage Municipality",1,2,223,0,225,0,5,0,6
"04/08/2021","Y","N","Anchorage Municipality",20,"Anchorage Municipality",1,1,224,0,225,0,5,0,6
"04/10/2021","Y","N","Anchorage Municipality",20,"Anchorage Municipality",1,0,224,1,226,0,5,0,6
"04/12/2021","Y","N","Anchorage Municipality",20,"Anchorage Municipality",1,1,225,1,227,0,5,0,6
"04/18/2021","Y","N","Anchorage Municipality",20,"Anchorage Municipality",1,1,226,1,228,0,5,0,6
"04/19/2021","Y","N","Anchorage Municipality",20,"Anchorage Municipality",1,0,226,1,229,0,5,0,6
"04/20/2021","Y","N","Anchorage Municipality",20,"Anchorage Municipality",1,1,227,1,230,0,5,0,6
"04/27/2021","Y","N","Anchorage Municipality",20,"Anchorage Municipality",1,1,228,0,230,0,5,0,6
"04/29/2021","Y","N","Anchorage Municipality",20,"Anchorage Municipality",1,1,229,1,231,0,5,0,6
"04/30/2021","Y","N","Anchorage Municipality",20,"Anchorage Municipality",1,1,230,0,231,0,5,0,6
"05/04/2021","Y","N","Anchorage Municipality",20,"Anchorage Municipality",1,0,230,2,233,0,5,0,6
"05/05/2021","Y","N","Anchorage Municipality",20,"Anchorage Municipality",1,0,230,1,234,0,5,0,6
"05/06/2021","Y","N","Anchorage Municipality",20,"Anchorage Municipality",1,0,230,1,235,0,5,0,6
"05/07/2021","Y","N","Anchorage Municipality",20,"Anchorage Municipality",1,0,230,1,236,0,5,0,6
"05/10/2021","Y","N","Anchorage Municipality",20,"Anchorage Municipality",1,1,231,0,236,0,5,0,6
"05/11/2021","Y","N","Anchorage Municipality",20,"Anchorage Municipality",1,1,232,0,236,0,5,0,6
"05/12/2021","Y","N","Anchorage Municipality",20,"Anchorage Municipality",1,2,234,0,236,0,5,0,6
"05/14/2021","Y","N","Anchorage Municipality",20,"Anchorage Municipality",1,0,234,1,237,0,5,0,6
"05/16/2021","Y","N","Anchorage Municipality",20,"Anchorage Municipality",1,0,234,1,238,0,5,0,6
"05/17/2021","Y","N","Anchorage Municipality",20,"Anchorage Municipality",1,1,235,0,238,0,5,0,6
"05/19/2021","Y","N","Anchorage Municipality",20,"Anchorage Municipality",1,0,235,1,239,0,5,0,6
"05/21/2021","Y","N","Anchorage Municipality",20,"Anchorage Municipality",1,2,237,2,241,0,5,0,6
"05/24/2021","Y","N","Anchorage Municipality",20,"Anchorage Municipality",1,1,238,0,241,0,5,0,6
"05/25/2021","Y","N","Anchorage Municipality",20,"Anchorage Municipality",1,1,239,0,241,0,5,0,6
"05/26/2021","Y","N","Anchorage Municipality",20,"Anchorage Municipality",1,2,241,0,241,0,5,0,6
"06/11/2021","Y","N","Anchorage Municipality",20,"Anchorage Municipality",1,0,241,2,243,1,6,0,6
"06/12/2021","Y","N","Anchorage Municipality",20,"Anchorage Municipality",1,0,241,1,244,0,6,0,6
"06/13/2021","Y","N","Anchorage Municipality",20,"Anchorage Municipality",1,1,242,0,244,0,6,0,6
"06/16/2021","Y","N","Anchorage Municipality",20,"Anchorage Municipality",1,1,243,0,244,0,6,0,6
"06/18/2021","Y","N","Anchorage Municipality",20,"Anchorage Municipality",1,1,244,0,244,0,6,0,6
"06/22/2021","Y","N","Anchorage Municipality",20,"Anchorage Municipality",1,0,244,1,245,0,6,0,6
"06/24/2021","Y","N","Anchorage Municipality",20,"Anchorage Municipality",1,1,245,0,245,0,6,0,6
"06/30/2021","Y","N","Anchorage Municipality",20,"Anchorage Municipality",1,1,246,2,247,0,6,0,6
"07/05/2021","Y","N","Anchorage Municipality",20,"Anchorage Municipality",1,0,246,1,248,0,6,0,6
"07/07/2021","Y","N","Anchorage Municipality",20,"Anchorage Municipality",1,1,247,1,249,0,6,0,6
"07/09/2021","Y","N","Anchorage Municipality",20,"Anchorage Municipality",1,1,248,0,249,0,6,0,6
"07/13/2021","Y","N","Anchorage Municipality",20,"Anchorage Municipality",1,0,248,1,250,0,6,0,6
"07/16/2021","Y","N","Anchorage Municipality",20,"Anchorage Municipality",1,1,249,0,250,0,6,0,6
"07/18/2021","Y","N","Anchorage Municipality",20,"Anchorage Municipality",1,0,249,1,251,0,6,0,6
"07/19/2021","Y","N","Anchorage Municipality",20,"Anchorage Municipality",1,0,249,1,252,0,6,0,6
"07/20/2021","Y","N","Anchorage Municipality",20,"Anchorage Municipality",1,2,251,1,253,0,6,0,6
"07/22/2021","Y","N","Anchorage Municipality",20,"Anchorage Municipality",1,0,251,2,255,0,6,0,6
"07/26/2021","Y","N","Anchorage Municipality",20,"Anchorage Municipality",1,0,251,2,257,0,6,0,6
"07/27/2021","Y","N","Anchorage Municipality",20,"Anchorage Municipality",1,1,252,0,257,0,6,0,6
"07/28/2021","Y","N","Anchorage Municipality",20,"Anchorage Municipality",1,2,254,0,257,0,6,0,6
"07/29/2021","Y","N","Anchorage Municipality",20,"Anchorage Municipality",1,0,254,2,259,0,6,0,6
"07/30/2021","Y","N","Anchorage Municipality",20,"Anchorage Municipality",1,0,254,2,261,0,6,0,6
"07/31/2021","Y","N","Anchorage Municipality",20,"Anchorage Municipality",1,1,255,0,261,0,6,0,6
"08/01/2021","Y","N","Anchorage Municipality",20,"Anchorage Municipality",1,2,257,2,263,1,7,0,6
"08/02/2021","Y","N","Anchorage Municipality",20,"Anchorage Municipality",1,1,258,6,269,0,7,0,6
"08/03/2021","Y","N","Anchorage Municipality",20,"Anchorage Municipality",1,3,261,1,270,0,7,0,6
"08/04/2021","Y","N","Anchorage Municipality",20,"Anchorage Municipality",1,0,261,1,271,0,7,0,6
"08/05/2021","Y","N","Anchorage Municipality",20,"Anchorage Municipality",1,0,261,2,273,0,7,0,6
"08/06/2021","Y","N","Anchorage Municipality",20,"Anchorage Municipality",1,2,263,0,273,0,7,0,6
"08/07/2021","Y","N","Anchorage Municipality",20,"Anchorage Municipality",1,1,264,1,274,0,7,0,6
"08/08/2021","Y","N","Anchorage Municipality",20,"Anchorage Municipality",1,3,267,1,275,0,7,0,6
"08/09/2021","Y","N","Anchorage Municipality",20,"Anchorage Municipality",1,2,269,2,277,0,7,0,6
"08/10/2021","Y","N","Anchorage Municipality",20,"Anchorage Municipality",1,1,270,1,278,0,7,0,6
"08/12/2021","Y","N","Anchorage Municipality",20,"Anchorage Municipality",1,4,274,3,281,0,7,0,6
"08/13/2021","Y","N","Anchorage Municipality",20,"Anchorage Municipality",1,2,276,1,282,0,7,0,6
"08/15/2021","Y","N","Anchorage Municipality",20,"Anchorage Municipality",1,1,277,0,282,0,7,0,6
"08/16/2021","Y","N","Anchorage Municipality",20,"Anchorage Municipality",1,1,278,1,283,0,7,0,6
"08/17/2021","Y","N","Anchorage Municipality",20,"Anchorage Municipality",1,1,279,0,283,0,7,0,6
"08/18/2021","Y","N","Anchorage Municipality",20,"Anchorage Municipality",1,1,280,0,283,0,7,0,6
"08/19/2021","Y","N","Anchorage Municipality",20,"Anchorage Municipality",1,1,281,1,284,0,7,0,6
"08/20/2021","Y","N","Anchorage Municipality",20,"Anchorage Municipality",1,1,282,3,287,0,7,0,6
"08/21/2021","Y","N","Anchorage Municipality",20,"Anchorage Municipality",1,0,282,1,288,0,7,0,6
"08/24/2021","Y","N","Anchorage Municipality",20,"Anchorage Municipality",1,1,283,3,291,0,7,0,6
"08/25/2021","Y","N","Anchorage Municipality",20,"Anchorage Municipality",1,0,283,1,292,0,7,0,6
"08/26/2021","Y","N","Anchorage Municipality",20,"Anchorage Municipality",1,0,283,4,296,0,7,0,6
"08/27/2021","Y","N","Anchorage Municipality",20,"Anchorage Municipality",1,0,283,1,297,0,7,0,6
"08/28/2021","Y","N","Anchorage Municipality",20,"Anchorage Municipality",1,3,286,2,299,0,7,0,6
"08/29/2021","Y","N","Anchorage Municipality",20,"Anchorage Municipality",1,0,286,2,301,0,7,0,6
"08/30/2021","Y","N","Anchorage Municipality",20,"Anchorage Municipality",1,0,286,3,304,0,7,0,6
"08/31/2021","Y","N","Anchorage Municipality",20,"Anchorage Municipality",1,3,289,4,308,0,7,0,6
"09/01/2021","Y","N","Anchorage Municipality",20,"Anchorage Municipality",1,2,291,3,311,1,8,0,6
"09/02/2021","Y","N","Anchorage Municipality",20,"Anchorage Municipality",1,1,292,3,314,0,8,1,7
"09/03/2021","Y","N","Anchorage Municipality",20,"Anchorage Municipality",1,0,292,1,315,0,8,0,7
"09/04/2021","Y","N","Anchorage Municipality",20,"Anchorage Municipality",1,4,296,0,315,0,8,0,7
"09/05/2021","Y","N","Anchorage Municipality",20,"Anchorage Municipality",1,2,298,0,315,1,9,0,7
"09/06/2021","Y","N","Anchorage Municipality",20,"Anchorage Municipality",1,4,302,0,315,0,9,0,7
"09/07/2021","Y","N","Anchorage Municipality",20,"Anchorage Municipality",1,1,303,1,316,0,9,0,7
"09/08/2021","Y","N","Anchorage Municipality",20,"Anchorage Municipality",1,5,308,3,319,0,9,0,7
"09/09/2021","Y","N","Anchorage Municipality",20,"Anchorage Municipality",1,2,310,3,322,0,9,0,7
"09/10/2021","Y","N","Anchorage Municipality",20,"Anchorage Municipality",1,0,310,0,322,0,9,1,8
"09/13/2021","Y","N","Anchorage Municipality",20,"Anchorage Municipality",1,1,311,2,324,0,9,0,8
"09/14/2021","Y","N","Anchorage Municipality",20,"Anchorage Municipality",1,3,314,2,326,0,9,0,8
"09/15/2021","Y","N","Anchorage Municipality",20,"Anchorage Municipality",1,1,315,2,328,1,10,0,8
"09/16/2021","Y","N","Anchorage Municipality",20,"Anchorage Municipality",1,6,321,2,330,0,10,0,8
"09/17/2021","Y","N","Anchorage Municipality",20,"Anchorage Municipality",1,3,324,5,335,1,11,0,8
"09/18/2021","Y","N","Anchorage Municipality",20,"Anchorage Municipality",1,0,324,1,336,0,11,0,8
"09/19/2021","Y","N","Anchorage Municipality",20,"Anchorage Municipality",1,0,324,4,340,0,11,0,8
"09/21/2021","Y","N","Anchorage Municipality",20,"Anchorage Municipality",1,0,324,3,343,0,11,1,9
"09/22/2021","Y","N","Anchorage Municipality",20,"Anchorage Municipality",1,1,325,2,345,0,11,0,9
"09/23/2021","Y","N","Anchorage Municipality",20,"Anchorage Municipality",1,2,327,0,345,0,11,0,9
"09/25/2021","Y","N","Anchorage Municipality",20,"Anchorage Municipality",1,7,334,1,346,0,11,0,9
"09/27/2021","Y","N","Anchorage Municipality",20,"Anchorage Municipality",1,9,343,4,350,0,11,0,9
"09/28/2021","Y","N","Anchorage Municipality",20,"Anchorage Municipality",1,3,346,3,353,0,11,0,9
"09/29/2021","Y","N","Anchorage Municipality",20,"Anchorage Municipality",1,0,346,1,354,0,11,0,9
"09/30/2021","Y","N","Anchorage Municipality",20,"Anchorage Municipality",1,0,346,2,356,0,11,0,9
"10/01/2021","Y","N","Anchorage Municipality",20,"Anchorage Municipality",1,2,348,0,356,0,11,0,9
"10/02/2021","Y","N","Anchorage Municipality",20,"Anchorage Municipality",1,1,349,4,360,0,11,0,9
"10/04/2021","Y","N","Anchorage Municipality",20,"Anchorage Municipality",1,1,350,1,361,0,11,1,10
"10/05/2021","Y","N","Anchorage Municipality",20,"Anchorage Municipality",1,2,352,1,362,0,11,0,10
"10/06/2021","Y","N","Anchorage Municipality",20,"Anchorage Municipality",1,1,353,3,365,0,11,0,10
"10/07/2021","Y","N","Anchorage Municipality",20,"Anchorage Municipality",1,0,353,1,366,0,11,0,10
"10/08/2021","Y","N","Anchorage Municipality",20,"Anchorage Municipality",1,2,355,0,366,0,11,0,10
"10/09/2021","Y","N","Anchorage Municipality",20,"Anchorage Municipality",1,0,355,2,368,0,11,0,10
"10/10/2021","Y","N","Anchorage Municipality",20,"Anchorage Municipality",1,0,355,1,369,0,11,0,10
"10/11/2021","Y","N","Anchorage Municipality",20,"Anchorage Municipality",1,4,359,1,370,0,11,0,10
"10/12/2021","Y","N","Anchorage Municipality",20,"Anchorage Municipality",1,0,359,1,371,0,11,0,10
"10/13/2021","Y","N","Anchorage Municipality",20,"Anchorage Municipality",1,4,363,0,371,0,11,0,10
"10/14/2021","Y","N","Anchorage Municipality",20,"Anchorage Municipality",1,0,363,3,374,0,11,0,10
"10/15/2021","Y","N","Anchorage Municipality",20,"Anchorage Municipality",1,0,363,1,375,0,11,0,10
"10/16/2021","Y","N","Anchorage Municipality",20,"Anchorage Municipality",1,0,363,1,376,0,11,0,10
"10/17/2021","Y","N","Anchorage Municipality",20,"Anchorage Municipality",1,0,363,1,377,0,11,0,10
"10/18/2021","Y","N","Anchorage Municipality",20,"Anchorage Municipality",1,0,363,1,378,0,11,0,10
"10/20/2021","Y","N","Anchorage Municipality",20,"Anchorage Municipality",1,1,364,2,380,0,11,0,10
"10/21/2021","Y","N","Anchorage Municipality",20,"Anchorage Municipality",1,1,365,0,380,0,11,0,10
"10/22/2021","Y","N","Anchorage Municipality",20,"Anchorage Municipality",1,1,366,1,381,0,11,0,10
"10/23/2021","Y","N","Anchorage Municipality",20,"Anchorage Municipality",1,3,369,0,381,0,11,0,10
"10/24/2021","Y","N","Anchorage Municipality",20,"Anchorage Municipality",1,1,370,0,381,0,11,0,10
"10/25/2021","Y","N","Anchorage Municipality",20,"Anchorage Municipality",1,1,371,2,383,0,11,0,10
"10/26/2021","Y","N","Anchorage Municipality",20,"Anchorage Municipality",1,5,376,0,383,0,11,0,10
"10/27/2021","Y","N","Anchorage Municipality",20,"Anchorage Municipality",1,1,377,1,384,0,11,0,10
"10/29/2021","Y","N","Anchorage Municipality",20,"Anchorage Municipality",1,0,377,0,384,0,11,1,11
"10/30/2021","Y","N","Anchorage Municipality",20,"Anchorage Municipality",1,2,379,0,384,0,11,0,11
"10/31/2021","Y","N","Anchorage Municipality",20,"Anchorage Municipality",1,2,381,2,386,0,11,0,11
"11/01/2021","Y","N","Anchorage Municipality",20,"Anchorage Municipality",1,1,382,2,388,0,11,0,11
"11/02/2021","Y","N","Anchorage Municipality",20,"Anchorage Municipality",1,1,383,1,389,0,11,0,11
"11/04/2021","Y","N","Anchorage Municipality",20,"Anchorage Municipality",1,2,385,0,389,0,11,0,11
"11/05/2021","Y","N","Anchorage Municipality",20,"Anchorage Municipality",1,3,388,1,390,0,11,0,11
"11/06/2021","Y","N","Anchorage Municipality",20,"Anchorage Municipality",1,1,389,0,390,0,11,0,11
"11/07/2021","Y","N","Anchorage Municipality",20,"Anchorage Municipality",1,0,389,1,391,0,11,0,11
"11/08/2021","Y","N","Anchorage Municipality",20,"Anchorage Municipality",1,1,390,1,392,0,11,0,11
"11/11/2021","Y","N","Anchorage Municipality",20,"Anchorage Municipality",1,0,390,1,393,0,11,0,11
"11/13/2021","Y","N","Anchorage Municipality",20,"Anchorage Municipality",1,0,390,1,394,0,11,0,11
"11/15/2021","Y","N","Anchorage Municipality",20,"Anchorage Municipality",1,0,390,1,395,0,11,0,11
"11/16/2021","Y","N","Anchorage Municipality",20,"Anchorage Municipality",1,2,392,0,395,0,11,0,11
"11/17/2021","Y","N","Anchorage Municipality",20,"Anchorage Municipality",1,0,392,1,396,1,12,0,11
"11/18/2021","Y","N","Anchorage Municipality",20,"Anchorage Municipality",1,0,392,0,396,0,12,1,12
"11/20/2021","Y","N","Anchorage Municipality",20,"Anchorage Municipality",1,0,392,1,397,0,12,0,12
"11/22/2021","Y","N","Anchorage Municipality",20,"Anchorage Municipality",1,0,392,1,398,0,12,0,12
"11/23/2021","Y","N","Anchorage Municipality",20,"Anchorage Municipality",1,0,392,2,400,0,12,0,12
"11/24/2021","Y","N","Anchorage Municipality",20,"Anchorage Municipality",1,1,393,1,401,0,12,0,12
"11/27/2021","Y","N","Anchorage Municipality",20,"Anchorage Municipality",1,0,393,1,402,0,12,0,12
"11/29/2021","Y","N","Anchorage Municipality",20,"Anchorage Municipality",1,4,397,2,404,0,12,0,12
"11/30/2021","Y","N","Anchorage Municipality",20,"Anchorage Municipality",1,1,398,0,404,0,12,0,12
"12/01/2021","Y","N","Anchorage Municipality",20,"Anchorage Municipality",1,1,399,1,405,0,12,0,12
"12/02/2021","Y","N","Anchorage Municipality",20,"Anchorage Municipality",1,0,399,2,407,0,12,0,12
"12/03/2021","Y","N","Anchorage Municipality",20,"Anchorage Municipality",1,3,402,2,409,0,12,0,12
"12/06/2021","Y","N","Anchorage Municipality",20,"Anchorage Municipality",1,0,402,1,410,0,12,0,12
"12/08/2021","Y","N","Anchorage Municipality",20,"Anchorage Municipality",1,0,402,1,411,0,12,0,12
"12/09/2021","Y","N","Anchorage Municipality",20,"Anchorage Municipality",1,2,404,0,411,0,12,0,12
"12/10/2021","Y","N","Anchorage Municipality",20,"Anchorage Municipality",1,2,406,1,412,0,12,0,12
"12/13/2021","Y","N","Anchorage Municipality",20,"Anchorage Municipality",1,0,406,1,413,0,12,0,12
"12/14/2021","Y","N","Anchorage Municipality",20,"Anchorage Municipality",1,0,406,2,415,0,12,0,12
"12/16/2021","Y","N","Anchorage Municipality",20,"Anchorage Municipality",1,0,406,1,416,0,12,0,12
"12/17/2021","Y","N","Anchorage Municipality",20,"Anchorage Municipality",1,1,407,2,418,0,12,0,12
"12/18/2021","Y","N","Anchorage Municipality",20,"Anchorage Municipality",1,0,407,1,419,0,12,0,12
"12/19/2021","Y","N","Anchorage Municipality",20,"Anchorage Municipality",1,1,408,0,419,0,12,0,12
"12/20/2021","Y","N","Anchorage Municipality",20,"Anchorage Municipality",1,3,411,1,420,0,12,0,12
"12/21/2021","Y","N","Anchorage Municipality",20,"Anchorage Municipality",1,2,413,1,421,0,12,0,12
"12/23/2021","Y","N","Anchorage Municipality",20,"Anchorage Municipality",1,4,417,6,427,0,12,0,12
"12/24/2021","Y","N","Anchorage Municipality",20,"Anchorage Municipality",1,0,417,3,430,0,12,0,12
"12/25/2021","Y","N","Anchorage Municipality",20,"Anchorage Municipality",1,0,417,1,431,0,12,0,12
"12/26/2021","Y","N","Anchorage Municipality",20,"Anchorage Municipality",1,0,417,4,435,0,12,0,12
"12/27/2021","Y","N","Anchorage Municipality",20,"Anchorage Municipality",1,3,420,10,445,0,12,0,12
"12/28/2021","Y","N","Anchorage Municipality",20,"Anchorage Municipality",1,2,422,2,447,0,12,0,12
"12/29/2021","Y","N","Anchorage Municipality",20,"Anchorage Municipality",1,1,423,4,451,0,12,0,12
"12/30/2021","Y","N","Anchorage Municipality",20,"Anchorage Municipality",1,6,429,9,460,0,12,0,12
"12/31/2021","Y","N","Anchorage Municipality",20,"Anchorage Municipality",1,0,429,5,465,0,12,0,12
"01/01/2022","Y","N","Anchorage Municipality",20,"Anchorage Municipality",1,6,435,0,465,0,12,0,12
"01/02/2022","Y","N","Anchorage Municipality",20,"Anchorage Municipality",1,8,443,10,475,0,12,0,12
"01/03/2022","Y","N","Anchorage Municipality",20,"Anchorage Municipality",1,9,452,5,480,0,12,0,12
"01/04/2022","Y","N","Anchorage Municipality",20,"Anchorage Municipality",1,4,456,5,485,0,12,0,12
"01/05/2022","Y","N","Anchorage Municipality",20,"Anchorage Municipality",1,1,457,12,497,0,12,0,12
"01/06/2022","Y","N","Anchorage Municipality",20,"Anchorage Municipality",1,4,461,10,507,0,12,0,12
"01/07/2022","Y","N","Anchorage Municipality",20,"Anchorage Municipality",1,3,464,8,515,0,12,0,12
"01/08/2022","Y","N","Anchorage Municipality",20,"Anchorage Municipality",1,1,465,4,519,0,12,0,12
"01/09/2022","Y","N","Anchorage Municipality",20,"Anchorage Municipality",1,4,469,4,523,0,12,0,12
"01/10/2022","Y","N","Anchorage Municipality",20,"Anchorage Municipality",1,4,473,2,525,0,12,0,12
"01/11/2022","Y","N","Anchorage Municipality",20,"Anchorage Municipality",1,6,479,10,535,0,12,0,12
"01/12/2022","Y","N","Anchorage Municipality",20,"Anchorage Municipality",1,10,489,9,544,0,12,0,12
"01/13/2022","Y","N","Anchorage Municipality",20,"Anchorage Municipality",1,8,497,6,550,0,12,0,12
"01/14/2022","Y","N","Anchorage Municipality",20,"Anchorage Municipality",1,1,498,8,558,0,12,0,12
"01/15/2022","Y","N","Anchorage Municipality",20,"Anchorage Municipality",1,1,499,1,559,0,12,0,12
"01/16/2022","Y","N","Anchorage Municipality",20,"Anchorage Municipality",1,1,500,2,561,0,12,0,12
"01/17/2022","Y","N","Anchorage Municipality",20,"Anchorage Municipality",1,0,500,5,566,0,12,0,12
"01/18/2022","Y","N","Anchorage Municipality",20,"Anchorage Municipality",1,0,500,7,573,0,12,0,12
"01/19/2022","Y","N","Anchorage Municipality",20,"Anchorage Municipality",1,4,504,6,579,0,12,1,13
"01/20/2022","Y","N","Anchorage Municipality",20,"Anchorage Municipality",1,19,523,5,584,0,12,0,13
"01/21/2022","Y","N","Anchorage Municipality",20,"Anchorage Municipality",1,8,531,1,585,0,12,0,13
"01/22/2022","Y","N","Anchorage Municipality",20,"Anchorage Municipality",1,4,535,1,586,0,12,0,13
"01/23/2022","Y","N","Anchorage Municipality",20,"Anchorage Municipality",1,11,546,1,587,0,12,0,13
"01/24/2022","Y","N","Anchorage Municipality",20,"Anchorage Municipality",1,5,551,2,589,0,12,0,13
"01/25/2022","Y","N","Anchorage Municipality",20,"Anchorage Municipality",1,4,555,2,591,0,12,0,13
"01/26/2022","Y","N","Anchorage Municipality",20,"Anchorage Municipality",1,3,558,1,592,0,12,0,13
"01/27/2022","Y","N","Anchorage Municipality",20,"Anchorage Municipality",1,2,560,0,592,0,12,0,13
"01/28/2022","Y","N","Anchorage Municipality",20,"Anchorage Municipality",1,5,565,1,593,0,12,0,13
"01/30/2022","Y","N","Anchorage Municipality",20,"Anchorage Municipality",1,1,566,2,595,0,12,0,13
"01/31/2022","Y","N","Anchorage Municipality",20,"Anchorage Municipality",1,4,570,4,599,0,12,0,13
"02/01/2022","Y","N","Anchorage Municipality",20,"Anchorage Municipality",1,1,571,0,599,0,12,0,13
"02/02/2022","Y","N","Anchorage Municipality",20,"Anchorage Municipality",1,7,578,4,603,0,12,0,13
"02/03/2022","Y","N","Anchorage Municipality",20,"Anchorage Municipality",1,6,584,3,606,0,12,0,13
"02/04/2022","Y","N","Anchorage Municipality",20,"Anchorage Municipality",1,8,592,1,607,1,13,0,13
"02/05/2022","Y","N","Anchorage Municipality",20,"Anchorage Municipality",1,0,592,2,609,0,13,1,14
"02/06/2022","Y","N","Anchorage Municipality",20,"Anchorage Municipality",1,1,593,1,610,0,13,0,14
"02/07/2022","Y","N","Anchorage Municipality",20,"Anchorage Municipality",1,1,594,5,615,0,13,0,14
"02/08/2022","Y","N","Anchorage Municipality",20,"Anchorage Municipality",1,1,595,3,618,0,13,0,14
"02/09/2022","Y","N","Anchorage Municipality",20,"Anchorage Municipality",1,1,596,3,621,0,13,0,14
"02/10/2022","Y","N","Anchorage Municipality",20,"Anchorage Municipality",1,2,598,5,626,0,13,0,14
"02/11/2022","Y","N","Anchorage Municipality",20,"Anchorage Municipality",1,5,603,1,627,0,13,0,14
"02/12/2022","Y","N","Anchorage Municipality",20,"Anchorage Municipality",1,2,605,0,627,0,13,0,14
"02/14/2022","Y","N","Anchorage Municipality",20,"Anchorage Municipality",1,0,605,4,631,0,13,0,14
"02/16/2022","Y","N","Anchorage Municipality",20,"Anchorage Municipality",1,3,608,1,632,0,13,0,14
"02/17/2022","Y","N","Anchorage Municipality",20,"Anchorage Municipality",1,2,610,0,632,0,13,0,14
"02/18/2022","Y","N","Anchorage Municipality",20,"Anchorage Municipality",1,1,611,2,634,0,13,0,14
"02/21/2022","Y","N","Anchorage Municipality",20,"Anchorage Municipality",1,0,611,2,636,0,13,0,14
"02/22/2022","Y","N","Anchorage Municipality",20,"Anchorage Municipality",1,0,611,1,637,0,13,0,14
"02/23/2022","Y","N","Anchorage Municipality",20,"Anchorage Municipality",1,1,612,0,637,0,13,0,14
"02/24/2022","Y","N","Anchorage Municipality",20,"Anchorage Municipality",1,1,613,0,637,0,13,0,14
"02/25/2022","Y","N","Anchorage Municipality",20,"Anchorage Municipality",1,6,619,0,637,0,13,0,14
"02/26/2022","Y","N","Anchorage Municipality",20,"Anchorage Municipality",1,12,631,1,638,0,13,0,14
"02/27/2022","Y","N","Anchorage Municipality",20,"Anchorage Municipality",1,0,631,3,641,0,13,0,14
"02/28/2022","Y","N","Anchorage Municipality",20,"Anchorage Municipality",1,1,632,0,641,0,13,0,14
"03/01/2022","Y","N","Anchorage Municipality",20,"Anchorage Municipality",1,6,638,0,641,0,13,0,14
"03/03/2022","Y","N","Anchorage Municipality",20,"Anchorage Municipality",1,1,639,0,641,0,13,0,14
"03/05/2022","Y","N","Anchorage Municipality",20,"Anchorage Municipality",1,0,639,1,642,0,13,0,14
"03/06/2022","Y","N","Anchorage Municipality",20,"Anchorage Municipality",1,0,639,1,643,0,13,0,14
"03/08/2022","Y","N","Anchorage Municipality",20,"Anchorage Municipality",1,0,639,1,644,0,13,0,14
"03/15/2022","Y","N","Anchorage Municipality",20,"Anchorage Municipality",1,5,644,0,644,0,13,0,14
"03/21/2022","Y","N","Anchorage Municipality",20,"Anchorage Municipality",1,0,644,1,645,0,13,0,14
"03/22/2022","Y","N","Anchorage Municipality",20,"Anchorage Municipality",1,0,644,1,646,0,13,0,14
"03/24/2022","Y","N","Anchorage Municipality",20,"Anchorage Municipality",1,0,644,1,647,0,13,0,14
"03/30/2022","Y","N","Anchorage Municipality",20,"Anchorage Municipality",1,1,645,0,647,0,13,0,14
"04/01/2022","Y","N","Anchorage Municipality",20,"Anchorage Municipality",1,1,646,0,647,0,13,0,14
"04/05/2022","Y","N","Anchorage Municipality",20,"Anchorage Municipality",1,1,647,0,647,0,13,0,14
"04/07/2022","Y","N","Anchorage Municipality",20,"Anchorage Municipality",1,0,647,1,648,0,13,0,14
"04/12/2022","Y","N","Anchorage Municipality",20,"Anchorage Municipality",1,0,647,1,649,0,13,0,14
"04/13/2022","Y","N","Anchorage Municipality",20,"Anchorage Municipality",1,1,648,2,651,0,13,0,14
"04/15/2022","Y","N","Anchorage Municipality",20,"Anchorage Municipality",1,1,649,0,651,0,13,0,14
"04/26/2022","Y","N","Anchorage Municipality",20,"Anchorage Municipality",1,2,651,0,651,0,13,0,14
"09/23/2020","Y","N","Bethel Census Area",50,"Y-K Delta Region",10,0,0,1,1,0,0,0,0
"09/24/2020","Y","N","Bethel Census Area",50,"Y-K Delta Region",10,1,1,0,1,0,0,0,0
"01/06/2021","Y","N","Bethel Census Area",50,"Y-K Delta Region",10,0,1,1,2,0,0,0,0
"01/08/2021","Y","N","Bethel Census Area",50,"Y-K Delta Region",10,1,2,0,2,0,0,0,0
"12/30/2021","Y","N","Bethel Census Area",50,"Y-K Delta Region",10,1,3,1,3,0,0,0,0
"01/04/2022","Y","N","Bethel Census Area",50,"Y-K Delta Region",10,0,3,2,5,0,0,0,0
"01/06/2022","Y","N","Bethel Census Area",50,"Y-K Delta Region",10,0,3,1,6,0,0,0,0
"01/07/2022","Y","N","Bethel Census Area",50,"Y-K Delta Region",10,1,4,0,6,0,0,0,0
"01/10/2022","Y","N","Bethel Census Area",50,"Y-K Delta Region",10,1,5,1,7,0,0,0,0
"01/11/2022","Y","N","Bethel Census Area",50,"Y-K Delta Region",10,1,6,0,7,0,0,0,0
"01/12/2022","Y","N","Bethel Census Area",50,"Y-K Delta Region",10,2,8,2,9,0,0,0,0
"01/13/2022","Y","N","Bethel Census Area",50,"Y-K Delta Region",10,1,9,1,10,0,0,0,0
"01/21/2022","Y","N","Bethel Census Area",50,"Y-K Delta Region",10,0,9,1,11,0,0,0,0
"01/22/2022","Y","N","Bethel Census Area",50,"Y-K Delta Region",10,1,10,0,11,0,0,0,0
"02/07/2022","Y","N","Bethel Census Area",50,"Y-K Delta Region",10,0,10,1,12,0,0,0,0
"02/08/2022","Y","N","Bethel Census Area",50,"Y-K Delta Region",10,0,10,1,13,0,0,0,0
"02/16/2022","Y","N","Bethel Census Area",50,"Y-K Delta Region",10,1,11,1,14,0,0,0,0
"02/22/2022","Y","N","Bethel Census Area",50,"Y-K Delta Region",10,0,11,1,15,0,0,0,0
"02/25/2022","Y","N","Bethel Census Area",50,"Y-K Delta Region",10,2,13,0,15,0,0,0,0
"02/26/2022","Y","N","Bethel Census Area",50,"Y-K Delta Region",10,1,14,0,15,0,0,0,0
"03/02/2022","Y","N","Bethel Census Area",50,"Y-K Delta Region",10,1,15,0,15,0,0,0,0
"12/27/2020","Y","N","Bristol Bay plus Lake and Peninsula",300,"Southwest Region",11,0,0,1,1,0,0,0,0
"12/30/2020","Y","N","Bristol Bay plus Lake and Peninsula",300,"Southwest Region",11,1,1,0,1,0,0,0,0
"04/29/2021","Y","N","Bristol Bay plus Lake and Peninsula",300,"Southwest Region",11,0,1,1,2,0,0,0,0
"05/06/2021","Y","N","Bristol Bay plus Lake and Peninsula",300,"Southwest Region",11,1,2,0,2,0,0,0,0
"09/10/2021","Y","N","Bristol Bay plus Lake and Peninsula",300,"Southwest Region",11,0,2,1,3,0,0,0,0
"09/24/2021","Y","N","Bristol Bay plus Lake and Peninsula",300,"Southwest Region",11,1,3,0,3,0,0,0,0
"10/26/2021","Y","N","Bristol Bay plus Lake and Peninsula",300,"Southwest Region",11,0,3,2,5,0,0,0,0
"10/28/2021","Y","N","Bristol Bay plus Lake and Peninsula",300,"Southwest Region",11,0,3,1,6,0,0,0,0
"11/05/2021","Y","N","Bristol Bay plus Lake and Peninsula",300,"Southwest Region",11,3,6,0,6,0,0,0,0
"01/12/2022","Y","N","Bristol Bay plus Lake and Peninsula",300,"Southwest Region",11,0,6,1,7,0,0,0,0
"01/18/2022","Y","N","Bristol Bay plus Lake and Peninsula",300,"Southwest Region",11,1,7,0,7,0,0,0,0
"08/05/2020","Y","N","Chugach Census Area",63,"Other Interior Region",7,0,0,1,1,0,0,0,0
"08/06/2020","Y","N","Chugach Census Area",63,"Other Interior Region",7,0,0,1,2,0,0,0,0
"08/09/2020","Y","N","Chugach Census Area",63,"Other Interior Region",7,2,2,0,2,0,0,0,0
"10/24/2020","Y","N","Chugach Census Area",63,"Other Interior Region",7,0,2,1,3,0,0,0,0
"11/02/2020","Y","N","Chugach Census Area",63,"Other Interior Region",7,0,2,1,4,0,0,0,0
"11/05/2020","Y","N","Chugach Census Area",63,"Other Interior Region",7,1,3,0,4,1,1,0,0
"11/06/2020","Y","N","Chugach Census Area",63,"Other Interior Region",7,1,4,0,4,0,1,0,0
"11/11/2020","Y","N","Chugach Census Area",63,"Other Interior Region",7,1,5,1,5,0,1,0,0
"11/24/2020","Y","N","Chugach Census Area",63,"Other Interior Region",7,0,5,0,5,0,1,1,1
"01/15/2021","Y","N","Chugach Census Area",63,"Other Interior Region",7,0,5,1,6,0,1,0,1
"01/24/2021","Y","N","Chugach Census Area",63,"Other Interior Region",7,0,5,1,7,0,1,0,1
"02/06/2021","Y","N","Chugach Census Area",63,"Other Interior Region",7,1,6,0,7,0,1,0,1
"02/16/2021","Y","N","Chugach Census Area",63,"Other Interior Region",7,1,7,0,7,0,1,0,1
"08/07/2021","Y","N","Chugach Census Area",63,"Other Interior Region",7,0,7,1,8,0,1,0,1
"08/17/2021","Y","N","Chugach Census Area",63,"Other Interior Region",7,1,8,0,8,0,1,0,1
"09/06/2021","Y","N","Chugach Census Area",63,"Other Interior Region",7,0,8,1,9,0,1,0,1
"09/14/2021","Y","N","Chugach Census Area",63,"Other Interior Region",7,1,9,0,9,0,1,0,1
"10/16/2021","Y","N","Chugach Census Area",63,"Other Interior Region",7,0,9,1,10,0,1,0,1
"10/30/2021","Y","N","Chugach Census Area",63,"Other Interior Region",7,1,10,0,10,0,1,0,1
"12/26/2021","Y","N","Chugach Census Area",63,"Other Interior Region",7,0,10,2,12,0,1,0,1
"12/27/2021","Y","N","Chugach Census Area",63,"Other Interior Region",7,0,10,3,15,0,1,0,1
"12/28/2021","Y","N","Chugach Census Area",63,"Other Interior Region",7,1,11,0,15,0,1,0,1
"12/29/2021","Y","N","Chugach Census Area",63,"Other Interior Region",7,2,13,0,15,0,1,0,1
"01/01/2022","Y","N","Chugach Census Area",63,"Other Interior Region",7,1,14,0,15,0,1,0,1
"01/04/2022","Y","N","Chugach Census Area",63,"Other Interior Region",7,0,14,1,16,0,1,0,1
"01/19/2022","Y","N","Chugach Census Area",63,"Other Interior Region",7,2,16,2,18,0,1,0,1
"01/20/2022","Y","N","Chugach Census Area",63,"Other Interior Region",7,1,17,0,18,0,1,0,1
"01/21/2022","Y","N","Chugach Census Area",63,"Other Interior Region",7,1,18,0,18,0,1,0,1
"01/27/2022","Y","N","Chugach Census Area",63,"Other Interior Region",7,0,18,1,19,0,1,0,1
"02/03/2022","Y","N","Chugach Census Area",63,"Other Interior Region",7,1,19,0,19,0,1,0,1
"10/08/2020","Y","N","Copper River Census Area",66,"Other Interior Region",7,0,0,1,1,0,0,0,0
"10/10/2020","Y","N","Copper River Census Area",66,"Other Interior Region",7,1,1,0,1,0,0,0,0
"10/11/2020","Y","N","Copper River Census Area",66,"Other Interior Region",7,0,1,1,2,0,0,0,0
"10/24/2020","Y","N","Copper River Census Area",66,"Other Interior Region",7,1,2,0,2,0,0,0,0
"11/06/2020","Y","N","Copper River Census Area",66,"Other Interior Region",7,0,2,1,3,0,0,0,0
"11/09/2020","Y","N","Copper River Census Area",66,"Other Interior Region",7,1,3,0,3,0,0,0,0
"04/08/2021","Y","N","Copper River Census Area",66,"Other Interior Region",7,0,3,1,4,0,0,0,0
"04/21/2021","Y","N","Copper River Census Area",66,"Other Interior Region",7,1,4,0,4,0,0,0,0
"09/07/2021","Y","N","Copper River Census Area",66,"Other Interior Region",7,1,5,1,5,0,0,0,0
"10/13/2021","Y","N","Copper River Census Area",66,"Other Interior Region",7,0,5,1,6,0,0,0,0
"10/16/2021","Y","N","Copper River Census Area",66,"Other Interior Region",7,1,6,0,6,0,0,0,0
"11/22/2021","Y","N","Copper River Census Area",66,"Other Interior Region",7,0,6,1,7,0,0,0,0
"11/26/2021","Y","N","Copper River Census Area",66,"Other Interior Region",7,1,7,0,7,0,0,0,0
"12/28/2021","Y","N","Copper River Census Area",66,"Other Interior Region",7,1,8,1,8,0,0,0,0
"01/07/2022","Y","N","Copper River Census Area",66,"Other Interior Region",7,0,8,1,9,0,0,0,0
"01/12/2022","Y","N","Copper River Census Area",66,"Other Interior Region",7,1,9,0,9,0,0,0,0
"01/18/2022","Y","N","Copper River Census Area",66,"Other Interior Region",7,0,9,1,10,0,0,0,0
"01/25/2022","Y","N","Copper River Census Area",66,"Other Interior Region",7,1,10,0,10,0,0,0,0
"02/08/2022","Y","N","Copper River Census Area",66,"Other Interior Region",7,1,11,1,11,0,0,0,0
"12/09/2020","Y","N","Denali Borough",68,"Other Interior Region",7,0,0,1,1,0,0,0,0
"12/11/2020","Y","N","Denali Borough",68,"Other Interior Region",7,1,1,0,1,0,0,0,0
"03/15/2021","Y","N","Denali Borough",68,"Other Interior Region",7,0,1,1,2,0,0,0,0
"03/18/2021","Y","N","Denali Borough",68,"Other Interior Region",7,1,2,0,2,0,0,0,0
"04/02/2021","Y","N","Denali Borough",68,"Other Interior Region",7,0,2,1,3,0,0,0,0
"04/09/2021","Y","N","Denali Borough",68,"Other Interior Region",7,1,3,0,3,0,0,0,0
"08/06/2021","Y","N","Denali Borough",68,"Other Interior Region",7,0,3,1,4,0,0,0,0
"08/09/2021","Y","N","Denali Borough",68,"Other Interior Region",7,1,4,0,4,0,0,0,0
"08/24/2021","Y","N","Denali Borough",68,"Other Interior Region",7,0,4,1,5,0,0,0,0
"08/31/2021","Y","N","Denali Borough",68,"Other Interior Region",7,1,5,0,5,0,0,0,0
"12/17/2021","Y","N","Denali Borough",68,"Other Interior Region",7,0,5,1,6,0,0,0,0
"12/30/2021","Y","N","Denali Borough",68,"Other Interior Region",7,1,6,0,6,0,0,0,0
"01/04/2022","Y","N","Denali Borough",68,"Other Interior Region",7,1,7,1,7,0,0,0,0
"01/07/2022","Y","N","Denali Borough",68,"Other Interior Region",7,1,8,1,8,0,0,0,0
"01/29/2022","Y","N","Denali Borough",68,"Other Interior Region",7,1,9,3,11,0,0,0,0
"02/25/2022","Y","N","Denali Borough",68,"Other Interior Region",7,1,10,0,11,0,0,0,0
"03/01/2022","Y","N","Denali Borough",68,"Other Interior Region",7,1,11,0,11,0,0,0,0
"06/17/2020","Y","N","Dillingham Census Area",70,"Southwest Region",11,0,0,1,1,0,0,0,0
"06/18/2020","Y","N","Dillingham Census Area",70,"Southwest Region",11,1,1,0,1,0,0,0,0
"08/19/2021","Y","N","Dillingham Census Area",70,"Southwest Region",11,0,1,1,2,0,0,0,0
"08/23/2021","Y","N","Dillingham Census Area",70,"Southwest Region",11,1,2,0,2,0,0,0,0
"01/13/2022","Y","N","Dillingham Census Area",70,"Southwest Region",11,0,2,1,3,0,0,0,0
"01/17/2022","Y","N","Dillingham Census Area",70,"Southwest Region",11,0,2,1,4,0,0,0,0
"01/23/2022","Y","N","Dillingham Census Area",70,"Southwest Region",11,1,3,0,4,0,0,0,0
"01/25/2022","Y","N","Dillingham Census Area",70,"Southwest Region",11,1,4,0,4,0,0,0,0
"03/08/2022","Y","N","Dillingham Census Area",70,"Southwest Region",11,0,4,1,5,0,0,0,0
"03/14/2022","Y","N","Dillingham Census Area",70,"Southwest Region",11,1,5,0,5,0,0,0,0
"03/16/2020","Y","N","Fairbanks North Star Borough",90,"Fairbanks North Star Borough",2,0,0,1,1,0,0,0,0
"04/03/2020","Y","N","Fairbanks North Star Borough",90,"Fairbanks North Star Borough",2,1,1,0,1,0,0,0,0
"06/26/2020","Y","N","Fairbanks North Star Borough",90,"Fairbanks North Star Borough",2,0,1,1,2,0,0,0,0
"07/10/2020","Y","N","Fairbanks North Star Borough",90,"Fairbanks North Star Borough",2,0,1,1,3,0,0,0,0
"07/29/2020","Y","N","Fairbanks North Star Borough",90,"Fairbanks North Star Borough",2,1,2,0,3,0,0,0,0
"08/12/2020","Y","N","Fairbanks North Star Borough",90,"Fairbanks North Star Borough",2,1,3,0,3,0,0,0,0
"08/29/2020","Y","N","Fairbanks North Star Borough",90,"Fairbanks North Star Borough",2,0,3,1,4,0,0,0,0
"09/03/2020","Y","N","Fairbanks North Star Borough",90,"Fairbanks North Star Borough",2,1,4,0,4,0,0,0,0
"09/18/2020","Y","N","Fairbanks North Star Borough",90,"Fairbanks North Star Borough",2,1,5,1,5,0,0,0,0
"09/25/2020","Y","N","Fairbanks North Star Borough",90,"Fairbanks North Star Borough",2,1,6,1,6,0,0,0,0
"10/05/2020","Y","N","Fairbanks North Star Borough",90,"Fairbanks North Star Borough",2,0,6,1,7,0,0,0,0
"10/06/2020","Y","N","Fairbanks North Star Borough",90,"Fairbanks North Star Borough",2,0,6,1,8,0,0,0,0
"10/11/2020","Y","N","Fairbanks North Star Borough",90,"Fairbanks North Star Borough",2,1,7,0,8,0,0,0,0
"10/15/2020","Y","N","Fairbanks North Star Borough",90,"Fairbanks North Star Borough",2,0,7,2,10,0,0,0,0
"10/17/2020","Y","N","Fairbanks North Star Borough",90,"Fairbanks North Star Borough",2,0,7,1,11,0,0,0,0
"10/19/2020","Y","N","Fairbanks North Star Borough",90,"Fairbanks North Star Borough",2,1,8,1,12,0,0,0,0
"10/21/2020","Y","N","Fairbanks North Star Borough",90,"Fairbanks North Star Borough",2,2,10,1,13,0,0,0,0
"10/22/2020","Y","N","Fairbanks North Star Borough",90,"Fairbanks North Star Borough",2,1,11,0,13,0,0,0,0
"10/25/2020","Y","N","Fairbanks North Star Borough",90,"Fairbanks North Star Borough",2,1,12,0,13,0,0,0,0
"10/26/2020","Y","N","Fairbanks North Star Borough",90,"Fairbanks North Star Borough",2,0,12,1,14,0,0,0,0
"10/27/2020","Y","N","Fairbanks North Star Borough",90,"Fairbanks North Star Borough",2,0,12,1,15,0,0,0,0
"10/30/2020","Y","N","Fairbanks North Star Borough",90,"Fairbanks North Star Borough",2,1,13,1,16,0,0,0,0
"11/02/2020","Y","N","Fairbanks North Star Borough",90,"Fairbanks North Star Borough",2,0,13,1,17,0,0,0,0
"11/05/2020","Y","N","Fairbanks North Star Borough",90,"Fairbanks North Star Borough",2,1,14,0,17,0,0,0,0
"11/07/2020","Y","N","Fairbanks North Star Borough",90,"Fairbanks North Star Borough",2,1,15,0,17,0,0,0,0
"11/13/2020","Y","N","Fairbanks North Star Borough",90,"Fairbanks North Star Borough",2,1,16,1,18,0,0,0,0
"11/17/2020","Y","N","Fairbanks North Star Borough",90,"Fairbanks North Star Borough",2,0,16,1,19,0,0,0,0
"11/29/2020","Y","N","Fairbanks North Star Borough",90,"Fairbanks North Star Borough",2,1,17,1,20,0,0,0,0
"11/30/2020","Y","N","Fairbanks North Star Borough",90,"Fairbanks North Star Borough",2,1,18,1,21,0,0,0,0
"12/04/2020","Y","N","Fairbanks North Star Borough",90,"Fairbanks North Star Borough",2,0,18,1,22,0,0,0,0
"12/07/2020","Y","N","Fairbanks North Star Borough",90,"Fairbanks North Star Borough",2,0,18,1,23,0,0,0,0
"12/08/2020","Y","N","Fairbanks North Star Borough",90,"Fairbanks North Star Borough",2,1,19,0,23,0,0,0,0
"12/09/2020","Y","N","Fairbanks North Star Borough",90,"Fairbanks North Star Borough",2,1,20,1,24,0,0,0,0
"12/10/2020","Y","N","Fairbanks North Star Borough",90,"Fairbanks North Star Borough",2,2,22,0,24,0,0,0,0
"12/14/2020","Y","N","Fairbanks North Star Borough",90,"Fairbanks North Star Borough",2,0,22,1,25,0,0,0,0
"12/15/2020","Y","N","Fairbanks North Star Borough",90,"Fairbanks North Star Borough",2,0,22,1,26,0,0,0,0
"12/17/2020","Y","N","Fairbanks North Star Borough",90,"Fairbanks North Star Borough",2,2,24,0,26,0,0,0,0
"12/21/2020","Y","N","Fairbanks North Star Borough",90,"Fairbanks North Star Borough",2,0,24,1,27,0,0,0,0
"12/23/2020","Y","N","Fairbanks North Star Borough",90,"Fairbanks North Star Borough",2,0,24,2,29,0,0,0,0
"12/24/2020","Y","N","Fairbanks North Star Borough",90,"Fairbanks North Star Borough",2,2,26,1,30,0,0,0,0
"12/27/2020","Y","N","Fairbanks North Star Borough",90,"Fairbanks North Star Borough",2,2,28,1,31,0,0,0,0
"12/28/2020","Y","N","Fairbanks North Star Borough",90,"Fairbanks North Star Borough",2,0,28,2,33,0,0,0,0
"12/30/2020","Y","N","Fairbanks North Star Borough",90,"Fairbanks North Star Borough",2,1,29,2,35,0,0,0,0
"12/31/2020","Y","N","Fairbanks North Star Borough",90,"Fairbanks North Star Borough",2,1,30,0,35,0,0,0,0
"01/01/2021","Y","N","Fairbanks North Star Borough",90,"Fairbanks North Star Borough",2,2,32,1,36,0,0,0,0
"01/02/2021","Y","N","Fairbanks North Star Borough",90,"Fairbanks North Star Borough",2,1,33,2,38,0,0,0,0
"01/03/2021","Y","N","Fairbanks North Star Borough",90,"Fairbanks North Star Borough",2,0,33,2,40,0,0,0,0
"01/04/2021","Y","N","Fairbanks North Star Borough",90,"Fairbanks North Star Borough",2,0,33,2,42,0,0,0,0
"01/05/2021","Y","N","Fairbanks North Star Borough",90,"Fairbanks North Star Borough",2,1,34,0,42,0,0,0,0
"01/06/2021","Y","N","Fairbanks North Star Borough",90,"Fairbanks North Star Borough",2,3,37,0,42,0,0,0,0
"01/08/2021","Y","N","Fairbanks North Star Borough",90,"Fairbanks North Star Borough",2,1,38,2,44,0,0,0,0
"01/11/2021","Y","N","Fairbanks North Star Borough",90,"Fairbanks North Star Borough",2,1,39,2,46,0,0,0,0
"01/12/2021","Y","N","Fairbanks North Star Borough",90,"Fairbanks North Star Borough",2,3,42,2,48,0,0,0,0
"01/13/2021","Y","N","Fairbanks North Star Borough",90,"Fairbanks North Star Borough",2,1,43,0,48,0,0,0,0
"01/14/2021","Y","N","Fairbanks North Star Borough",90,"Fairbanks North Star Borough",2,0,43,1,49,0,0,0,0
"01/15/2021","Y","N","Fairbanks North Star Borough",90,"Fairbanks North Star Borough",2,1,44,0,49,0,0,0,0
"01/18/2021","Y","N","Fairbanks North Star Borough",90,"Fairbanks North Star Borough",2,0,44,2,51,0,0,0,0
"01/19/2021","Y","N","Fairbanks North Star Borough",90,"Fairbanks North Star Borough",2,1,45,0,51,0,0,0,0
"01/20/2021","Y","N","Fairbanks North Star Borough",90,"Fairbanks North Star Borough",2,2,47,1,52,0,0,0,0
"01/21/2021","Y","N","Fairbanks North Star Borough",90,"Fairbanks North Star Borough",2,1,48,0,52,0,0,0,0
"01/22/2021","Y","N","Fairbanks North Star Borough",90,"Fairbanks North Star Borough",2,0,48,3,55,0,0,0,0
"01/23/2021","Y","N","Fairbanks North Star Borough",90,"Fairbanks North Star Borough",2,1,49,0,55,0,0,0,0
"01/24/2021","Y","N","Fairbanks North Star Borough",90,"Fairbanks North Star Borough",2,1,50,3,58,0,0,0,0
"01/25/2021","Y","N","Fairbanks North Star Borough",90,"Fairbanks North Star Borough",2,1,51,0,58,0,0,0,0
"01/26/2021","Y","N","Fairbanks North Star Borough",90,"Fairbanks North Star Borough",2,0,51,1,59,0,0,0,0
"01/28/2021","Y","N","Fairbanks North Star Borough",90,"Fairbanks North Star Borough",2,1,52,0,59,0,0,0,0
"01/29/2021","Y","N","Fairbanks North Star Borough",90,"Fairbanks North Star Borough",2,1,53,0,59,0,0,0,0
"01/31/2021","Y","N","Fairbanks North Star Borough",90,"Fairbanks North Star Borough",2,1,54,0,59,0,0,0,0
"02/01/2021","Y","N","Fairbanks North Star Borough",90,"Fairbanks North Star Borough",2,0,54,2,61,0,0,0,0
"02/03/2021","Y","N","Fairbanks North Star Borough",90,"Fairbanks North Star Borough",2,0,54,2,63,0,0,0,0
"02/04/2021","Y","N","Fairbanks North Star Borough",90,"Fairbanks North Star Borough",2,0,54,1,64,0,0,0,0
"02/05/2021","Y","N","Fairbanks North Star Borough",90,"Fairbanks North Star Borough",2,4,58,0,64,0,0,0,0
"02/06/2021","Y","N","Fairbanks North Star Borough",90,"Fairbanks North Star Borough",2,0,58,1,65,0,0,0,0
"02/09/2021","Y","N","Fairbanks North Star Borough",90,"Fairbanks North Star Borough",2,1,59,0,65,0,0,0,0
"02/10/2021","Y","N","Fairbanks North Star Borough",90,"Fairbanks North Star Borough",2,0,59,1,66,0,0,0,0
"02/13/2021","Y","N","Fairbanks North Star Borough",90,"Fairbanks North Star Borough",2,1,60,0,66,0,0,0,0
"02/16/2021","Y","N","Fairbanks North Star Borough",90,"Fairbanks North Star Borough",2,3,63,0,66,0,0,0,0
"02/21/2021","Y","N","Fairbanks North Star Borough",90,"Fairbanks North Star Borough",2,0,63,1,67,0,0,0,0
"02/24/2021","Y","N","Fairbanks North Star Borough",90,"Fairbanks North Star Borough",2,2,65,0,67,0,0,0,0
"02/26/2021","Y","N","Fairbanks North Star Borough",90,"Fairbanks North Star Borough",2,1,66,0,67,0,0,0,0
"03/02/2021","Y","N","Fairbanks North Star Borough",90,"Fairbanks North Star Borough",2,0,66,1,68,0,0,0,0
"03/03/2021","Y","N","Fairbanks North Star Borough",90,"Fairbanks North Star Borough",2,1,67,1,69,0,0,0,0
"03/04/2021","Y","N","Fairbanks North Star Borough",90,"Fairbanks North Star Borough",2,1,68,0,69,0,0,0,0
"03/05/2021","Y","N","Fairbanks North Star Borough",90,"Fairbanks North Star Borough",2,1,69,1,70,0,0,0,0
"03/08/2021","Y","N","Fairbanks North Star Borough",90,"Fairbanks North Star Borough",2,1,70,0,70,0,0,0,0
"03/11/2021","Y","N","Fairbanks North Star Borough",90,"Fairbanks North Star Borough",2,0,70,1,71,0,0,0,0
"03/13/2021","Y","N","Fairbanks North Star Borough",90,"Fairbanks North Star Borough",2,1,71,0,71,0,0,0,0
"03/14/2021","Y","N","Fairbanks North Star Borough",90,"Fairbanks North Star Borough",2,0,71,1,72,0,0,0,0
"03/17/2021","Y","N","Fairbanks North Star Borough",90,"Fairbanks North Star Borough",2,1,72,0,72,0,0,0,0
"03/18/2021","Y","N","Fairbanks North Star Borough",90,"Fairbanks North Star Borough",2,0,72,1,73,0,0,0,0
"03/23/2021","Y","N","Fairbanks North Star Borough",90,"Fairbanks North Star Borough",2,0,72,1,74,0,0,0,0
"03/31/2021","Y","N","Fairbanks North Star Borough",90,"Fairbanks North Star Borough",2,2,74,0,74,0,0,0,0
"04/05/2021","Y","N","Fairbanks North Star Borough",90,"Fairbanks North Star Borough",2,0,74,1,75,0,0,0,0
"04/06/2021","Y","N","Fairbanks North Star Borough",90,"Fairbanks North Star Borough",2,0,74,1,76,0,0,0,0
"04/08/2021","Y","N","Fairbanks North Star Borough",90,"Fairbanks North Star Borough",2,2,76,0,76,0,0,0,0
"05/07/2021","Y","N","Fairbanks North Star Borough",90,"Fairbanks North Star Borough",2,0,76,2,78,0,0,0,0
"05/08/2021","Y","N","Fairbanks North Star Borough",90,"Fairbanks North Star Borough",2,1,77,0,78,0,0,0,0
"05/12/2021","Y","N","Fairbanks North Star Borough",90,"Fairbanks North Star Borough",2,1,78,0,78,0,0,0,0
"05/15/2021","Y","N","Fairbanks North Star Borough",90,"Fairbanks North Star Borough",2,0,78,1,79,0,0,0,0
"05/17/2021","Y","N","Fairbanks North Star Borough",90,"Fairbanks North Star Borough",2,1,79,0,79,0,0,0,0
"05/18/2021","Y","N","Fairbanks North Star Borough",90,"Fairbanks North Star Borough",2,0,79,1,80,0,0,0,0
"05/19/2021","Y","N","Fairbanks North Star Borough",90,"Fairbanks North Star Borough",2,1,80,0,80,0,0,0,0
"05/31/2021","Y","N","Fairbanks North Star Borough",90,"Fairbanks North Star Borough",2,0,80,1,81,0,0,0,0
"06/02/2021","Y","N","Fairbanks North Star Borough",90,"Fairbanks North Star Borough",2,0,80,2,83,0,0,0,0
"06/07/2021","Y","N","Fairbanks North Star Borough",90,"Fairbanks North Star Borough",2,1,81,0,83,0,0,0,0
"06/10/2021","Y","N","Fairbanks North Star Borough",90,"Fairbanks North Star Borough",2,0,81,1,84,0,0,0,0
"06/11/2021","Y","N","Fairbanks North Star Borough",90,"Fairbanks North Star Borough",2,0,81,1,85,0,0,0,0
"06/13/2021","Y","N","Fairbanks North Star Borough",90,"Fairbanks North Star Borough",2,0,81,1,86,0,0,0,0
"06/15/2021","Y","N","Fairbanks North Star Borough",90,"Fairbanks North Star Borough",2,1,82,0,86,0,0,0,0
"06/22/2021","Y","N","Fairbanks North Star Borough",90,"Fairbanks North Star Borough",2,2,84,0,86,0,0,0,0
"06/23/2021","Y","N","Fairbanks North Star Borough",90,"Fairbanks North Star Borough",2,1,85,0,86,0,0,0,0
"06/25/2021","Y","N","Fairbanks North Star Borough",90,"Fairbanks North Star Borough",2,0,85,1,87,0,0,0,0
"07/01/2021","Y","N","Fairbanks North Star Borough",90,"Fairbanks North Star Borough",2,2,87,0,87,0,0,0,0
"07/14/2021","Y","N","Fairbanks North Star Borough",90,"Fairbanks North Star Borough",2,0,87,1,88,0,0,0,0
"07/15/2021","Y","N","Fairbanks North Star Borough",90,"Fairbanks North Star Borough",2,0,87,1,89,0,0,0,0
"07/16/2021","Y","N","Fairbanks North Star Borough",90,"Fairbanks North Star Borough",2,0,87,2,91,0,0,0,0
"07/17/2021","Y","N","Fairbanks North Star Borough",90,"Fairbanks North Star Borough",2,1,88,0,91,0,0,0,0
"07/20/2021","Y","N","Fairbanks North Star Borough",90,"Fairbanks North Star Borough",2,0,88,1,92,0,0,0,0
"07/22/2021","Y","N","Fairbanks North Star Borough",90,"Fairbanks North Star Borough",2,2,90,0,92,0,0,0,0
"07/23/2021","Y","N","Fairbanks North Star Borough",90,"Fairbanks North Star Borough",2,1,91,0,92,0,0,0,0
"07/25/2021","Y","N","Fairbanks North Star Borough",90,"Fairbanks North Star Borough",2,1,92,3,95,0,0,0,0
"07/27/2021","Y","N","Fairbanks North Star Borough",90,"Fairbanks North Star Borough",2,1,93,1,96,0,0,0,0
"07/28/2021","Y","N","Fairbanks North Star Borough",90,"Fairbanks North Star Borough",2,1,94,0,96,0,0,0,0
"07/31/2021","Y","N","Fairbanks North Star Borough",90,"Fairbanks North Star Borough",2,0,94,1,97,0,0,0,0
"08/01/2021","Y","N","Fairbanks North Star Borough",90,"Fairbanks North Star Borough",2,1,95,0,97,0,0,0,0
"08/04/2021","Y","N","Fairbanks North Star Borough",90,"Fairbanks North Star Borough",2,0,95,1,98,0,0,0,0
"08/05/2021","Y","N","Fairbanks North Star Borough",90,"Fairbanks North Star Borough",2,1,96,0,98,0,0,0,0
"08/07/2021","Y","N","Fairbanks North Star Borough",90,"Fairbanks North Star Borough",2,0,96,1,99,0,0,0,0
"08/09/2021","Y","N","Fairbanks North Star Borough",90,"Fairbanks North Star Borough",2,0,96,1,100,0,0,0,0
"08/10/2021","Y","N","Fairbanks North Star Borough",90,"Fairbanks North Star Borough",2,0,96,1,101,0,0,0,0
"08/11/2021","Y","N","Fairbanks North Star Borough",90,"Fairbanks North Star Borough",2,2,98,1,102,0,0,0,0
"08/13/2021","Y","N","Fairbanks North Star Borough",90,"Fairbanks North Star Borough",2,1,99,1,103,0,0,0,0
"08/14/2021","Y","N","Fairbanks North Star Borough",90,"Fairbanks North Star Borough",2,0,99,1,104,0,0,0,0
"08/15/2021","Y","N","Fairbanks North Star Borough",90,"Fairbanks North Star Borough",2,2,101,0,104,0,0,0,0
"08/16/2021","Y","N","Fairbanks North Star Borough",90,"Fairbanks North Star Borough",2,1,102,0,104,0,0,0,0
"08/17/2021","Y","N","Fairbanks North Star Borough",90,"Fairbanks North Star Borough",2,2,104,1,105,0,0,0,0
"08/19/2021","Y","N","Fairbanks North Star Borough",90,"Fairbanks North Star Borough",2,0,104,1,106,0,0,0,0
"08/23/2021","Y","N","Fairbanks North Star Borough",90,"Fairbanks North Star Borough",2,1,105,1,107,0,0,0,0
"08/24/2021","Y","N","Fairbanks North Star Borough",90,"Fairbanks North Star Borough",2,1,106,0,107,0,0,0,0
"08/26/2021","Y","N","Fairbanks North Star Borough",90,"Fairbanks North Star Borough",2,1,107,1,108,0,0,0,0
"08/27/2021","Y","N","Fairbanks North Star Borough",90,"Fairbanks North Star Borough",2,0,107,1,109,0,0,0,0
"08/28/2021","Y","N","Fairbanks North Star Borough",90,"Fairbanks North Star Borough",2,1,108,0,109,0,0,0,0
"08/29/2021","Y","N","Fairbanks North Star Borough",90,"Fairbanks North Star Borough",2,0,108,1,110,0,0,0,0
"08/30/2021","Y","N","Fairbanks North Star Borough",90,"Fairbanks North Star Borough",2,1,109,1,111,0,0,0,0
"08/31/2021","Y","N","Fairbanks North Star Borough",90,"Fairbanks North Star Borough",2,1,110,0,111,0,0,0,0
"09/01/2021","Y","N","Fairbanks North Star Borough",90,"Fairbanks North Star Borough",2,1,111,2,113,0,0,0,0
"09/03/2021","Y","N","Fairbanks North Star Borough",90,"Fairbanks North Star Borough",2,0,111,1,114,0,0,0,0
"09/05/2021","Y","N","Fairbanks North Star Borough",90,"Fairbanks North Star Borough",2,0,111,1,115,0,0,0,0
"09/06/2021","Y","N","Fairbanks North Star Borough",90,"Fairbanks North Star Borough",2,0,111,1,116,0,0,0,0
"09/07/2021","Y","N","Fairbanks North Star Borough",90,"Fairbanks North Star Borough",2,2,113,0,116,0,0,0,0
"09/08/2021","Y","N","Fairbanks North Star Borough",90,"Fairbanks North Star Borough",2,0,113,1,117,0,0,0,0
"09/09/2021","Y","N","Fairbanks North Star Borough",90,"Fairbanks North Star Borough",2,2,115,2,119,0,0,0,0
"09/12/2021","Y","N","Fairbanks North Star Borough",90,"Fairbanks North Star Borough",2,0,115,1,120,0,0,0,0
"09/13/2021","Y","N","Fairbanks North Star Borough",90,"Fairbanks North Star Borough",2,1,116,1,121,0,0,0,0
"09/14/2021","Y","N","Fairbanks North Star Borough",90,"Fairbanks North Star Borough",2,1,117,2,123,0,0,0,0
"09/15/2021","Y","N","Fairbanks North Star Borough",90,"Fairbanks North Star Borough",2,0,117,1,124,0,0,0,0
"09/16/2021","Y","N","Fairbanks North Star Borough",90,"Fairbanks North Star Borough",2,0,117,4,128,0,0,0,0
"09/17/2021","Y","N","Fairbanks North Star Borough",90,"Fairbanks North Star Borough",2,0,117,1,129,0,0,0,0
"09/20/2021","Y","N","Fairbanks North Star Borough",90,"Fairbanks North Star Borough",2,2,119,0,129,0,0,0,0
"09/21/2021","Y","N","Fairbanks North Star Borough",90,"Fairbanks North Star Borough",2,0,119,2,131,0,0,0,0
"09/22/2021","Y","N","Fairbanks North Star Borough",90,"Fairbanks North Star Borough",2,3,122,0,131,0,0,0,0
"09/23/2021","Y","N","Fairbanks North Star Borough",90,"Fairbanks North Star Borough",2,1,123,0,131,0,0,0,0
"09/24/2021","Y","N","Fairbanks North Star Borough",90,"Fairbanks North Star Borough",2,0,123,1,132,0,0,0,0
"09/25/2021","Y","N","Fairbanks North Star Borough",90,"Fairbanks North Star Borough",2,4,127,1,133,0,0,0,0
"09/27/2021","Y","N","Fairbanks North Star Borough",90,"Fairbanks North Star Borough",2,2,129,0,133,0,0,0,0
"09/29/2021","Y","N","Fairbanks North Star Borough",90,"Fairbanks North Star Borough",2,2,131,0,133,0,0,0,0
"09/30/2021","Y","N","Fairbanks North Star Borough",90,"Fairbanks North Star Borough",2,0,131,1,134,0,0,0,0
"10/01/2021","Y","N","Fairbanks North Star Borough",90,"Fairbanks North Star Borough",2,0,131,3,137,0,0,0,0
"10/03/2021","Y","N","Fairbanks North Star Borough",90,"Fairbanks North Star Borough",2,1,132,0,137,0,0,0,0
"10/04/2021","Y","N","Fairbanks North Star Borough",90,"Fairbanks North Star Borough",2,1,133,1,138,0,0,0,0
"10/05/2021","Y","N","Fairbanks North Star Borough",90,"Fairbanks North Star Borough",2,1,134,0,138,0,0,0,0
"10/06/2021","Y","N","Fairbanks North Star Borough",90,"Fairbanks North Star Borough",2,0,134,2,140,0,0,0,0
"10/08/2021","Y","N","Fairbanks North Star Borough",90,"Fairbanks North Star Borough",2,2,136,0,140,0,0,0,0
"10/09/2021","Y","N","Fairbanks North Star Borough",90,"Fairbanks North Star Borough",2,0,136,1,141,0,0,0,0
"10/11/2021","Y","N","Fairbanks North Star Borough",90,"Fairbanks North Star Borough",2,1,137,0,141,0,0,0,0
"10/13/2021","Y","N","Fairbanks North Star Borough",90,"Fairbanks North Star Borough",2,1,138,1,142,0,0,0,0
"10/16/2021","Y","N","Fairbanks North Star Borough",90,"Fairbanks North Star Borough",2,0,138,1,143,0,0,0,0
"10/22/2021","Y","N","Fairbanks North Star Borough",90,"Fairbanks North Star Borough",2,0,138,1,144,0,0,0,0
"10/23/2021","Y","N","Fairbanks North Star Borough",90,"Fairbanks North Star Borough",2,1,139,0,144,0,0,0,0
"10/24/2021","Y","N","Fairbanks North Star Borough",90,"Fairbanks North Star Borough",2,2,141,0,144,0,0,0,0
"10/26/2021","Y","N","Fairbanks North Star Borough",90,"Fairbanks North Star Borough",2,2,143,5,149,0,0,0,0
"10/28/2021","Y","N","Fairbanks North Star Borough",90,"Fairbanks North Star Borough",2,1,144,0,149,0,0,0,0
"10/30/2021","Y","N","Fairbanks North Star Borough",90,"Fairbanks North Star Borough",2,4,148,0,149,0,0,0,0
"10/31/2021","Y","N","Fairbanks North Star Borough",90,"Fairbanks North Star Borough",2,1,149,0,149,0,0,0,0
"11/01/2021","Y","N","Fairbanks North Star Borough",90,"Fairbanks North Star Borough",2,0,149,1,150,0,0,0,0
"11/02/2021","Y","N","Fairbanks North Star Borough",90,"Fairbanks North Star Borough",2,0,149,2,152,0,0,0,0
"11/03/2021","Y","N","Fairbanks North Star Borough",90,"Fairbanks North Star Borough",2,0,149,1,153,0,0,0,0
"11/04/2021","Y","N","Fairbanks North Star Borough",90,"Fairbanks North Star Borough",2,0,149,1,154,0,0,0,0
"11/05/2021","Y","N","Fairbanks North Star Borough",90,"Fairbanks North Star Borough",2,1,150,0,154,0,0,0,0
"11/06/2021","Y","N","Fairbanks North Star Borough",90,"Fairbanks North Star Borough",2,3,153,0,154,0,0,0,0
"11/09/2021","Y","N","Fairbanks North Star Borough",90,"Fairbanks North Star Borough",2,0,153,1,155,0,0,0,0
"11/19/2021","Y","N","Fairbanks North Star Borough",90,"Fairbanks North Star Borough",2,1,154,1,156,0,0,0,0
"11/22/2021","Y","N","Fairbanks North Star Borough",90,"Fairbanks North Star Borough",2,0,154,1,157,0,0,0,0
"11/27/2021","Y","N","Fairbanks North Star Borough",90,"Fairbanks North Star Borough",2,0,154,1,158,0,0,0,0
"11/29/2021","Y","N","Fairbanks North Star Borough",90,"Fairbanks North Star Borough",2,2,156,1,159,0,0,0,0
"11/30/2021","Y","N","Fairbanks North Star Borough",90,"Fairbanks North Star Borough",2,1,157,0,159,0,0,0,0
"12/01/2021","Y","N","Fairbanks North Star Borough",90,"Fairbanks North Star Borough",2,0,157,1,160,0,0,0,0
"12/10/2021","Y","N","Fairbanks North Star Borough",90,"Fairbanks North Star Borough",2,2,159,0,160,0,0,0,0
"12/14/2021","Y","N","Fairbanks North Star Borough",90,"Fairbanks North Star Borough",2,0,159,1,161,0,0,0,0
"12/21/2021","Y","N","Fairbanks North Star Borough",90,"Fairbanks North Star Borough",2,1,160,1,162,0,0,0,0
"12/23/2021","Y","N","Fairbanks North Star Borough",90,"Fairbanks North Star Borough",2,0,160,1,163,0,0,0,0
"12/24/2021","Y","N","Fairbanks North Star Borough",90,"Fairbanks North Star Borough",2,0,160,3,166,0,0,0,0
"12/26/2021","Y","N","Fairbanks North Star Borough",90,"Fairbanks North Star Borough",2,1,161,0,166,0,0,0,0
"12/27/2021","Y","N","Fairbanks North Star Borough",90,"Fairbanks North Star Borough",2,0,161,1,167,0,0,0,0
"12/28/2021","Y","N","Fairbanks North Star Borough",90,"Fairbanks North Star Borough",2,0,161,3,170,0,0,0,0
"12/29/2021","Y","N","Fairbanks North Star Borough",90,"Fairbanks North Star Borough",2,2,163,4,174,0,0,0,0
"12/30/2021","Y","N","Fairbanks North Star Borough",90,"Fairbanks North Star Borough",2,2,165,3,177,0,0,0,0
"01/01/2022","Y","N","Fairbanks North Star Borough",90,"Fairbanks North Star Borough",2,2,167,1,178,0,0,0,0
"01/02/2022","Y","N","Fairbanks North Star Borough",90,"Fairbanks North Star Borough",2,1,168,2,180,0,0,0,0
"01/03/2022","Y","N","Fairbanks North Star Borough",90,"Fairbanks North Star Borough",2,1,169,0,180,0,0,0,0
"01/04/2022","Y","N","Fairbanks North Star Borough",90,"Fairbanks North Star Borough",2,0,169,4,184,0,0,0,0
"01/05/2022","Y","N","Fairbanks North Star Borough",90,"Fairbanks North Star Borough",2,3,172,2,186,0,0,0,0
"01/06/2022","Y","N","Fairbanks North Star Borough",90,"Fairbanks North Star Borough",2,0,172,5,191,0,0,0,0
"01/07/2022","Y","N","Fairbanks North Star Borough",90,"Fairbanks North Star Borough",2,0,172,1,192,0,0,0,0
"01/08/2022","Y","N","Fairbanks North Star Borough",90,"Fairbanks North Star Borough",2,0,172,3,195,1,1,0,0
"01/09/2022","Y","N","Fairbanks North Star Borough",90,"Fairbanks North Star Borough",2,2,174,2,197,0,1,0,0
"01/10/2022","Y","N","Fairbanks North Star Borough",90,"Fairbanks North Star Borough",2,3,177,3,200,0,1,0,0
"01/11/2022","Y","N","Fairbanks North Star Borough",90,"Fairbanks North Star Borough",2,0,177,1,201,0,1,0,0
"01/12/2022","Y","N","Fairbanks North Star Borough",90,"Fairbanks North Star Borough",2,4,181,2,203,0,1,0,0
"01/13/2022","Y","N","Fairbanks North Star Borough",90,"Fairbanks North Star Borough",2,2,183,2,205,0,1,0,0
"01/14/2022","Y","N","Fairbanks North Star Borough",90,"Fairbanks North Star Borough",2,0,183,2,207,0,1,0,0
"01/15/2022","Y","N","Fairbanks North Star Borough",90,"Fairbanks North Star Borough",2,1,184,3,210,0,1,0,0
"01/16/2022","Y","N","Fairbanks North Star Borough",90,"Fairbanks North Star Borough",2,2,186,1,211,0,1,0,0
"01/17/2022","Y","N","Fairbanks North Star Borough",90,"Fairbanks North Star Borough",2,1,187,1,212,0,1,0,0
"01/18/2022","Y","N","Fairbanks North Star Borough",90,"Fairbanks North Star Borough",2,1,188,1,213,0,1,0,0
"01/19/2022","Y","N","Fairbanks North Star Borough",90,"Fairbanks North Star Borough",2,8,196,2,215,0,1,0,0
"01/20/2022","Y","N","Fairbanks North Star Borough",90,"Fairbanks North Star Borough",2,0,196,2,217,0,1,0,0
"01/21/2022","Y","N","Fairbanks North Star Borough",90,"Fairbanks North Star Borough",2,4,200,4,221,0,1,0,0
"01/22/2022","Y","N","Fairbanks North Star Borough",90,"Fairbanks North Star Borough",2,3,203,2,223,0,1,0,0
"01/24/2022","Y","N","Fairbanks North Star Borough",90,"Fairbanks North Star Borough",2,0,203,1,224,0,1,0,0
"01/26/2022","Y","N","Fairbanks North Star Borough",90,"Fairbanks North Star Borough",2,3,206,3,227,0,1,0,0
"01/27/2022","Y","N","Fairbanks North Star Borough",90,"Fairbanks North Star Borough",2,1,207,1,228,0,1,0,0
"01/28/2022","Y","N","Fairbanks North Star Borough",90,"Fairbanks North Star Borough",2,4,211,0,228,0,1,0,0
"01/29/2022","Y","N","Fairbanks North Star Borough",90,"Fairbanks North Star Borough",2,0,211,1,229,0,1,0,0
"01/31/2022","Y","N","Fairbanks North Star Borough",90,"Fairbanks North Star Borough",2,0,211,1,230,0,1,0,0
"02/01/2022","Y","N","Fairbanks North Star Borough",90,"Fairbanks North Star Borough",2,2,213,0,230,0,1,0,0
"02/02/2022","Y","N","Fairbanks North Star Borough",90,"Fairbanks North Star Borough",2,5,218,0,230,0,1,0,0
"02/03/2022","Y","N","Fairbanks North Star Borough",90,"Fairbanks North Star Borough",2,2,220,2,232,0,1,0,0
"02/04/2022","Y","N","Fairbanks North Star Borough",90,"Fairbanks North Star Borough",2,3,223,0,232,0,1,0,0
"02/06/2022","Y","N","Fairbanks North Star Borough",90,"Fairbanks North Star Borough",2,2,225,0,232,0,1,0,0
"02/08/2022","Y","N","Fairbanks North Star Borough",90,"Fairbanks North Star Borough",2,0,225,1,233,0,1,0,0
"02/10/2022","Y","N","Fairbanks North Star Borough",90,"Fairbanks North Star Borough",2,0,225,2,235,0,1,0,0
"02/11/2022","Y","N","Fairbanks North Star Borough",90,"Fairbanks North Star Borough",2,1,226,0,235,0,1,0,0
"02/13/2022","Y","N","Fairbanks North Star Borough",90,"Fairbanks North Star Borough",2,1,227,0,235,0,1,0,0
"02/15/2022","Y","N","Fairbanks North Star Borough",90,"Fairbanks North Star Borough",2,0,227,1,236,0,1,0,0
"02/16/2022","Y","N","Fairbanks North Star Borough",90,"Fairbanks North Star Borough",2,1,228,0,236,0,1,0,0
"02/19/2022","Y","N","Fairbanks North Star Borough",90,"Fairbanks North Star Borough",2,0,228,1,237,0,1,0,0
"02/25/2022","Y","N","Fairbanks North Star Borough",90,"Fairbanks North Star Borough",2,5,233,0,237,0,1,0,0
"03/01/2022","Y","N","Fairbanks North Star Borough",90,"Fairbanks North Star Borough",2,3,236,0,237,0,1,0,0
"03/15/2022","Y","N","Fairbanks North Star Borough",90,"Fairbanks North Star Borough",2,1,237,0,237,0,1,0,0
"03/18/2022","Y","N","Fairbanks North Star Borough",90,"Fairbanks North Star Borough",2,0,237,1,238,0,1,0,0
"03/30/2022","Y","N","Fairbanks North Star Borough",90,"Fairbanks North Star Borough",2,1,238,0,238,0,1,0,0
"04/16/2022","Y","N","Fairbanks North Star Borough",90,"Fairbanks North Star Borough",2,0,238,1,239,0,1,0,0
"04/26/2022","Y","N","Fairbanks North Star Borough",90,"Fairbanks North Star Borough",2,1,239,0,239,0,1,0,0
"11/30/2020","Y","N","Haines Borough",100,"Other Southeast Region - Northern",8,0,0,1,1,0,0,0,0
"12/06/2020","Y","N","Haines Borough",100,"Other Southeast Region - Northern",8,1,1,1,2,0,0,0,0
"12/07/2020","Y","N","Haines Borough",100,"Other Southeast Region - Northern",8,0,1,1,3,0,0,0,0
"12/10/2020","Y","N","Haines Borough",100,"Other Southeast Region - Northern",8,1,2,0,3,0,0,0,0
"12/11/2020","Y","N","Haines Borough",100,"Other Southeast Region - Northern",8,1,3,0,3,0,0,0,0
"08/05/2021","Y","N","Haines Borough",100,"Other Southeast Region - Northern",8,0,3,1,4,0,0,0,0
"08/06/2021","Y","N","Haines Borough",100,"Other Southeast Region - Northern",8,1,4,0,4,0,0,0,0
"08/07/2021","Y","N","Haines Borough",100,"Other Southeast Region - Northern",8,1,5,1,5,0,0,0,0
"09/13/2021","Y","N","Haines Borough",100,"Other Southeast Region - Northern",8,0,5,1,6,0,0,0,0
"09/25/2021","Y","N","Haines Borough",100,"Other Southeast Region - Northern",8,1,6,0,6,0,0,0,0
"10/04/2021","Y","N","Haines Borough",100,"Other Southeast Region - Northern",8,0,6,1,7,0,0,0,0
"10/06/2021","Y","N","Haines Borough",100,"Other Southeast Region - Northern",8,1,7,0,7,0,0,0,0
"12/28/2021","Y","N","Haines Borough",100,"Other Southeast Region - Northern",8,1,8,1,8,0,0,0,0
"12/29/2021","Y","N","Haines Borough",100,"Other Southeast Region - Northern",8,0,8,2,10,0,0,0,0
"01/03/2022","Y","N","Haines Borough",100,"Other Southeast Region - Northern",8,2,10,0,10,0,0,0,0
"01/04/2022","Y","N","Haines Borough",100,"Other Southeast Region - Northern",8,0,10,2,12,0,0,0,0
"01/06/2022","Y","N","Haines Borough",100,"Other Southeast Region - Northern",8,2,12,0,12,0,0,0,0
"01/08/2022","Y","N","Haines Borough",100,"Other Southeast Region - Northern",8,0,12,1,13,0,0,0,0
"01/15/2022","Y","N","Haines Borough",100,"Other Southeast Region - Northern",8,1,13,0,13,0,0,0,0
"01/26/2022","Y","N","Haines Borough",100,"Other Southeast Region - Northern",8,0,13,1,14,0,0,0,0
"01/27/2022","Y","N","Haines Borough",100,"Other Southeast Region - Northern",8,0,13,1,15,0,0,0,0
"02/03/2022","Y","N","Haines Borough",100,"Other Southeast Region - Northern",8,2,15,0,15,0,0,0,0
"04/09/2020","Y","N","Juneau City and Borough",110,"Juneau City and Borough",3,0,0,0,0,1,1,0,0
"04/16/2020","Y","N","Juneau City and Borough",110,"Juneau City and Borough",3,0,0,1,1,0,1,0,0
"05/09/2020","Y","N","Juneau City and Borough",110,"Juneau City and Borough",3,0,0,0,1,0,1,1,1
"06/25/2020","Y","N","Juneau City and Borough",110,"Juneau City and Borough",3,1,1,0,1,0,1,0,1
"08/07/2020","Y","N","Juneau City and Borough",110,"Juneau City and Borough",3,0,1,1,2,0,1,0,1
"08/08/2020","Y","N","Juneau City and Borough",110,"Juneau City and Borough",3,1,2,0,2,0,1,0,1
"08/12/2020","Y","N","Juneau City and Borough",110,"Juneau City and Borough",3,0,2,1,3,0,1,0,1
"08/13/2020","Y","N","Juneau City and Borough",110,"Juneau City and Borough",3,0,2,2,5,0,1,0,1
"08/14/2020","Y","N","Juneau City and Borough",110,"Juneau City and Borough",3,1,3,1,6,1,2,0,1
"08/17/2020","Y","N","Juneau City and Borough",110,"Juneau City and Borough",3,0,3,1,7,0,2,0,1
"08/19/2020","Y","N","Juneau City and Borough",110,"Juneau City and Borough",3,1,4,0,7,0,2,0,1
"08/21/2020","Y","N","Juneau City and Borough",110,"Juneau City and Borough",3,0,4,0,7,0,2,1,2
"08/22/2020","Y","N","Juneau City and Borough",110,"Juneau City and Borough",3,1,5,0,7,0,2,0,2
"08/24/2020","Y","N","Juneau City and Borough",110,"Juneau City and Borough",3,1,6,0,7,0,2,0,2
"08/26/2020","Y","N","Juneau City and Borough",110,"Juneau City and Borough",3,0,6,1,8,0,2,0,2
"08/27/2020","Y","N","Juneau City and Borough",110,"Juneau City and Borough",3,1,7,0,8,0,2,0,2
"10/19/2020","Y","N","Juneau City and Borough",110,"Juneau City and Borough",3,0,7,1,9,0,2,0,2
"10/20/2020","Y","N","Juneau City and Borough",110,"Juneau City and Borough",3,0,7,2,11,0,2,0,2
"10/22/2020","Y","N","Juneau City and Borough",110,"Juneau City and Borough",3,2,9,0,11,0,2,0,2
"10/24/2020","Y","N","Juneau City and Borough",110,"Juneau City and Borough",3,1,10,1,12,0,2,0,2
"10/28/2020","Y","N","Juneau City and Borough",110,"Juneau City and Borough",3,1,11,0,12,0,2,0,2
"11/04/2020","Y","N","Juneau City and Borough",110,"Juneau City and Borough",3,0,11,1,13,0,2,0,2
"11/06/2020","Y","N","Juneau City and Borough",110,"Juneau City and Borough",3,1,12,2,15,0,2,0,2
"11/07/2020","Y","N","Juneau City and Borough",110,"Juneau City and Borough",3,0,12,1,16,0,2,0,2
"11/10/2020","Y","N","Juneau City and Borough",110,"Juneau City and Borough",3,1,13,0,16,0,2,0,2
"11/17/2020","Y","N","Juneau City and Borough",110,"Juneau City and Borough",3,1,14,0,16,0,2,0,2
"11/19/2020","Y","N","Juneau City and Borough",110,"Juneau City and Borough",3,0,14,1,17,0,2,0,2
"11/26/2020","Y","N","Juneau City and Borough",110,"Juneau City and Borough",3,1,15,0,17,0,2,0,2
"11/27/2020","Y","N","Juneau City and Borough",110,"Juneau City and Borough",3,0,15,1,18,0,2,0,2
"12/01/2020","Y","N","Juneau City and Borough",110,"Juneau City and Borough",3,1,16,0,18,0,2,0,2
"12/02/2020","Y","N","Juneau City and Borough",110,"Juneau City and Borough",3,0,16,1,19,0,2,0,2
"12/07/2020","Y","N","Juneau City and Borough",110,"Juneau City and Borough",3,1,17,0,19,0,2,0,2
"12/14/2020","Y","N","Juneau City and Borough",110,"Juneau City and Borough",3,1,18,0,19,0,2,0,2
"12/16/2020","Y","N","Juneau City and Borough",110,"Juneau City and Borough",3,0,18,1,20,0,2,0,2
"12/24/2020","Y","N","Juneau City and Borough",110,"Juneau City and Borough",3,0,18,1,21,0,2,0,2
"12/27/2020","Y","N","Juneau City and Borough",110,"Juneau City and Borough",3,0,18,1,22,1,3,0,2
"12/30/2020","Y","N","Juneau City and Borough",110,"Juneau City and Borough",3,1,19,0,22,0,3,0,2
"12/31/2020","Y","N","Juneau City and Borough",110,"Juneau City and Borough",3,1,20,0,22,0,3,0,2
"01/02/2021","Y","N","Juneau City and Borough",110,"Juneau City and Borough",3,0,20,2,24,0,3,0,2
"01/05/2021","Y","N","Juneau City and Borough",110,"Juneau City and Borough",3,1,21,0,24,0,3,0,2
"01/09/2021","Y","N","Juneau City and Borough",110,"Juneau City and Borough",3,2,23,1,25,0,3,0,2
"01/13/2021","Y","N","Juneau City and Borough",110,"Juneau City and Borough",3,0,23,1,26,0,3,0,2
"01/18/2021","Y","N","Juneau City and Borough",110,"Juneau City and Borough",3,0,23,1,27,0,3,0,2
"01/19/2021","Y","N","Juneau City and Borough",110,"Juneau City and Borough",3,1,24,0,27,0,3,0,2
"01/22/2021","Y","N","Juneau City and Borough",110,"Juneau City and Borough",3,0,24,1,28,0,3,0,2
"01/24/2021","Y","N","Juneau City and Borough",110,"Juneau City and Borough",3,1,25,0,28,0,3,0,2
"01/25/2021","Y","N","Juneau City and Borough",110,"Juneau City and Borough",3,1,26,0,28,0,3,0,2
"02/04/2021","Y","N","Juneau City and Borough",110,"Juneau City and Borough",3,1,27,1,29,0,3,0,2
"02/06/2021","Y","N","Juneau City and Borough",110,"Juneau City and Borough",3,1,28,0,29,0,3,0,2
"02/12/2021","Y","N","Juneau City and Borough",110,"Juneau City and Borough",3,0,28,1,30,0,3,0,2
"02/14/2021","Y","N","Juneau City and Borough",110,"Juneau City and Borough",3,1,29,0,30,0,3,0,2
"02/27/2021","Y","N","Juneau City and Borough",110,"Juneau City and Borough",3,0,29,1,31,0,3,0,2
"03/12/2021","Y","N","Juneau City and Borough",110,"Juneau City and Borough",3,1,30,0,31,0,3,0,2
"03/23/2021","Y","N","Juneau City and Borough",110,"Juneau City and Borough",3,1,31,0,31,0,3,0,2
"04/25/2021","Y","N","Juneau City and Borough",110,"Juneau City and Borough",3,0,31,1,32,0,3,0,2
"04/26/2021","Y","N","Juneau City and Borough",110,"Juneau City and Borough",3,1,32,0,32,0,3,0,2
"04/28/2021","Y","N","Juneau City and Borough",110,"Juneau City and Borough",3,0,32,2,34,0,3,0,2
"04/30/2021","Y","N","Juneau City and Borough",110,"Juneau City and Borough",3,2,34,0,34,0,3,0,2
"05/27/2021","Y","N","Juneau City and Borough",110,"Juneau City and Borough",3,0,34,1,35,0,3,0,2
"05/30/2021","Y","N","Juneau City and Borough",110,"Juneau City and Borough",3,1,35,0,35,0,3,0,2
"07/14/2021","Y","N","Juneau City and Borough",110,"Juneau City and Borough",3,0,35,1,36,0,3,0,2
"07/22/2021","Y","N","Juneau City and Borough",110,"Juneau City and Borough",3,1,36,0,36,0,3,0,2
"07/29/2021","Y","N","Juneau City and Borough",110,"Juneau City and Borough",3,1,37,1,37,0,3,0,2
"07/30/2021","Y","N","Juneau City and Borough",110,"Juneau City and Borough",3,0,37,1,38,0,3,0,2
"08/02/2021","Y","N","Juneau City and Borough",110,"Juneau City and Borough",3,1,38,0,38,0,3,0,2
"08/04/2021","Y","N","Juneau City and Borough",110,"Juneau City and Borough",3,1,39,2,40,0,3,0,2
"08/08/2021","Y","N","Juneau City and Borough",110,"Juneau City and Borough",3,1,40,0,40,0,3,0,2
"08/20/2021","Y","N","Juneau City and Borough",110,"Juneau City and Borough",3,1,41,1,41,0,3,0,2
"08/28/2021","Y","N","Juneau City and Borough",110,"Juneau City and Borough",3,0,41,1,42,0,3,0,2
"08/31/2021","Y","N","Juneau City and Borough",110,"Juneau City and Borough",3,0,41,2,44,0,3,0,2
"09/03/2021","Y","N","Juneau City and Borough",110,"Juneau City and Borough",3,1,42,0,44,0,3,0,2
"09/05/2021","Y","N","Juneau City and Borough",110,"Juneau City and Borough",3,0,42,1,45,0,3,0,2
"09/06/2021","Y","N","Juneau City and Borough",110,"Juneau City and Borough",3,2,44,0,45,0,3,0,2
"09/13/2021","Y","N","Juneau City and Borough",110,"Juneau City and Borough",3,1,45,0,45,0,3,0,2
"09/15/2021","Y","N","Juneau City and Borough",110,"Juneau City and Borough",3,0,45,1,46,0,3,0,2
"09/16/2021","Y","N","Juneau City and Borough",110,"Juneau City and Borough",3,0,45,1,47,0,3,0,2
"09/18/2021","Y","N","Juneau City and Borough",110,"Juneau City and Borough",3,0,45,1,48,0,3,0,2
"09/21/2021","Y","N","Juneau City and Borough",110,"Juneau City and Borough",3,1,46,0,48,0,3,0,2
"09/22/2021","Y","N","Juneau City and Borough",110,"Juneau City and Borough",3,0,46,1,49,0,3,0,2
"09/27/2021","Y","N","Juneau City and Borough",110,"Juneau City and Borough",3,1,47,0,49,0,3,0,2
"10/09/2021","Y","N","Juneau City and Borough",110,"Juneau City and Borough",3,1,48,1,50,0,3,0,2
"10/13/2021","Y","N","Juneau City and Borough",110,"Juneau City and Borough",3,1,49,0,50,0,3,0,2
"10/19/2021","Y","N","Juneau City and Borough",110,"Juneau City and Borough",3,0,49,1,51,0,3,0,2
"10/22/2021","Y","N","Juneau City and Borough",110,"Juneau City and Borough",3,0,49,1,52,0,3,0,2
"10/24/2021","Y","N","Juneau City and Borough",110,"Juneau City and Borough",3,1,50,0,52,0,3,0,2
"10/25/2021","Y","N","Juneau City and Borough",110,"Juneau City and Borough",3,0,50,1,53,0,3,0,2
"10/26/2021","Y","N","Juneau City and Borough",110,"Juneau City and Borough",3,1,51,1,54,0,3,0,2
"10/30/2021","Y","N","Juneau City and Borough",110,"Juneau City and Borough",3,2,53,0,54,0,3,0,2
"10/31/2021","Y","N","Juneau City and Borough",110,"Juneau City and Borough",3,0,53,1,55,0,3,0,2
"11/02/2021","Y","N","Juneau City and Borough",110,"Juneau City and Borough",3,0,53,1,56,0,3,0,2
"11/03/2021","Y","N","Juneau City and Borough",110,"Juneau City and Borough",3,1,54,1,57,0,3,0,2
"11/05/2021","Y","N","Juneau City and Borough",110,"Juneau City and Borough",3,1,55,0,57,0,3,0,2
"11/09/2021","Y","N","Juneau City and Borough",110,"Juneau City and Borough",3,0,55,1,58,0,3,0,2
"11/12/2021","Y","N","Juneau City and Borough",110,"Juneau City and Borough",3,0,55,1,59,0,3,0,2
"11/27/2021","Y","N","Juneau City and Borough",110,"Juneau City and Borough",3,1,56,0,59,0,3,0,2
"11/29/2021","Y","N","Juneau City and Borough",110,"Juneau City and Borough",3,3,59,0,59,0,3,0,2
"12/16/2021","Y","N","Juneau City and Borough",110,"Juneau City and Borough",3,0,59,1,60,0,3,0,2
"12/19/2021","Y","N","Juneau City and Borough",110,"Juneau City and Borough",3,1,60,0,60,0,3,0,2
"12/24/2021","Y","N","Juneau City and Borough",110,"Juneau City and Borough",3,0,60,1,61,0,3,0,2
"12/28/2021","Y","N","Juneau City and Borough",110,"Juneau City and Borough",3,1,61,3,64,0,3,0,2
"12/29/2021","Y","N","Juneau City and Borough",110,"Juneau City and Borough",3,0,61,1,65,0,3,0,2
"12/30/2021","Y","N","Juneau City and Borough",110,"Juneau City and Borough",3,1,62,0,65,0,3,0,2
"12/31/2021","Y","N","Juneau City and Borough",110,"Juneau City and Borough",3,1,63,1,66,0,3,0,2
"01/01/2022","Y","N","Juneau City and Borough",110,"Juneau City and Borough",3,2,65,1,67,0,3,0,2
"01/03/2022","Y","N","Juneau City and Borough",110,"Juneau City and Borough",3,1,66,4,71,0,3,0,2
"01/05/2022","Y","N","Juneau City and Borough",110,"Juneau City and Borough",3,0,66,1,72,0,3,0,2
"01/07/2022","Y","N","Juneau City and Borough",110,"Juneau City and Borough",3,0,66,1,73,0,3,0,2
"01/08/2022","Y","N","Juneau City and Borough",110,"Juneau City and Borough",3,0,66,1,74,0,3,0,2
"01/10/2022","Y","N","Juneau City and Borough",110,"Juneau City and Borough",3,0,66,1,75,0,3,0,2
"01/11/2022","Y","N","Juneau City and Borough",110,"Juneau City and Borough",3,0,66,1,76,0,3,0,2
"01/12/2022","Y","N","Juneau City and Borough",110,"Juneau City and Borough",3,1,67,0,76,0,3,0,2
"01/13/2022","Y","N","Juneau City and Borough",110,"Juneau City and Borough",3,1,68,2,78,0,3,0,2
"01/14/2022","Y","N","Juneau City and Borough",110,"Juneau City and Borough",3,2,70,1,79,0,3,0,2
"01/18/2022","Y","N","Juneau City and Borough",110,"Juneau City and Borough",3,0,70,1,80,0,3,0,2
"01/19/2022","Y","N","Juneau City and Borough",110,"Juneau City and Borough",3,3,73,1,81,0,3,0,2
"01/20/2022","Y","N","Juneau City and Borough",110,"Juneau City and Borough",3,3,76,0,81,0,3,0,2
"01/21/2022","Y","N","Juneau City and Borough",110,"Juneau City and Borough",3,1,77,0,81,0,3,0,2
"01/23/2022","Y","N","Juneau City and Borough",110,"Juneau City and Borough",3,1,78,1,82,0,3,0,2
"01/28/2022","Y","N","Juneau City and Borough",110,"Juneau City and Borough",3,2,80,0,82,0,3,0,2
"01/30/2022","Y","N","Juneau City and Borough",110,"Juneau City and Borough",3,0,80,1,83,0,3,0,2
"02/01/2022","Y","N","Juneau City and Borough",110,"Juneau City and Borough",3,0,80,1,84,0,3,0,2
"02/02/2022","Y","N","Juneau City and Borough",110,"Juneau City and Borough",3,0,80,1,85,0,3,0,2
"02/04/2022","Y","N","Juneau City and Borough",110,"Juneau City and Borough",3,3,83,0,85,0,3,0,2
"02/08/2022","Y","N","Juneau City and Borough",110,"Juneau City and Borough",3,0,83,1,86,0,3,0,2
"02/10/2022","Y","N","Juneau City and Borough",110,"Juneau City and Borough",3,2,85,1,87,0,3,0,2
"02/12/2022","Y","N","Juneau City and Borough",110,"Juneau City and Borough",3,0,85,1,88,0,3,0,2
"02/25/2022","Y","N","Juneau City and Borough",110,"Juneau City and Borough",3,1,86,0,88,0,3,0,2
"02/26/2022","Y","N","Juneau City and Borough",110,"Juneau City and Borough",3,1,87,0,88,0,3,0,2
"03/01/2022","Y","N","Juneau City and Borough",110,"Juneau City and Borough",3,1,88,0,88,0,3,0,2
"03/25/2020","Y","N","Kenai Peninsula Borough",122,"Kenai Peninsula Borough",4,0,0,1,1,0,0,0,0
"03/29/2020","Y","N","Kenai Peninsula Borough",122,"Kenai Peninsula Borough",4,1,1,0,1,0,0,1,1
"06/24/2020","Y","N","Kenai Peninsula Borough",122,"Kenai Peninsula Borough",4,0,1,1,2,0,0,0,1
"07/03/2020","Y","N","Kenai Peninsula Borough",122,"Kenai Peninsula Borough",4,1,2,0,2,0,0,0,1
"07/13/2020","Y","N","Kenai Peninsula Borough",122,"Kenai Peninsula Borough",4,0,2,0,2,0,0,1,2
"08/02/2020","Y","N","Kenai Peninsula Borough",122,"Kenai Peninsula Borough",4,0,2,0,2,0,0,1,3
"08/03/2020","Y","N","Kenai Peninsula Borough",122,"Kenai Peninsula Borough",4,0,2,1,3,0,0,0,3
"08/11/2020","Y","N","Kenai Peninsula Borough",122,"Kenai Peninsula Borough",4,0,2,1,4,0,0,0,3
"08/14/2020","Y","N","Kenai Peninsula Borough",122,"Kenai Peninsula Borough",4,0,2,1,5,0,0,0,3
"08/15/2020","Y","N","Kenai Peninsula Borough",122,"Kenai Peninsula Borough",4,1,3,0,5,0,0,0,3
"08/26/2020","Y","N","Kenai Peninsula Borough",122,"Kenai Peninsula Borough",4,1,4,1,6,0,0,0,3
"08/31/2020","Y","N","Kenai Peninsula Borough",122,"Kenai Peninsula Borough",4,1,5,0,6,0,0,0,3
"09/18/2020","Y","N","Kenai Peninsula Borough",122,"Kenai Peninsula Borough",4,1,6,1,7,0,0,0,3
"09/19/2020","Y","N","Kenai Peninsula Borough",122,"Kenai Peninsula Borough",4,1,7,1,8,0,0,0,3
"09/24/2020","Y","N","Kenai Peninsula Borough",122,"Kenai Peninsula Borough",4,1,8,0,8,0,0,0,3
"09/26/2020","Y","N","Kenai Peninsula Borough",122,"Kenai Peninsula Borough",4,0,8,1,9,0,0,0,3
"09/29/2020","Y","N","Kenai Peninsula Borough",122,"Kenai Peninsula Borough",4,1,9,0,9,0,0,0,3
"10/06/2020","Y","N","Kenai Peninsula Borough",122,"Kenai Peninsula Borough",4,0,9,1,10,0,0,0,3
"10/09/2020","Y","N","Kenai Peninsula Borough",122,"Kenai Peninsula Borough",4,1,10,0,10,0,0,0,3
"10/19/2020","Y","N","Kenai Peninsula Borough",122,"Kenai Peninsula Borough",4,0,10,1,11,0,0,0,3
"10/24/2020","Y","N","Kenai Peninsula Borough",122,"Kenai Peninsula Borough",4,0,10,1,12,0,0,0,3
"10/27/2020","Y","N","Kenai Peninsula Borough",122,"Kenai Peninsula Borough",4,0,10,1,13,0,0,0,3
"10/28/2020","Y","N","Kenai Peninsula Borough",122,"Kenai Peninsula Borough",4,1,11,0,13,0,0,0,3
"11/01/2020","Y","N","Kenai Peninsula Borough",122,"Kenai Peninsula Borough",4,1,12,0,13,0,0,0,3
"11/03/2020","Y","N","Kenai Peninsula Borough",122,"Kenai Peninsula Borough",4,0,12,1,14,0,0,0,3
"11/04/2020","Y","N","Kenai Peninsula Borough",122,"Kenai Peninsula Borough",4,1,13,0,14,0,0,0,3
"11/06/2020","Y","N","Kenai Peninsula Borough",122,"Kenai Peninsula Borough",4,0,13,1,15,0,0,0,3
"11/09/2020","Y","N","Kenai Peninsula Borough",122,"Kenai Peninsula Borough",4,1,14,1,16,0,0,0,3
"11/10/2020","Y","N","Kenai Peninsula Borough",122,"Kenai Peninsula Borough",4,1,15,1,17,0,0,0,3
"11/12/2020","Y","N","Kenai Peninsula Borough",122,"Kenai Peninsula Borough",4,0,15,1,18,0,0,0,3
"11/15/2020","Y","N","Kenai Peninsula Borough",122,"Kenai Peninsula Borough",4,1,16,0,18,0,0,0,3
"11/16/2020","Y","N","Kenai Peninsula Borough",122,"Kenai Peninsula Borough",4,0,16,1,19,0,0,0,3
"11/18/2020","Y","N","Kenai Peninsula Borough",122,"Kenai Peninsula Borough",4,1,17,0,19,0,0,0,3
"11/19/2020","Y","N","Kenai Peninsula Borough",122,"Kenai Peninsula Borough",4,0,17,1,20,0,0,0,3
"11/22/2020","Y","N","Kenai Peninsula Borough",122,"Kenai Peninsula Borough",4,1,18,0,20,0,0,0,3
"11/25/2020","Y","N","Kenai Peninsula Borough",122,"Kenai Peninsula Borough",4,1,19,1,21,0,0,0,3
"11/30/2020","Y","N","Kenai Peninsula Borough",122,"Kenai Peninsula Borough",4,0,19,1,22,0,0,0,3
"12/03/2020","Y","N","Kenai Peninsula Borough",122,"Kenai Peninsula Borough",4,1,20,0,22,0,0,0,3
"12/06/2020","Y","N","Kenai Peninsula Borough",122,"Kenai Peninsula Borough",4,0,20,1,23,0,0,0,3
"12/07/2020","Y","N","Kenai Peninsula Borough",122,"Kenai Peninsula Borough",4,1,21,0,23,0,0,0,3
"12/12/2020","Y","N","Kenai Peninsula Borough",122,"Kenai Peninsula Borough",4,1,22,0,23,0,0,0,3
"12/13/2020","Y","N","Kenai Peninsula Borough",122,"Kenai Peninsula Borough",4,0,22,1,24,0,0,0,3
"12/17/2020","Y","N","Kenai Peninsula Borough",122,"Kenai Peninsula Borough",4,1,23,0,24,0,0,0,3
"12/21/2020","Y","N","Kenai Peninsula Borough",122,"Kenai Peninsula Borough",4,0,23,2,26,0,0,0,3
"12/23/2020","Y","N","Kenai Peninsula Borough",122,"Kenai Peninsula Borough",4,1,24,0,26,0,0,0,3
"12/24/2020","Y","N","Kenai Peninsula Borough",122,"Kenai Peninsula Borough",4,0,24,1,27,0,0,0,3
"12/25/2020","Y","N","Kenai Peninsula Borough",122,"Kenai Peninsula Borough",4,1,25,0,27,0,0,0,3
"12/28/2020","Y","N","Kenai Peninsula Borough",122,"Kenai Peninsula Borough",4,0,25,1,28,0,0,0,3
"12/29/2020","Y","N","Kenai Peninsula Borough",122,"Kenai Peninsula Borough",4,1,26,0,28,0,0,0,3
"01/01/2021","Y","N","Kenai Peninsula Borough",122,"Kenai Peninsula Borough",4,1,27,1,29,0,0,0,3
"01/04/2021","Y","N","Kenai Peninsula Borough",122,"Kenai Peninsula Borough",4,0,27,1,30,0,0,0,3
"01/06/2021","Y","N","Kenai Peninsula Borough",122,"Kenai Peninsula Borough",4,1,28,1,31,0,0,0,3
"01/08/2021","Y","N","Kenai Peninsula Borough",122,"Kenai Peninsula Borough",4,0,28,1,32,1,1,0,3
"01/09/2021","Y","N","Kenai Peninsula Borough",122,"Kenai Peninsula Borough",4,1,29,0,32,0,1,0,3
"01/11/2021","Y","N","Kenai Peninsula Borough",122,"Kenai Peninsula Borough",4,1,30,3,35,0,1,0,3
"01/13/2021","Y","N","Kenai Peninsula Borough",122,"Kenai Peninsula Borough",4,1,31,2,37,0,1,0,3
"01/14/2021","Y","N","Kenai Peninsula Borough",122,"Kenai Peninsula Borough",4,2,33,2,39,0,1,0,3
"01/15/2021","Y","N","Kenai Peninsula Borough",122,"Kenai Peninsula Borough",4,2,35,0,39,0,1,0,3
"01/20/2021","Y","N","Kenai Peninsula Borough",122,"Kenai Peninsula Borough",4,2,37,0,39,0,1,0,3
"01/21/2021","Y","N","Kenai Peninsula Borough",122,"Kenai Peninsula Borough",4,0,37,2,41,0,1,0,3
"01/24/2021","Y","N","Kenai Peninsula Borough",122,"Kenai Peninsula Borough",4,1,38,0,41,0,1,0,3
"01/25/2021","Y","N","Kenai Peninsula Borough",122,"Kenai Peninsula Borough",4,0,38,1,42,0,1,0,3
"01/26/2021","Y","N","Kenai Peninsula Borough",122,"Kenai Peninsula Borough",4,1,39,0,42,0,1,0,3
"01/27/2021","Y","N","Kenai Peninsula Borough",122,"Kenai Peninsula Borough",4,1,40,2,44,0,1,0,3
"01/28/2021","Y","N","Kenai Peninsula Borough",122,"Kenai Peninsula Borough",4,1,41,0,44,0,1,0,3
"01/29/2021","Y","N","Kenai Peninsula Borough",122,"Kenai Peninsula Borough",4,1,42,1,45,0,1,0,3
"02/01/2021","Y","N","Kenai Peninsula Borough",122,"Kenai Peninsula Borough",4,1,43,0,45,0,1,0,3
"02/08/2021","Y","N","Kenai Peninsula Borough",122,"Kenai Peninsula Borough",4,0,43,1,46,0,1,0,3
"02/16/2021","Y","N","Kenai Peninsula Borough",122,"Kenai Peninsula Borough",4,1,44,0,46,0,1,0,3
"02/18/2021","Y","N","Kenai Peninsula Borough",122,"Kenai Peninsula Borough",4,1,45,0,46,0,1,0,3
"02/26/2021","Y","N","Kenai Peninsula Borough",122,"Kenai Peninsula Borough",4,0,45,1,47,0,1,0,3
"02/27/2021","Y","N","Kenai Peninsula Borough",122,"Kenai Peninsula Borough",4,1,46,0,47,0,1,0,3
"02/28/2021","Y","N","Kenai Peninsula Borough",122,"Kenai Peninsula Borough",4,1,47,2,49,0,1,0,3
"03/10/2021","Y","N","Kenai Peninsula Borough",122,"Kenai Peninsula Borough",4,1,48,0,49,0,1,0,3
"03/12/2021","Y","N","Kenai Peninsula Borough",122,"Kenai Peninsula Borough",4,1,49,1,50,0,1,0,3
"03/17/2021","Y","N","Kenai Peninsula Borough",122,"Kenai Peninsula Borough",4,1,50,0,50,0,1,0,3
"03/19/2021","Y","N","Kenai Peninsula Borough",122,"Kenai Peninsula Borough",4,0,50,1,51,0,1,0,3
"03/22/2021","Y","N","Kenai Peninsula Borough",122,"Kenai Peninsula Borough",4,1,51,1,52,0,1,0,3
"03/27/2021","Y","N","Kenai Peninsula Borough",122,"Kenai Peninsula Borough",4,0,51,1,53,0,1,0,3
"03/29/2021","Y","N","Kenai Peninsula Borough",122,"Kenai Peninsula Borough",4,0,51,1,54,0,1,0,3
"03/31/2021","Y","N","Kenai Peninsula Borough",122,"Kenai Peninsula Borough",4,1,52,0,54,0,1,0,3
"04/01/2021","Y","N","Kenai Peninsula Borough",122,"Kenai Peninsula Borough",4,1,53,0,54,0,1,0,3
"04/02/2021","Y","N","Kenai Peninsula Borough",122,"Kenai Peninsula Borough",4,0,53,1,55,0,1,0,3
"04/08/2021","Y","N","Kenai Peninsula Borough",122,"Kenai Peninsula Borough",4,1,54,1,56,0,1,0,3
"04/10/2021","Y","N","Kenai Peninsula Borough",122,"Kenai Peninsula Borough",4,1,55,0,56,0,1,0,3
"04/19/2021","Y","N","Kenai Peninsula Borough",122,"Kenai Peninsula Borough",4,0,55,2,58,0,1,0,3
"04/21/2021","Y","N","Kenai Peninsula Borough",122,"Kenai Peninsula Borough",4,0,55,1,59,0,1,0,3
"04/22/2021","Y","N","Kenai Peninsula Borough",122,"Kenai Peninsula Borough",4,1,56,0,59,0,1,0,3
"04/23/2021","Y","N","Kenai Peninsula Borough",122,"Kenai Peninsula Borough",4,1,57,0,59,0,1,0,3
"04/29/2021","Y","N","Kenai Peninsula Borough",122,"Kenai Peninsula Borough",4,2,59,0,59,0,1,0,3
"06/06/2021","Y","N","Kenai Peninsula Borough",122,"Kenai Peninsula Borough",4,0,59,1,60,0,1,0,3
"06/24/2021","Y","N","Kenai Peninsula Borough",122,"Kenai Peninsula Borough",4,1,60,0,60,0,1,0,3
"06/29/2021","Y","N","Kenai Peninsula Borough",122,"Kenai Peninsula Borough",4,0,60,1,61,0,1,0,3
"07/03/2021","Y","N","Kenai Peninsula Borough",122,"Kenai Peninsula Borough",4,1,61,0,61,0,1,0,3
"07/19/2021","Y","N","Kenai Peninsula Borough",122,"Kenai Peninsula Borough",4,0,61,1,62,0,1,0,3
"07/21/2021","Y","N","Kenai Peninsula Borough",122,"Kenai Peninsula Borough",4,1,62,0,62,0,1,0,3
"07/29/2021","Y","N","Kenai Peninsula Borough",122,"Kenai Peninsula Borough",4,1,63,1,63,0,1,0,3
"08/05/2021","Y","N","Kenai Peninsula Borough",122,"Kenai Peninsula Borough",4,0,63,1,64,0,1,0,3
"08/09/2021","Y","N","Kenai Peninsula Borough",122,"Kenai Peninsula Borough",4,0,63,1,65,0,1,0,3
"08/10/2021","Y","N","Kenai Peninsula Borough",122,"Kenai Peninsula Borough",4,1,64,0,65,0,1,0,3
"08/11/2021","Y","N","Kenai Peninsula Borough",122,"Kenai Peninsula Borough",4,1,65,0,65,0,1,0,3
"08/20/2021","Y","N","Kenai Peninsula Borough",122,"Kenai Peninsula Borough",4,0,65,0,65,0,1,1,4
"08/26/2021","Y","N","Kenai Peninsula Borough",122,"Kenai Peninsula Borough",4,0,65,1,66,0,1,0,4
"08/31/2021","Y","N","Kenai Peninsula Borough",122,"Kenai Peninsula Borough",4,0,65,1,67,0,1,0,4
"09/10/2021","Y","N","Kenai Peninsula Borough",122,"Kenai Peninsula Borough",4,1,66,0,67,0,1,0,4
"09/12/2021","Y","N","Kenai Peninsula Borough",122,"Kenai Peninsula Borough",4,0,66,1,68,0,1,0,4
"09/13/2021","Y","N","Kenai Peninsula Borough",122,"Kenai Peninsula Borough",4,1,67,2,70,0,1,0,4
"09/14/2021","Y","N","Kenai Peninsula Borough",122,"Kenai Peninsula Borough",4,1,68,0,70,0,1,0,4
"09/21/2021","Y","N","Kenai Peninsula Borough",122,"Kenai Peninsula Borough",4,2,70,0,70,0,1,0,4
"09/22/2021","Y","N","Kenai Peninsula Borough",122,"Kenai Peninsula Borough",4,0,70,2,72,0,1,0,4
"09/24/2021","Y","N","Kenai Peninsula Borough",122,"Kenai Peninsula Borough",4,0,70,3,75,0,1,0,4
"09/26/2021","Y","N","Kenai Peninsula Borough",122,"Kenai Peninsula Borough",4,2,72,0,75,0,1,0,4
"09/27/2021","Y","N","Kenai Peninsula Borough",122,"Kenai Peninsula Borough",4,1,73,1,76,0,1,0,4
"09/28/2021","Y","N","Kenai Peninsula Borough",122,"Kenai Peninsula Borough",4,0,73,2,78,0,1,0,4
"09/30/2021","Y","N","Kenai Peninsula Borough",122,"Kenai Peninsula Borough",4,2,75,0,78,0,1,0,4
"10/04/2021","Y","N","Kenai Peninsula Borough",122,"Kenai Peninsula Borough",4,3,78,0,78,0,1,0,4
"10/05/2021","Y","N","Kenai Peninsula Borough",122,"Kenai Peninsula Borough",4,0,78,2,80,1,2,0,4
"10/08/2021","Y","N","Kenai Peninsula Borough",122,"Kenai Peninsula Borough",4,0,78,0,80,0,2,1,5
"10/09/2021","Y","N","Kenai Peninsula Borough",122,"Kenai Peninsula Borough",4,0,78,1,81,0,2,0,5
"10/11/2021","Y","N","Kenai Peninsula Borough",122,"Kenai Peninsula Borough",4,1,79,0,81,0,2,0,5
"10/13/2021","Y","N","Kenai Peninsula Borough",122,"Kenai Peninsula Borough",4,2,81,0,81,0,2,0,5
"10/14/2021","Y","N","Kenai Peninsula Borough",122,"Kenai Peninsula Borough",4,0,81,1,82,0,2,0,5
"10/15/2021","Y","N","Kenai Peninsula Borough",122,"Kenai Peninsula Borough",4,0,81,1,83,0,2,0,5
"10/16/2021","Y","N","Kenai Peninsula Borough",122,"Kenai Peninsula Borough",4,0,81,1,84,0,2,0,5
"10/19/2021","Y","N","Kenai Peninsula Borough",122,"Kenai Peninsula Borough",4,1,82,0,84,0,2,0,5
"10/21/2021","Y","N","Kenai Peninsula Borough",122,"Kenai Peninsula Borough",4,0,82,1,85,0,2,0,5
"10/26/2021","Y","N","Kenai Peninsula Borough",122,"Kenai Peninsula Borough",4,1,83,1,86,0,2,0,5
"10/27/2021","Y","N","Kenai Peninsula Borough",122,"Kenai Peninsula Borough",4,0,83,1,87,0,2,0,5
"10/28/2021","Y","N","Kenai Peninsula Borough",122,"Kenai Peninsula Borough",4,0,83,1,88,0,2,0,5
"10/31/2021","Y","N","Kenai Peninsula Borough",122,"Kenai Peninsula Borough",4,1,84,0,88,0,2,0,5
"11/01/2021","Y","N","Kenai Peninsula Borough",122,"Kenai Peninsula Borough",4,1,85,0,88,0,2,0,5
"11/03/2021","Y","N","Kenai Peninsula Borough",122,"Kenai Peninsula Borough",4,0,85,1,89,0,2,0,5
"11/05/2021","Y","N","Kenai Peninsula Borough",122,"Kenai Peninsula Borough",4,1,86,0,89,0,2,0,5
"11/07/2021","Y","N","Kenai Peninsula Borough",122,"Kenai Peninsula Borough",4,0,86,1,90,0,2,0,5
"11/09/2021","Y","N","Kenai Peninsula Borough",122,"Kenai Peninsula Borough",4,0,86,1,91,0,2,0,5
"11/10/2021","Y","N","Kenai Peninsula Borough",122,"Kenai Peninsula Borough",4,1,87,0,91,0,2,0,5
"11/11/2021","Y","N","Kenai Peninsula Borough",122,"Kenai Peninsula Borough",4,0,87,1,92,0,2,0,5
"11/16/2021","Y","N","Kenai Peninsula Borough",122,"Kenai Peninsula Borough",4,1,88,0,92,0,2,0,5
"11/20/2021","Y","N","Kenai Peninsula Borough",122,"Kenai Peninsula Borough",4,0,88,1,93,1,3,0,5
"11/22/2021","Y","N","Kenai Peninsula Borough",122,"Kenai Peninsula Borough",4,0,88,1,94,0,3,0,5
"11/26/2021","Y","N","Kenai Peninsula Borough",122,"Kenai Peninsula Borough",4,0,88,1,95,0,3,0,5
"11/29/2021","Y","N","Kenai Peninsula Borough",122,"Kenai Peninsula Borough",4,4,92,0,95,0,3,0,5
"12/04/2021","Y","N","Kenai Peninsula Borough",122,"Kenai Peninsula Borough",4,0,92,1,96,0,3,0,5
"12/06/2021","Y","N","Kenai Peninsula Borough",122,"Kenai Peninsula Borough",4,0,92,1,97,0,3,0,5
"12/09/2021","Y","N","Kenai Peninsula Borough",122,"Kenai Peninsula Borough",4,2,94,0,97,0,3,0,5
"12/10/2021","Y","N","Kenai Peninsula Borough",122,"Kenai Peninsula Borough",4,1,95,0,97,0,3,0,5
"12/12/2021","Y","N","Kenai Peninsula Borough",122,"Kenai Peninsula Borough",4,0,95,1,98,0,3,0,5
"12/13/2021","Y","N","Kenai Peninsula Borough",122,"Kenai Peninsula Borough",4,0,95,1,99,0,3,0,5
"12/16/2021","Y","N","Kenai Peninsula Borough",122,"Kenai Peninsula Borough",4,0,95,0,99,0,3,1,6
"12/18/2021","Y","N","Kenai Peninsula Borough",122,"Kenai Peninsula Borough",4,0,95,1,100,0,3,0,6
"12/19/2021","Y","N","Kenai Peninsula Borough",122,"Kenai Peninsula Borough",4,1,96,0,100,0,3,0,6
"12/20/2021","Y","N","Kenai Peninsula Borough",122,"Kenai Peninsula Borough",4,2,98,0,100,0,3,0,6
"12/23/2021","Y","N","Kenai Peninsula Borough",122,"Kenai Peninsula Borough",4,2,100,1,101,0,3,0,6
"12/27/2021","Y","N","Kenai Peninsula Borough",122,"Kenai Peninsula Borough",4,1,101,2,103,0,3,0,6
"12/28/2021","Y","N","Kenai Peninsula Borough",122,"Kenai Peninsula Borough",4,1,102,1,104,0,3,0,6
"12/30/2021","Y","N","Kenai Peninsula Borough",122,"Kenai Peninsula Borough",4,2,104,1,105,0,3,0,6
"01/02/2022","Y","N","Kenai Peninsula Borough",122,"Kenai Peninsula Borough",4,1,105,3,108,0,3,0,6
"01/04/2022","Y","N","Kenai Peninsula Borough",122,"Kenai Peninsula Borough",4,0,105,2,110,0,3,0,6
"01/06/2022","Y","N","Kenai Peninsula Borough",122,"Kenai Peninsula Borough",4,2,107,2,112,0,3,0,6
"01/07/2022","Y","N","Kenai Peninsula Borough",122,"Kenai Peninsula Borough",4,0,107,1,113,0,3,0,6
"01/09/2022","Y","N","Kenai Peninsula Borough",122,"Kenai Peninsula Borough",4,1,108,0,113,0,3,0,6
"01/10/2022","Y","N","Kenai Peninsula Borough",122,"Kenai Peninsula Borough",4,0,108,4,117,0,3,0,6
"01/11/2022","Y","N","Kenai Peninsula Borough",122,"Kenai Peninsula Borough",4,2,110,0,117,0,3,0,6
"01/13/2022","Y","N","Kenai Peninsula Borough",122,"Kenai Peninsula Borough",4,0,110,4,121,0,3,0,6
"01/15/2022","Y","N","Kenai Peninsula Borough",122,"Kenai Peninsula Borough",4,2,112,1,122,0,3,0,6
"01/17/2022","Y","N","Kenai Peninsula Borough",122,"Kenai Peninsula Borough",4,0,112,1,123,0,3,0,6
"01/18/2022","Y","N","Kenai Peninsula Borough",122,"Kenai Peninsula Borough",4,0,112,5,128,0,3,0,6
"01/19/2022","Y","N","Kenai Peninsula Borough",122,"Kenai Peninsula Borough",4,2,114,0,128,0,3,0,6
"01/20/2022","Y","N","Kenai Peninsula Borough",122,"Kenai Peninsula Borough",4,0,114,2,130,0,3,0,6
"01/21/2022","Y","N","Kenai Peninsula Borough",122,"Kenai Peninsula Borough",4,1,115,1,131,0,3,0,6
"01/22/2022","Y","N","Kenai Peninsula Borough",122,"Kenai Peninsula Borough",4,1,116,2,133,0,3,0,6
"01/23/2022","Y","N","Kenai Peninsula Borough",122,"Kenai Peninsula Borough",4,1,117,1,134,0,3,0,6
"01/24/2022","Y","N","Kenai Peninsula Borough",122,"Kenai Peninsula Borough",4,3,120,3,137,0,3,0,6
"01/25/2022","Y","N","Kenai Peninsula Borough",122,"Kenai Peninsula Borough",4,3,123,1,138,0,3,0,6
"01/26/2022","Y","N","Kenai Peninsula Borough",122,"Kenai Peninsula Borough",4,1,124,0,138,0,3,0,6
"01/27/2022","Y","N","Kenai Peninsula Borough",122,"Kenai Peninsula Borough",4,1,125,0,138,0,3,0,6
"01/28/2022","Y","N","Kenai Peninsula Borough",122,"Kenai Peninsula Borough",4,2,127,0,138,0,3,0,6
"01/30/2022","Y","N","Kenai Peninsula Borough",122,"Kenai Peninsula Borough",4,0,127,1,139,0,3,0,6
"02/02/2022","Y","N","Kenai Peninsula Borough",122,"Kenai Peninsula Borough",4,1,128,1,140,0,3,0,6
"02/03/2022","Y","N","Kenai Peninsula Borough",122,"Kenai Peninsula Borough",4,1,129,0,140,0,3,0,6
"02/04/2022","Y","N","Kenai Peninsula Borough",122,"Kenai Peninsula Borough",4,5,134,2,142,0,3,0,6
"02/05/2022","Y","N","Kenai Peninsula Borough",122,"Kenai Peninsula Borough",4,0,134,1,143,0,3,0,6
"02/06/2022","Y","N","Kenai Peninsula Borough",122,"Kenai Peninsula Borough",4,3,137,0,143,0,3,0,6
"02/07/2022","Y","N","Kenai Peninsula Borough",122,"Kenai Peninsula Borough",4,1,138,1,144,0,3,0,6
"02/08/2022","Y","N","Kenai Peninsula Borough",122,"Kenai Peninsula Borough",4,0,138,1,145,0,3,0,6
"02/09/2022","Y","N","Kenai Peninsula Borough",122,"Kenai Peninsula Borough",4,0,138,2,147,0,3,0,6
"02/11/2022","Y","N","Kenai Peninsula Borough",122,"Kenai Peninsula Borough",4,1,139,0,147,0,3,0,6
"02/12/2022","Y","N","Kenai Peninsula Borough",122,"Kenai Peninsula Borough",4,2,141,0,147,0,3,0,6
"02/13/2022","Y","N","Kenai Peninsula Borough",122,"Kenai Peninsula Borough",4,1,142,0,147,0,3,0,6
"02/14/2022","Y","N","Kenai Peninsula Borough",122,"Kenai Peninsula Borough",4,0,142,1,148,0,3,0,6
"02/15/2022","Y","N","Kenai Peninsula Borough",122,"Kenai Peninsula Borough",4,1,143,0,148,0,3,0,6
"02/17/2022","Y","N","Kenai Peninsula Borough",122,"Kenai Peninsula Borough",4,1,144,0,148,0,3,0,6
"02/18/2022","Y","N","Kenai Peninsula Borough",122,"Kenai Peninsula Borough",4,0,144,1,149,0,3,0,6
"02/25/2022","Y","N","Kenai Peninsula Borough",122,"Kenai Peninsula Borough",4,3,147,0,149,0,3,0,6
"02/26/2022","Y","N","Kenai Peninsula Borough",122,"Kenai Peninsula Borough",4,1,148,0,149,0,3,0,6
"03/01/2022","Y","N","Kenai Peninsula Borough",122,"Kenai Peninsula Borough",4,1,149,0,149,0,3,0,6
"03/07/2022","Y","N","Kenai Peninsula Borough",122,"Kenai Peninsula Borough",4,0,149,1,150,0,3,0,6
"03/09/2022","Y","N","Kenai Peninsula Borough",122,"Kenai Peninsula Borough",4,0,149,1,151,0,3,0,6
"03/25/2022","Y","N","Kenai Peninsula Borough",122,"Kenai Peninsula Borough",4,2,151,0,151,0,3,0,6
"07/17/2020","Y","N","Ketchikan Gateway Borough",130,"Other Southeast Region - Southern",9,0,0,1,1,0,0,0,0
"07/31/2020","Y","N","Ketchikan Gateway Borough",130,"Other Southeast Region - Southern",9,1,1,0,1,0,0,0,0
"10/02/2020","Y","N","Ketchikan Gateway Borough",130,"Other Southeast Region - Southern",9,0,1,1,2,0,0,0,0
"11/01/2020","Y","N","Ketchikan Gateway Borough",130,"Other Southeast Region - Southern",9,0,1,1,3,0,0,0,0
"11/08/2020","Y","N","Ketchikan Gateway Borough",130,"Other Southeast Region - Southern",9,1,2,0,3,0,0,0,0
"11/11/2020","Y","N","Ketchikan Gateway Borough",130,"Other Southeast Region - Southern",9,2,4,1,4,0,0,0,0
"11/12/2020","Y","N","Ketchikan Gateway Borough",130,"Other Southeast Region - Southern",9,0,4,1,5,1,1,0,0
"11/13/2020","Y","N","Ketchikan Gateway Borough",130,"Other Southeast Region - Southern",9,1,5,0,5,0,1,0,0
"12/11/2020","Y","N","Ketchikan Gateway Borough",130,"Other Southeast Region - Southern",9,0,5,0,5,0,1,1,1
"12/20/2020","Y","N","Ketchikan Gateway Borough",130,"Other Southeast Region - Southern",9,0,5,1,6,0,1,0,1
"01/04/2021","Y","N","Ketchikan Gateway Borough",130,"Other Southeast Region - Southern",9,1,6,0,6,0,1,0,1
"01/18/2021","Y","N","Ketchikan Gateway Borough",130,"Other Southeast Region - Southern",9,0,6,1,7,0,1,0,1
"01/19/2021","Y","N","Ketchikan Gateway Borough",130,"Other Southeast Region - Southern",9,0,6,1,8,0,1,0,1
"01/20/2021","Y","N","Ketchikan Gateway Borough",130,"Other Southeast Region - Southern",9,1,7,0,8,0,1,0,1
"01/21/2021","Y","N","Ketchikan Gateway Borough",130,"Other Southeast Region - Southern",9,0,7,2,10,0,1,0,1
"01/22/2021","Y","N","Ketchikan Gateway Borough",130,"Other Southeast Region - Southern",9,0,7,1,11,0,1,0,1
"01/23/2021","Y","N","Ketchikan Gateway Borough",130,"Other Southeast Region - Southern",9,1,8,0,11,0,1,0,1
"01/26/2021","Y","N","Ketchikan Gateway Borough",130,"Other Southeast Region - Southern",9,1,9,0,11,0,1,0,1
"02/15/2021","Y","N","Ketchikan Gateway Borough",130,"Other Southeast Region - Southern",9,0,9,1,12,0,1,0,1
"02/16/2021","Y","N","Ketchikan Gateway Borough",130,"Other Southeast Region - Southern",9,1,10,0,12,0,1,0,1
"02/19/2021","Y","N","Ketchikan Gateway Borough",130,"Other Southeast Region - Southern",9,1,11,0,12,0,1,0,1
"02/21/2021","Y","N","Ketchikan Gateway Borough",130,"Other Southeast Region - Southern",9,0,11,1,13,0,1,0,1
"02/23/2021","Y","N","Ketchikan Gateway Borough",130,"Other Southeast Region - Southern",9,1,12,2,15,0,1,0,1
"02/24/2021","Y","N","Ketchikan Gateway Borough",130,"Other Southeast Region - Southern",9,2,14,0,15,0,1,0,1
"03/04/2021","Y","N","Ketchikan Gateway Borough",130,"Other Southeast Region - Southern",9,1,15,0,15,0,1,0,1
"04/01/2021","Y","N","Ketchikan Gateway Borough",130,"Other Southeast Region - Southern",9,0,15,1,16,0,1,0,1
"04/08/2021","Y","N","Ketchikan Gateway Borough",130,"Other Southeast Region - Southern",9,0,15,1,17,0,1,0,1
"04/09/2021","Y","N","Ketchikan Gateway Borough",130,"Other Southeast Region - Southern",9,1,16,0,17,0,1,0,1
"04/25/2021","Y","N","Ketchikan Gateway Borough",130,"Other Southeast Region - Southern",9,1,17,0,17,0,1,0,1
"05/31/2021","Y","N","Ketchikan Gateway Borough",130,"Other Southeast Region - Southern",9,0,17,1,18,0,1,0,1
"06/03/2021","Y","N","Ketchikan Gateway Borough",130,"Other Southeast Region - Southern",9,1,18,0,18,0,1,0,1
"08/26/2021","Y","N","Ketchikan Gateway Borough",130,"Other Southeast Region - Southern",9,0,18,1,19,1,2,0,1
"08/27/2021","Y","N","Ketchikan Gateway Borough",130,"Other Southeast Region - Southern",9,1,19,0,19,0,2,1,2
"08/30/2021","Y","N","Ketchikan Gateway Borough",130,"Other Southeast Region - Southern",9,0,19,1,20,0,2,0,2
"09/04/2021","Y","N","Ketchikan Gateway Borough",130,"Other Southeast Region - Southern",9,1,20,0,20,0,2,0,2
"10/01/2021","Y","N","Ketchikan Gateway Borough",130,"Other Southeast Region - Southern",9,0,20,1,21,0,2,0,2
"10/05/2021","Y","N","Ketchikan Gateway Borough",130,"Other Southeast Region - Southern",9,1,21,0,21,0,2,0,2
"10/09/2021","Y","N","Ketchikan Gateway Borough",130,"Other Southeast Region - Southern",9,0,21,1,22,0,2,0,2
"10/13/2021","Y","N","Ketchikan Gateway Borough",130,"Other Southeast Region - Southern",9,1,22,0,22,0,2,0,2
"12/01/2021","Y","N","Ketchikan Gateway Borough",130,"Other Southeast Region - Southern",9,0,22,1,23,0,2,0,2
"12/02/2021","Y","N","Ketchikan Gateway Borough",130,"Other Southeast Region - Southern",9,0,22,0,23,0,2,1,3
"12/03/2021","Y","N","Ketchikan Gateway Borough",130,"Other Southeast Region - Southern",9,0,22,1,24,0,2,0,3
"12/09/2021","Y","N","Ketchikan Gateway Borough",130,"Other Southeast Region - Southern",9,1,23,1,25,0,2,0,3
"12/10/2021","Y","N","Ketchikan Gateway Borough",130,"Other Southeast Region - Southern",9,1,24,0,25,0,2,0,3
"12/14/2021","Y","N","Ketchikan Gateway Borough",130,"Other Southeast Region - Southern",9,0,24,1,26,1,3,0,3
"12/15/2021","Y","N","Ketchikan Gateway Borough",130,"Other Southeast Region - Southern",9,0,24,1,27,0,3,0,3
"12/16/2021","Y","N","Ketchikan Gateway Borough",130,"Other Southeast Region - Southern",9,0,24,1,28,0,3,0,3
"12/18/2021","Y","N","Ketchikan Gateway Borough",130,"Other Southeast Region - Southern",9,1,25,0,28,0,3,0,3
"12/21/2021","Y","N","Ketchikan Gateway Borough",130,"Other Southeast Region - Southern",9,1,26,0,28,0,3,0,3
"12/22/2021","Y","N","Ketchikan Gateway Borough",130,"Other Southeast Region - Southern",9,1,27,0,28,0,3,0,3
"12/23/2021","Y","N","Ketchikan Gateway Borough",130,"Other Southeast Region - Southern",9,1,28,0,28,0,3,1,4
"01/05/2022","Y","N","Ketchikan Gateway Borough",130,"Other Southeast Region - Southern",9,0,28,2,30,0,3,0,4
"01/06/2022","Y","N","Ketchikan Gateway Borough",130,"Other Southeast Region - Southern",9,2,30,1,31,0,3,0,4
"01/10/2022","Y","N","Ketchikan Gateway Borough",130,"Other Southeast Region - Southern",9,1,31,1,32,0,3,0,4
"01/15/2022","Y","N","Ketchikan Gateway Borough",130,"Other Southeast Region - Southern",9,1,32,0,32,0,3,0,4
"01/18/2022","Y","N","Ketchikan Gateway Borough",130,"Other Southeast Region - Southern",9,0,32,1,33,0,3,0,4
"01/19/2022","Y","N","Ketchikan Gateway Borough",130,"Other Southeast Region - Southern",9,1,33,1,34,0,3,0,4
"01/26/2022","Y","N","Ketchikan Gateway Borough",130,"Other Southeast Region - Southern",9,1,34,0,34,0,3,0,4
"02/13/2022","Y","N","Ketchikan Gateway Borough",130,"Other Southeast Region - Southern",9,0,34,1,35,0,3,0,4
"02/17/2022","Y","N","Ketchikan Gateway Borough",130,"Other Southeast Region - Southern",9,1,35,0,35,0,3,0,4
"11/09/2020","Y","N","Kodiak Island Borough",150,"Southwest Region",11,0,0,1,1,0,0,0,0
"11/15/2020","Y","N","Kodiak Island Borough",150,"Southwest Region",11,1,1,1,2,0,0,0,0
"11/27/2020","Y","N","Kodiak Island Borough",150,"Southwest Region",11,0,1,1,3,0,0,0,0
"12/01/2020","Y","N","Kodiak Island Borough",150,"Southwest Region",11,1,2,0,3,0,0,0,0
"12/05/2020","Y","N","Kodiak Island Borough",150,"Southwest Region",11,1,3,0,3,0,0,0,0
"12/08/2020","Y","N","Kodiak Island Borough",150,"Southwest Region",11,1,4,1,4,0,0,0,0
"12/29/2020","Y","N","Kodiak Island Borough",150,"Southwest Region",11,0,4,1,5,0,0,0,0
"01/05/2021","Y","N","Kodiak Island Borough",150,"Southwest Region",11,1,5,0,5,0,0,0,0
"05/20/2021","Y","N","Kodiak Island Borough",150,"Southwest Region",11,0,5,1,6,0,0,0,0
"05/27/2021","Y","N","Kodiak Island Borough",150,"Southwest Region",11,1,6,0,6,0,0,0,0
"07/29/2021","Y","N","Kodiak Island Borough",150,"Southwest Region",11,1,7,1,7,0,0,0,0
"08/06/2021","Y","N","Kodiak Island Borough",150,"Southwest Region",11,0,7,1,8,0,0,0,0
"08/08/2021","Y","N","Kodiak Island Borough",150,"Southwest Region",11,0,7,1,9,0,0,0,0
"08/09/2021","Y","N","Kodiak Island Borough",150,"Southwest Region",11,0,7,1,10,0,0,0,0
"08/10/2021","Y","N","Kodiak Island Borough",150,"Southwest Region",11,1,8,0,10,0,0,0,0
"08/21/2021","Y","N","Kodiak Island Borough",150,"Southwest Region",11,0,8,3,13,0,0,0,0
"08/28/2021","Y","N","Kodiak Island Borough",150,"Southwest Region",11,2,10,0,13,0,0,0,0
"08/31/2021","Y","N","Kodiak Island Borough",150,"Southwest Region",11,1,11,0,13,0,0,0,0
"09/06/2021","Y","N","Kodiak Island Borough",150,"Southwest Region",11,2,13,0,13,0,0,0,0
"09/13/2021","Y","N","Kodiak Island Borough",150,"Southwest Region",11,0,13,1,14,0,0,0,0
"09/22/2021","Y","N","Kodiak Island Borough",150,"Southwest Region",11,0,13,1,15,0,0,0,0
"09/23/2021","Y","N","Kodiak Island Borough",150,"Southwest Region",11,1,14,1,16,0,0,0,0
"09/28/2021","Y","N","Kodiak Island Borough",150,"Southwest Region",11,1,15,0,16,0,0,0,0
"09/30/2021","Y","N","Kodiak Island Borough",150,"Southwest Region",11,1,16,0,16,0,0,0,0
"10/06/2021","Y","N","Kodiak Island Borough",150,"Southwest Region",11,0,16,1,17,0,0,0,0
"10/07/2021","Y","N","Kodiak Island Borough",150,"Southwest Region",11,0,16,1,18,0,0,0,0
"10/23/2021","Y","N","Kodiak Island Borough",150,"Southwest Region",11,1,17,0,18,0,0,0,0
"10/24/2021","Y","N","Kodiak Island Borough",150,"Southwest Region",11,1,18,0,18,0,0,0,0
"10/26/2021","Y","N","Kodiak Island Borough",150,"Southwest Region",11,1,19,1,19,0,0,0,0
"12/01/2021","Y","N","Kodiak Island Borough",150,"Southwest Region",11,0,19,1,20,0,0,0,0
"12/27/2021","Y","N","Kodiak Island Borough",150,"Southwest Region",11,1,20,2,22,0,0,0,0
"12/30/2021","Y","N","Kodiak Island Borough",150,"Southwest Region",11,1,21,0,22,0,0,0,0
"01/01/2022","Y","N","Kodiak Island Borough",150,"Southwest Region",11,1,22,0,22,0,0,0,0
"01/13/2022","Y","N","Kodiak Island Borough",150,"Southwest Region",11,0,22,1,23,0,0,0,0
"01/21/2022","Y","N","Kodiak Island Borough",150,"Southwest Region",11,0,22,1,24,0,0,0,0
"01/31/2022","Y","N","Kodiak Island Borough",150,"Southwest Region",11,1,23,0,24,0,0,0,0
"02/04/2022","Y","N","Kodiak Island Borough",150,"Southwest Region",11,1,24,0,24,0,0,0,0
"01/02/2021","Y","N","Kusilvak Census Area",158,"Y-K Delta Region",10,0,0,1,1,0,0,0,0
"01/03/2021","Y","N","Kusilvak Census Area",158,"Y-K Delta Region",10,0,0,1,2,0,0,0,0
"01/04/2021","Y","N","Kusilvak Census Area",158,"Y-K Delta Region",10,1,1,0,2,0,0,0,0
"01/05/2021","Y","N","Kusilvak Census Area",158,"Y-K Delta Region",10,1,2,0,2,0,0,0,0
"07/11/2021","Y","N","Kusilvak Census Area",158,"Y-K Delta Region",10,1,3,1,3,0,0,0,0
"07/13/2021","Y","N","Kusilvak Census Area",158,"Y-K Delta Region",10,0,3,1,4,0,0,0,0
"07/17/2021","Y","N","Kusilvak Census Area",158,"Y-K Delta Region",10,1,4,0,4,0,0,0,0
"08/16/2021","Y","N","Kusilvak Census Area",158,"Y-K Delta Region",10,0,4,1,5,0,0,0,0
"08/18/2021","Y","N","Kusilvak Census Area",158,"Y-K Delta Region",10,1,5,0,5,0,0,0,0
"08/26/2021","Y","N","Kusilvak Census Area",158,"Y-K Delta Region",10,0,5,1,6,0,0,0,0
"08/31/2021","Y","N","Kusilvak Census Area",158,"Y-K Delta Region",10,1,6,0,6,0,0,0,0
"11/19/2021","Y","N","Kusilvak Census Area",158,"Y-K Delta Region",10,0,6,1,7,0,0,0,0
"11/29/2021","Y","N","Kusilvak Census Area",158,"Y-K Delta Region",10,1,7,0,7,0,0,0,0
"04/02/2020","Y","N","Matanuska-Susitna Borough",170,"Matanuska-Susitna Borough",5,0,0,1,1,0,0,0,0
"04/11/2020","Y","N","Matanuska-Susitna Borough",170,"Matanuska-Susitna Borough",5,1,1,0,1,0,0,0,0
"05/15/2020","Y","N","Matanuska-Susitna Borough",170,"Matanuska-Susitna Borough",5,0,1,1,2,1,1,0,0
"07/31/2020","Y","N","Matanuska-Susitna Borough",170,"Matanuska-Susitna Borough",5,0,1,1,3,0,1,0,0
"08/03/2020","Y","N","Matanuska-Susitna Borough",170,"Matanuska-Susitna Borough",5,1,2,0,3,0,1,0,0
"08/07/2020","Y","N","Matanuska-Susitna Borough",170,"Matanuska-Susitna Borough",5,0,2,1,4,0,1,0,0
"08/12/2020","Y","N","Matanuska-Susitna Borough",170,"Matanuska-Susitna Borough",5,1,3,0,4,0,1,0,0
"08/22/2020","Y","N","Matanuska-Susitna Borough",170,"Matanuska-Susitna Borough",5,0,3,1,5,0,1,0,0
"08/25/2020","Y","N","Matanuska-Susitna Borough",170,"Matanuska-Susitna Borough",5,1,4,0,5,0,1,0,0
"09/18/2020","Y","N","Matanuska-Susitna Borough",170,"Matanuska-Susitna Borough",5,0,4,1,6,0,1,0,0
"09/19/2020","Y","N","Matanuska-Susitna Borough",170,"Matanuska-Susitna Borough",5,1,5,0,6,0,1,0,0
"09/20/2020","Y","N","Matanuska-Susitna Borough",170,"Matanuska-Susitna Borough",5,0,5,1,7,0,1,0,0
"09/24/2020","Y","N","Matanuska-Susitna Borough",170,"Matanuska-Susitna Borough",5,0,5,1,8,0,1,0,0
"09/25/2020","Y","N","Matanuska-Susitna Borough",170,"Matanuska-Susitna Borough",5,1,6,0,8,0,1,0,0
"09/26/2020","Y","N","Matanuska-Susitna Borough",170,"Matanuska-Susitna Borough",5,1,7,0,8,0,1,0,0
"09/30/2020","Y","N","Matanuska-Susitna Borough",170,"Matanuska-Susitna Borough",5,1,8,0,8,0,1,0,0
"10/18/2020","Y","N","Matanuska-Susitna Borough",170,"Matanuska-Susitna Borough",5,0,8,2,10,0,1,0,0
"10/19/2020","Y","N","Matanuska-Susitna Borough",170,"Matanuska-Susitna Borough",5,0,8,1,11,0,1,0,0
"10/21/2020","Y","N","Matanuska-Susitna Borough",170,"Matanuska-Susitna Borough",5,0,8,2,13,0,1,0,0
"10/22/2020","Y","N","Matanuska-Susitna Borough",170,"Matanuska-Susitna Borough",5,3,11,1,14,0,1,0,0
"10/27/2020","Y","N","Matanuska-Susitna Borough",170,"Matanuska-Susitna Borough",5,1,12,0,14,0,1,0,0
"10/29/2020","Y","N","Matanuska-Susitna Borough",170,"Matanuska-Susitna Borough",5,0,12,1,15,0,1,0,0
"11/06/2020","Y","N","Matanuska-Susitna Borough",170,"Matanuska-Susitna Borough",5,1,13,0,15,0,1,0,0
"11/09/2020","Y","N","Matanuska-Susitna Borough",170,"Matanuska-Susitna Borough",5,0,13,1,16,0,1,0,0
"11/10/2020","Y","N","Matanuska-Susitna Borough",170,"Matanuska-Susitna Borough",5,1,14,1,17,0,1,0,0
"11/11/2020","Y","N","Matanuska-Susitna Borough",170,"Matanuska-Susitna Borough",5,1,15,1,18,0,1,0,0
"11/13/2020","Y","N","Matanuska-Susitna Borough",170,"Matanuska-Susitna Borough",5,0,15,1,19,0,1,0,0
"11/14/2020","Y","N","Matanuska-Susitna Borough",170,"Matanuska-Susitna Borough",5,1,16,0,19,0,1,0,0
"11/15/2020","Y","N","Matanuska-Susitna Borough",170,"Matanuska-Susitna Borough",5,0,16,1,20,0,1,0,0
"11/16/2020","Y","N","Matanuska-Susitna Borough",170,"Matanuska-Susitna Borough",5,0,16,2,22,0,1,0,0
"11/18/2020","Y","N","Matanuska-Susitna Borough",170,"Matanuska-Susitna Borough",5,0,16,1,23,0,1,0,0
"11/19/2020","Y","N","Matanuska-Susitna Borough",170,"Matanuska-Susitna Borough",5,4,20,1,24,0,1,0,0
"11/20/2020","Y","N","Matanuska-Susitna Borough",170,"Matanuska-Susitna Borough",5,1,21,1,25,0,1,0,0
"11/21/2020","Y","N","Matanuska-Susitna Borough",170,"Matanuska-Susitna Borough",5,0,21,1,26,0,1,0,0
"11/23/2020","Y","N","Matanuska-Susitna Borough",170,"Matanuska-Susitna Borough",5,2,23,0,26,0,1,0,0
"11/24/2020","Y","N","Matanuska-Susitna Borough",170,"Matanuska-Susitna Borough",5,1,24,0,26,0,1,0,0
"11/26/2020","Y","N","Matanuska-Susitna Borough",170,"Matanuska-Susitna Borough",5,1,25,0,26,0,1,0,0
"11/27/2020","Y","N","Matanuska-Susitna Borough",170,"Matanuska-Susitna Borough",5,0,25,1,27,0,1,0,0
"11/28/2020","Y","N","Matanuska-Susitna Borough",170,"Matanuska-Susitna Borough",5,0,25,1,28,0,1,0,0
"11/30/2020","Y","N","Matanuska-Susitna Borough",170,"Matanuska-Susitna Borough",5,1,26,0,28,0,1,0,0
"12/01/2020","Y","N","Matanuska-Susitna Borough",170,"Matanuska-Susitna Borough",5,1,27,1,29,0,1,0,0
"12/04/2020","Y","N","Matanuska-Susitna Borough",170,"Matanuska-Susitna Borough",5,1,28,1,30,0,1,0,0
"12/05/2020","Y","N","Matanuska-Susitna Borough",170,"Matanuska-Susitna Borough",5,1,29,0,30,0,1,0,0
"12/09/2020","Y","N","Matanuska-Susitna Borough",170,"Matanuska-Susitna Borough",5,1,30,1,31,0,1,1,1
"12/10/2020","Y","N","Matanuska-Susitna Borough",170,"Matanuska-Susitna Borough",5,0,30,1,32,0,1,0,1
"12/15/2020","Y","N","Matanuska-Susitna Borough",170,"Matanuska-Susitna Borough",5,1,31,1,33,0,1,0,1
"12/17/2020","Y","N","Matanuska-Susitna Borough",170,"Matanuska-Susitna Borough",5,0,31,0,33,1,2,0,1
"12/19/2020","Y","N","Matanuska-Susitna Borough",170,"Matanuska-Susitna Borough",5,1,32,1,34,0,2,0,1
"12/22/2020","Y","N","Matanuska-Susitna Borough",170,"Matanuska-Susitna Borough",5,0,32,1,35,0,2,0,1
"12/24/2020","Y","N","Matanuska-Susitna Borough",170,"Matanuska-Susitna Borough",5,1,33,2,37,0,2,0,1
"12/25/2020","Y","N","Matanuska-Susitna Borough",170,"Matanuska-Susitna Borough",5,1,34,1,38,0,2,0,1
"12/26/2020","Y","N","Matanuska-Susitna Borough",170,"Matanuska-Susitna Borough",5,1,35,0,38,0,2,0,1
"12/31/2020","Y","N","Matanuska-Susitna Borough",170,"Matanuska-Susitna Borough",5,1,36,2,40,1,3,0,1
"01/03/2021","Y","N","Matanuska-Susitna Borough",170,"Matanuska-Susitna Borough",5,1,37,1,41,0,3,0,1
"01/04/2021","Y","N","Matanuska-Susitna Borough",170,"Matanuska-Susitna Borough",5,1,38,1,42,0,3,0,1
"01/06/2021","Y","N","Matanuska-Susitna Borough",170,"Matanuska-Susitna Borough",5,1,39,1,43,0,3,0,1
"01/07/2021","Y","N","Matanuska-Susitna Borough",170,"Matanuska-Susitna Borough",5,2,41,1,44,0,3,0,1
"01/08/2021","Y","N","Matanuska-Susitna Borough",170,"Matanuska-Susitna Borough",5,0,41,1,45,0,3,0,1
"01/14/2021","Y","N","Matanuska-Susitna Borough",170,"Matanuska-Susitna Borough",5,2,43,0,45,0,3,0,1
"01/30/2021","Y","N","Matanuska-Susitna Borough",170,"Matanuska-Susitna Borough",5,0,43,1,46,0,3,1,2
"02/04/2021","Y","N","Matanuska-Susitna Borough",170,"Matanuska-Susitna Borough",5,1,44,1,47,0,3,0,2
"02/05/2021","Y","N","Matanuska-Susitna Borough",170,"Matanuska-Susitna Borough",5,1,45,1,48,0,3,0,2
"02/06/2021","Y","N","Matanuska-Susitna Borough",170,"Matanuska-Susitna Borough",5,2,47,0,48,0,3,0,2
"02/19/2021","Y","N","Matanuska-Susitna Borough",170,"Matanuska-Susitna Borough",5,1,48,1,49,0,3,0,2
"03/01/2021","Y","N","Matanuska-Susitna Borough",170,"Matanuska-Susitna Borough",5,1,49,2,51,0,3,0,2
"03/02/2021","Y","N","Matanuska-Susitna Borough",170,"Matanuska-Susitna Borough",5,0,49,1,52,0,3,0,2
"03/04/2021","Y","N","Matanuska-Susitna Borough",170,"Matanuska-Susitna Borough",5,0,49,1,53,0,3,0,2
"03/11/2021","Y","N","Matanuska-Susitna Borough",170,"Matanuska-Susitna Borough",5,1,50,1,54,0,3,0,2
"03/13/2021","Y","N","Matanuska-Susitna Borough",170,"Matanuska-Susitna Borough",5,1,51,0,54,0,3,0,2
"03/15/2021","Y","N","Matanuska-Susitna Borough",170,"Matanuska-Susitna Borough",5,0,51,1,55,0,3,0,2
"03/16/2021","Y","N","Matanuska-Susitna Borough",170,"Matanuska-Susitna Borough",5,1,52,0,55,0,3,0,2
"03/17/2021","Y","N","Matanuska-Susitna Borough",170,"Matanuska-Susitna Borough",5,0,52,1,56,0,3,0,2
"03/19/2021","Y","N","Matanuska-Susitna Borough",170,"Matanuska-Susitna Borough",5,0,52,1,57,0,3,0,2
"03/23/2021","Y","N","Matanuska-Susitna Borough",170,"Matanuska-Susitna Borough",5,3,55,0,57,0,3,0,2
"03/25/2021","Y","N","Matanuska-Susitna Borough",170,"Matanuska-Susitna Borough",5,1,56,0,57,0,3,0,2
"03/30/2021","Y","N","Matanuska-Susitna Borough",170,"Matanuska-Susitna Borough",5,1,57,0,57,0,3,0,2
"04/06/2021","Y","N","Matanuska-Susitna Borough",170,"Matanuska-Susitna Borough",5,0,57,1,58,0,3,0,2
"04/07/2021","Y","N","Matanuska-Susitna Borough",170,"Matanuska-Susitna Borough",5,0,57,1,59,0,3,0,2
"04/08/2021","Y","N","Matanuska-Susitna Borough",170,"Matanuska-Susitna Borough",5,1,58,1,60,0,3,0,2
"04/10/2021","Y","N","Matanuska-Susitna Borough",170,"Matanuska-Susitna Borough",5,0,58,1,61,0,3,0,2
"04/11/2021","Y","N","Matanuska-Susitna Borough",170,"Matanuska-Susitna Borough",5,0,58,1,62,0,3,0,2
"04/12/2021","Y","N","Matanuska-Susitna Borough",170,"Matanuska-Susitna Borough",5,1,59,0,62,0,3,0,2
"04/13/2021","Y","N","Matanuska-Susitna Borough",170,"Matanuska-Susitna Borough",5,1,60,1,63,0,3,0,2
"04/14/2021","Y","N","Matanuska-Susitna Borough",170,"Matanuska-Susitna Borough",5,0,60,1,64,0,3,0,2
"04/16/2021","Y","N","Matanuska-Susitna Borough",170,"Matanuska-Susitna Borough",5,1,61,0,64,0,3,0,2
"04/17/2021","Y","N","Matanuska-Susitna Borough",170,"Matanuska-Susitna Borough",5,2,63,0,64,0,3,0,2
"04/19/2021","Y","N","Matanuska-Susitna Borough",170,"Matanuska-Susitna Borough",5,0,63,1,65,0,3,0,2
"04/20/2021","Y","N","Matanuska-Susitna Borough",170,"Matanuska-Susitna Borough",5,1,64,0,65,0,3,0,2
"04/23/2021","Y","N","Matanuska-Susitna Borough",170,"Matanuska-Susitna Borough",5,0,64,1,66,0,3,0,2
"04/25/2021","Y","N","Matanuska-Susitna Borough",170,"Matanuska-Susitna Borough",5,0,64,1,67,0,3,0,2
"04/28/2021","Y","N","Matanuska-Susitna Borough",170,"Matanuska-Susitna Borough",5,0,64,1,68,0,3,0,2
"04/29/2021","Y","N","Matanuska-Susitna Borough",170,"Matanuska-Susitna Borough",5,3,67,0,68,0,3,0,2
"04/30/2021","Y","N","Matanuska-Susitna Borough",170,"Matanuska-Susitna Borough",5,1,68,1,69,1,4,0,2
"05/06/2021","Y","N","Matanuska-Susitna Borough",170,"Matanuska-Susitna Borough",5,1,69,1,70,0,4,0,2
"05/07/2021","Y","N","Matanuska-Susitna Borough",170,"Matanuska-Susitna Borough",5,0,69,1,71,0,4,0,2
"05/08/2021","Y","N","Matanuska-Susitna Borough",170,"Matanuska-Susitna Borough",5,1,70,0,71,0,4,0,2
"05/10/2021","Y","N","Matanuska-Susitna Borough",170,"Matanuska-Susitna Borough",5,1,71,0,71,0,4,0,2
"05/16/2021","Y","N","Matanuska-Susitna Borough",170,"Matanuska-Susitna Borough",5,1,72,1,72,0,4,0,2
"05/17/2021","Y","N","Matanuska-Susitna Borough",170,"Matanuska-Susitna Borough",5,0,72,1,73,0,4,0,2
"05/18/2021","Y","N","Matanuska-Susitna Borough",170,"Matanuska-Susitna Borough",5,0,72,1,74,0,4,0,2
"05/20/2021","Y","N","Matanuska-Susitna Borough",170,"Matanuska-Susitna Borough",5,1,73,0,74,0,4,0,2
"05/22/2021","Y","N","Matanuska-Susitna Borough",170,"Matanuska-Susitna Borough",5,0,73,1,75,0,4,0,2
"05/23/2021","Y","N","Matanuska-Susitna Borough",170,"Matanuska-Susitna Borough",5,1,74,0,75,0,4,0,2
"06/06/2021","Y","N","Matanuska-Susitna Borough",170,"Matanuska-Susitna Borough",5,0,74,1,76,0,4,0,2
"06/08/2021","Y","N","Matanuska-Susitna Borough",170,"Matanuska-Susitna Borough",5,1,75,0,76,0,4,0,2
"06/14/2021","Y","N","Matanuska-Susitna Borough",170,"Matanuska-Susitna Borough",5,1,76,1,77,0,4,0,2
"06/16/2021","Y","N","Matanuska-Susitna Borough",170,"Matanuska-Susitna Borough",5,1,77,0,77,0,4,0,2
"06/25/2021","Y","N","Matanuska-Susitna Borough",170,"Matanuska-Susitna Borough",5,0,77,1,78,0,4,0,2
"07/01/2021","Y","N","Matanuska-Susitna Borough",170,"Matanuska-Susitna Borough",5,1,78,0,78,0,4,0,2
"07/04/2021","Y","N","Matanuska-Susitna Borough",170,"Matanuska-Susitna Borough",5,0,78,1,79,0,4,0,2
"07/19/2021","Y","N","Matanuska-Susitna Borough",170,"Matanuska-Susitna Borough",5,0,78,1,80,0,4,0,2
"07/21/2021","Y","N","Matanuska-Susitna Borough",170,"Matanuska-Susitna Borough",5,1,79,0,80,0,4,0,2
"07/25/2021","Y","N","Matanuska-Susitna Borough",170,"Matanuska-Susitna Borough",5,0,79,1,81,0,4,0,2
"07/28/2021","Y","N","Matanuska-Susitna Borough",170,"Matanuska-Susitna Borough",5,1,80,1,82,0,4,0,2
"07/30/2021","Y","N","Matanuska-Susitna Borough",170,"Matanuska-Susitna Borough",5,1,81,0,82,0,4,0,2
"08/03/2021","Y","N","Matanuska-Susitna Borough",170,"Matanuska-Susitna Borough",5,1,82,0,82,0,4,1,3
"08/05/2021","Y","N","Matanuska-Susitna Borough",170,"Matanuska-Susitna Borough",5,0,82,1,83,0,4,0,3
"08/06/2021","Y","N","Matanuska-Susitna Borough",170,"Matanuska-Susitna Borough",5,0,82,2,85,0,4,0,3
"08/09/2021","Y","N","Matanuska-Susitna Borough",170,"Matanuska-Susitna Borough",5,2,84,0,85,0,4,0,3
"08/10/2021","Y","N","Matanuska-Susitna Borough",170,"Matanuska-Susitna Borough",5,1,85,0,85,0,4,0,3
"08/13/2021","Y","N","Matanuska-Susitna Borough",170,"Matanuska-Susitna Borough",5,0,85,1,86,1,5,0,3
"08/14/2021","Y","N","Matanuska-Susitna Borough",170,"Matanuska-Susitna Borough",5,0,85,1,87,0,5,0,3
"08/16/2021","Y","N","Matanuska-Susitna Borough",170,"Matanuska-Susitna Borough",5,1,86,0,87,0,5,0,3
"08/19/2021","Y","N","Matanuska-Susitna Borough",170,"Matanuska-Susitna Borough",5,0,86,1,88,0,5,0,3
"08/20/2021","Y","N","Matanuska-Susitna Borough",170,"Matanuska-Susitna Borough",5,0,86,0,88,1,6,0,3
"08/21/2021","Y","N","Matanuska-Susitna Borough",170,"Matanuska-Susitna Borough",5,1,87,0,88,0,6,0,3
"08/24/2021","Y","N","Matanuska-Susitna Borough",170,"Matanuska-Susitna Borough",5,0,87,1,89,0,6,0,3
"08/26/2021","Y","N","Matanuska-Susitna Borough",170,"Matanuska-Susitna Borough",5,1,88,0,89,0,6,0,3
"09/01/2021","Y","N","Matanuska-Susitna Borough",170,"Matanuska-Susitna Borough",5,1,89,1,90,0,6,1,4
"09/02/2021","Y","N","Matanuska-Susitna Borough",170,"Matanuska-Susitna Borough",5,0,89,1,91,0,6,0,4
"09/03/2021","Y","N","Matanuska-Susitna Borough",170,"Matanuska-Susitna Borough",5,1,90,1,92,0,6,0,4
"09/07/2021","Y","N","Matanuska-Susitna Borough",170,"Matanuska-Susitna Borough",5,1,91,1,93,0,6,0,4
"09/09/2021","Y","N","Matanuska-Susitna Borough",170,"Matanuska-Susitna Borough",5,1,92,0,93,0,6,0,4
"09/13/2021","Y","N","Matanuska-Susitna Borough",170,"Matanuska-Susitna Borough",5,0,92,3,96,0,6,0,4
"09/16/2021","Y","N","Matanuska-Susitna Borough",170,"Matanuska-Susitna Borough",5,1,93,0,96,0,6,0,4
"09/17/2021","Y","N","Matanuska-Susitna Borough",170,"Matanuska-Susitna Borough",5,0,93,1,97,0,6,0,4
"09/18/2021","Y","N","Matanuska-Susitna Borough",170,"Matanuska-Susitna Borough",5,2,95,1,98,0,6,0,4
"09/19/2021","Y","N","Matanuska-Susitna Borough",170,"Matanuska-Susitna Borough",5,0,95,2,100,0,6,0,4
"09/20/2021","Y","N","Matanuska-Susitna Borough",170,"Matanuska-Susitna Borough",5,0,95,1,101,0,6,0,4
"09/21/2021","Y","N","Matanuska-Susitna Borough",170,"Matanuska-Susitna Borough",5,1,96,0,101,0,6,0,4
"09/25/2021","Y","N","Matanuska-Susitna Borough",170,"Matanuska-Susitna Borough",5,1,97,0,101,0,6,0,4
"09/27/2021","Y","N","Matanuska-Susitna Borough",170,"Matanuska-Susitna Borough",5,1,98,0,101,0,6,0,4
"09/28/2021","Y","N","Matanuska-Susitna Borough",170,"Matanuska-Susitna Borough",5,2,100,1,102,0,6,0,4
"09/29/2021","Y","N","Matanuska-Susitna Borough",170,"Matanuska-Susitna Borough",5,3,103,1,103,0,6,0,4
"10/04/2021","Y","N","Matanuska-Susitna Borough",170,"Matanuska-Susitna Borough",5,0,103,1,104,0,6,0,4
"10/05/2021","Y","N","Matanuska-Susitna Borough",170,"Matanuska-Susitna Borough",5,1,104,0,104,0,6,0,4
"10/09/2021","Y","N","Matanuska-Susitna Borough",170,"Matanuska-Susitna Borough",5,0,104,1,105,0,6,0,4
"10/13/2021","Y","N","Matanuska-Susitna Borough",170,"Matanuska-Susitna Borough",5,1,105,0,105,0,6,0,4
"10/18/2021","Y","N","Matanuska-Susitna Borough",170,"Matanuska-Susitna Borough",5,0,105,1,106,0,6,0,4
"10/20/2021","Y","N","Matanuska-Susitna Borough",170,"Matanuska-Susitna Borough",5,0,105,1,107,0,6,0,4
"10/22/2021","Y","N","Matanuska-Susitna Borough",170,"Matanuska-Susitna Borough",5,1,106,0,107,0,6,0,4
"10/23/2021","Y","N","Matanuska-Susitna Borough",170,"Matanuska-Susitna Borough",5,0,106,1,108,0,6,0,4
"10/25/2021","Y","N","Matanuska-Susitna Borough",170,"Matanuska-Susitna Borough",5,0,106,1,109,0,6,0,4
"10/26/2021","Y","N","Matanuska-Susitna Borough",170,"Matanuska-Susitna Borough",5,2,108,0,109,0,6,0,4
"11/02/2021","Y","N","Matanuska-Susitna Borough",170,"Matanuska-Susitna Borough",5,1,109,0,109,0,6,0,4
"11/03/2021","Y","N","Matanuska-Susitna Borough",170,"Matanuska-Susitna Borough",5,0,109,2,111,1,7,0,4
"11/04/2021","Y","N","Matanuska-Susitna Borough",170,"Matanuska-Susitna Borough",5,1,110,1,112,0,7,0,4
"11/08/2021","Y","N","Matanuska-Susitna Borough",170,"Matanuska-Susitna Borough",5,1,111,1,113,0,7,0,4
"11/15/2021","Y","N","Matanuska-Susitna Borough",170,"Matanuska-Susitna Borough",5,1,112,0,113,0,7,0,4
"11/19/2021","Y","N","Matanuska-Susitna Borough",170,"Matanuska-Susitna Borough",5,1,113,1,114,0,7,0,4
"11/29/2021","Y","N","Matanuska-Susitna Borough",170,"Matanuska-Susitna Borough",5,1,114,0,114,0,7,0,4
"12/08/2021","Y","N","Matanuska-Susitna Borough",170,"Matanuska-Susitna Borough",5,0,114,1,115,0,7,0,4
"12/09/2021","Y","N","Matanuska-Susitna Borough",170,"Matanuska-Susitna Borough",5,0,114,1,116,0,7,0,4
"12/14/2021","Y","N","Matanuska-Susitna Borough",170,"Matanuska-Susitna Borough",5,0,114,1,117,0,7,0,4
"12/15/2021","Y","N","Matanuska-Susitna Borough",170,"Matanuska-Susitna Borough",5,1,115,2,119,0,7,0,4
"12/17/2021","Y","N","Matanuska-Susitna Borough",170,"Matanuska-Susitna Borough",5,1,116,0,119,0,7,0,4
"12/21/2021","Y","N","Matanuska-Susitna Borough",170,"Matanuska-Susitna Borough",5,1,117,0,119,0,7,1,5
"12/23/2021","Y","N","Matanuska-Susitna Borough",170,"Matanuska-Susitna Borough",5,0,117,0,119,1,8,0,5
"12/27/2021","Y","N","Matanuska-Susitna Borough",170,"Matanuska-Susitna Borough",5,1,118,3,122,0,8,0,5
"12/29/2021","Y","N","Matanuska-Susitna Borough",170,"Matanuska-Susitna Borough",5,0,118,4,126,1,9,0,5
"12/30/2021","Y","N","Matanuska-Susitna Borough",170,"Matanuska-Susitna Borough",5,5,123,4,130,0,9,1,6
"12/31/2021","Y","N","Matanuska-Susitna Borough",170,"Matanuska-Susitna Borough",5,1,124,0,130,0,9,0,6
"01/02/2022","Y","N","Matanuska-Susitna Borough",170,"Matanuska-Susitna Borough",5,1,125,0,130,0,9,0,6
"01/04/2022","Y","N","Matanuska-Susitna Borough",170,"Matanuska-Susitna Borough",5,0,125,2,132,0,9,0,6
"01/06/2022","Y","N","Matanuska-Susitna Borough",170,"Matanuska-Susitna Borough",5,0,125,2,134,0,9,0,6
"01/07/2022","Y","N","Matanuska-Susitna Borough",170,"Matanuska-Susitna Borough",5,0,125,1,135,0,9,0,6
"01/08/2022","Y","N","Matanuska-Susitna Borough",170,"Matanuska-Susitna Borough",5,0,125,1,136,0,9,0,6
"01/09/2022","Y","N","Matanuska-Susitna Borough",170,"Matanuska-Susitna Borough",5,2,127,1,137,0,9,0,6
"01/10/2022","Y","N","Matanuska-Susitna Borough",170,"Matanuska-Susitna Borough",5,1,128,2,139,0,9,0,6
"01/11/2022","Y","N","Matanuska-Susitna Borough",170,"Matanuska-Susitna Borough",5,0,128,2,141,0,9,1,7
"01/12/2022","Y","N","Matanuska-Susitna Borough",170,"Matanuska-Susitna Borough",5,2,130,1,142,0,9,0,7
"01/13/2022","Y","N","Matanuska-Susitna Borough",170,"Matanuska-Susitna Borough",5,0,130,2,144,0,9,0,7
"01/14/2022","Y","N","Matanuska-Susitna Borough",170,"Matanuska-Susitna Borough",5,1,131,1,145,0,9,0,7
"01/15/2022","Y","N","Matanuska-Susitna Borough",170,"Matanuska-Susitna Borough",5,0,131,1,146,0,9,0,7
"01/16/2022","Y","N","Matanuska-Susitna Borough",170,"Matanuska-Susitna Borough",5,0,131,1,147,0,9,0,7
"01/17/2022","Y","N","Matanuska-Susitna Borough",170,"Matanuska-Susitna Borough",5,2,133,2,149,0,9,0,7
"01/18/2022","Y","N","Matanuska-Susitna Borough",170,"Matanuska-Susitna Borough",5,1,134,1,150,0,9,0,7
"01/19/2022","Y","N","Matanuska-Susitna Borough",170,"Matanuska-Susitna Borough",5,3,137,0,150,0,9,0,7
"01/20/2022","Y","N","Matanuska-Susitna Borough",170,"Matanuska-Susitna Borough",5,3,140,2,152,0,9,0,7
"01/21/2022","Y","N","Matanuska-Susitna Borough",170,"Matanuska-Susitna Borough",5,3,143,2,154,0,9,0,7
"01/22/2022","Y","N","Matanuska-Susitna Borough",170,"Matanuska-Susitna Borough",5,1,144,0,154,0,9,0,7
"01/23/2022","Y","N","Matanuska-Susitna Borough",170,"Matanuska-Susitna Borough",5,0,144,1,155,0,9,0,7
"01/24/2022","Y","N","Matanuska-Susitna Borough",170,"Matanuska-Susitna Borough",5,2,146,2,157,0,9,0,7
"01/25/2022","Y","N","Matanuska-Susitna Borough",170,"Matanuska-Susitna Borough",5,3,149,3,160,1,10,0,7
"01/26/2022","Y","N","Matanuska-Susitna Borough",170,"Matanuska-Susitna Borough",5,1,150,2,162,0,10,0,7
"01/27/2022","Y","N","Matanuska-Susitna Borough",170,"Matanuska-Susitna Borough",5,0,150,1,163,0,10,0,7
"01/28/2022","Y","N","Matanuska-Susitna Borough",170,"Matanuska-Susitna Borough",5,2,152,1,164,0,10,0,7
"01/30/2022","Y","N","Matanuska-Susitna Borough",170,"Matanuska-Susitna Borough",5,0,152,1,165,0,10,1,8
"01/31/2022","Y","N","Matanuska-Susitna Borough",170,"Matanuska-Susitna Borough",5,3,155,0,165,0,10,0,8
"02/01/2022","Y","N","Matanuska-Susitna Borough",170,"Matanuska-Susitna Borough",5,0,155,1,166,1,11,0,8
"02/02/2022","Y","N","Matanuska-Susitna Borough",170,"Matanuska-Susitna Borough",5,2,157,1,167,0,11,0,8
"02/03/2022","Y","N","Matanuska-Susitna Borough",170,"Matanuska-Susitna Borough",5,2,159,0,167,0,11,0,8
"02/04/2022","Y","N","Matanuska-Susitna Borough",170,"Matanuska-Susitna Borough",5,3,162,3,170,0,11,0,8
"02/05/2022","Y","N","Matanuska-Susitna Borough",170,"Matanuska-Susitna Borough",5,0,162,1,171,0,11,0,8
"02/06/2022","Y","N","Matanuska-Susitna Borough",170,"Matanuska-Susitna Borough",5,2,164,0,171,0,11,0,8
"02/07/2022","Y","N","Matanuska-Susitna Borough",170,"Matanuska-Susitna Borough",5,0,164,2,173,0,11,0,8
"02/08/2022","Y","N","Matanuska-Susitna Borough",170,"Matanuska-Susitna Borough",5,0,164,1,174,0,11,0,8
"02/09/2022","Y","N","Matanuska-Susitna Borough",170,"Matanuska-Susitna Borough",5,3,167,0,174,0,11,0,8
"02/11/2022","Y","N","Matanuska-Susitna Borough",170,"Matanuska-Susitna Borough",5,3,170,0,174,0,11,0,8
"02/14/2022","Y","N","Matanuska-Susitna Borough",170,"Matanuska-Susitna Borough",5,0,170,1,175,0,11,0,8
"02/15/2022","Y","N","Matanuska-Susitna Borough",170,"Matanuska-Susitna Borough",5,0,170,3,178,0,11,0,8
"02/16/2022","Y","N","Matanuska-Susitna Borough",170,"Matanuska-Susitna Borough",5,0,170,1,179,0,11,0,8
"02/17/2022","Y","N","Matanuska-Susitna Borough",170,"Matanuska-Susitna Borough",5,1,171,0,179,0,11,0,8
"02/20/2022","Y","N","Matanuska-Susitna Borough",170,"Matanuska-Susitna Borough",5,0,171,0,179,0,11,1,9
"02/25/2022","Y","N","Matanuska-Susitna Borough",170,"Matanuska-Susitna Borough",5,4,175,0,179,0,11,0,9
"02/26/2022","Y","N","Matanuska-Susitna Borough",170,"Matanuska-Susitna Borough",5,2,177,0,179,0,11,0,9
"03/01/2022","Y","N","Matanuska-Susitna Borough",170,"Matanuska-Susitna Borough",5,2,179,0,179,0,11,0,9
"03/21/2022","Y","N","Matanuska-Susitna Borough",170,"Matanuska-Susitna Borough",5,0,179,1,180,0,11,0,9
"03/30/2022","Y","N","Matanuska-Susitna Borough",170,"Matanuska-Susitna Borough",5,1,180,0,180,0,11,0,9
"04/20/2022","Y","N","Matanuska-Susitna Borough",170,"Matanuska-Susitna Borough",5,0,180,1,181,0,11,0,9
"04/21/2022","Y","N","Matanuska-Susitna Borough",170,"Matanuska-Susitna Borough",5,1,181,0,181,0,11,0,9
"02/17/2021","Y","N","Nome Census Area",180,"Northwest Region",6,0,0,1,1,0,0,0,0
"02/25/2021","Y","N","Nome Census Area",180,"Northwest Region",6,1,1,0,1,0,0,0,0
"09/20/2021","Y","N","Nome Census Area",180,"Northwest Region",6,0,1,1,2,0,0,0,0
"09/29/2021","Y","N","Nome Census Area",180,"Northwest Region",6,1,2,0,2,0,0,0,0
"12/29/2021","Y","N","Nome Census Area",180,"Northwest Region",6,0,2,1,3,0,0,0,0
"01/03/2022","Y","N","Nome Census Area",180,"Northwest Region",6,1,3,0,3,0,0,0,0
"01/11/2022","Y","N","Nome Census Area",180,"Northwest Region",6,0,3,1,4,0,0,0,0
"02/04/2022","Y","N","Nome Census Area",180,"Northwest Region",6,1,4,0,4,0,0,0,0
"07/27/2020","Y","N","North Slope Borough",185,"Northwest Region",6,0,0,1,1,0,0,0,0
"08/20/2020","Y","N","North Slope Borough",185,"Northwest Region",6,1,1,0,1,0,0,0,0
"08/21/2020","Y","N","North Slope Borough",185,"Northwest Region",6,0,1,1,2,0,0,0,0
"08/25/2020","Y","N","North Slope Borough",185,"Northwest Region",6,1,2,0,2,0,0,0,0
"09/14/2020","Y","N","North Slope Borough",185,"Northwest Region",6,0,2,1,3,0,0,0,0
"09/16/2020","Y","N","North Slope Borough",185,"Northwest Region",6,1,3,0,3,0,0,0,0
"09/24/2020","Y","N","North Slope Borough",185,"Northwest Region",6,0,3,1,4,0,0,0,0
"09/28/2020","Y","N","North Slope Borough",185,"Northwest Region",6,1,4,0,4,0,0,0,0
"10/17/2020","Y","N","North Slope Borough",185,"Northwest Region",6,0,4,1,5,0,0,0,0
"10/20/2020","Y","N","North Slope Borough",185,"Northwest Region",6,1,5,0,5,0,0,0,0
"11/27/2020","Y","N","North Slope Borough",185,"Northwest Region",6,0,5,1,6,0,0,0,0
"12/02/2020","Y","N","North Slope Borough",185,"Northwest Region",6,1,6,0,6,0,0,0,0
"12/04/2020","Y","N","North Slope Borough",185,"Northwest Region",6,0,6,1,7,0,0,0,0
"12/08/2020","Y","N","North Slope Borough",185,"Northwest Region",6,1,7,0,7,0,0,0,0
"12/14/2020","Y","N","North Slope Borough",185,"Northwest Region",6,0,7,1,8,0,0,0,0
"12/19/2020","Y","N","North Slope Borough",185,"Northwest Region",6,1,8,0,8,0,0,0,0
"09/30/2021","Y","N","North Slope Borough",185,"Northwest Region",6,0,8,1,9,0,0,0,0
"10/03/2021","Y","N","North Slope Borough",185,"Northwest Region",6,1,9,0,9,0,0,0,0
"10/18/2021","Y","N","North Slope Borough",185,"Northwest Region",6,0,9,1,10,0,0,0,0
"11/07/2021","Y","N","North Slope Borough",185,"Northwest Region",6,1,10,0,10,0,0,0,0
"01/09/2021","Y","N","Northwest Arctic Borough",188,"Northwest Region",6,0,0,1,1,0,0,0,0
"01/15/2021","Y","N","Northwest Arctic Borough",188,"Northwest Region",6,1,1,0,1,0,0,0,0
"04/01/2021","Y","N","Northwest Arctic Borough",188,"Northwest Region",6,0,1,1,2,0,0,0,0
"04/02/2021","Y","N","Northwest Arctic Borough",188,"Northwest Region",6,1,2,0,2,0,0,0,0
"08/09/2021","Y","N","Northwest Arctic Borough",188,"Northwest Region",6,0,2,1,3,0,0,0,0
"08/10/2021","Y","N","Northwest Arctic Borough",188,"Northwest Region",6,0,2,0,3,1,1,0,0
"08/18/2021","Y","N","Northwest Arctic Borough",188,"Northwest Region",6,1,3,0,3,0,1,1,1
"11/15/2021","Y","N","Northwest Arctic Borough",188,"Northwest Region",6,0,3,1,4,0,1,0,1
"11/17/2021","Y","N","Northwest Arctic Borough",188,"Northwest Region",6,1,4,0,4,0,1,0,1
"12/28/2021","Y","N","Northwest Arctic Borough",188,"Northwest Region",6,0,4,1,5,0,1,0,1
"01/03/2022","Y","N","Northwest Arctic Borough",188,"Northwest Region",6,1,5,0,5,0,1,0,1
"01/18/2022","Y","N","Northwest Arctic Borough",188,"Northwest Region",6,1,6,1,6,0,1,0,1
"01/21/2022","Y","N","Northwest Arctic Borough",188,"Northwest Region",6,0,6,1,7,0,1,0,1
"01/26/2022","Y","N","Northwest Arctic Borough",188,"Northwest Region",6,1,7,0,7,0,1,0,1
"03/06/2020","Y","N","Petersburg Borough",195,"Other Southeast Region - Northern",8,0,0,1,1,1,1,0,0
"03/16/2020","Y","N","Petersburg Borough",195,"Other Southeast Region - Northern",8,1,1,0,1,0,1,1,1
"06/30/2020","Y","N","Petersburg Borough",195,"Other Southeast Region - Northern",8,0,1,1,2,0,1,0,1
"07/08/2020","Y","N","Petersburg Borough",195,"Other Southeast Region - Northern",8,1,2,0,2,0,1,0,1
"11/08/2020","Y","N","Petersburg Borough",195,"Other Southeast Region - Northern",8,0,2,1,3,0,1,0,1
"11/12/2020","Y","N","Petersburg Borough",195,"Other Southeast Region - Northern",8,1,3,0,3,0,1,0,1
"12/18/2020","Y","N","Petersburg Borough",195,"Other Southeast Region - Northern",8,0,3,1,4,0,1,0,1
"12/25/2020","Y","N","Petersburg Borough",195,"Other Southeast Region - Northern",8,1,4,0,4,0,1,0,1
"12/27/2020","Y","N","Petersburg Borough",195,"Other Southeast Region - Northern",8,0,4,0,4,1,2,0,1
"02/04/2021","Y","N","Petersburg Borough",195,"Other Southeast Region - Northern",8,0,4,1,5,0,2,0,1
"02/09/2021","Y","N","Petersburg Borough",195,"Other Southeast Region - Northern",8,1,5,0,5,0,2,0,1
"02/10/2021","Y","N","Petersburg Borough",195,"Other Southeast Region - Northern",8,0,5,1,6,0,2,0,1
"02/18/2021","Y","N","Petersburg Borough",195,"Other Southeast Region - Northern",8,1,6,0,6,0,2,0,1
"03/03/2021","Y","N","Petersburg Borough",195,"Other Southeast Region - Northern",8,0,6,1,7,0,2,0,1
"03/10/2021","Y","N","Petersburg Borough",195,"Other Southeast Region - Northern",8,1,7,1,8,1,3,0,1
"03/23/2021","Y","N","Petersburg Borough",195,"Other Southeast Region - Northern",8,1,8,0,8,0,3,0,1
"08/10/2021","Y","N","Petersburg Borough",195,"Other Southeast Region - Northern",8,0,8,1,9,0,3,0,1
"08/19/2021","Y","N","Petersburg Borough",195,"Other Southeast Region - Northern",8,0,8,2,11,0,3,0,1
"08/21/2021","Y","N","Petersburg Borough",195,"Other Southeast Region - Northern",8,0,8,1,12,0,3,0,1
"08/23/2021","Y","N","Petersburg Borough",195,"Other Southeast Region - Northern",8,1,9,0,12,0,3,0,1
"08/24/2021","Y","N","Petersburg Borough",195,"Other Southeast Region - Northern",8,1,10,0,12,0,3,0,1
"08/28/2021","Y","N","Petersburg Borough",195,"Other Southeast Region - Northern",8,2,12,0,12,0,3,0,1
"09/29/2021","Y","N","Petersburg Borough",195,"Other Southeast Region - Northern",8,0,12,2,14,0,3,0,1
"10/03/2021","Y","N","Petersburg Borough",195,"Other Southeast Region - Northern",8,2,14,0,14,0,3,0,1
"11/18/2021","Y","N","Petersburg Borough",195,"Other Southeast Region - Northern",8,0,14,1,15,0,3,0,1
"11/21/2021","Y","N","Petersburg Borough",195,"Other Southeast Region - Northern",8,1,15,0,15,0,3,0,1
"01/30/2022","Y","N","Petersburg Borough",195,"Other Southeast Region - Northern",8,0,15,1,16,0,3,0,1
"02/25/2022","Y","N","Petersburg Borough",195,"Other Southeast Region - Northern",8,1,16,0,16,0,3,0,1
"08/04/2020","Y","N","Prince of Wales-Hyder Census Area",198,"Other Southeast Region - Southern",9,0,0,1,1,0,0,0,0
"08/11/2020","Y","N","Prince of Wales-Hyder Census Area",198,"Other Southeast Region - Southern",9,1,1,0,1,0,0,0,0
"10/30/2020","Y","N","Prince of Wales-Hyder Census Area",198,"Other Southeast Region - Southern",9,0,1,1,2,0,0,0,0
"11/02/2020","Y","N","Prince of Wales-Hyder Census Area",198,"Other Southeast Region - Southern",9,0,1,1,3,0,0,0,0
"11/03/2020","Y","N","Prince of Wales-Hyder Census Area",198,"Other Southeast Region - Southern",9,0,1,1,4,0,0,0,0
"11/06/2020","Y","N","Prince of Wales-Hyder Census Area",198,"Other Southeast Region - Southern",9,1,2,0,4,0,0,0,0
"11/07/2020","Y","N","Prince of Wales-Hyder Census Area",198,"Other Southeast Region - Southern",9,1,3,0,4,0,0,0,0
"11/08/2020","Y","N","Prince of Wales-Hyder Census Area",198,"Other Southeast Region - Southern",9,1,4,0,4,0,0,0,0
"12/14/2020","Y","N","Prince of Wales-Hyder Census Area",198,"Other Southeast Region - Southern",9,0,4,1,5,0,0,0,0
"12/29/2020","Y","N","Prince of Wales-Hyder Census Area",198,"Other Southeast Region - Southern",9,1,5,0,5,0,0,0,0
"01/10/2021","Y","N","Prince of Wales-Hyder Census Area",198,"Other Southeast Region - Southern",9,0,5,1,6,0,0,0,0
"01/25/2021","Y","N","Prince of Wales-Hyder Census Area",198,"Other Southeast Region - Southern",9,1,6,0,6,0,0,0,0
"01/26/2021","Y","N","Prince of Wales-Hyder Census Area",198,"Other Southeast Region - Southern",9,1,7,1,7,0,0,0,0
"05/04/2021","Y","N","Prince of Wales-Hyder Census Area",198,"Other Southeast Region - Southern",9,0,7,1,8,0,0,0,0
"05/12/2021","Y","N","Prince of Wales-Hyder Census Area",198,"Other Southeast Region - Southern",9,1,8,0,8,0,0,0,0
"09/16/2021","Y","N","Prince of Wales-Hyder Census Area",198,"Other Southeast Region - Southern",9,0,8,1,9,0,0,0,0
"09/25/2021","Y","N","Prince of Wales-Hyder Census Area",198,"Other Southeast Region - Southern",9,1,9,0,9,0,0,0,0
"11/19/2021","Y","N","Prince of Wales-Hyder Census Area",198,"Other Southeast Region - Southern",9,0,9,4,13,0,0,0,0
"11/21/2021","Y","N","Prince of Wales-Hyder Census Area",198,"Other Southeast Region - Southern",9,4,13,0,13,0,0,0,0
"01/06/2022","Y","N","Prince of Wales-Hyder Census Area",198,"Other Southeast Region - Southern",9,1,14,1,14,0,0,0,0
"01/13/2022","Y","N","Prince of Wales-Hyder Census Area",198,"Other Southeast Region - Southern",9,1,15,1,15,0,0,0,0
"01/17/2022","Y","N","Prince of Wales-Hyder Census Area",198,"Other Southeast Region - Southern",9,0,15,1,16,0,0,0,0
"01/19/2022","Y","N","Prince of Wales-Hyder Census Area",198,"Other Southeast Region - Southern",9,0,15,1,17,0,0,0,0
"01/21/2022","Y","N","Prince of Wales-Hyder Census Area",198,"Other Southeast Region - Southern",9,0,15,1,18,0,0,0,0
"01/24/2022","Y","N","Prince of Wales-Hyder Census Area",198,"Other Southeast Region - Southern",9,0,15,1,19,0,0,0,0
"01/28/2022","Y","N","Prince of Wales-Hyder Census Area",198,"Other Southeast Region - Southern",9,1,16,0,19,0,0,0,0
"02/04/2022","Y","N","Prince of Wales-Hyder Census Area",198,"Other Southeast Region - Southern",9,1,17,0,19,0,0,0,0
"02/05/2022","Y","N","Prince of Wales-Hyder Census Area",198,"Other Southeast Region - Southern",9,1,18,0,19,0,0,0,0
"02/25/2022","Y","N","Prince of Wales-Hyder Census Area",198,"Other Southeast Region - Southern",9,1,19,0,19,0,0,0,0
"03/07/2022","Y","N","Prince of Wales-Hyder Census Area",198,"Other Southeast Region - Southern",9,0,19,1,20,0,0,0,0
"03/09/2022","Y","N","Prince of Wales-Hyder Census Area",198,"Other Southeast Region - Southern",9,1,20,0,20,0,0,0,0
"07/10/2020","Y","N","Sitka City and Borough",220,"Other Southeast Region - Northern",8,0,0,1,1,0,0,0,0
"08/28/2020","Y","N","Sitka City and Borough",220,"Other Southeast Region - Northern",8,1,1,0,1,0,0,0,0
"11/25/2020","Y","N","Sitka City and Borough",220,"Other Southeast Region - Northern",8,0,1,1,2,0,0,0,0
"11/26/2020","Y","N","Sitka City and Borough",220,"Other Southeast Region - Northern",8,1,2,0,2,0,0,0,0
"12/02/2020","Y","N","Sitka City and Borough",220,"Other Southeast Region - Northern",8,0,2,1,3,0,0,0,0
"12/10/2020","Y","N","Sitka City and Borough",220,"Other Southeast Region - Northern",8,0,2,1,4,0,0,0,0
"12/12/2020","Y","N","Sitka City and Borough",220,"Other Southeast Region - Northern",8,1,3,1,5,0,0,0,0
"12/15/2020","Y","N","Sitka City and Borough",220,"Other Southeast Region - Northern",8,1,4,0,5,0,0,0,0
"12/28/2020","Y","N","Sitka City and Borough",220,"Other Southeast Region - Northern",8,1,5,0,5,0,0,0,0
"12/29/2020","Y","N","Sitka City and Borough",220,"Other Southeast Region - Northern",8,0,5,1,6,0,0,0,0
"01/05/2021","Y","N","Sitka City and Borough",220,"Other Southeast Region - Northern",8,1,6,0,6,0,0,0,0
"01/11/2021","Y","N","Sitka City and Borough",220,"Other Southeast Region - Northern",8,0,6,1,7,0,0,0,0
"01/12/2021","Y","N","Sitka City and Borough",220,"Other Southeast Region - Northern",8,0,6,1,8,0,0,0,0
"01/20/2021","Y","N","Sitka City and Borough",220,"Other Southeast Region - Northern",8,1,7,0,8,0,0,0,0
"01/22/2021","Y","N","Sitka City and Borough",220,"Other Southeast Region - Northern",8,1,8,0,8,0,0,0,0
"02/01/2021","Y","N","Sitka City and Borough",220,"Other Southeast Region - Northern",8,0,8,1,9,0,0,0,0
"02/04/2021","Y","N","Sitka City and Borough",220,"Other Southeast Region - Northern",8,1,9,0,9,0,0,0,0
"02/10/2021","Y","N","Sitka City and Borough",220,"Other Southeast Region - Northern",8,0,9,1,10,1,1,0,0
"02/19/2021","Y","N","Sitka City and Borough",220,"Other Southeast Region - Northern",8,1,10,0,10,0,1,0,0
"02/24/2021","Y","N","Sitka City and Borough",220,"Other Southeast Region - Northern",8,0,10,0,10,0,1,1,1
"03/22/2021","Y","N","Sitka City and Borough",220,"Other Southeast Region - Northern",8,0,10,1,11,0,1,0,1
"03/30/2021","Y","N","Sitka City and Borough",220,"Other Southeast Region - Northern",8,1,11,0,11,0,1,0,1
"04/20/2021","Y","N","Sitka City and Borough",220,"Other Southeast Region - Northern",8,0,11,1,12,0,1,0,1
"04/21/2021","Y","N","Sitka City and Borough",220,"Other Southeast Region - Northern",8,1,12,0,12,0,1,0,1
"05/13/2021","Y","N","Sitka City and Borough",220,"Other Southeast Region - Northern",8,0,12,1,13,0,1,0,1
"05/14/2021","Y","N","Sitka City and Borough",220,"Other Southeast Region - Northern",8,1,13,0,13,0,1,0,1
"07/12/2021","Y","N","Sitka City and Borough",220,"Other Southeast Region - Northern",8,1,14,1,14,0,1,0,1
"08/04/2021","Y","N","Sitka City and Borough",220,"Other Southeast Region - Northern",8,0,14,1,15,0,1,0,1
"08/09/2021","Y","N","Sitka City and Borough",220,"Other Southeast Region - Northern",8,1,15,0,15,0,1,0,1
"08/26/2021","Y","N","Sitka City and Borough",220,"Other Southeast Region - Northern",8,0,15,1,16,0,1,0,1
"08/29/2021","Y","N","Sitka City and Borough",220,"Other Southeast Region - Northern",8,1,16,0,16,0,1,0,1
"08/30/2021","Y","N","Sitka City and Borough",220,"Other Southeast Region - Northern",8,0,16,1,17,0,1,0,1
"08/31/2021","Y","N","Sitka City and Borough",220,"Other Southeast Region - Northern",8,0,16,1,18,0,1,0,1
"09/06/2021","Y","N","Sitka City and Borough",220,"Other Southeast Region - Northern",8,1,17,0,18,0,1,0,1
"09/08/2021","Y","N","Sitka City and Borough",220,"Other Southeast Region - Northern",8,0,17,1,19,0,1,0,1
"09/09/2021","Y","N","Sitka City and Borough",220,"Other Southeast Region - Northern",8,0,17,1,20,0,1,0,1
"09/17/2021","Y","N","Sitka City and Borough",220,"Other Southeast Region - Northern",8,0,17,1,21,0,1,0,1
"09/20/2021","Y","N","Sitka City and Borough",220,"Other Southeast Region - Northern",8,1,18,0,21,0,1,0,1
"09/21/2021","Y","N","Sitka City and Borough",220,"Other Southeast Region - Northern",8,1,19,1,22,0,1,0,1
"09/27/2021","Y","N","Sitka City and Borough",220,"Other Southeast Region - Northern",8,2,21,0,22,0,1,0,1
"10/19/2021","Y","N","Sitka City and Borough",220,"Other Southeast Region - Northern",8,1,22,0,22,0,1,0,1
"11/03/2021","Y","N","Sitka City and Borough",220,"Other Southeast Region - Northern",8,0,22,1,23,0,1,0,1
"11/15/2021","Y","N","Sitka City and Borough",220,"Other Southeast Region - Northern",8,1,23,0,23,0,1,0,1
"01/03/2022","Y","N","Sitka City and Borough",220,"Other Southeast Region - Northern",8,1,24,2,25,0,1,0,1
"01/05/2022","Y","N","Sitka City and Borough",220,"Other Southeast Region - Northern",8,1,25,1,26,0,1,0,1
"01/06/2022","Y","N","Sitka City and Borough",220,"Other Southeast Region - Northern",8,0,25,1,27,0,1,0,1
"01/07/2022","Y","N","Sitka City and Borough",220,"Other Southeast Region - Northern",8,1,26,1,28,0,1,0,1
"01/10/2022","Y","N","Sitka City and Borough",220,"Other Southeast Region - Northern",8,1,27,1,29,0,1,0,1
"01/11/2022","Y","N","Sitka City and Borough",220,"Other Southeast Region - Northern",8,1,28,0,29,0,1,0,1
"01/15/2022","Y","N","Sitka City and Borough",220,"Other Southeast Region - Northern",8,1,29,1,30,0,1,0,1
"01/18/2022","Y","N","Sitka City and Borough",220,"Other Southeast Region - Northern",8,0,29,1,31,0,1,0,1
"01/19/2022","Y","N","Sitka City and Borough",220,"Other Southeast Region - Northern",8,1,30,0,31,0,1,0,1
"01/20/2022","Y","N","Sitka City and Borough",220,"Other Southeast Region - Northern",8,1,31,0,31,0,1,0,1
"01/28/2022","Y","N","Sitka City and Borough",220,"Other Southeast Region - Northern",8,0,31,1,32,0,1,0,1
"02/25/2022","Y","N","Sitka City and Borough",220,"Other Southeast Region - Northern",8,1,32,0,32,0,1,0,1
"03/15/2022","Y","N","Sitka City and Borough",220,"Other Southeast Region - Northern",8,0,32,1,33,0,1,0,1
"03/25/2022","Y","N","Sitka City and Borough",220,"Other Southeast Region - Northern",8,1,33,0,33,0,1,0,1
"12/21/2020","Y","N","Skagway Municipality",230,"Other Southeast Region - Northern",8,0,0,1,1,0,0,0,0
"12/23/2020","Y","N","Skagway Municipality",230,"Other Southeast Region - Northern",8,1,1,0,1,0,0,0,0
"08/30/2021","Y","N","Skagway Municipality",230,"Other Southeast Region - Northern",8,0,1,1,2,0,0,0,0
"09/04/2021","Y","N","Skagway Municipality",230,"Other Southeast Region - Northern",8,1,2,0,2,0,0,0,0
"09/22/2021","Y","N","Skagway Municipality",230,"Other Southeast Region - Northern",8,0,2,1,3,0,0,0,0
"09/30/2021","Y","N","Skagway Municipality",230,"Other Southeast Region - Northern",8,1,3,0,3,0,0,0,0
"10/19/2021","Y","N","Skagway Municipality",230,"Other Southeast Region - Northern",8,0,3,1,4,0,0,0,0
"10/21/2021","Y","N","Skagway Municipality",230,"Other Southeast Region - Northern",8,1,4,0,4,0,0,0,0
"10/22/2021","Y","N","Skagway Municipality",230,"Other Southeast Region - Northern",8,1,5,1,5,0,0,0,0
"12/20/2021","Y","N","Skagway Municipality",230,"Other Southeast Region - Northern",8,0,5,1,6,0,0,0,0
"12/22/2021","Y","N","Skagway Municipality",230,"Other Southeast Region - Northern",8,1,6,0,6,0,0,0,0
"12/28/2021","Y","N","Skagway Municipality",230,"Other Southeast Region - Northern",8,0,6,1,7,0,0,0,0
"12/30/2021","Y","N","Skagway Municipality",230,"Other Southeast Region - Northern",8,1,7,0,7,0,0,0,0
"01/05/2022","Y","N","Skagway Municipality",230,"Other Southeast Region - Northern",8,1,8,1,8,0,0,0,0
"01/23/2022","Y","N","Skagway Municipality",230,"Other Southeast Region - Northern",8,0,8,2,10,0,0,0,0
"01/31/2022","Y","N","Skagway Municipality",230,"Other Southeast Region - Northern",8,2,10,0,10,0,0,0,0
"02/09/2022","Y","N","Skagway Municipality",230,"Other Southeast Region - Northern",8,1,11,1,11,0,0,0,0
"09/08/2020","Y","N","Southeast Fairbanks Census Area",240,"Other Interior Region",7,0,0,1,1,0,0,0,0
"09/10/2020","Y","N","Southeast Fairbanks Census Area",240,"Other Interior Region",7,1,1,0,1,0,0,0,0
"12/07/2020","Y","N","Southeast Fairbanks Census Area",240,"Other Interior Region",7,0,1,1,2,0,0,0,0
"12/24/2020","Y","N","Southeast Fairbanks Census Area",240,"Other Interior Region",7,1,2,0,2,0,0,0,0
"01/05/2021","Y","N","Southeast Fairbanks Census Area",240,"Other Interior Region",7,1,3,1,3,0,0,0,0
"01/08/2021","Y","N","Southeast Fairbanks Census Area",240,"Other Interior Region",7,0,3,1,4,0,0,0,0
"01/11/2021","Y","N","Southeast Fairbanks Census Area",240,"Other Interior Region",7,1,4,0,4,0,0,0,0
"01/13/2021","Y","N","Southeast Fairbanks Census Area",240,"Other Interior Region",7,0,4,1,5,0,0,0,0
"02/09/2021","Y","N","Southeast Fairbanks Census Area",240,"Other Interior Region",7,1,5,0,5,0,0,0,0
"02/21/2021","Y","N","Southeast Fairbanks Census Area",240,"Other Interior Region",7,0,5,1,6,0,0,0,0
"03/19/2021","Y","N","Southeast Fairbanks Census Area",240,"Other Interior Region",7,1,6,0,6,0,0,0,0
"05/17/2021","Y","N","Southeast Fairbanks Census Area",240,"Other Interior Region",7,1,7,1,7,0,0,0,0
"08/02/2021","Y","N","Southeast Fairbanks Census Area",240,"Other Interior Region",7,0,7,1,8,0,0,0,0
"08/04/2021","Y","N","Southeast Fairbanks Census Area",240,"Other Interior Region",7,1,8,0,8,0,0,0,0
"08/20/2021","Y","N","Southeast Fairbanks Census Area",240,"Other Interior Region",7,0,8,1,9,0,0,0,0
"08/24/2021","Y","N","Southeast Fairbanks Census Area",240,"Other Interior Region",7,1,9,0,9,0,0,0,0
"01/10/2022","Y","N","Southeast Fairbanks Census Area",240,"Other Interior Region",7,0,9,1,10,0,0,0,0
"01/11/2022","Y","N","Southeast Fairbanks Census Area",240,"Other Interior Region",7,0,9,1,11,0,0,0,0
"01/15/2022","Y","N","Southeast Fairbanks Census Area",240,"Other Interior Region",7,1,10,0,11,0,0,0,0
"01/23/2022","Y","N","Southeast Fairbanks Census Area",240,"Other Interior Region",7,1,11,0,11,0,0,0,0
"01/28/2022","Y","N","Southeast Fairbanks Census Area",240,"Other Interior Region",7,0,11,1,12,0,0,0,0
"01/31/2022","Y","N","Southeast Fairbanks Census Area",240,"Other Interior Region",7,0,11,1,13,0,0,0,0
"02/04/2022","Y","N","Southeast Fairbanks Census Area",240,"Other Interior Region",7,1,12,1,14,0,0,0,0
"02/06/2022","Y","N","Southeast Fairbanks Census Area",240,"Other Interior Region",7,2,14,0,14,0,0,0,0
"11/06/2020","Y","N","Wrangell City and Borough",275,"Other Southeast Region - Northern",8,0,0,1,1,0,0,0,0
"11/14/2020","Y","N","Wrangell City and Borough",275,"Other Southeast Region - Northern",8,1,1,0,1,0,0,0,0
"12/29/2020","Y","N","Wrangell City and Borough",275,"Other Southeast Region - Northern",8,0,1,1,2,0,0,0,0
"01/17/2021","Y","N","Wrangell City and Borough",275,"Other Southeast Region - Northern",8,1,2,0,2,0,0,0,0
"02/13/2021","Y","N","Wrangell City and Borough",275,"Other Southeast Region - Northern",8,0,2,1,3,0,0,0,0
"02/19/2021","Y","N","Wrangell City and Borough",275,"Other Southeast Region - Northern",8,1,3,0,3,0,0,0,0
"04/22/2021","Y","N","Wrangell City and Borough",275,"Other Southeast Region - Northern",8,1,4,1,4,0,0,0,0
"09/20/2021","Y","N","Wrangell City and Borough",275,"Other Southeast Region - Northern",8,0,4,2,6,0,0,0,0
"09/29/2021","Y","N","Wrangell City and Borough",275,"Other Southeast Region - Northern",8,2,6,0,6,0,0,0,0
"11/07/2021","Y","N","Wrangell City and Borough",275,"Other Southeast Region - Northern",8,0,6,1,7,0,0,0,0
"11/08/2021","Y","N","Wrangell City and Borough",275,"Other Southeast Region - Northern",8,1,7,0,7,0,0,0,0
"12/11/2021","Y","N","Wrangell City and Borough",275,"Other Southeast Region - Northern",8,0,7,1,8,0,0,0,0
"12/23/2021","Y","N","Wrangell City and Borough",275,"Other Southeast Region - Northern",8,1,8,1,9,0,0,0,0
"12/27/2021","Y","N","Wrangell City and Borough",275,"Other Southeast Region - Northern",8,1,9,0,9,0,0,0,0
"01/15/2022","Y","N","Wrangell City and Borough",275,"Other Southeast Region - Northern",8,0,9,1,10,0,0,0,0
"01/17/2022","Y","N","Wrangell City and Borough",275,"Other Southeast Region - Northern",8,0,9,1,11,0,0,0,0
"01/19/2022","Y","N","Wrangell City and Borough",275,"Other Southeast Region - Northern",8,1,10,0,11,0,0,0,0
"01/20/2022","Y","N","Wrangell City and Borough",275,"Other Southeast Region - Northern",8,1,11,0,11,0,0,0,0
"04/20/2022","Y","N","Wrangell City and Borough",275,"Other Southeast Region - Northern",8,0,11,1,12,0,0,0,0
"04/23/2022","Y","N","Wrangell City and Borough",275,"Other Southeast Region - Northern",8,1,12,0,12,0,0,0,0
"11/18/2020","Y","N","Yakutat plus Hoonah-Angoon",400,"Other Southeast Region - Northern",8,0,0,1,1,0,0,0,0
"11/27/2020","Y","N","Yakutat plus Hoonah-Angoon",400,"Other Southeast Region - Northern",8,1,1,0,1,0,0,0,0
"01/16/2021","Y","N","Yakutat plus Hoonah-Angoon",400,"Other Southeast Region - Northern",8,0,1,1,2,0,0,0,0
"01/27/2021","Y","N","Yakutat plus Hoonah-Angoon",400,"Other Southeast Region - Northern",8,1,2,0,2,0,0,0,0
"04/13/2021","Y","N","Yakutat plus Hoonah-Angoon",400,"Other Southeast Region - Northern",8,0,2,1,3,0,0,0,0
"04/15/2021","Y","N","Yakutat plus Hoonah-Angoon",400,"Other Southeast Region - Northern",8,1,3,0,3,0,0,0,0
"07/01/2021","Y","N","Yakutat plus Hoonah-Angoon",400,"Other Southeast Region - Northern",8,0,3,1,4,0,0,0,0
"07/03/2021","Y","N","Yakutat plus Hoonah-Angoon",400,"Other Southeast Region - Northern",8,1,4,0,4,0,0,0,0
"08/17/2021","Y","N","Yakutat plus Hoonah-Angoon",400,"Other Southeast Region - Northern",8,0,4,1,5,0,0,0,0
"08/18/2021","Y","N","Yakutat plus Hoonah-Angoon",400,"Other Southeast Region - Northern",8,0,4,1,6,0,0,0,0
"08/20/2021","Y","N","Yakutat plus Hoonah-Angoon",400,"Other Southeast Region - Northern",8,2,6,1,7,0,0,0,0
"08/28/2021","Y","N","Yakutat plus Hoonah-Angoon",400,"Other Southeast Region - Northern",8,1,7,0,7,0,0,0,0
"09/10/2021","Y","N","Yakutat plus Hoonah-Angoon",400,"Other Southeast Region - Northern",8,0,7,1,8,0,0,0,0
"09/23/2021","Y","N","Yakutat plus Hoonah-Angoon",400,"Other Southeast Region - Northern",8,1,8,0,8,0,0,0,0
"12/18/2021","Y","N","Yakutat plus Hoonah-Angoon",400,"Other Southeast Region - Northern",8,0,8,1,9,0,0,0,0
"12/21/2021","Y","N","Yakutat plus Hoonah-Angoon",400,"Other Southeast Region - Northern",8,1,9,0,9,0,0,0,0
"01/07/2022","Y","N","Yakutat plus Hoonah-Angoon",400,"Other Southeast Region - Northern",8,1,10,1,10,0,0,0,0
"01/19/2022","Y","N","Yakutat plus Hoonah-Angoon",400,"Other Southeast Region - Northern",8,0,10,2,12,0,0,0,0
"01/26/2022","Y","N","Yakutat plus Hoonah-Angoon",400,"Other Southeast Region - Northern",8,0,10,1,13,0,0,0,0
"02/03/2022","Y","N","Yakutat plus Hoonah-Angoon",400,"Other Southeast Region - Northern",8,1,11,0,13,0,0,0,0
"02/06/2022","Y","N","Yakutat plus Hoonah-Angoon",400,"Other Southeast Region - Northern",8,2,13,0,13,0,0,0,0
"10/01/2020","Y","N","Yukon-Koyukuk Census Area",290,"Other Interior Region",7,0,0,1,1,0,0,0,0
"11/30/2020","Y","N","Yukon-Koyukuk Census Area",290,"Other Interior Region",7,1,1,0,1,0,0,0,0
"01/30/2021","Y","N","Yukon-Koyukuk Census Area",290,"Other Interior Region",7,0,1,1,2,0,0,0,0
"02/01/2021","Y","N","Yukon-Koyukuk Census Area",290,"Other Interior Region",7,1,2,0,2,0,0,0,0
"01/18/2022","Y","N","Yukon-Koyukuk Census Area",290,"Other Interior Region",7,0,2,1,3,0,0,0,0
"01/26/2022","Y","N","Yukon-Koyukuk Census Area",290,"Other Interior Region",7,1,3,0,3,0,0,0,0
"07/20/2020","Y","Y","Aleutians East Borough",13,"Southwest Region",11,1,1,1,1,0,0,0,0
"08/02/2020","Y","Y","Aleutians East Borough",13,"Southwest Region",11,0,1,1,2,0,0,0,0
"08/03/2020","Y","Y","Aleutians East Borough",13,"Southwest Region",11,1,2,0,2,0,0,0,0
"09/25/2020","Y","Y","Aleutians East Borough",13,"Southwest Region",11,0,2,1,3,0,0,0,0
"09/26/2020","Y","Y","Aleutians East Borough",13,"Southwest Region",11,1,3,0,3,0,0,0,0
"10/02/2020","Y","Y","Aleutians East Borough",13,"Southwest Region",11,2,5,2,5,0,0,0,0
"10/25/2020","Y","Y","Aleutians East Borough",13,"Southwest Region",11,1,6,1,6,0,0,0,0
"10/30/2020","Y","Y","Aleutians East Borough",13,"Southwest Region",11,0,6,1,7,0,0,0,0
"10/31/2020","Y","Y","Aleutians East Borough",13,"Southwest Region",11,0,6,1,8,0,0,0,0
"11/01/2020","Y","Y","Aleutians East Borough",13,"Southwest Region",11,1,7,0,8,0,0,0,0
"11/03/2020","Y","Y","Aleutians East Borough",13,"Southwest Region",11,1,8,0,8,0,0,0,0
"11/09/2020","Y","Y","Aleutians East Borough",13,"Southwest Region",11,0,8,1,9,0,0,0,0
"11/10/2020","Y","Y","Aleutians East Borough",13,"Southwest Region",11,1,9,1,10,0,0,0,0
"11/14/2020","Y","Y","Aleutians East Borough",13,"Southwest Region",11,1,10,0,10,0,0,0,0
"11/19/2020","Y","Y","Aleutians East Borough",13,"Southwest Region",11,0,10,1,11,0,0,0,0
"11/20/2020","Y","Y","Aleutians East Borough",13,"Southwest Region",11,0,10,3,14,0,0,0,0
"11/21/2020","Y","Y","Aleutians East Borough",13,"Southwest Region",11,1,11,5,19,0,0,0,0
"11/22/2020","Y","Y","Aleutians East Borough",13,"Southwest Region",11,2,13,3,22,0,0,0,0
"11/23/2020","Y","Y","Aleutians East Borough",13,"Southwest Region",11,1,14,4,26,0,0,0,0
"11/24/2020","Y","Y","Aleutians East Borough",13,"Southwest Region",11,6,20,0,26,0,0,0,0
"11/27/2020","Y","Y","Aleutians East Borough",13,"Southwest Region",11,0,20,2,28,0,0,0,0
"11/28/2020","Y","Y","Aleutians East Borough",13,"Southwest Region",11,4,24,0,28,0,0,0,0
"12/01/2020","Y","Y","Aleutians East Borough",13,"Southwest Region",11,2,26,0,28,0,0,0,0
"12/02/2020","Y","Y","Aleutians East Borough",13,"Southwest Region",11,2,28,0,28,0,0,0,0
"01/10/2021","Y","Y","Aleutians East Borough",13,"Southwest Region",11,0,28,1,29,0,0,0,0
"01/14/2021","Y","Y","Aleutians East Borough",13,"Southwest Region",11,1,29,1,30,0,0,0,0
"01/18/2021","Y","Y","Aleutians East Borough",13,"Southwest Region",11,0,29,1,31,1,1,0,0
"01/19/2021","Y","Y","Aleutians East Borough",13,"Southwest Region",11,0,29,1,32,0,1,0,0
"01/20/2021","Y","Y","Aleutians East Borough",13,"Southwest Region",11,1,30,0,32,0,1,0,0
"01/21/2021","Y","Y","Aleutians East Borough",13,"Southwest Region",11,2,32,0,32,0,1,0,0
"01/22/2021","Y","Y","Aleutians East Borough",13,"Southwest Region",11,1,33,2,34,0,1,0,0
"01/23/2021","Y","Y","Aleutians East Borough",13,"Southwest Region",11,0,33,1,35,0,1,0,0
"01/24/2021","Y","Y","Aleutians East Borough",13,"Southwest Region",11,0,33,1,36,0,1,0,0
"01/25/2021","Y","Y","Aleutians East Borough",13,"Southwest Region",11,0,33,2,38,1,2,0,0
"01/26/2021","Y","Y","Aleutians East Borough",13,"Southwest Region",11,1,34,8,46,0,2,0,0
"01/27/2021","Y","Y","Aleutians East Borough",13,"Southwest Region",11,6,40,6,52,0,2,0,0
"01/28/2021","Y","Y","Aleutians East Borough",13,"Southwest Region",11,0,40,2,54,0,2,0,0
"01/29/2021","Y","Y","Aleutians East Borough",13,"Southwest Region",11,2,42,0,54,0,2,0,0
"01/31/2021","Y","Y","Aleutians East Borough",13,"Southwest Region",11,3,45,1,55,0,2,0,0
"02/01/2021","Y","Y","Aleutians East Borough",13,"Southwest Region",11,3,48,0,55,0,2,0,0
"02/02/2021","Y","Y","Aleutians East Borough",13,"Southwest Region",11,1,49,0,55,0,2,0,0
"02/03/2021","Y","Y","Aleutians East Borough",13,"Southwest Region",11,1,50,0,55,0,2,0,0
"02/05/2021","Y","Y","Aleutians East Borough",13,"Southwest Region",11,3,53,1,56,0,2,0,0
"02/06/2021","Y","Y","Aleutians East Borough",13,"Southwest Region",11,1,54,0,56,0,2,0,0
"02/07/2021","Y","Y","Aleutians East Borough",13,"Southwest Region",11,1,55,0,56,0,2,0,0
"02/11/2021","Y","Y","Aleutians East Borough",13,"Southwest Region",11,1,56,0,56,0,2,0,0
"04/27/2021","Y","Y","Aleutians East Borough",13,"Southwest Region",11,0,56,1,57,0,2,0,0
"04/28/2021","Y","Y","Aleutians East Borough",13,"Southwest Region",11,1,57,0,57,0,2,0,0
"05/13/2021","Y","Y","Aleutians East Borough",13,"Southwest Region",11,0,57,1,58,0,2,0,0
"05/18/2021","Y","Y","Aleutians East Borough",13,"Southwest Region",11,1,58,0,58,0,2,0,0
"07/15/2021","Y","Y","Aleutians East Borough",13,"Southwest Region",11,0,58,1,59,0,2,0,0
"07/16/2021","Y","Y","Aleutians East Borough",13,"Southwest Region",11,1,59,1,60,0,2,0,0
"07/17/2021","Y","Y","Aleutians East Borough",13,"Southwest Region",11,1,60,0,60,0,2,0,0
"07/19/2021","Y","Y","Aleutians East Borough",13,"Southwest Region",11,0,60,1,61,0,2,0,0
"07/20/2021","Y","Y","Aleutians East Borough",13,"Southwest Region",11,1,61,2,63,0,2,0,0
"07/21/2021","Y","Y","Aleutians East Borough",13,"Southwest Region",11,2,63,1,64,0,2,0,0
"07/23/2021","Y","Y","Aleutians East Borough",13,"Southwest Region",11,1,64,1,65,0,2,0,0
"07/25/2021","Y","Y","Aleutians East Borough",13,"Southwest Region",11,1,65,0,65,0,2,0,0
"07/29/2021","Y","Y","Aleutians East Borough",13,"Southwest Region",11,0,65,1,66,0,2,0,0
"07/30/2021","Y","Y","Aleutians East Borough",13,"Southwest Region",11,1,66,1,67,0,2,0,0
"08/02/2021","Y","Y","Aleutians East Borough",13,"Southwest Region",11,1,67,0,67,1,3,0,0
"08/03/2021","Y","Y","Aleutians East Borough",13,"Southwest Region",11,0,67,1,68,0,3,0,0
"08/04/2021","Y","Y","Aleutians East Borough",13,"Southwest Region",11,2,69,2,70,0,3,0,0
"08/05/2021","Y","Y","Aleutians East Borough",13,"Southwest Region",11,1,70,8,78,0,3,0,0
"08/06/2021","Y","Y","Aleutians East Borough",13,"Southwest Region",11,5,75,0,78,0,3,0,0
"08/07/2021","Y","Y","Aleutians East Borough",13,"Southwest Region",11,3,78,0,78,0,3,0,0
"08/09/2021","Y","Y","Aleutians East Borough",13,"Southwest Region",11,2,80,2,80,0,3,0,0
"08/10/2021","Y","Y","Aleutians East Borough",13,"Southwest Region",11,2,82,3,83,0,3,0,0
"08/11/2021","Y","Y","Aleutians East Borough",13,"Southwest Region",11,0,82,0,83,1,4,0,0
"08/13/2021","Y","Y","Aleutians East Borough",13,"Southwest Region",11,0,82,2,85,1,5,0,0
"08/15/2021","Y","Y","Aleutians East Borough",13,"Southwest Region",11,1,83,0,85,0,5,0,0
"08/16/2021","Y","Y","Aleutians East Borough",13,"Southwest Region",11,1,84,0,85,0,5,0,0
"08/18/2021","Y","Y","Aleutians East Borough",13,"Southwest Region",11,1,85,1,86,0,5,0,0
"08/20/2021","Y","Y","Aleutians East Borough",13,"Southwest Region",11,0,85,3,89,0,5,0,0
"08/22/2021","Y","Y","Aleutians East Borough",13,"Southwest Region",11,1,86,0,89,0,5,0,0
"08/23/2021","Y","Y","Aleutians East Borough",13,"Southwest Region",11,2,88,1,90,0,5,0,0
"08/25/2021","Y","Y","Aleutians East Borough",13,"Southwest Region",11,1,89,0,90,0,5,0,0
"08/27/2021","Y","Y","Aleutians East Borough",13,"Southwest Region",11,0,89,4,94,0,5,0,0
"08/29/2021","Y","Y","Aleutians East Borough",13,"Southwest Region",11,0,89,4,98,0,5,0,0
"08/30/2021","Y","Y","Aleutians East Borough",13,"Southwest Region",11,1,90,1,99,0,5,0,0
"08/31/2021","Y","Y","Aleutians East Borough",13,"Southwest Region",11,2,92,0,99,0,5,0,0
"09/01/2021","Y","Y","Aleutians East Borough",13,"Southwest Region",11,0,92,2,101,0,5,0,0
"09/02/2021","Y","Y","Aleutians East Borough",13,"Southwest Region",11,5,97,0,101,0,5,0,0
"09/03/2021","Y","Y","Aleutians East Borough",13,"Southwest Region",11,1,98,0,101,0,5,0,0
"09/04/2021","Y","Y","Aleutians East Borough",13,"Southwest Region",11,1,99,0,101,0,5,0,0
"09/07/2021","Y","Y","Aleutians East Borough",13,"Southwest Region",11,0,99,1,102,0,5,0,0
"09/08/2021","Y","Y","Aleutians East Borough",13,"Southwest Region",11,1,100,3,105,0,5,0,0
"09/12/2021","Y","Y","Aleutians East Borough",13,"Southwest Region",11,3,103,0,105,0,5,0,0
"09/14/2021","Y","Y","Aleutians East Borough",13,"Southwest Region",11,1,104,0,105,0,5,0,0
"09/15/2021","Y","Y","Aleutians East Borough",13,"Southwest Region",11,1,105,0,105,0,5,0,0
"09/16/2021","Y","Y","Aleutians East Borough",13,"Southwest Region",11,0,105,1,106,0,5,0,0
"09/20/2021","Y","Y","Aleutians East Borough",13,"Southwest Region",11,0,105,5,111,0,5,0,0
"09/22/2021","Y","Y","Aleutians East Borough",13,"Southwest Region",11,0,105,1,112,0,5,0,0
"09/23/2021","Y","Y","Aleutians East Borough",13,"Southwest Region",11,0,105,2,114,0,5,0,0
"09/26/2021","Y","Y","Aleutians East Borough",13,"Southwest Region",11,0,105,1,115,0,5,0,0
"09/27/2021","Y","Y","Aleutians East Borough",13,"Southwest Region",11,1,106,3,118,0,5,0,0
"09/29/2021","Y","Y","Aleutians East Borough",13,"Southwest Region",11,5,111,0,118,0,5,0,0
"09/30/2021","Y","Y","Aleutians East Borough",13,"Southwest Region",11,7,118,0,118,0,5,0,0
"10/04/2021","Y","Y","Aleutians East Borough",13,"Southwest Region",11,0,118,1,119,0,5,0,0
"10/07/2021","Y","Y","Aleutians East Borough",13,"Southwest Region",11,0,118,1,120,0,5,0,0
"10/08/2021","Y","Y","Aleutians East Borough",13,"Southwest Region",11,1,119,0,120,0,5,0,0
"10/11/2021","Y","Y","Aleutians East Borough",13,"Southwest Region",11,1,120,0,120,0,5,0,0
"10/25/2021","Y","Y","Aleutians East Borough",13,"Southwest Region",11,0,120,1,121,0,5,0,0
"10/27/2021","Y","Y","Aleutians East Borough",13,"Southwest Region",11,0,120,1,122,0,5,0,0
"10/29/2021","Y","Y","Aleutians East Borough",13,"Southwest Region",11,1,121,2,124,0,5,0,0
"10/30/2021","Y","Y","Aleutians East Borough",13,"Southwest Region",11,1,122,0,124,0,5,0,0
"10/31/2021","Y","Y","Aleutians East Borough",13,"Southwest Region",11,1,123,0,124,0,5,0,0
"11/01/2021","Y","Y","Aleutians East Borough",13,"Southwest Region",11,0,123,2,126,0,5,0,0
"11/03/2021","Y","Y","Aleutians East Borough",13,"Southwest Region",11,1,124,1,127,0,5,0,0
"11/04/2021","Y","Y","Aleutians East Borough",13,"Southwest Region",11,2,126,0,127,1,6,0,0
"11/05/2021","Y","Y","Aleutians East Borough",13,"Southwest Region",11,1,127,1,128,0,6,0,0
"11/07/2021","Y","Y","Aleutians East Borough",13,"Southwest Region",11,1,128,0,128,0,6,0,0
"11/10/2021","Y","Y","Aleutians East Borough",13,"Southwest Region",11,0,128,1,129,0,6,0,0
"11/12/2021","Y","Y","Aleutians East Borough",13,"Southwest Region",11,1,129,1,130,0,6,0,0
"11/13/2021","Y","Y","Aleutians East Borough",13,"Southwest Region",11,1,130,0,130,0,6,0,0
"11/14/2021","Y","Y","Aleutians East Borough",13,"Southwest Region",11,0,130,1,131,0,6,0,0
"11/17/2021","Y","Y","Aleutians East Borough",13,"Southwest Region",11,1,131,0,131,0,6,0,0
"11/18/2021","Y","Y","Aleutians East Borough",13,"Southwest Region",11,0,131,1,132,0,6,0,0
"11/19/2021","Y","Y","Aleutians East Borough",13,"Southwest Region",11,1,132,0,132,0,6,0,0
"11/24/2021","Y","Y","Aleutians East Borough",13,"Southwest Region",11,1,133,1,133,0,6,0,0
"12/07/2021","Y","Y","Aleutians East Borough",13,"Southwest Region",11,0,133,1,134,0,6,0,0
"12/09/2021","Y","Y","Aleutians East Borough",13,"Southwest Region",11,1,134,0,134,0,6,0,0
"12/27/2021","Y","Y","Aleutians East Borough",13,"Southwest Region",11,0,134,1,135,0,6,0,0
"12/28/2021","Y","Y","Aleutians East Borough",13,"Southwest Region",11,1,135,0,135,0,6,0,0
"01/01/2022","Y","Y","Aleutians East Borough",13,"Southwest Region",11,0,135,1,136,0,6,0,0
"01/03/2022","Y","Y","Aleutians East Borough",13,"Southwest Region",11,1,136,1,137,0,6,0,0
"01/04/2022","Y","Y","Aleutians East Borough",13,"Southwest Region",11,0,136,2,139,0,6,0,0
"01/05/2022","Y","Y","Aleutians East Borough",13,"Southwest Region",11,0,136,1,140,0,6,0,0
"01/06/2022","Y","Y","Aleutians East Borough",13,"Southwest Region",11,4,140,6,146,0,6,0,0
"01/07/2022","Y","Y","Aleutians East Borough",13,"Southwest Region",11,1,141,4,150,0,6,0,0
"01/08/2022","Y","Y","Aleutians East Borough",13,"Southwest Region",11,2,143,3,153,0,6,0,0
"01/09/2022","Y","Y","Aleutians East Borough",13,"Southwest Region",11,2,145,1,154,0,6,0,0
"01/10/2022","Y","Y","Aleutians East Borough",13,"Southwest Region",11,0,145,19,173,0,6,0,0
"01/11/2022","Y","Y","Aleutians East Borough",13,"Southwest Region",11,4,149,12,185,0,6,0,0
"01/12/2022","Y","Y","Aleutians East Borough",13,"Southwest Region",11,2,151,17,202,0,6,0,0
"01/13/2022","Y","Y","Aleutians East Borough",13,"Southwest Region",11,5,156,9,211,0,6,0,0
"01/14/2022","Y","Y","Aleutians East Borough",13,"Southwest Region",11,4,160,17,228,0,6,0,0
"01/15/2022","Y","Y","Aleutians East Borough",13,"Southwest Region",11,10,170,5,233,0,6,0,0
"01/16/2022","Y","Y","Aleutians East Borough",13,"Southwest Region",11,2,172,21,254,0,6,0,0
"01/17/2022","Y","Y","Aleutians East Borough",13,"Southwest Region",11,3,175,13,267,0,6,0,0
"01/18/2022","Y","Y","Aleutians East Borough",13,"Southwest Region",11,1,176,54,321,0,6,0,0
"01/19/2022","Y","Y","Aleutians East Borough",13,"Southwest Region",11,17,193,23,344,0,6,0,0
"01/20/2022","Y","Y","Aleutians East Borough",13,"Southwest Region",11,0,193,23,367,0,6,0,0
"01/21/2022","Y","Y","Aleutians East Borough",13,"Southwest Region",11,14,207,23,390,0,6,0,0
"01/22/2022","Y","Y","Aleutians East Borough",13,"Southwest Region",11,0,207,4,394,0,6,0,0
"01/23/2022","Y","Y","Aleutians East Borough",13,"Southwest Region",11,1,208,1,395,0,6,0,0
"01/24/2022","Y","Y","Aleutians East Borough",13,"Southwest Region",11,0,208,34,429,0,6,0,0
"01/25/2022","Y","Y","Aleutians East Borough",13,"Southwest Region",11,19,227,21,450,0,6,0,0
"01/26/2022","Y","Y","Aleutians East Borough",13,"Southwest Region",11,13,240,11,461,0,6,0,0
"01/27/2022","Y","Y","Aleutians East Borough",13,"Southwest Region",11,110,350,6,467,0,6,0,0
"01/28/2022","Y","Y","Aleutians East Borough",13,"Southwest Region",11,32,382,14,481,0,6,0,0
"01/29/2022","Y","Y","Aleutians East Borough",13,"Southwest Region",11,8,390,1,482,0,6,0,0
"01/30/2022","Y","Y","Aleutians East Borough",13,"Southwest Region",11,2,392,1,483,0,6,0,0
"01/31/2022","Y","Y","Aleutians East Borough",13,"Southwest Region",11,42,434,16,499,0,6,0,0
"02/01/2022","Y","Y","Aleutians East Borough",13,"Southwest Region",11,29,463,4,503,0,6,0,0
"02/02/2022","Y","Y","Aleutians East Borough",13,"Southwest Region",11,19,482,7,510,0,6,0,0
"02/03/2022","Y","Y","Aleutians East Borough",13,"Southwest Region",11,5,487,1,511,0,6,0,0
"02/04/2022","Y","Y","Aleutians East Borough",13,"Southwest Region",11,13,500,1,512,0,6,0,0
"02/05/2022","Y","Y","Aleutians East Borough",13,"Southwest Region",11,4,504,0,512,0,6,0,0
"02/06/2022","Y","Y","Aleutians East Borough",13,"Southwest Region",11,5,509,0,512,0,6,0,0
"02/07/2022","Y","Y","Aleutians East Borough",13,"Southwest Region",11,2,511,3,515,0,6,0,0
"02/08/2022","Y","Y","Aleutians East Borough",13,"Southwest Region",11,1,512,0,515,0,6,0,0
"02/09/2022","Y","Y","Aleutians East Borough",13,"Southwest Region",11,1,513,0,515,0,6,0,0
"02/11/2022","Y","Y","Aleutians East Borough",13,"Southwest Region",11,1,514,2,517,0,6,0,0
"02/12/2022","Y","Y","Aleutians East Borough",13,"Southwest Region",11,1,515,1,518,0,6,0,0
"02/13/2022","Y","Y","Aleutians East Borough",13,"Southwest Region",11,0,515,2,520,0,6,0,0
"02/14/2022","Y","Y","Aleutians East Borough",13,"Southwest Region",11,0,515,3,523,0,6,0,0
"02/15/2022","Y","Y","Aleutians East Borough",13,"Southwest Region",11,3,518,1,524,0,6,0,0
"02/17/2022","Y","Y","Aleutians East Borough",13,"Southwest Region",11,3,521,2,526,0,6,0,0
"02/18/2022","Y","Y","Aleutians East Borough",13,"Southwest Region",11,1,522,1,527,0,6,0,0
"02/19/2022","Y","Y","Aleutians East Borough",13,"Southwest Region",11,1,523,0,527,0,6,0,0
"02/20/2022","Y","Y","Aleutians East Borough",13,"Southwest Region",11,1,524,2,529,0,6,0,0
"02/21/2022","Y","Y","Aleutians East Borough",13,"Southwest Region",11,0,524,1,530,0,6,0,0
"02/22/2022","Y","Y","Aleutians East Borough",13,"Southwest Region",11,2,526,1,531,0,6,0,0
"02/23/2022","Y","Y","Aleutians East Borough",13,"Southwest Region",11,1,527,2,533,0,6,0,0
"02/24/2022","Y","Y","Aleutians East Borough",13,"Southwest Region",11,2,529,1,534,0,6,0,0
"02/25/2022","Y","Y","Aleutians East Borough",13,"Southwest Region",11,3,532,2,536,0,6,0,0
"02/26/2022","Y","Y","Aleutians East Borough",13,"Southwest Region",11,1,533,0,536,0,6,0,0
"02/27/2022","Y","Y","Aleutians East Borough",13,"Southwest Region",11,1,534,0,536,0,6,0,0
"02/28/2022","Y","Y","Aleutians East Borough",13,"Southwest Region",11,1,535,2,538,0,6,0,0
"03/01/2022","Y","Y","Aleutians East Borough",13,"Southwest Region",11,0,535,1,539,0,6,0,0
"03/02/2022","Y","Y","Aleutians East Borough",13,"Southwest Region",11,2,537,0,539,0,6,0,0
"03/03/2022","Y","Y","Aleutians East Borough",13,"Southwest Region",11,1,538,0,539,0,6,0,0
"03/04/2022","Y","Y","Aleutians East Borough",13,"Southwest Region",11,0,538,1,540,0,6,0,0
"03/06/2022","Y","Y","Aleutians East Borough",13,"Southwest Region",11,1,539,5,545,0,6,0,0
"03/07/2022","Y","Y","Aleutians East Borough",13,"Southwest Region",11,0,539,1,546,0,6,0,0
"03/08/2022","Y","Y","Aleutians East Borough",13,"Southwest Region",11,0,539,3,549,0,6,0,0
"03/09/2022","Y","Y","Aleutians East Borough",13,"Southwest Region",11,2,541,2,551,0,6,0,0
"03/10/2022","Y","Y","Aleutians East Borough",13,"Southwest Region",11,2,543,0,551,0,6,0,0
"03/11/2022","Y","Y","Aleutians East Borough",13,"Southwest Region",11,8,551,1,552,0,6,0,0
"03/13/2022","Y","Y","Aleutians East Borough",13,"Southwest Region",11,1,552,0,552,0,6,0,0
"03/14/2022","Y","Y","Aleutians East Borough",13,"Southwest Region",11,0,552,1,553,0,6,0,0
"03/15/2022","Y","Y","Aleutians East Borough",13,"Southwest Region",11,0,552,2,555,0,6,0,0
"03/16/2022","Y","Y","Aleutians East Borough",13,"Southwest Region",11,3,555,0,555,0,6,0,0
"03/17/2022","Y","Y","Aleutians East Borough",13,"Southwest Region",11,0,555,1,556,0,6,0,0
"03/23/2022","Y","Y","Aleutians East Borough",13,"Southwest Region",11,1,556,1,557,0,6,0,0
"03/24/2022","Y","Y","Aleutians East Borough",13,"Southwest Region",11,1,557,0,557,0,6,0,0
"03/29/2022","Y","Y","Aleutians East Borough",13,"Southwest Region",11,0,557,3,560,0,6,0,0
"03/30/2022","Y","Y","Aleutians East Borough",13,"Southwest Region",11,1,558,2,562,0,6,0,0
"03/31/2022","Y","Y","Aleutians East Borough",13,"Southwest Region",11,6,564,7,569,0,6,0,0
"04/01/2022","Y","Y","Aleutians East Borough",13,"Southwest Region",11,1,565,4,573,0,6,0,0
"04/02/2022","Y","Y","Aleutians East Borough",13,"Southwest Region",11,8,573,3,576,0,6,0,0
"04/03/2022","Y","Y","Aleutians East Borough",13,"Southwest Region",11,3,576,0,576,0,6,0,0
"04/04/2022","Y","Y","Aleutians East Borough",13,"Southwest Region",11,0,576,1,577,0,6,0,0
"04/06/2022","Y","Y","Aleutians East Borough",13,"Southwest Region",11,3,579,2,579,0,6,0,0
"04/08/2022","Y","Y","Aleutians East Borough",13,"Southwest Region",11,0,579,1,580,0,6,0,0
"04/10/2022","Y","Y","Aleutians East Borough",13,"Southwest Region",11,1,580,0,580,0,6,0,0
"04/11/2022","Y","Y","Aleutians East Borough",13,"Southwest Region",11,0,580,10,590,0,6,0,0
"04/12/2022","Y","Y","Aleutians East Borough",13,"Southwest Region",11,9,589,2,592,0,6,0,0
"04/13/2022","Y","Y","Aleutians East Borough",13,"Southwest Region",11,1,590,0,592,0,6,0,0
"04/14/2022","Y","Y","Aleutians East Borough",13,"Southwest Region",11,1,591,0,592,0,6,0,0
"04/15/2022","Y","Y","Aleutians East Borough",13,"Southwest Region",11,1,592,0,592,0,6,0,0
"04/17/2022","Y","Y","Aleutians East Borough",13,"Southwest Region",11,1,593,1,593,0,6,0,0
"04/18/2022","Y","Y","Aleutians East Borough",13,"Southwest Region",11,0,593,3,596,0,6,0,0
"04/19/2022","Y","Y","Aleutians East Borough",13,"Southwest Region",11,1,594,1,597,0,6,0,0
"04/20/2022","Y","Y","Aleutians East Borough",13,"Southwest Region",11,3,597,0,597,0,6,0,0
"04/21/2022","Y","Y","Aleutians East Borough",13,"Southwest Region",11,2,599,2,599,0,6,0,0
"04/23/2022","Y","Y","Aleutians East Borough",13,"Southwest Region",11,1,600,1,600,0,6,0,0
"04/26/2022","Y","Y","Aleutians East Borough",13,"Southwest Region",11,4,604,4,604,0,6,0,0
"07/04/2020","Y","Y","Aleutians West Census Area",16,"Southwest Region",11,0,0,1,1,0,0,0,0
"07/07/2020","Y","Y","Aleutians West Census Area",16,"Southwest Region",11,1,1,0,1,0,0,0,0
"07/26/2020","Y","Y","Aleutians West Census Area",16,"Southwest Region",11,0,1,1,2,0,0,0,0
"07/29/2020","Y","Y","Aleutians West Census Area",16,"Southwest Region",11,1,2,0,2,0,0,0,0
"07/30/2020","Y","Y","Aleutians West Census Area",16,"Southwest Region",11,1,3,1,3,0,0,0,0
"08/10/2020","Y","Y","Aleutians West Census Area",16,"Southwest Region",11,0,3,1,4,0,0,0,0
"08/13/2020","Y","Y","Aleutians West Census Area",16,"Southwest Region",11,1,4,0,4,0,0,0,0
"09/20/2020","Y","Y","Aleutians West Census Area",16,"Southwest Region",11,0,4,1,5,0,0,0,0
"09/21/2020","Y","Y","Aleutians West Census Area",16,"Southwest Region",11,1,5,0,5,0,0,0,0
"10/25/2020","Y","Y","Aleutians West Census Area",16,"Southwest Region",11,0,5,1,6,0,0,0,0
"10/26/2020","Y","Y","Aleutians West Census Area",16,"Southwest Region",11,0,5,2,8,0,0,0,0
"10/27/2020","Y","Y","Aleutians West Census Area",16,"Southwest Region",11,1,6,0,8,0,0,0,0
"10/28/2020","Y","Y","Aleutians West Census Area",16,"Southwest Region",11,1,7,0,8,0,0,0,0
"10/30/2020","Y","Y","Aleutians West Census Area",16,"Southwest Region",11,0,7,1,9,0,0,0,0
"10/31/2020","Y","Y","Aleutians West Census Area",16,"Southwest Region",11,1,8,0,9,0,0,0,0
"11/02/2020","Y","Y","Aleutians West Census Area",16,"Southwest Region",11,1,9,1,10,0,0,0,0
"11/04/2020","Y","Y","Aleutians West Census Area",16,"Southwest Region",11,1,10,0,10,0,0,0,0
"11/05/2020","Y","Y","Aleutians West Census Area",16,"Southwest Region",11,0,10,1,11,0,0,0,0
"11/06/2020","Y","Y","Aleutians West Census Area",16,"Southwest Region",11,1,11,0,11,0,0,0,0
"11/09/2020","Y","Y","Aleutians West Census Area",16,"Southwest Region",11,0,11,2,13,0,0,0,0
"11/10/2020","Y","Y","Aleutians West Census Area",16,"Southwest Region",11,1,12,1,14,0,0,0,0
"11/11/2020","Y","Y","Aleutians West Census Area",16,"Southwest Region",11,1,13,0,14,0,0,0,0
"11/16/2020","Y","Y","Aleutians West Census Area",16,"Southwest Region",11,1,14,0,14,0,0,0,0
"11/22/2020","Y","Y","Aleutians West Census Area",16,"Southwest Region",11,0,14,1,15,0,0,0,0
"11/23/2020","Y","Y","Aleutians West Census Area",16,"Southwest Region",11,1,15,1,16,0,0,0,0
"11/27/2020","Y","Y","Aleutians West Census Area",16,"Southwest Region",11,1,16,0,16,0,0,0,0
"11/30/2020","Y","Y","Aleutians West Census Area",16,"Southwest Region",11,0,16,1,17,0,0,0,0
"12/01/2020","Y","Y","Aleutians West Census Area",16,"Southwest Region",11,3,19,3,20,0,0,0,0
"12/05/2020","Y","Y","Aleutians West Census Area",16,"Southwest Region",11,1,20,0,20,0,0,0,0
"12/06/2020","Y","Y","Aleutians West Census Area",16,"Southwest Region",11,0,20,1,21,0,0,0,0
"12/07/2020","Y","Y","Aleutians West Census Area",16,"Southwest Region",11,1,21,1,22,0,0,0,0
"12/08/2020","Y","Y","Aleutians West Census Area",16,"Southwest Region",11,0,21,3,25,0,0,0,0
"12/09/2020","Y","Y","Aleutians West Census Area",16,"Southwest Region",11,1,22,4,29,0,0,0,0
"12/10/2020","Y","Y","Aleutians West Census Area",16,"Southwest Region",11,5,27,1,30,0,0,0,0
"12/11/2020","Y","Y","Aleutians West Census Area",16,"Southwest Region",11,1,28,0,30,0,0,0,0
"12/12/2020","Y","Y","Aleutians West Census Area",16,"Southwest Region",11,2,30,0,30,0,0,0,0
"12/14/2020","Y","Y","Aleutians West Census Area",16,"Southwest Region",11,0,30,1,31,0,0,0,0
"12/15/2020","Y","Y","Aleutians West Census Area",16,"Southwest Region",11,1,31,1,32,0,0,0,0
"12/16/2020","Y","Y","Aleutians West Census Area",16,"Southwest Region",11,1,32,1,33,0,0,0,0
"12/21/2020","Y","Y","Aleutians West Census Area",16,"Southwest Region",11,0,32,3,36,0,0,0,0
"12/22/2020","Y","Y","Aleutians West Census Area",16,"Southwest Region",11,3,35,3,39,0,0,0,0
"12/23/2020","Y","Y","Aleutians West Census Area",16,"Southwest Region",11,2,37,3,42,0,0,0,0
"12/24/2020","Y","Y","Aleutians West Census Area",16,"Southwest Region",11,2,39,1,43,0,0,0,0
"12/25/2020","Y","Y","Aleutians West Census Area",16,"Southwest Region",11,1,40,0,43,0,0,0,0
"12/26/2020","Y","Y","Aleutians West Census Area",16,"Southwest Region",11,2,42,0,43,0,0,0,0
"12/28/2020","Y","Y","Aleutians West Census Area",16,"Southwest Region",11,0,42,1,44,0,0,0,0
"12/29/2020","Y","Y","Aleutians West Census Area",16,"Southwest Region",11,1,43,2,46,0,0,0,0
"12/30/2020","Y","Y","Aleutians West Census Area",16,"Southwest Region",11,2,45,0,46,0,0,0,0
"01/04/2021","Y","Y","Aleutians West Census Area",16,"Southwest Region",11,2,47,4,50,0,0,0,0
"01/05/2021","Y","Y","Aleutians West Census Area",16,"Southwest Region",11,5,52,3,53,0,0,0,0
"01/06/2021","Y","Y","Aleutians West Census Area",16,"Southwest Region",11,1,53,3,56,0,0,0,0
"01/07/2021","Y","Y","Aleutians West Census Area",16,"Southwest Region",11,1,54,2,58,0,0,0,0
"01/08/2021","Y","Y","Aleutians West Census Area",16,"Southwest Region",11,2,56,4,62,0,0,0,0
"01/09/2021","Y","Y","Aleutians West Census Area",16,"Southwest Region",11,3,59,0,62,0,0,0,0
"01/10/2021","Y","Y","Aleutians West Census Area",16,"Southwest Region",11,2,61,0,62,0,0,0,0
"01/11/2021","Y","Y","Aleutians West Census Area",16,"Southwest Region",11,1,62,7,69,0,0,0,0
"01/12/2021","Y","Y","Aleutians West Census Area",16,"Southwest Region",11,3,65,4,73,0,0,0,0
"01/13/2021","Y","Y","Aleutians West Census Area",16,"Southwest Region",11,3,68,19,92,0,0,0,0
"01/14/2021","Y","Y","Aleutians West Census Area",16,"Southwest Region",11,2,70,2,94,0,0,0,0
"01/15/2021","Y","Y","Aleutians West Census Area",16,"Southwest Region",11,3,73,1,95,0,0,0,0
"01/16/2021","Y","Y","Aleutians West Census Area",16,"Southwest Region",11,19,92,2,97,0,0,0,0
"01/17/2021","Y","Y","Aleutians West Census Area",16,"Southwest Region",11,0,92,3,100,0,0,0,0
"01/18/2021","Y","Y","Aleutians West Census Area",16,"Southwest Region",11,2,94,1,101,0,0,0,0
"01/19/2021","Y","Y","Aleutians West Census Area",16,"Southwest Region",11,1,95,4,105,0,0,0,0
"01/20/2021","Y","Y","Aleutians West Census Area",16,"Southwest Region",11,4,99,3,108,0,0,0,0
"01/21/2021","Y","Y","Aleutians West Census Area",16,"Southwest Region",11,5,104,0,108,0,0,0,0
"01/22/2021","Y","Y","Aleutians West Census Area",16,"Southwest Region",11,2,106,0,108,0,0,0,0
"01/25/2021","Y","Y","Aleutians West Census Area",16,"Southwest Region",11,0,106,2,110,0,0,0,0
"01/26/2021","Y","Y","Aleutians West Census Area",16,"Southwest Region",11,2,108,2,112,0,0,0,0
"01/27/2021","Y","Y","Aleutians West Census Area",16,"Southwest Region",11,4,112,2,114,0,0,0,0
"01/28/2021","Y","Y","Aleutians West Census Area",16,"Southwest Region",11,2,114,0,114,0,0,0,0
"01/29/2021","Y","Y","Aleutians West Census Area",16,"Southwest Region",11,0,114,3,117,0,0,0,0
"01/30/2021","Y","Y","Aleutians West Census Area",16,"Southwest Region",11,3,117,0,117,0,0,0,0
"02/01/2021","Y","Y","Aleutians West Census Area",16,"Southwest Region",11,1,118,3,120,0,0,0,0
"02/02/2021","Y","Y","Aleutians West Census Area",16,"Southwest Region",11,2,120,1,121,0,0,0,0
"02/03/2021","Y","Y","Aleutians West Census Area",16,"Southwest Region",11,1,121,0,121,0,0,0,0
"02/06/2021","Y","Y","Aleutians West Census Area",16,"Southwest Region",11,0,121,1,122,0,0,0,0
"02/08/2021","Y","Y","Aleutians West Census Area",16,"Southwest Region",11,1,122,2,124,0,0,0,0
"02/09/2021","Y","Y","Aleutians West Census Area",16,"Southwest Region",11,3,125,10,134,0,0,0,0
"02/10/2021","Y","Y","Aleutians West Census Area",16,"Southwest Region",11,0,125,1,135,0,0,0,0
"02/11/2021","Y","Y","Aleutians West Census Area",16,"Southwest Region",11,4,129,21,156,0,0,0,0
"02/12/2021","Y","Y","Aleutians West Census Area",16,"Southwest Region",11,11,140,4,160,0,0,0,0
"02/13/2021","Y","Y","Aleutians West Census Area",16,"Southwest Region",11,6,146,0,160,0,0,0,0
"02/14/2021","Y","Y","Aleutians West Census Area",16,"Southwest Region",11,12,158,0,160,0,0,0,0
"02/15/2021","Y","Y","Aleutians West Census Area",16,"Southwest Region",11,1,159,0,160,0,0,0,0
"02/16/2021","Y","Y","Aleutians West Census Area",16,"Southwest Region",11,0,159,1,161,0,0,0,0
"02/18/2021","Y","Y","Aleutians West Census Area",16,"Southwest Region",11,2,161,1,162,0,0,0,0
"02/19/2021","Y","Y","Aleutians West Census Area",16,"Southwest Region",11,0,161,2,164,0,0,0,0
"02/20/2021","Y","Y","Aleutians West Census Area",16,"Southwest Region",11,0,161,2,166,0,0,0,0
"02/22/2021","Y","Y","Aleutians West Census Area",16,"Southwest Region",11,1,162,0,166,0,0,0,0
"02/24/2021","Y","Y","Aleutians West Census Area",16,"Southwest Region",11,2,164,1,167,0,0,0,0
"02/26/2021","Y","Y","Aleutians West Census Area",16,"Southwest Region",11,2,166,0,167,0,0,0,0
"03/01/2021","Y","Y","Aleutians West Census Area",16,"Southwest Region",11,0,166,1,168,0,0,0,0
"03/03/2021","Y","Y","Aleutians West Census Area",16,"Southwest Region",11,2,168,0,168,0,0,0,0
"03/04/2021","Y","Y","Aleutians West Census Area",16,"Southwest Region",11,0,168,3,171,0,0,0,0
"03/05/2021","Y","Y","Aleutians West Census Area",16,"Southwest Region",11,0,168,1,172,0,0,0,0
"03/06/2021","Y","Y","Aleutians West Census Area",16,"Southwest Region",11,0,168,1,173,0,0,0,0
"03/07/2021","Y","Y","Aleutians West Census Area",16,"Southwest Region",11,2,170,0,173,0,0,0,0
"03/09/2021","Y","Y","Aleutians West Census Area",16,"Southwest Region",11,3,173,0,173,0,0,0,0
"03/13/2021","Y","Y","Aleutians West Census Area",16,"Southwest Region",11,0,173,1,174,0,0,0,0
"03/15/2021","Y","Y","Aleutians West Census Area",16,"Southwest Region",11,1,174,0,174,0,0,0,0
"03/17/2021","Y","Y","Aleutians West Census Area",16,"Southwest Region",11,0,174,1,175,0,0,0,0
"03/19/2021","Y","Y","Aleutians West Census Area",16,"Southwest Region",11,1,175,0,175,0,0,0,0
"03/20/2021","Y","Y","Aleutians West Census Area",16,"Southwest Region",11,0,175,1,176,0,0,0,0
"03/22/2021","Y","Y","Aleutians West Census Area",16,"Southwest Region",11,0,175,1,177,0,0,0,0
"03/23/2021","Y","Y","Aleutians West Census Area",16,"Southwest Region",11,1,176,0,177,0,0,0,0
"03/29/2021","Y","Y","Aleutians West Census Area",16,"Southwest Region",11,1,177,1,178,0,0,0,0
"03/31/2021","Y","Y","Aleutians West Census Area",16,"Southwest Region",11,1,178,0,178,0,0,0,0
"04/05/2021","Y","Y","Aleutians West Census Area",16,"Southwest Region",11,0,178,1,179,0,0,0,0
"04/06/2021","Y","Y","Aleutians West Census Area",16,"Southwest Region",11,1,179,0,179,0,0,0,0
"04/07/2021","Y","Y","Aleutians West Census Area",16,"Southwest Region",11,0,179,2,181,0,0,0,0
"04/08/2021","Y","Y","Aleutians West Census Area",16,"Southwest Region",11,1,180,0,181,0,0,0,0
"04/09/2021","Y","Y","Aleutians West Census Area",16,"Southwest Region",11,1,181,0,181,0,0,0,0
"04/11/2021","Y","Y","Aleutians West Census Area",16,"Southwest Region",11,0,181,1,182,0,0,0,0
"04/12/2021","Y","Y","Aleutians West Census Area",16,"Southwest Region",11,1,182,0,182,0,0,0,0
"04/20/2021","Y","Y","Aleutians West Census Area",16,"Southwest Region",11,0,182,1,183,0,0,0,0
"04/22/2021","Y","Y","Aleutians West Census Area",16,"Southwest Region",11,1,183,0,183,0,0,0,0
"04/26/2021","Y","Y","Aleutians West Census Area",16,"Southwest Region",11,0,183,1,184,0,0,0,0
"04/28/2021","Y","Y","Aleutians West Census Area",16,"Southwest Region",11,1,184,0,184,0,0,0,0
"04/30/2021","Y","Y","Aleutians West Census Area",16,"Southwest Region",11,0,184,1,185,0,0,0,0
"05/03/2021","Y","Y","Aleutians West Census Area",16,"Southwest Region",11,1,185,0,185,0,0,0,0
"05/06/2021","Y","Y","Aleutians West Census Area",16,"Southwest Region",11,0,185,1,186,0,0,0,0
"05/09/2021","Y","Y","Aleutians West Census Area",16,"Southwest Region",11,0,185,1,187,0,0,0,0
"05/10/2021","Y","Y","Aleutians West Census Area",16,"Southwest Region",11,1,186,0,187,0,0,0,0
"05/12/2021","Y","Y","Aleutians West Census Area",16,"Southwest Region",11,1,187,0,187,0,0,0,0
"05/18/2021","Y","Y","Aleutians West Census Area",16,"Southwest Region",11,0,187,1,188,0,0,0,0
"05/19/2021","Y","Y","Aleutians West Census Area",16,"Southwest Region",11,0,187,1,189,0,0,0,0
"05/20/2021","Y","Y","Aleutians West Census Area",16,"Southwest Region",11,1,188,1,190,0,0,0,0
"05/24/2021","Y","Y","Aleutians West Census Area",16,"Southwest Region",11,1,189,0,190,0,0,0,0
"05/26/2021","Y","Y","Aleutians West Census Area",16,"Southwest Region",11,1,190,1,191,0,0,0,0
"05/27/2021","Y","Y","Aleutians West Census Area",16,"Southwest Region",11,1,191,0,191,0,0,0,0
"06/01/2021","Y","Y","Aleutians West Census Area",16,"Southwest Region",11,0,191,1,192,0,0,0,0
"06/02/2021","Y","Y","Aleutians West Census Area",16,"Southwest Region",11,0,191,1,193,0,0,0,0
"06/03/2021","Y","Y","Aleutians West Census Area",16,"Southwest Region",11,2,193,0,193,0,0,0,0
"06/14/2021","Y","Y","Aleutians West Census Area",16,"Southwest Region",11,0,193,4,197,0,0,0,0
"06/16/2021","Y","Y","Aleutians West Census Area",16,"Southwest Region",11,4,197,1,198,0,0,0,0
"06/18/2021","Y","Y","Aleutians West Census Area",16,"Southwest Region",11,0,197,4,202,1,1,0,0
"06/19/2021","Y","Y","Aleutians West Census Area",16,"Southwest Region",11,1,198,0,202,0,1,0,0
"06/21/2021","Y","Y","Aleutians West Census Area",16,"Southwest Region",11,4,202,0,202,0,1,0,0
"06/22/2021","Y","Y","Aleutians West Census Area",16,"Southwest Region",11,0,202,1,203,0,1,0,0
"06/26/2021","Y","Y","Aleutians West Census Area",16,"Southwest Region",11,1,203,0,203,0,1,0,0
"06/27/2021","Y","Y","Aleutians West Census Area",16,"Southwest Region",11,0,203,1,204,0,1,0,0
"06/30/2021","Y","Y","Aleutians West Census Area",16,"Southwest Region",11,1,204,0,204,0,1,0,0
"07/06/2021","Y","Y","Aleutians West Census Area",16,"Southwest Region",11,0,204,1,205,0,1,0,0
"07/07/2021","Y","Y","Aleutians West Census Area",16,"Southwest Region",11,1,205,0,205,0,1,0,0
"07/12/2021","Y","Y","Aleutians West Census Area",16,"Southwest Region",11,0,205,2,207,0,1,0,0
"07/13/2021","Y","Y","Aleutians West Census Area",16,"Southwest Region",11,2,207,2,209,0,1,0,0
"07/18/2021","Y","Y","Aleutians West Census Area",16,"Southwest Region",11,0,207,1,210,0,1,0,0
"07/20/2021","Y","Y","Aleutians West Census Area",16,"Southwest Region",11,3,210,1,211,0,1,0,0
"07/21/2021","Y","Y","Aleutians West Census Area",16,"Southwest Region",11,1,211,3,214,0,1,0,0
"07/22/2021","Y","Y","Aleutians West Census Area",16,"Southwest Region",11,3,214,6,220,0,1,0,0
"07/26/2021","Y","Y","Aleutians West Census Area",16,"Southwest Region",11,6,220,0,220,0,1,0,0
"07/27/2021","Y","Y","Aleutians West Census Area",16,"Southwest Region",11,0,220,3,223,0,1,0,0
"07/28/2021","Y","Y","Aleutians West Census Area",16,"Southwest Region",11,0,220,1,224,0,1,0,0
"07/29/2021","Y","Y","Aleutians West Census Area",16,"Southwest Region",11,4,224,0,224,0,1,0,0
"08/04/2021","Y","Y","Aleutians West Census Area",16,"Southwest Region",11,0,224,1,225,0,1,0,0
"08/05/2021","Y","Y","Aleutians West Census Area",16,"Southwest Region",11,1,225,1,226,0,1,0,0
"08/08/2021","Y","Y","Aleutians West Census Area",16,"Southwest Region",11,0,225,1,227,0,1,0,0
"08/10/2021","Y","Y","Aleutians West Census Area",16,"Southwest Region",11,1,226,0,227,0,1,0,0
"08/12/2021","Y","Y","Aleutians West Census Area",16,"Southwest Region",11,1,227,1,228,0,1,0,0
"08/13/2021","Y","Y","Aleutians West Census Area",16,"Southwest Region",11,0,227,1,229,0,1,0,0
"08/16/2021","Y","Y","Aleutians West Census Area",16,"Southwest Region",11,0,227,4,233,0,1,0,0
"08/17/2021","Y","Y","Aleutians West Census Area",16,"Southwest Region",11,1,228,2,235,1,2,0,0
"08/18/2021","Y","Y","Aleutians West Census Area",16,"Southwest Region",11,2,230,2,237,0,2,0,0
"08/19/2021","Y","Y","Aleutians West Census Area",16,"Southwest Region",11,5,235,2,239,0,2,0,0
"08/21/2021","Y","Y","Aleutians West Census Area",16,"Southwest Region",11,2,237,2,241,0,2,0,0
"08/22/2021","Y","Y","Aleutians West Census Area",16,"Southwest Region",11,1,238,1,242,0,2,0,0
"08/23/2021","Y","Y","Aleutians West Census Area",16,"Southwest Region",11,1,239,3,245,0,2,0,0
"08/24/2021","Y","Y","Aleutians West Census Area",16,"Southwest Region",11,2,241,3,248,0,2,0,0
"08/25/2021","Y","Y","Aleutians West Census Area",16,"Southwest Region",11,0,241,1,249,0,2,0,0
"08/26/2021","Y","Y","Aleutians West Census Area",16,"Southwest Region",11,3,244,5,254,0,2,0,0
"08/27/2021","Y","Y","Aleutians West Census Area",16,"Southwest Region",11,2,246,6,260,0,2,0,0
"08/28/2021","Y","Y","Aleutians West Census Area",16,"Southwest Region",11,0,246,2,262,0,2,0,0
"08/30/2021","Y","Y","Aleutians West Census Area",16,"Southwest Region",11,1,247,4,266,0,2,0,0
"08/31/2021","Y","Y","Aleutians West Census Area",16,"Southwest Region",11,5,252,1,267,0,2,0,0
"09/01/2021","Y","Y","Aleutians West Census Area",16,"Southwest Region",11,7,259,2,269,0,2,0,0
"09/02/2021","Y","Y","Aleutians West Census Area",16,"Southwest Region",11,3,262,2,271,0,2,0,0
"09/03/2021","Y","Y","Aleutians West Census Area",16,"Southwest Region",11,1,263,3,274,0,2,0,0
"09/04/2021","Y","Y","Aleutians West Census Area",16,"Southwest Region",11,3,266,0,274,0,2,0,0
"09/06/2021","Y","Y","Aleutians West Census Area",16,"Southwest Region",11,1,267,0,274,0,2,0,0
"09/07/2021","Y","Y","Aleutians West Census Area",16,"Southwest Region",11,1,268,0,274,0,2,0,0
"09/08/2021","Y","Y","Aleutians West Census Area",16,"Southwest Region",11,6,274,2,276,0,2,1,1
"09/09/2021","Y","Y","Aleutians West Census Area",16,"Southwest Region",11,0,274,2,278,0,2,0,1
"09/11/2021","Y","Y","Aleutians West Census Area",16,"Southwest Region",11,0,274,1,279,0,2,0,1
"09/12/2021","Y","Y","Aleutians West Census Area",16,"Southwest Region",11,0,274,1,280,0,2,0,1
"09/13/2021","Y","Y","Aleutians West Census Area",16,"Southwest Region",11,0,274,6,286,0,2,0,1
"09/14/2021","Y","Y","Aleutians West Census Area",16,"Southwest Region",11,0,274,3,289,0,2,0,1
"09/15/2021","Y","Y","Aleutians West Census Area",16,"Southwest Region",11,1,275,4,293,0,2,0,1
"09/16/2021","Y","Y","Aleutians West Census Area",16,"Southwest Region",11,1,276,2,295,0,2,0,1
"09/17/2021","Y","Y","Aleutians West Census Area",16,"Southwest Region",11,2,278,2,297,0,2,0,1
"09/18/2021","Y","Y","Aleutians West Census Area",16,"Southwest Region",11,2,280,7,304,0,2,0,1
"09/19/2021","Y","Y","Aleutians West Census Area",16,"Southwest Region",11,0,280,2,306,0,2,0,1
"09/20/2021","Y","Y","Aleutians West Census Area",16,"Southwest Region",11,3,283,3,309,0,2,0,1
"09/22/2021","Y","Y","Aleutians West Census Area",16,"Southwest Region",11,11,294,1,310,0,2,0,1
"09/23/2021","Y","Y","Aleutians West Census Area",16,"Southwest Region",11,0,294,3,313,0,2,0,1
"09/24/2021","Y","Y","Aleutians West Census Area",16,"Southwest Region",11,7,301,7,320,0,2,0,1
"09/25/2021","Y","Y","Aleutians West Census Area",16,"Southwest Region",11,1,302,1,321,0,2,0,1
"09/27/2021","Y","Y","Aleutians West Census Area",16,"Southwest Region",11,7,309,1,322,0,2,0,1
"09/28/2021","Y","Y","Aleutians West Census Area",16,"Southwest Region",11,3,312,1,323,0,2,0,1
"09/30/2021","Y","Y","Aleutians West Census Area",16,"Southwest Region",11,11,323,2,325,0,2,0,1
"10/01/2021","Y","Y","Aleutians West Census Area",16,"Southwest Region",11,0,323,1,326,0,2,0,1
"10/02/2021","Y","Y","Aleutians West Census Area",16,"Southwest Region",11,1,324,0,326,0,2,0,1
"10/04/2021","Y","Y","Aleutians West Census Area",16,"Southwest Region",11,1,325,1,327,0,2,0,1
"10/05/2021","Y","Y","Aleutians West Census Area",16,"Southwest Region",11,1,326,1,328,0,2,0,1
"10/06/2021","Y","Y","Aleutians West Census Area",16,"Southwest Region",11,1,327,0,328,0,2,0,1
"10/07/2021","Y","Y","Aleutians West Census Area",16,"Southwest Region",11,1,328,0,328,0,2,0,1
"10/09/2021","Y","Y","Aleutians West Census Area",16,"Southwest Region",11,0,328,2,330,0,2,0,1
"10/11/2021","Y","Y","Aleutians West Census Area",16,"Southwest Region",11,2,330,2,332,0,2,0,1
"10/12/2021","Y","Y","Aleutians West Census Area",16,"Southwest Region",11,0,330,2,334,0,2,0,1
"10/13/2021","Y","Y","Aleutians West Census Area",16,"Southwest Region",11,2,332,1,335,0,2,0,1
"10/14/2021","Y","Y","Aleutians West Census Area",16,"Southwest Region",11,0,332,3,338,0,2,0,1
"10/15/2021","Y","Y","Aleutians West Census Area",16,"Southwest Region",11,4,336,2,340,0,2,0,1
"10/16/2021","Y","Y","Aleutians West Census Area",16,"Southwest Region",11,1,337,0,340,0,2,0,1
"10/17/2021","Y","Y","Aleutians West Census Area",16,"Southwest Region",11,1,338,0,340,0,2,0,1
"10/20/2021","Y","Y","Aleutians West Census Area",16,"Southwest Region",11,2,340,1,341,0,2,0,1
"10/23/2021","Y","Y","Aleutians West Census Area",16,"Southwest Region",11,1,341,0,341,0,2,0,1
"10/30/2021","Y","Y","Aleutians West Census Area",16,"Southwest Region",11,0,341,2,343,0,2,0,1
"11/01/2021","Y","Y","Aleutians West Census Area",16,"Southwest Region",11,2,343,1,344,0,2,0,1
"11/03/2021","Y","Y","Aleutians West Census Area",16,"Southwest Region",11,1,344,0,344,0,2,0,1
"11/04/2021","Y","Y","Aleutians West Census Area",16,"Southwest Region",11,0,344,1,345,0,2,0,1
"11/05/2021","Y","Y","Aleutians West Census Area",16,"Southwest Region",11,1,345,0,345,0,2,0,1
"11/15/2021","Y","Y","Aleutians West Census Area",16,"Southwest Region",11,2,347,2,347,0,2,0,1
"11/20/2021","Y","Y","Aleutians West Census Area",16,"Southwest Region",11,0,347,3,350,0,2,0,1
"11/22/2021","Y","Y","Aleutians West Census Area",16,"Southwest Region",11,3,350,0,350,0,2,0,1
"11/24/2021","Y","Y","Aleutians West Census Area",16,"Southwest Region",11,0,350,1,351,0,2,0,1
"11/26/2021","Y","Y","Aleutians West Census Area",16,"Southwest Region",11,1,351,0,351,0,2,0,1
"12/04/2021","Y","Y","Aleutians West Census Area",16,"Southwest Region",11,0,351,1,352,0,2,0,1
"12/06/2021","Y","Y","Aleutians West Census Area",16,"Southwest Region",11,1,352,0,352,0,2,0,1
"12/07/2021","Y","Y","Aleutians West Census Area",16,"Southwest Region",11,0,352,1,353,0,2,0,1
"12/09/2021","Y","Y","Aleutians West Census Area",16,"Southwest Region",11,1,353,0,353,0,2,0,1
"12/23/2021","Y","Y","Aleutians West Census Area",16,"Southwest Region",11,0,353,1,354,0,2,0,1
"12/24/2021","Y","Y","Aleutians West Census Area",16,"Southwest Region",11,2,355,3,357,0,2,0,1
"12/26/2021","Y","Y","Aleutians West Census Area",16,"Southwest Region",11,2,357,1,358,0,2,0,1
"12/27/2021","Y","Y","Aleutians West Census Area",16,"Southwest Region",11,1,358,4,362,0,2,0,1
"12/28/2021","Y","Y","Aleutians West Census Area",16,"Southwest Region",11,1,359,3,365,0,2,0,1
"12/29/2021","Y","Y","Aleutians West Census Area",16,"Southwest Region",11,2,361,3,368,0,2,0,1
"12/30/2021","Y","Y","Aleutians West Census Area",16,"Southwest Region",11,4,365,1,369,0,2,0,1
"01/01/2022","Y","Y","Aleutians West Census Area",16,"Southwest Region",11,0,365,1,370,0,2,0,1
"01/02/2022","Y","Y","Aleutians West Census Area",16,"Southwest Region",11,4,369,2,372,0,2,0,1
"01/03/2022","Y","Y","Aleutians West Census Area",16,"Southwest Region",11,5,374,18,390,0,2,0,1
"01/04/2022","Y","Y","Aleutians West Census Area",16,"Southwest Region",11,10,384,21,411,0,2,0,1
"01/05/2022","Y","Y","Aleutians West Census Area",16,"Southwest Region",11,14,398,16,427,0,2,0,1
"01/06/2022","Y","Y","Aleutians West Census Area",16,"Southwest Region",11,23,421,19,446,0,2,0,1
"01/07/2022","Y","Y","Aleutians West Census Area",16,"Southwest Region",11,15,436,25,471,0,2,0,1
"01/08/2022","Y","Y","Aleutians West Census Area",16,"Southwest Region",11,3,439,5,476,0,2,0,1
"01/09/2022","Y","Y","Aleutians West Census Area",16,"Southwest Region",11,2,441,8,484,0,2,0,1
"01/10/2022","Y","Y","Aleutians West Census Area",16,"Southwest Region",11,4,445,37,521,0,2,0,1
"01/11/2022","Y","Y","Aleutians West Census Area",16,"Southwest Region",11,20,465,45,566,0,2,0,1
"01/12/2022","Y","Y","Aleutians West Census Area",16,"Southwest Region",11,80,545,56,622,0,2,0,1
"01/13/2022","Y","Y","Aleutians West Census Area",16,"Southwest Region",11,9,554,19,641,0,2,0,1
"01/14/2022","Y","Y","Aleutians West Census Area",16,"Southwest Region",11,63,617,33,674,0,2,0,1
"01/15/2022","Y","Y","Aleutians West Census Area",16,"Southwest Region",11,3,620,13,687,0,2,0,1
"01/16/2022","Y","Y","Aleutians West Census Area",16,"Southwest Region",11,3,623,4,691,0,2,0,1
"01/17/2022","Y","Y","Aleutians West Census Area",16,"Southwest Region",11,1,624,14,705,0,2,0,1
"01/18/2022","Y","Y","Aleutians West Census Area",16,"Southwest Region",11,44,668,18,723,0,2,0,1
"01/19/2022","Y","Y","Aleutians West Census Area",16,"Southwest Region",11,40,708,22,745,0,2,0,1
"01/20/2022","Y","Y","Aleutians West Census Area",16,"Southwest Region",11,9,717,12,757,0,2,0,1
"01/21/2022","Y","Y","Aleutians West Census Area",16,"Southwest Region",11,0,717,4,761,0,2,0,1
"01/22/2022","Y","Y","Aleutians West Census Area",16,"Southwest Region",11,29,746,9,770,0,2,0,1
"01/23/2022","Y","Y","Aleutians West Census Area",16,"Southwest Region",11,0,746,1,771,0,2,0,1
"01/24/2022","Y","Y","Aleutians West Census Area",16,"Southwest Region",11,12,758,15,786,0,2,0,1
"01/25/2022","Y","Y","Aleutians West Census Area",16,"Southwest Region",11,5,763,6,792,0,2,0,1
"01/26/2022","Y","Y","Aleutians West Census Area",16,"Southwest Region",11,6,769,3,795,0,2,0,1
"01/27/2022","Y","Y","Aleutians West Census Area",16,"Southwest Region",11,22,791,15,810,0,2,0,1
"01/28/2022","Y","Y","Aleutians West Census Area",16,"Southwest Region",11,0,791,3,813,0,2,0,1
"01/29/2022","Y","Y","Aleutians West Census Area",16,"Southwest Region",11,2,793,1,814,0,2,0,1
"01/30/2022","Y","Y","Aleutians West Census Area",16,"Southwest Region",11,0,793,2,816,0,2,0,1
"01/31/2022","Y","Y","Aleutians West Census Area",16,"Southwest Region",11,15,808,3,819,0,2,0,1
"02/01/2022","Y","Y","Aleutians West Census Area",16,"Southwest Region",11,1,809,3,822,0,2,0,1
"02/02/2022","Y","Y","Aleutians West Census Area",16,"Southwest Region",11,6,815,1,823,0,2,0,1
"02/03/2022","Y","Y","Aleutians West Census Area",16,"Southwest Region",11,3,818,6,829,0,2,0,1
"02/04/2022","Y","Y","Aleutians West Census Area",16,"Southwest Region",11,9,827,1,830,0,2,0,1
"02/05/2022","Y","Y","Aleutians West Census Area",16,"Southwest Region",11,3,830,0,830,0,2,0,1
"02/06/2022","Y","Y","Aleutians West Census Area",16,"Southwest Region",11,2,832,2,832,0,2,0,1
"02/07/2022","Y","Y","Aleutians West Census Area",16,"Southwest Region",11,4,836,8,840,0,2,0,1
"02/08/2022","Y","Y","Aleutians West Census Area",16,"Southwest Region",11,3,839,0,840,0,2,0,1
"02/09/2022","Y","Y","Aleutians West Census Area",16,"Southwest Region",11,3,842,2,842,0,2,0,1
"02/10/2022","Y","Y","Aleutians West Census Area",16,"Southwest Region",11,1,843,1,843,0,2,0,1
"02/11/2022","Y","Y","Aleutians West Census Area",16,"Southwest Region",11,1,844,2,845,0,2,0,1
"02/12/2022","Y","Y","Aleutians West Census Area",16,"Southwest Region",11,0,844,1,846,0,2,0,1
"02/13/2022","Y","Y","Aleutians West Census Area",16,"Southwest Region",11,1,845,0,846,0,2,0,1
"02/14/2022","Y","Y","Aleutians West Census Area",16,"Southwest Region",11,1,846,0,846,0,2,0,1
"02/17/2022","Y","Y","Aleutians West Census Area",16,"Southwest Region",11,0,846,1,847,0,2,0,1
"02/19/2022","Y","Y","Aleutians West Census Area",16,"Southwest Region",11,1,847,1,848,0,2,0,1
"02/21/2022","Y","Y","Aleutians West Census Area",16,"Southwest Region",11,1,848,0,848,0,2,0,1
"02/22/2022","Y","Y","Aleutians West Census Area",16,"Southwest Region",11,1,849,1,849,0,2,0,1
"02/25/2022","Y","Y","Aleutians West Census Area",16,"Southwest Region",11,0,849,1,850,0,2,0,1
"02/26/2022","Y","Y","Aleutians West Census Area",16,"Southwest Region",11,0,849,1,851,0,2,0,1
"02/27/2022","Y","Y","Aleutians West Census Area",16,"Southwest Region",11,2,851,0,851,0,2,0,1
"03/13/2022","Y","Y","Aleutians West Census Area",16,"Southwest Region",11,1,852,1,852,0,2,0,1
"03/14/2022","Y","Y","Aleutians West Census Area",16,"Southwest Region",11,0,852,2,854,0,2,0,1
"03/16/2022","Y","Y","Aleutians West Census Area",16,"Southwest Region",11,1,853,0,854,0,2,0,1
"03/17/2022","Y","Y","Aleutians West Census Area",16,"Southwest Region",11,1,854,0,854,0,2,0,1
"03/22/2022","Y","Y","Aleutians West Census Area",16,"Southwest Region",11,1,855,1,855,0,2,0,1
"03/26/2022","Y","Y","Aleutians West Census Area",16,"Southwest Region",11,1,856,1,856,0,2,0,1
"04/04/2022","Y","Y","Aleutians West Census Area",16,"Southwest Region",11,0,856,1,857,0,2,0,1
"04/05/2022","Y","Y","Aleutians West Census Area",16,"Southwest Region",11,1,857,0,857,0,2,0,1
"04/06/2022","Y","Y","Aleutians West Census Area",16,"Southwest Region",11,0,857,1,858,0,2,0,1
"04/07/2022","Y","Y","Aleutians West Census Area",16,"Southwest Region",11,2,859,1,859,0,2,0,1
"04/13/2022","Y","Y","Aleutians West Census Area",16,"Southwest Region",11,0,859,1,860,0,2,0,1
"04/15/2022","Y","Y","Aleutians West Census Area",16,"Southwest Region",11,1,860,0,860,0,2,0,1
"04/16/2022","Y","Y","Aleutians West Census Area",16,"Southwest Region",11,0,860,1,861,0,2,0,1
"04/18/2022","Y","Y","Aleutians West Census Area",16,"Southwest Region",11,1,861,0,861,0,2,0,1
"03/03/2020","Y","Y","Anchorage Municipality",20,"Anchorage Municipality",1,0,0,2,2,0,0,0,0
"03/04/2020","Y","Y","Anchorage Municipality",20,"Anchorage Municipality",1,0,0,1,3,0,0,0,0
"03/07/2020","Y","Y","Anchorage Municipality",20,"Anchorage Municipality",1,0,0,1,4,0,0,0,0
"03/10/2020","Y","Y","Anchorage Municipality",20,"Anchorage Municipality",1,0,0,4,8,0,0,0,0
"03/11/2020","Y","Y","Anchorage Municipality",20,"Anchorage Municipality",1,0,0,1,9,0,0,0,0
"03/12/2020","Y","Y","Anchorage Municipality",20,"Anchorage Municipality",1,0,0,3,12,0,0,0,0
"03/14/2020","Y","Y","Anchorage Municipality",20,"Anchorage Municipality",1,0,0,4,16,0,0,0,0
"03/15/2020","Y","Y","Anchorage Municipality",20,"Anchorage Municipality",1,0,0,5,21,0,0,0,0
"03/16/2020","Y","Y","Anchorage Municipality",20,"Anchorage Municipality",1,0,0,2,23,0,0,0,0
"03/17/2020","Y","Y","Anchorage Municipality",20,"Anchorage Municipality",1,2,2,8,31,0,0,0,0
"03/18/2020","Y","Y","Anchorage Municipality",20,"Anchorage Municipality",1,2,4,5,36,0,0,0,0
"03/19/2020","Y","Y","Anchorage Municipality",20,"Anchorage Municipality",1,0,4,6,42,0,0,0,0
"03/20/2020","Y","Y","Anchorage Municipality",20,"Anchorage Municipality",1,0,4,7,49,0,0,0,0
"03/21/2020","Y","Y","Anchorage Municipality",20,"Anchorage Municipality",1,2,6,4,53,0,0,0,0
"03/22/2020","Y","Y","Anchorage Municipality",20,"Anchorage Municipality",1,9,15,8,61,0,0,0,0
"03/23/2020","Y","Y","Anchorage Municipality",20,"Anchorage Municipality",1,1,16,10,71,1,1,0,0
"03/24/2020","Y","Y","Anchorage Municipality",20,"Anchorage Municipality",1,4,20,5,76,0,1,0,0
"03/25/2020","Y","Y","Anchorage Municipality",20,"Anchorage Municipality",1,9,29,4,80,1,2,0,0
"03/26/2020","Y","Y","Anchorage Municipality",20,"Anchorage Municipality",1,5,34,6,86,0,2,0,0
"03/27/2020","Y","Y","Anchorage Municipality",20,"Anchorage Municipality",1,10,44,7,93,0,2,1,1
"03/28/2020","Y","Y","Anchorage Municipality",20,"Anchorage Municipality",1,14,58,2,95,0,2,1,2
"03/29/2020","Y","Y","Anchorage Municipality",20,"Anchorage Municipality",1,2,60,4,99,0,2,0,2
"03/30/2020","Y","Y","Anchorage Municipality",20,"Anchorage Municipality",1,2,62,8,107,0,2,0,2
"03/31/2020","Y","Y","Anchorage Municipality",20,"Anchorage Municipality",1,3,65,4,111,0,2,0,2
"04/01/2020","Y","Y","Anchorage Municipality",20,"Anchorage Municipality",1,2,67,4,115,0,2,0,2
"04/02/2020","Y","Y","Anchorage Municipality",20,"Anchorage Municipality",1,7,74,6,121,2,4,0,2
"04/03/2020","Y","Y","Anchorage Municipality",20,"Anchorage Municipality",1,7,81,3,124,3,7,0,2
"04/04/2020","Y","Y","Anchorage Municipality",20,"Anchorage Municipality",1,4,85,6,130,1,8,1,3
"04/05/2020","Y","Y","Anchorage Municipality",20,"Anchorage Municipality",1,3,88,3,133,2,10,0,3
"04/06/2020","Y","Y","Anchorage Municipality",20,"Anchorage Municipality",1,10,98,2,135,0,10,0,3
"04/07/2020","Y","Y","Anchorage Municipality",20,"Anchorage Municipality",1,5,103,6,141,0,10,1,4
"04/08/2020","Y","Y","Anchorage Municipality",20,"Anchorage Municipality",1,4,107,3,144,2,12,0,4
"04/09/2020","Y","Y","Anchorage Municipality",20,"Anchorage Municipality",1,3,110,3,147,0,12,0,4
"04/10/2020","Y","Y","Anchorage Municipality",20,"Anchorage Municipality",1,9,119,2,149,0,12,0,4
"04/11/2020","Y","Y","Anchorage Municipality",20,"Anchorage Municipality",1,6,125,1,150,0,12,0,4
"04/12/2020","Y","Y","Anchorage Municipality",20,"Anchorage Municipality",1,4,129,2,152,0,12,0,4
"04/13/2020","Y","Y","Anchorage Municipality",20,"Anchorage Municipality",1,5,134,2,154,2,14,0,4
"04/14/2020","Y","Y","Anchorage Municipality",20,"Anchorage Municipality",1,3,137,5,159,0,14,0,4
"04/15/2020","Y","Y","Anchorage Municipality",20,"Anchorage Municipality",1,4,141,3,162,0,14,0,4
"04/16/2020","Y","Y","Anchorage Municipality",20,"Anchorage Municipality",1,7,148,2,164,0,14,0,4
"04/17/2020","Y","Y","Anchorage Municipality",20,"Anchorage Municipality",1,1,149,3,167,0,14,0,4
"04/18/2020","Y","Y","Anchorage Municipality",20,"Anchorage Municipality",1,3,152,4,171,0,14,0,4
"04/19/2020","Y","Y","Anchorage Municipality",20,"Anchorage Municipality",1,1,153,4,175,0,14,0,4
"04/20/2020","Y","Y","Anchorage Municipality",20,"Anchorage Municipality",1,5,158,1,176,0,14,0,4
"04/21/2020","Y","Y","Anchorage Municipality",20,"Anchorage Municipality",1,4,162,0,176,0,14,0,4
"04/22/2020","Y","Y","Anchorage Municipality",20,"Anchorage Municipality",1,2,164,0,176,0,14,0,4
"04/23/2020","Y","Y","Anchorage Municipality",20,"Anchorage Municipality",1,2,166,1,177,0,14,0,4
"04/24/2020","Y","Y","Anchorage Municipality",20,"Anchorage Municipality",1,0,166,1,178,0,14,0,4
"04/25/2020","Y","Y","Anchorage Municipality",20,"Anchorage Municipality",1,0,166,1,179,1,15,0,4
"04/26/2020","Y","Y","Anchorage Municipality",20,"Anchorage Municipality",1,3,169,2,181,0,15,0,4
"04/27/2020","Y","Y","Anchorage Municipality",20,"Anchorage Municipality",1,4,173,1,182,0,15,0,4
"04/28/2020","Y","Y","Anchorage Municipality",20,"Anchorage Municipality",1,4,177,0,182,0,15,0,4
"04/30/2020","Y","Y","Anchorage Municipality",20,"Anchorage Municipality",1,5,182,2,184,0,15,0,4
"05/01/2020","Y","Y","Anchorage Municipality",20,"Anchorage Municipality",1,0,182,2,186,0,15,0,4
"05/02/2020","Y","Y","Anchorage Municipality",20,"Anchorage Municipality",1,2,184,1,187,0,15,0,4
"05/03/2020","Y","Y","Anchorage Municipality",20,"Anchorage Municipality",1,2,186,0,187,1,16,0,4
"05/04/2020","Y","Y","Anchorage Municipality",20,"Anchorage Municipality",1,1,187,0,187,0,16,0,4
"05/06/2020","Y","Y","Anchorage Municipality",20,"Anchorage Municipality",1,0,187,1,188,0,16,0,4
"05/07/2020","Y","Y","Anchorage Municipality",20,"Anchorage Municipality",1,2,189,1,189,0,16,0,4
"05/10/2020","Y","Y","Anchorage Municipality",20,"Anchorage Municipality",1,0,189,2,191,0,16,0,4
"05/11/2020","Y","Y","Anchorage Municipality",20,"Anchorage Municipality",1,0,189,1,192,1,17,0,4
"05/12/2020","Y","Y","Anchorage Municipality",20,"Anchorage Municipality",1,0,189,0,192,1,18,0,4
"05/13/2020","Y","Y","Anchorage Municipality",20,"Anchorage Municipality",1,2,191,2,194,1,19,0,4
"05/14/2020","Y","Y","Anchorage Municipality",20,"Anchorage Municipality",1,1,192,2,196,1,20,0,4
"05/15/2020","Y","Y","Anchorage Municipality",20,"Anchorage Municipality",1,2,194,1,197,0,20,0,4
"05/16/2020","Y","Y","Anchorage Municipality",20,"Anchorage Municipality",1,2,196,2,199,0,20,0,4
"05/17/2020","Y","Y","Anchorage Municipality",20,"Anchorage Municipality",1,2,198,0,199,0,20,0,4
"05/18/2020","Y","Y","Anchorage Municipality",20,"Anchorage Municipality",1,0,198,0,199,1,21,0,4
"05/19/2020","Y","Y","Anchorage Municipality",20,"Anchorage Municipality",1,1,199,0,199,0,21,0,4
"05/22/2020","Y","Y","Anchorage Municipality",20,"Anchorage Municipality",1,0,199,1,200,0,21,0,4
"05/24/2020","Y","Y","Anchorage Municipality",20,"Anchorage Municipality",1,0,199,3,203,0,21,0,4
"05/25/2020","Y","Y","Anchorage Municipality",20,"Anchorage Municipality",1,1,200,1,204,0,21,0,4
"05/26/2020","Y","Y","Anchorage Municipality",20,"Anchorage Municipality",1,0,200,4,208,0,21,0,4
"05/27/2020","Y","Y","Anchorage Municipality",20,"Anchorage Municipality",1,4,204,6,214,0,21,0,4
"05/28/2020","Y","Y","Anchorage Municipality",20,"Anchorage Municipality",1,2,206,3,217,0,21,0,4
"05/29/2020","Y","Y","Anchorage Municipality",20,"Anchorage Municipality",1,1,207,13,230,0,21,0,4
"05/30/2020","Y","Y","Anchorage Municipality",20,"Anchorage Municipality",1,15,222,8,238,1,22,0,4
"05/31/2020","Y","Y","Anchorage Municipality",20,"Anchorage Municipality",1,3,225,9,247,1,23,0,4
"06/01/2020","Y","Y","Anchorage Municipality",20,"Anchorage Municipality",1,15,240,15,262,0,23,0,4
"06/02/2020","Y","Y","Anchorage Municipality",20,"Anchorage Municipality",1,7,247,4,266,1,24,0,4
"06/03/2020","Y","Y","Anchorage Municipality",20,"Anchorage Municipality",1,4,251,3,269,0,24,0,4
"06/04/2020","Y","Y","Anchorage Municipality",20,"Anchorage Municipality",1,6,257,8,277,0,24,0,4
"06/05/2020","Y","Y","Anchorage Municipality",20,"Anchorage Municipality",1,2,259,12,289,0,24,0,4
"06/06/2020","Y","Y","Anchorage Municipality",20,"Anchorage Municipality",1,6,265,2,291,0,24,0,4
"06/07/2020","Y","Y","Anchorage Municipality",20,"Anchorage Municipality",1,10,275,5,296,0,24,1,5
"06/08/2020","Y","Y","Anchorage Municipality",20,"Anchorage Municipality",1,6,281,5,301,1,25,1,6
"06/09/2020","Y","Y","Anchorage Municipality",20,"Anchorage Municipality",1,9,290,10,311,1,26,0,6
"06/10/2020","Y","Y","Anchorage Municipality",20,"Anchorage Municipality",1,4,294,5,316,1,27,0,6
"06/11/2020","Y","Y","Anchorage Municipality",20,"Anchorage Municipality",1,6,300,3,319,0,27,1,7
"06/12/2020","Y","Y","Anchorage Municipality",20,"Anchorage Municipality",1,8,308,6,325,0,27,0,7
"06/13/2020","Y","Y","Anchorage Municipality",20,"Anchorage Municipality",1,3,311,5,330,1,28,0,7
"06/14/2020","Y","Y","Anchorage Municipality",20,"Anchorage Municipality",1,1,312,4,334,0,28,0,7
"06/15/2020","Y","Y","Anchorage Municipality",20,"Anchorage Municipality",1,6,318,6,340,0,28,0,7
"06/16/2020","Y","Y","Anchorage Municipality",20,"Anchorage Municipality",1,4,322,6,346,1,29,0,7
"06/17/2020","Y","Y","Anchorage Municipality",20,"Anchorage Municipality",1,2,324,6,352,0,29,0,7
"06/18/2020","Y","Y","Anchorage Municipality",20,"Anchorage Municipality",1,6,330,6,358,0,29,0,7
"06/19/2020","Y","Y","Anchorage Municipality",20,"Anchorage Municipality",1,8,338,8,366,0,29,0,7
"06/20/2020","Y","Y","Anchorage Municipality",20,"Anchorage Municipality",1,6,344,5,371,0,29,0,7
"06/21/2020","Y","Y","Anchorage Municipality",20,"Anchorage Municipality",1,3,347,6,377,1,30,0,7
"06/22/2020","Y","Y","Anchorage Municipality",20,"Anchorage Municipality",1,8,355,17,394,0,30,0,7
"06/23/2020","Y","Y","Anchorage Municipality",20,"Anchorage Municipality",1,8,363,16,410,0,30,0,7
"06/24/2020","Y","Y","Anchorage Municipality",20,"Anchorage Municipality",1,7,370,12,422,0,30,0,7
"06/25/2020","Y","Y","Anchorage Municipality",20,"Anchorage Municipality",1,6,376,17,439,0,30,0,7
"06/26/2020","Y","Y","Anchorage Municipality",20,"Anchorage Municipality",1,10,386,16,455,0,30,0,7
"06/27/2020","Y","Y","Anchorage Municipality",20,"Anchorage Municipality",1,15,401,23,478,0,30,0,7
"06/28/2020","Y","Y","Anchorage Municipality",20,"Anchorage Municipality",1,7,408,18,496,0,30,0,7
"06/29/2020","Y","Y","Anchorage Municipality",20,"Anchorage Municipality",1,22,430,17,513,0,30,0,7
"06/30/2020","Y","Y","Anchorage Municipality",20,"Anchorage Municipality",1,17,447,15,528,1,31,0,7
"07/01/2020","Y","Y","Anchorage Municipality",20,"Anchorage Municipality",1,15,462,28,556,1,32,0,7
"07/02/2020","Y","Y","Anchorage Municipality",20,"Anchorage Municipality",1,21,483,35,591,0,32,0,7
"07/03/2020","Y","Y","Anchorage Municipality",20,"Anchorage Municipality",1,31,514,28,619,3,35,1,8
"07/04/2020","Y","Y","Anchorage Municipality",20,"Anchorage Municipality",1,22,536,24,643,2,37,0,8
"07/05/2020","Y","Y","Anchorage Municipality",20,"Anchorage Municipality",1,19,555,26,669,3,40,0,8
"07/06/2020","Y","Y","Anchorage Municipality",20,"Anchorage Municipality",1,12,567,30,699,3,43,0,8
"07/07/2020","Y","Y","Anchorage Municipality",20,"Anchorage Municipality",1,19,586,24,723,3,46,0,8
"07/08/2020","Y","Y","Anchorage Municipality",20,"Anchorage Municipality",1,23,609,43,766,2,48,0,8
"07/09/2020","Y","Y","Anchorage Municipality",20,"Anchorage Municipality",1,23,632,32,798,1,49,0,8
"07/10/2020","Y","Y","Anchorage Municipality",20,"Anchorage Municipality",1,29,661,31,829,1,50,0,8
"07/11/2020","Y","Y","Anchorage Municipality",20,"Anchorage Municipality",1,33,694,22,851,0,50,0,8
"07/12/2020","Y","Y","Anchorage Municipality",20,"Anchorage Municipality",1,32,726,32,883,2,52,0,8
"07/13/2020","Y","Y","Anchorage Municipality",20,"Anchorage Municipality",1,18,744,30,913,1,53,0,8
"07/14/2020","Y","Y","Anchorage Municipality",20,"Anchorage Municipality",1,36,780,40,953,2,55,0,8
"07/15/2020","Y","Y","Anchorage Municipality",20,"Anchorage Municipality",1,22,802,31,984,1,56,0,8
"07/16/2020","Y","Y","Anchorage Municipality",20,"Anchorage Municipality",1,22,824,50,1034,0,56,1,9
"07/17/2020","Y","Y","Anchorage Municipality",20,"Anchorage Municipality",1,33,857,48,1082,1,57,0,9
"07/18/2020","Y","Y","Anchorage Municipality",20,"Anchorage Municipality",1,43,900,31,1113,2,59,0,9
"07/19/2020","Y","Y","Anchorage Municipality",20,"Anchorage Municipality",1,50,950,44,1157,3,62,0,9
"07/20/2020","Y","Y","Anchorage Municipality",20,"Anchorage Municipality",1,66,1016,68,1225,3,65,0,9
"07/21/2020","Y","Y","Anchorage Municipality",20,"Anchorage Municipality",1,43,1059,58,1283,1,66,1,10
"07/22/2020","Y","Y","Anchorage Municipality",20,"Anchorage Municipality",1,31,1090,58,1341,2,68,0,10
"07/23/2020","Y","Y","Anchorage Municipality",20,"Anchorage Municipality",1,33,1123,53,1394,2,70,1,11
"07/24/2020","Y","Y","Anchorage Municipality",20,"Anchorage Municipality",1,45,1168,49,1443,1,71,0,11
"07/25/2020","Y","Y","Anchorage Municipality",20,"Anchorage Municipality",1,158,1326,144,1587,2,73,0,11
"07/26/2020","Y","Y","Anchorage Municipality",20,"Anchorage Municipality",1,62,1388,49,1636,2,75,0,11
"07/27/2020","Y","Y","Anchorage Municipality",20,"Anchorage Municipality",1,78,1466,72,1708,2,77,0,11
"07/28/2020","Y","Y","Anchorage Municipality",20,"Anchorage Municipality",1,55,1521,69,1777,1,78,0,11
"07/29/2020","Y","Y","Anchorage Municipality",20,"Anchorage Municipality",1,41,1562,59,1836,0,78,1,12
"07/30/2020","Y","Y","Anchorage Municipality",20,"Anchorage Municipality",1,76,1638,45,1881,0,78,1,13
"07/31/2020","Y","Y","Anchorage Municipality",20,"Anchorage Municipality",1,105,1743,51,1932,2,80,1,14
"08/01/2020","Y","Y","Anchorage Municipality",20,"Anchorage Municipality",1,100,1843,32,1964,0,80,0,14
"08/02/2020","Y","Y","Anchorage Municipality",20,"Anchorage Municipality",1,40,1883,31,1995,2,82,2,16
"08/03/2020","Y","Y","Anchorage Municipality",20,"Anchorage Municipality",1,43,1926,46,2041,2,84,0,16
"08/04/2020","Y","Y","Anchorage Municipality",20,"Anchorage Municipality",1,39,1965,45,2086,1,85,0,16
"08/05/2020","Y","Y","Anchorage Municipality",20,"Anchorage Municipality",1,27,1992,41,2127,3,88,0,16
"08/06/2020","Y","Y","Anchorage Municipality",20,"Anchorage Municipality",1,31,2023,36,2163,3,91,0,16
"08/07/2020","Y","Y","Anchorage Municipality",20,"Anchorage Municipality",1,56,2079,37,2200,4,95,1,17
"08/08/2020","Y","Y","Anchorage Municipality",20,"Anchorage Municipality",1,61,2140,37,2237,1,96,0,17
"08/09/2020","Y","Y","Anchorage Municipality",20,"Anchorage Municipality",1,42,2182,28,2265,4,100,0,17
"08/10/2020","Y","Y","Anchorage Municipality",20,"Anchorage Municipality",1,27,2209,44,2309,3,103,2,19
"08/11/2020","Y","Y","Anchorage Municipality",20,"Anchorage Municipality",1,37,2246,57,2366,1,104,0,19
"08/12/2020","Y","Y","Anchorage Municipality",20,"Anchorage Municipality",1,33,2279,34,2400,2,106,1,20
"08/13/2020","Y","Y","Anchorage Municipality",20,"Anchorage Municipality",1,77,2356,48,2448,6,112,0,20
"08/14/2020","Y","Y","Anchorage Municipality",20,"Anchorage Municipality",1,34,2390,72,2520,2,114,0,20
"08/15/2020","Y","Y","Anchorage Municipality",20,"Anchorage Municipality",1,54,2444,20,2540,0,114,1,21
"08/16/2020","Y","Y","Anchorage Municipality",20,"Anchorage Municipality",1,36,2480,24,2564,5,119,0,21
"08/17/2020","Y","Y","Anchorage Municipality",20,"Anchorage Municipality",1,24,2504,35,2599,2,121,0,21
"08/18/2020","Y","Y","Anchorage Municipality",20,"Anchorage Municipality",1,37,2541,38,2637,1,122,0,21
"08/19/2020","Y","Y","Anchorage Municipality",20,"Anchorage Municipality",1,44,2585,54,2691,2,124,0,21
"08/20/2020","Y","Y","Anchorage Municipality",20,"Anchorage Municipality",1,30,2615,47,2738,1,125,0,21
"08/21/2020","Y","Y","Anchorage Municipality",20,"Anchorage Municipality",1,42,2657,42,2780,2,127,0,21
"08/22/2020","Y","Y","Anchorage Municipality",20,"Anchorage Municipality",1,30,2687,21,2801,3,130,2,23
"08/23/2020","Y","Y","Anchorage Municipality",20,"Anchorage Municipality",1,44,2731,33,2834,2,132,0,23
"08/24/2020","Y","Y","Anchorage Municipality",20,"Anchorage Municipality",1,16,2747,28,2862,1,133,0,23
"08/25/2020","Y","Y","Anchorage Municipality",20,"Anchorage Municipality",1,26,2773,34,2896,1,134,1,24
"08/26/2020","Y","Y","Anchorage Municipality",20,"Anchorage Municipality",1,44,2817,60,2956,0,134,1,25
"08/27/2020","Y","Y","Anchorage Municipality",20,"Anchorage Municipality",1,77,2894,46,3002,1,135,0,25
"08/28/2020","Y","Y","Anchorage Municipality",20,"Anchorage Municipality",1,63,2957,44,3046,0,135,1,26
"08/29/2020","Y","Y","Anchorage Municipality",20,"Anchorage Municipality",1,8,2965,14,3060,4,139,0,26
"08/30/2020","Y","Y","Anchorage Municipality",20,"Anchorage Municipality",1,28,2993,16,3076,0,139,1,27
"08/31/2020","Y","Y","Anchorage Municipality",20,"Anchorage Municipality",1,18,3011,39,3115,2,141,0,27
"09/01/2020","Y","Y","Anchorage Municipality",20,"Anchorage Municipality",1,32,3043,70,3185,0,141,1,28
"09/02/2020","Y","Y","Anchorage Municipality",20,"Anchorage Municipality",1,47,3090,52,3237,2,143,0,28
"09/03/2020","Y","Y","Anchorage Municipality",20,"Anchorage Municipality",1,81,3171,41,3278,0,143,0,28
"09/04/2020","Y","Y","Anchorage Municipality",20,"Anchorage Municipality",1,50,3221,29,3307,3,146,0,28
"09/05/2020","Y","Y","Anchorage Municipality",20,"Anchorage Municipality",1,42,3263,20,3327,4,150,0,28
"09/06/2020","Y","Y","Anchorage Municipality",20,"Anchorage Municipality",1,13,3276,16,3343,1,151,0,28
"09/07/2020","Y","Y","Anchorage Municipality",20,"Anchorage Municipality",1,17,3293,36,3379,1,152,0,28
"09/08/2020","Y","Y","Anchorage Municipality",20,"Anchorage Municipality",1,32,3325,41,3420,0,152,1,29
"09/09/2020","Y","Y","Anchorage Municipality",20,"Anchorage Municipality",1,57,3382,59,3479,1,153,1,30
"09/10/2020","Y","Y","Anchorage Municipality",20,"Anchorage Municipality",1,36,3418,63,3542,0,153,0,30
"09/11/2020","Y","Y","Anchorage Municipality",20,"Anchorage Municipality",1,63,3481,33,3575,3,156,0,30
"09/12/2020","Y","Y","Anchorage Municipality",20,"Anchorage Municipality",1,31,3512,34,3609,2,158,0,30
"09/13/2020","Y","Y","Anchorage Municipality",20,"Anchorage Municipality",1,48,3560,16,3625,1,159,0,30
"09/14/2020","Y","Y","Anchorage Municipality",20,"Anchorage Municipality",1,23,3583,51,3676,0,159,0,30
"09/15/2020","Y","Y","Anchorage Municipality",20,"Anchorage Municipality",1,21,3604,38,3714,1,160,1,31
"09/16/2020","Y","Y","Anchorage Municipality",20,"Anchorage Municipality",1,49,3653,62,3776,0,160,0,31
"09/17/2020","Y","Y","Anchorage Municipality",20,"Anchorage Municipality",1,70,3723,57,3833,2,162,0,31
"09/18/2020","Y","Y","Anchorage Municipality",20,"Anchorage Municipality",1,60,3783,56,3889,3,165,0,31
"09/19/2020","Y","Y","Anchorage Municipality",20,"Anchorage Municipality",1,49,3832,35,3924,3,168,0,31
"09/20/2020","Y","Y","Anchorage Municipality",20,"Anchorage Municipality",1,35,3867,44,3968,0,168,0,31
"09/21/2020","Y","Y","Anchorage Municipality",20,"Anchorage Municipality",1,40,3907,88,4056,4,172,0,31
"09/22/2020","Y","Y","Anchorage Municipality",20,"Anchorage Municipality",1,43,3950,65,4121,3,175,0,31
"09/23/2020","Y","Y","Anchorage Municipality",20,"Anchorage Municipality",1,73,4023,75,4196,1,176,0,31
"09/24/2020","Y","Y","Anchorage Municipality",20,"Anchorage Municipality",1,71,4094,61,4257,4,180,3,34
"09/25/2020","Y","Y","Anchorage Municipality",20,"Anchorage Municipality",1,71,4165,113,4370,1,181,1,35
"09/26/2020","Y","Y","Anchorage Municipality",20,"Anchorage Municipality",1,59,4224,52,4422,3,184,0,35
"09/27/2020","Y","Y","Anchorage Municipality",20,"Anchorage Municipality",1,83,4307,47,4469,0,184,0,35
"09/28/2020","Y","Y","Anchorage Municipality",20,"Anchorage Municipality",1,67,4374,107,4576,2,186,0,35
"09/29/2020","Y","Y","Anchorage Municipality",20,"Anchorage Municipality",1,60,4434,108,4684,1,187,1,36
"09/30/2020","Y","Y","Anchorage Municipality",20,"Anchorage Municipality",1,66,4500,94,4778,2,189,0,36
"10/01/2020","Y","Y","Anchorage Municipality",20,"Anchorage Municipality",1,62,4562,96,4874,0,189,0,36
"10/02/2020","Y","Y","Anchorage Municipality",20,"Anchorage Municipality",1,79,4641,93,4967,1,190,0,36
"10/03/2020","Y","Y","Anchorage Municipality",20,"Anchorage Municipality",1,78,4719,47,5014,1,191,0,36
"10/04/2020","Y","Y","Anchorage Municipality",20,"Anchorage Municipality",1,117,4836,51,5065,2,193,1,37
"10/05/2020","Y","Y","Anchorage Municipality",20,"Anchorage Municipality",1,70,4906,119,5184,3,196,1,38
"10/06/2020","Y","Y","Anchorage Municipality",20,"Anchorage Municipality",1,60,4966,138,5322,1,197,1,39
"10/07/2020","Y","Y","Anchorage Municipality",20,"Anchorage Municipality",1,59,5025,123,5445,1,198,0,39
"10/08/2020","Y","Y","Anchorage Municipality",20,"Anchorage Municipality",1,96,5121,112,5557,2,200,1,40
"10/09/2020","Y","Y","Anchorage Municipality",20,"Anchorage Municipality",1,142,5263,112,5669,1,201,0,40
"10/10/2020","Y","Y","Anchorage Municipality",20,"Anchorage Municipality",1,131,5394,79,5748,3,204,1,41
"10/11/2020","Y","Y","Anchorage Municipality",20,"Anchorage Municipality",1,107,5501,54,5802,0,204,0,41
"10/12/2020","Y","Y","Anchorage Municipality",20,"Anchorage Municipality",1,71,5572,137,5939,6,210,1,42
"10/13/2020","Y","Y","Anchorage Municipality",20,"Anchorage Municipality",1,106,5678,102,6041,4,214,1,43
"10/14/2020","Y","Y","Anchorage Municipality",20,"Anchorage Municipality",1,80,5758,175,6216,4,218,0,43
"10/15/2020","Y","Y","Anchorage Municipality",20,"Anchorage Municipality",1,110,5868,130,6346,4,222,0,43
"10/16/2020","Y","Y","Anchorage Municipality",20,"Anchorage Municipality",1,104,5972,175,6521,3,225,1,44
"10/17/2020","Y","Y","Anchorage Municipality",20,"Anchorage Municipality",1,95,6067,101,6622,0,225,1,45
"10/18/2020","Y","Y","Anchorage Municipality",20,"Anchorage Municipality",1,93,6160,66,6688,4,229,0,45
"10/19/2020","Y","Y","Anchorage Municipality",20,"Anchorage Municipality",1,120,6280,188,6876,3,232,1,46
"10/20/2020","Y","Y","Anchorage Municipality",20,"Anchorage Municipality",1,148,6428,157,7033,9,241,2,48
"10/21/2020","Y","Y","Anchorage Municipality",20,"Anchorage Municipality",1,58,6486,156,7189,3,244,0,48
"10/22/2020","Y","Y","Anchorage Municipality",20,"Anchorage Municipality",1,149,6635,169,7358,0,244,0,48
"10/23/2020","Y","Y","Anchorage Municipality",20,"Anchorage Municipality",1,187,6822,193,7551,6,250,0,48
"10/24/2020","Y","Y","Anchorage Municipality",20,"Anchorage Municipality",1,209,7031,132,7683,2,252,0,48
"10/25/2020","Y","Y","Anchorage Municipality",20,"Anchorage Municipality",1,156,7187,120,7803,5,257,1,49
"10/26/2020","Y","Y","Anchorage Municipality",20,"Anchorage Municipality",1,166,7353,270,8073,7,264,0,49
"10/27/2020","Y","Y","Anchorage Municipality",20,"Anchorage Municipality",1,180,7533,222,8295,4,268,2,51
"10/28/2020","Y","Y","Anchorage Municipality",20,"Anchorage Municipality",1,165,7698,312,8607,3,271,0,51
"10/29/2020","Y","Y","Anchorage Municipality",20,"Anchorage Municipality",1,214,7912,233,8840,4,275,1,52
"10/30/2020","Y","Y","Anchorage Municipality",20,"Anchorage Municipality",1,253,8165,271,9111,3,278,1,53
"10/31/2020","Y","Y","Anchorage Municipality",20,"Anchorage Municipality",1,161,8326,160,9271,3,281,0,53
"11/01/2020","Y","Y","Anchorage Municipality",20,"Anchorage Municipality",1,181,8507,119,9390,5,286,0,53
"11/02/2020","Y","Y","Anchorage Municipality",20,"Anchorage Municipality",1,202,8709,374,9764,4,290,1,54
"11/03/2020","Y","Y","Anchorage Municipality",20,"Anchorage Municipality",1,169,8878,293,10057,4,294,0,54
"11/04/2020","Y","Y","Anchorage Municipality",20,"Anchorage Municipality",1,174,9052,326,10383,5,299,0,54
"11/05/2020","Y","Y","Anchorage Municipality",20,"Anchorage Municipality",1,320,9372,306,10689,7,306,1,55
"11/06/2020","Y","Y","Anchorage Municipality",20,"Anchorage Municipality",1,341,9713,421,11110,3,309,2,57
"11/07/2020","Y","Y","Anchorage Municipality",20,"Anchorage Municipality",1,285,9998,394,11504,2,311,1,58
"11/08/2020","Y","Y","Anchorage Municipality",20,"Anchorage Municipality",1,228,10226,162,11666,7,318,2,60
"11/09/2020","Y","Y","Anchorage Municipality",20,"Anchorage Municipality",1,259,10485,608,12274,10,328,3,63
"11/10/2020","Y","Y","Anchorage Municipality",20,"Anchorage Municipality",1,225,10710,281,12555,4,332,0,63
"11/11/2020","Y","Y","Anchorage Municipality",20,"Anchorage Municipality",1,280,10990,303,12858,3,335,1,64
"11/12/2020","Y","Y","Anchorage Municipality",20,"Anchorage Municipality",1,248,11238,363,13221,4,339,1,65
"11/13/2020","Y","Y","Anchorage Municipality",20,"Anchorage Municipality",1,482,11720,373,13594,8,347,0,65
"11/14/2020","Y","Y","Anchorage Municipality",20,"Anchorage Municipality",1,366,12086,222,13816,5,352,1,66
"11/15/2020","Y","Y","Anchorage Municipality",20,"Anchorage Municipality",1,388,12474,178,13994,6,358,0,66
"11/16/2020","Y","Y","Anchorage Municipality",20,"Anchorage Municipality",1,488,12962,841,14835,7,365,0,66
"11/17/2020","Y","Y","Anchorage Municipality",20,"Anchorage Municipality",1,287,13249,382,15217,9,374,0,66
"11/18/2020","Y","Y","Anchorage Municipality",20,"Anchorage Municipality",1,265,13514,351,15568,6,380,0,66
"11/19/2020","Y","Y","Anchorage Municipality",20,"Anchorage Municipality",1,247,13761,239,15807,5,385,0,66
"11/20/2020","Y","Y","Anchorage Municipality",20,"Anchorage Municipality",1,326,14087,211,16018,9,394,0,66
"11/21/2020","Y","Y","Anchorage Municipality",20,"Anchorage Municipality",1,298,14385,188,16206,7,401,4,70
"11/22/2020","Y","Y","Anchorage Municipality",20,"Anchorage Municipality",1,297,14682,172,16378,5,406,2,72
"11/23/2020","Y","Y","Anchorage Municipality",20,"Anchorage Municipality",1,374,15056,364,16742,11,417,1,73
"11/24/2020","Y","Y","Anchorage Municipality",20,"Anchorage Municipality",1,405,15461,267,17009,13,430,1,74
"11/25/2020","Y","Y","Anchorage Municipality",20,"Anchorage Municipality",1,250,15711,252,17261,13,443,2,76
"11/26/2020","Y","Y","Anchorage Municipality",20,"Anchorage Municipality",1,143,15854,62,17323,7,450,4,80
"11/27/2020","Y","Y","Anchorage Municipality",20,"Anchorage Municipality",1,290,16144,194,17517,3,453,3,83
"11/28/2020","Y","Y","Anchorage Municipality",20,"Anchorage Municipality",1,240,16384,189,17706,4,457,0,83
"11/29/2020","Y","Y","Anchorage Municipality",20,"Anchorage Municipality",1,192,16576,165,17871,7,464,2,85
"11/30/2020","Y","Y","Anchorage Municipality",20,"Anchorage Municipality",1,182,16758,282,18153,9,473,3,88
"12/01/2020","Y","Y","Anchorage Municipality",20,"Anchorage Municipality",1,253,17011,268,18421,9,482,5,93
"12/02/2020","Y","Y","Anchorage Municipality",20,"Anchorage Municipality",1,318,17329,264,18685,6,488,1,94
"12/03/2020","Y","Y","Anchorage Municipality",20,"Anchorage Municipality",1,262,17591,180,18865,7,495,3,97
"12/04/2020","Y","Y","Anchorage Municipality",20,"Anchorage Municipality",1,322,17913,283,19148,7,502,3,100
"12/05/2020","Y","Y","Anchorage Municipality",20,"Anchorage Municipality",1,337,18250,165,19313,4,506,3,103
"12/06/2020","Y","Y","Anchorage Municipality",20,"Anchorage Municipality",1,275,18525,97,19410,8,514,0,103
"12/07/2020","Y","Y","Anchorage Municipality",20,"Anchorage Municipality",1,228,18753,249,19659,10,524,1,104
"12/08/2020","Y","Y","Anchorage Municipality",20,"Anchorage Municipality",1,212,18965,223,19882,7,531,1,105
"12/09/2020","Y","Y","Anchorage Municipality",20,"Anchorage Municipality",1,249,19214,221,20103,3,534,3,108
"12/10/2020","Y","Y","Anchorage Municipality",20,"Anchorage Municipality",1,263,19477,181,20284,8,542,1,109
"12/11/2020","Y","Y","Anchorage Municipality",20,"Anchorage Municipality",1,228,19705,286,20570,5,547,1,110
"12/12/2020","Y","Y","Anchorage Municipality",20,"Anchorage Municipality",1,301,20006,122,20692,3,550,2,112
"12/13/2020","Y","Y","Anchorage Municipality",20,"Anchorage Municipality",1,213,20219,87,20779,6,556,3,115
"12/14/2020","Y","Y","Anchorage Municipality",20,"Anchorage Municipality",1,129,20348,223,21002,4,560,2,117
"12/15/2020","Y","Y","Anchorage Municipality",20,"Anchorage Municipality",1,267,20615,139,21141,5,565,2,119
"12/16/2020","Y","Y","Anchorage Municipality",20,"Anchorage Municipality",1,178,20793,154,21295,8,573,0,119
"12/17/2020","Y","Y","Anchorage Municipality",20,"Anchorage Municipality",1,201,20994,136,21431,7,580,1,120
"12/18/2020","Y","Y","Anchorage Municipality",20,"Anchorage Municipality",1,145,21139,177,21608,8,588,4,124
"12/19/2020","Y","Y","Anchorage Municipality",20,"Anchorage Municipality",1,110,21249,110,21718,4,592,3,127
"12/20/2020","Y","Y","Anchorage Municipality",20,"Anchorage Municipality",1,89,21338,57,21775,5,597,3,130
"12/21/2020","Y","Y","Anchorage Municipality",20,"Anchorage Municipality",1,213,21551,106,21881,3,600,1,131
"12/22/2020","Y","Y","Anchorage Municipality",20,"Anchorage Municipality",1,160,21711,143,22024,4,604,0,131
"12/23/2020","Y","Y","Anchorage Municipality",20,"Anchorage Municipality",1,112,21823,116,22140,1,605,3,134
"12/24/2020","Y","Y","Anchorage Municipality",20,"Anchorage Municipality",1,58,21881,38,22178,1,606,2,136
"12/25/2020","Y","Y","Anchorage Municipality",20,"Anchorage Municipality",1,79,21960,25,22203,2,608,1,137
"12/26/2020","Y","Y","Anchorage Municipality",20,"Anchorage Municipality",1,105,22065,109,22312,8,616,1,138
"12/27/2020","Y","Y","Anchorage Municipality",20,"Anchorage Municipality",1,68,22133,83,22395,1,617,0,138
"12/28/2020","Y","Y","Anchorage Municipality",20,"Anchorage Municipality",1,101,22234,208,22603,3,620,1,139
"12/29/2020","Y","Y","Anchorage Municipality",20,"Anchorage Municipality",1,144,22378,110,22713,2,622,2,141
"12/30/2020","Y","Y","Anchorage Municipality",20,"Anchorage Municipality",1,146,22524,157,22870,1,623,0,141
"12/31/2020","Y","Y","Anchorage Municipality",20,"Anchorage Municipality",1,214,22738,94,22964,4,627,1,142
"01/01/2021","Y","Y","Anchorage Municipality",20,"Anchorage Municipality",1,113,22851,61,23025,2,629,0,142
"01/02/2021","Y","Y","Anchorage Municipality",20,"Anchorage Municipality",1,46,22897,99,23124,7,636,0,142
"01/03/2021","Y","Y","Anchorage Municipality",20,"Anchorage Municipality",1,85,22982,73,23197,3,639,0,142
"01/04/2021","Y","Y","Anchorage Municipality",20,"Anchorage Municipality",1,61,23043,162,23359,5,644,4,146
"01/05/2021","Y","Y","Anchorage Municipality",20,"Anchorage Municipality",1,129,23172,134,23493,2,646,1,147
"01/06/2021","Y","Y","Anchorage Municipality",20,"Anchorage Municipality",1,152,23324,103,23596,3,649,0,147
"01/07/2021","Y","Y","Anchorage Municipality",20,"Anchorage Municipality",1,132,23456,115,23711,2,651,1,148
"01/08/2021","Y","Y","Anchorage Municipality",20,"Anchorage Municipality",1,143,23599,85,23796,1,652,0,148
"01/09/2021","Y","Y","Anchorage Municipality",20,"Anchorage Municipality",1,88,23687,62,23858,3,655,0,148
"01/10/2021","Y","Y","Anchorage Municipality",20,"Anchorage Municipality",1,63,23750,59,23917,2,657,1,149
"01/11/2021","Y","Y","Anchorage Municipality",20,"Anchorage Municipality",1,32,23782,99,24016,1,658,1,150
"01/12/2021","Y","Y","Anchorage Municipality",20,"Anchorage Municipality",1,92,23874,78,24094,4,662,1,151
"01/13/2021","Y","Y","Anchorage Municipality",20,"Anchorage Municipality",1,119,23993,86,24180,1,663,0,151
"01/14/2021","Y","Y","Anchorage Municipality",20,"Anchorage Municipality",1,81,24074,64,24244,0,663,0,151
"01/15/2021","Y","Y","Anchorage Municipality",20,"Anchorage Municipality",1,65,24139,60,24304,0,663,1,152
"01/16/2021","Y","Y","Anchorage Municipality",20,"Anchorage Municipality",1,62,24201,47,24351,1,664,0,152
"01/17/2021","Y","Y","Anchorage Municipality",20,"Anchorage Municipality",1,50,24251,36,24387,0,664,0,152
"01/18/2021","Y","Y","Anchorage Municipality",20,"Anchorage Municipality",1,30,24281,59,24446,1,665,0,152
"01/19/2021","Y","Y","Anchorage Municipality",20,"Anchorage Municipality",1,56,24337,60,24506,1,666,1,153
"01/20/2021","Y","Y","Anchorage Municipality",20,"Anchorage Municipality",1,49,24386,66,24572,1,667,0,153
"01/21/2021","Y","Y","Anchorage Municipality",20,"Anchorage Municipality",1,105,24491,54,24626,1,668,0,153
"01/22/2021","Y","Y","Anchorage Municipality",20,"Anchorage Municipality",1,71,24562,67,24693,0,668,0,153
"01/23/2021","Y","Y","Anchorage Municipality",20,"Anchorage Municipality",1,49,24611,41,24734,0,668,0,153
"01/24/2021","Y","Y","Anchorage Municipality",20,"Anchorage Municipality",1,51,24662,29,24763,5,673,0,153
"01/25/2021","Y","Y","Anchorage Municipality",20,"Anchorage Municipality",1,21,24683,59,24822,1,674,0,153
"01/26/2021","Y","Y","Anchorage Municipality",20,"Anchorage Municipality",1,66,24749,58,24880,1,675,1,154
"01/27/2021","Y","Y","Anchorage Municipality",20,"Anchorage Municipality",1,42,24791,54,24934,0,675,0,154
"01/28/2021","Y","Y","Anchorage Municipality",20,"Anchorage Municipality",1,72,24863,32,24966,2,677,0,154
"01/29/2021","Y","Y","Anchorage Municipality",20,"Anchorage Municipality",1,47,24910,54,25020,0,677,0,154
"01/30/2021","Y","Y","Anchorage Municipality",20,"Anchorage Municipality",1,42,24952,40,25060,2,679,0,154
"01/31/2021","Y","Y","Anchorage Municipality",20,"Anchorage Municipality",1,28,24980,24,25084,0,679,0,154
"02/01/2021","Y","Y","Anchorage Municipality",20,"Anchorage Municipality",1,61,25041,48,25132,2,681,0,154
"02/02/2021","Y","Y","Anchorage Municipality",20,"Anchorage Municipality",1,50,25091,57,25189,3,684,0,154
"02/03/2021","Y","Y","Anchorage Municipality",20,"Anchorage Municipality",1,32,25123,41,25230,0,684,0,154
"02/04/2021","Y","Y","Anchorage Municipality",20,"Anchorage Municipality",1,41,25164,32,25262,0,684,0,154
"02/05/2021","Y","Y","Anchorage Municipality",20,"Anchorage Municipality",1,36,25200,41,25303,0,684,1,155
"02/06/2021","Y","Y","Anchorage Municipality",20,"Anchorage Municipality",1,54,25254,25,25328,0,684,1,156
"02/07/2021","Y","Y","Anchorage Municipality",20,"Anchorage Municipality",1,22,25276,33,25361,1,685,0,156
"02/08/2021","Y","Y","Anchorage Municipality",20,"Anchorage Municipality",1,38,25314,58,25419,0,685,0,156
"02/09/2021","Y","Y","Anchorage Municipality",20,"Anchorage Municipality",1,50,25364,59,25478,1,686,1,157
"02/10/2021","Y","Y","Anchorage Municipality",20,"Anchorage Municipality",1,64,25428,51,25529,0,686,2,159
"02/11/2021","Y","Y","Anchorage Municipality",20,"Anchorage Municipality",1,53,25481,29,25558,0,686,0,159
"02/12/2021","Y","Y","Anchorage Municipality",20,"Anchorage Municipality",1,37,25518,59,25617,1,687,0,159
"02/13/2021","Y","Y","Anchorage Municipality",20,"Anchorage Municipality",1,63,25581,19,25636,0,687,0,159
"02/14/2021","Y","Y","Anchorage Municipality",20,"Anchorage Municipality",1,28,25609,19,25655,1,688,0,159
"02/15/2021","Y","Y","Anchorage Municipality",20,"Anchorage Municipality",1,21,25630,35,25690,3,691,0,159
"02/16/2021","Y","Y","Anchorage Municipality",20,"Anchorage Municipality",1,7,25637,42,25732,1,692,0,159
"02/17/2021","Y","Y","Anchorage Municipality",20,"Anchorage Municipality",1,58,25695,50,25782,1,693,1,160
"02/18/2021","Y","Y","Anchorage Municipality",20,"Anchorage Municipality",1,63,25758,32,25814,1,694,0,160
"02/19/2021","Y","Y","Anchorage Municipality",20,"Anchorage Municipality",1,33,25791,33,25847,1,695,0,160
"02/20/2021","Y","Y","Anchorage Municipality",20,"Anchorage Municipality",1,30,25821,22,25869,0,695,1,161
"02/21/2021","Y","Y","Anchorage Municipality",20,"Anchorage Municipality",1,22,25843,16,25885,1,696,1,162
"02/22/2021","Y","Y","Anchorage Municipality",20,"Anchorage Municipality",1,22,25865,67,25952,1,697,0,162
"02/23/2021","Y","Y","Anchorage Municipality",20,"Anchorage Municipality",1,59,25924,59,26011,2,699,1,163
"02/24/2021","Y","Y","Anchorage Municipality",20,"Anchorage Municipality",1,39,25963,40,26051,2,701,1,164
"02/25/2021","Y","Y","Anchorage Municipality",20,"Anchorage Municipality",1,39,26002,39,26090,0,701,0,164
"02/26/2021","Y","Y","Anchorage Municipality",20,"Anchorage Municipality",1,57,26059,36,26126,0,701,1,165
"02/27/2021","Y","Y","Anchorage Municipality",20,"Anchorage Municipality",1,40,26099,41,26167,0,701,1,166
"02/28/2021","Y","Y","Anchorage Municipality",20,"Anchorage Municipality",1,18,26117,17,26184,1,702,0,166
"03/01/2021","Y","Y","Anchorage Municipality",20,"Anchorage Municipality",1,43,26160,57,26241,0,702,0,166
"03/02/2021","Y","Y","Anchorage Municipality",20,"Anchorage Municipality",1,54,26214,40,26281,3,705,1,167
"03/03/2021","Y","Y","Anchorage Municipality",20,"Anchorage Municipality",1,43,26257,53,26334,0,705,1,168
"03/04/2021","Y","Y","Anchorage Municipality",20,"Anchorage Municipality",1,48,26305,47,26381,1,706,0,168
"03/05/2021","Y","Y","Anchorage Municipality",20,"Anchorage Municipality",1,54,26359,63,26444,1,707,0,168
"03/06/2021","Y","Y","Anchorage Municipality",20,"Anchorage Municipality",1,42,26401,37,26481,2,709,0,168
"03/07/2021","Y","Y","Anchorage Municipality",20,"Anchorage Municipality",1,49,26450,25,26506,4,713,0,168
"03/08/2021","Y","Y","Anchorage Municipality",20,"Anchorage Municipality",1,29,26479,68,26574,3,716,0,168
"03/09/2021","Y","Y","Anchorage Municipality",20,"Anchorage Municipality",1,58,26537,53,26627,2,718,0,168
"03/10/2021","Y","Y","Anchorage Municipality",20,"Anchorage Municipality",1,59,26596,49,26676,0,718,1,169
"03/11/2021","Y","Y","Anchorage Municipality",20,"Anchorage Municipality",1,42,26638,41,26717,1,719,0,169
"03/12/2021","Y","Y","Anchorage Municipality",20,"Anchorage Municipality",1,52,26690,43,26760,0,719,0,169
"03/13/2021","Y","Y","Anchorage Municipality",20,"Anchorage Municipality",1,41,26731,53,26813,1,720,0,169
"03/14/2021","Y","Y","Anchorage Municipality",20,"Anchorage Municipality",1,47,26778,16,26829,1,721,0,169
"03/15/2021","Y","Y","Anchorage Municipality",20,"Anchorage Municipality",1,32,26810,81,26910,5,726,0,169
"03/16/2021","Y","Y","Anchorage Municipality",20,"Anchorage Municipality",1,67,26877,64,26974,0,726,1,170
"03/17/2021","Y","Y","Anchorage Municipality",20,"Anchorage Municipality",1,65,26942,54,27028,2,728,0,170
"03/18/2021","Y","Y","Anchorage Municipality",20,"Anchorage Municipality",1,18,26960,42,27070,0,728,0,170
"03/19/2021","Y","Y","Anchorage Municipality",20,"Anchorage Municipality",1,66,27026,43,27113,0,728,0,170
"03/20/2021","Y","Y","Anchorage Municipality",20,"Anchorage Municipality",1,56,27082,62,27175,0,728,0,170
"03/21/2021","Y","Y","Anchorage Municipality",20,"Anchorage Municipality",1,29,27111,41,27216,2,730,0,170
"03/22/2021","Y","Y","Anchorage Municipality",20,"Anchorage Municipality",1,72,27183,124,27340,0,730,0,170
"03/23/2021","Y","Y","Anchorage Municipality",20,"Anchorage Municipality",1,105,27288,76,27416,2,732,0,170
"03/24/2021","Y","Y","Anchorage Municipality",20,"Anchorage Municipality",1,77,27365,69,27485,0,732,0,170
"03/25/2021","Y","Y","Anchorage Municipality",20,"Anchorage Municipality",1,54,27419,76,27561,0,732,0,170
"03/26/2021","Y","Y","Anchorage Municipality",20,"Anchorage Municipality",1,92,27511,81,27642,2,734,0,170
"03/27/2021","Y","Y","Anchorage Municipality",20,"Anchorage Municipality",1,88,27599,55,27697,3,737,0,170
"03/28/2021","Y","Y","Anchorage Municipality",20,"Anchorage Municipality",1,63,27662,36,27733,5,742,0,170
"03/29/2021","Y","Y","Anchorage Municipality",20,"Anchorage Municipality",1,21,27683,83,27816,0,742,0,170
"03/30/2021","Y","Y","Anchorage Municipality",20,"Anchorage Municipality",1,64,27747,100,27916,2,744,0,170
"03/31/2021","Y","Y","Anchorage Municipality",20,"Anchorage Municipality",1,110,27857,72,27988,1,745,0,170
"04/01/2021","Y","Y","Anchorage Municipality",20,"Anchorage Municipality",1,77,27934,76,28064,2,747,0,170
"04/02/2021","Y","Y","Anchorage Municipality",20,"Anchorage Municipality",1,99,28033,58,28122,2,749,0,170
"04/03/2021","Y","Y","Anchorage Municipality",20,"Anchorage Municipality",1,42,28075,59,28181,1,750,0,170
"04/04/2021","Y","Y","Anchorage Municipality",20,"Anchorage Municipality",1,66,28141,28,28209,2,752,0,170
"04/05/2021","Y","Y","Anchorage Municipality",20,"Anchorage Municipality",1,29,28170,96,28305,0,752,0,170
"04/06/2021","Y","Y","Anchorage Municipality",20,"Anchorage Municipality",1,99,28269,80,28385,0,752,0,170
"04/07/2021","Y","Y","Anchorage Municipality",20,"Anchorage Municipality",1,81,28350,81,28466,7,759,0,170
"04/08/2021","Y","Y","Anchorage Municipality",20,"Anchorage Municipality",1,87,28437,58,28524,1,760,1,171
"04/09/2021","Y","Y","Anchorage Municipality",20,"Anchorage Municipality",1,61,28498,52,28576,0,760,0,171
"04/10/2021","Y","Y","Anchorage Municipality",20,"Anchorage Municipality",1,42,28540,39,28615,2,762,0,171
"04/11/2021","Y","Y","Anchorage Municipality",20,"Anchorage Municipality",1,37,28577,36,28651,2,764,0,171
"04/12/2021","Y","Y","Anchorage Municipality",20,"Anchorage Municipality",1,47,28624,91,28742,1,765,0,171
"04/13/2021","Y","Y","Anchorage Municipality",20,"Anchorage Municipality",1,74,28698,71,28813,0,765,0,171
"04/14/2021","Y","Y","Anchorage Municipality",20,"Anchorage Municipality",1,68,28766,44,28857,1,766,0,171
"04/15/2021","Y","Y","Anchorage Municipality",20,"Anchorage Municipality",1,65,28831,66,28923,0,766,0,171
"04/16/2021","Y","Y","Anchorage Municipality",20,"Anchorage Municipality",1,57,28888,47,28970,1,767,0,171
"04/17/2021","Y","Y","Anchorage Municipality",20,"Anchorage Municipality",1,44,28932,38,29008,0,767,0,171
"04/18/2021","Y","Y","Anchorage Municipality",20,"Anchorage Municipality",1,51,28983,21,29029,1,768,0,171
"04/19/2021","Y","Y","Anchorage Municipality",20,"Anchorage Municipality",1,19,29002,75,29104,2,770,0,171
"04/20/2021","Y","Y","Anchorage Municipality",20,"Anchorage Municipality",1,73,29075,57,29161,1,771,0,171
"04/21/2021","Y","Y","Anchorage Municipality",20,"Anchorage Municipality",1,46,29121,48,29209,1,772,0,171
"04/22/2021","Y","Y","Anchorage Municipality",20,"Anchorage Municipality",1,49,29170,45,29254,2,774,0,171
"04/23/2021","Y","Y","Anchorage Municipality",20,"Anchorage Municipality",1,33,29203,39,29293,1,775,0,171
"04/24/2021","Y","Y","Anchorage Municipality",20,"Anchorage Municipality",1,36,29239,28,29321,3,778,0,171
"04/25/2021","Y","Y","Anchorage Municipality",20,"Anchorage Municipality",1,29,29268,17,29338,5,783,0,171
"04/26/2021","Y","Y","Anchorage Municipality",20,"Anchorage Municipality",1,20,29288,52,29390,1,784,0,171
"04/27/2021","Y","Y","Anchorage Municipality",20,"Anchorage Municipality",1,42,29330,42,29432,2,786,0,171
"04/28/2021","Y","Y","Anchorage Municipality",20,"Anchorage Municipality",1,55,29385,37,29469,0,786,0,171
"04/29/2021","Y","Y","Anchorage Municipality",20,"Anchorage Municipality",1,38,29423,27,29496,0,786,0,171
"04/30/2021","Y","Y","Anchorage Municipality",20,"Anchorage Municipality",1,25,29448,31,29527,2,788,0,171
"05/01/2021","Y","Y","Anchorage Municipality",20,"Anchorage Municipality",1,27,29475,20,29547,1,789,0,171
"05/02/2021","Y","Y","Anchorage Municipality",20,"Anchorage Municipality",1,24,29499,19,29566,1,790,0,171
"05/03/2021","Y","Y","Anchorage Municipality",20,"Anchorage Municipality",1,18,29517,49,29615,0,790,0,171
"05/04/2021","Y","Y","Anchorage Municipality",20,"Anchorage Municipality",1,44,29561,41,29656,1,791,0,171
"05/05/2021","Y","Y","Anchorage Municipality",20,"Anchorage Municipality",1,34,29595,21,29677,0,791,0,171
"05/06/2021","Y","Y","Anchorage Municipality",20,"Anchorage Municipality",1,37,29632,36,29713,2,793,2,173
"05/07/2021","Y","Y","Anchorage Municipality",20,"Anchorage Municipality",1,31,29663,21,29734,1,794,0,173
"05/08/2021","Y","Y","Anchorage Municipality",20,"Anchorage Municipality",1,40,29703,15,29749,3,797,0,173
"05/09/2021","Y","Y","Anchorage Municipality",20,"Anchorage Municipality",1,11,29714,10,29759,2,799,1,174
"05/10/2021","Y","Y","Anchorage Municipality",20,"Anchorage Municipality",1,10,29724,16,29775,0,799,0,174
"05/11/2021","Y","Y","Anchorage Municipality",20,"Anchorage Municipality",1,19,29743,14,29789,4,803,0,174
"05/12/2021","Y","Y","Anchorage Municipality",20,"Anchorage Municipality",1,14,29757,13,29802,2,805,0,174
"05/13/2021","Y","Y","Anchorage Municipality",20,"Anchorage Municipality",1,25,29782,17,29819,0,805,1,175
"05/14/2021","Y","Y","Anchorage Municipality",20,"Anchorage Municipality",1,17,29799,19,29838,0,805,0,175
"05/15/2021","Y","Y","Anchorage Municipality",20,"Anchorage Municipality",1,13,29812,11,29849,0,805,0,175
"05/16/2021","Y","Y","Anchorage Municipality",20,"Anchorage Municipality",1,11,29823,17,29866,0,805,0,175
"05/17/2021","Y","Y","Anchorage Municipality",20,"Anchorage Municipality",1,19,29842,20,29886,0,805,0,175
"05/18/2021","Y","Y","Anchorage Municipality",20,"Anchorage Municipality",1,19,29861,12,29898,0,805,0,175
"05/19/2021","Y","Y","Anchorage Municipality",20,"Anchorage Municipality",1,17,29878,17,29915,0,805,0,175
"05/20/2021","Y","Y","Anchorage Municipality",20,"Anchorage Municipality",1,15,29893,14,29929,0,805,0,175
"05/21/2021","Y","Y","Anchorage Municipality",20,"Anchorage Municipality",1,10,29903,12,29941,0,805,0,175
"05/22/2021","Y","Y","Anchorage Municipality",20,"Anchorage Municipality",1,6,29909,7,29948,0,805,0,175
"05/23/2021","Y","Y","Anchorage Municipality",20,"Anchorage Municipality",1,6,29915,8,29956,0,805,0,175
"05/24/2021","Y","Y","Anchorage Municipality",20,"Anchorage Municipality",1,12,29927,15,29971,0,805,0,175
"05/25/2021","Y","Y","Anchorage Municipality",20,"Anchorage Municipality",1,16,29943,9,29980,0,805,0,175
"05/26/2021","Y","Y","Anchorage Municipality",20,"Anchorage Municipality",1,11,29954,5,29985,1,806,0,175
"05/27/2021","Y","Y","Anchorage Municipality",20,"Anchorage Municipality",1,11,29965,12,29997,2,808,0,175
"05/28/2021","Y","Y","Anchorage Municipality",20,"Anchorage Municipality",1,10,29975,4,30001,0,808,1,176
"05/29/2021","Y","Y","Anchorage Municipality",20,"Anchorage Municipality",1,6,29981,3,30004,1,809,1,177
"05/30/2021","Y","Y","Anchorage Municipality",20,"Anchorage Municipality",1,5,29986,7,30011,1,810,0,177
"05/31/2021","Y","Y","Anchorage Municipality",20,"Anchorage Municipality",1,4,29990,4,30015,0,810,0,177
"06/01/2021","Y","Y","Anchorage Municipality",20,"Anchorage Municipality",1,5,29995,8,30023,0,810,0,177
"06/02/2021","Y","Y","Anchorage Municipality",20,"Anchorage Municipality",1,13,30008,12,30035,0,810,1,178
"06/03/2021","Y","Y","Anchorage Municipality",20,"Anchorage Municipality",1,11,30019,10,30045,2,812,0,178
"06/04/2021","Y","Y","Anchorage Municipality",20,"Anchorage Municipality",1,7,30026,4,30049,0,812,0,178
"06/05/2021","Y","Y","Anchorage Municipality",20,"Anchorage Municipality",1,6,30032,6,30055,0,812,0,178
"06/06/2021","Y","Y","Anchorage Municipality",20,"Anchorage Municipality",1,3,30035,5,30060,0,812,0,178
"06/07/2021","Y","Y","Anchorage Municipality",20,"Anchorage Municipality",1,6,30041,13,30073,0,812,0,178
"06/08/2021","Y","Y","Anchorage Municipality",20,"Anchorage Municipality",1,8,30049,10,30083,1,813,0,178
"06/09/2021","Y","Y","Anchorage Municipality",20,"Anchorage Municipality",1,11,30060,7,30090,0,813,0,178
"06/10/2021","Y","Y","Anchorage Municipality",20,"Anchorage Municipality",1,6,30066,8,30098,2,815,0,178
"06/11/2021","Y","Y","Anchorage Municipality",20,"Anchorage Municipality",1,9,30075,11,30109,1,816,0,178
"06/12/2021","Y","Y","Anchorage Municipality",20,"Anchorage Municipality",1,4,30079,9,30118,0,816,0,178
"06/13/2021","Y","Y","Anchorage Municipality",20,"Anchorage Municipality",1,7,30086,10,30128,1,817,1,179
"06/14/2021","Y","Y","Anchorage Municipality",20,"Anchorage Municipality",1,8,30094,16,30144,0,817,0,179
"06/15/2021","Y","Y","Anchorage Municipality",20,"Anchorage Municipality",1,11,30105,10,30154,2,819,0,179
"06/16/2021","Y","Y","Anchorage Municipality",20,"Anchorage Municipality",1,15,30120,14,30168,0,819,0,179
"06/17/2021","Y","Y","Anchorage Municipality",20,"Anchorage Municipality",1,19,30139,13,30181,0,819,0,179
"06/18/2021","Y","Y","Anchorage Municipality",20,"Anchorage Municipality",1,10,30149,25,30206,1,820,0,179
"06/19/2021","Y","Y","Anchorage Municipality",20,"Anchorage Municipality",1,23,30172,4,30210,0,820,0,179
"06/20/2021","Y","Y","Anchorage Municipality",20,"Anchorage Municipality",1,7,30179,14,30224,1,821,0,179
"06/21/2021","Y","Y","Anchorage Municipality",20,"Anchorage Municipality",1,9,30188,18,30242,0,821,0,179
"06/22/2021","Y","Y","Anchorage Municipality",20,"Anchorage Municipality",1,21,30209,18,30260,1,822,0,179
"06/23/2021","Y","Y","Anchorage Municipality",20,"Anchorage Municipality",1,19,30228,23,30283,1,823,0,179
"06/24/2021","Y","Y","Anchorage Municipality",20,"Anchorage Municipality",1,19,30247,11,30294,0,823,1,180
"06/25/2021","Y","Y","Anchorage Municipality",20,"Anchorage Municipality",1,13,30260,17,30311,1,824,0,180
"06/26/2021","Y","Y","Anchorage Municipality",20,"Anchorage Municipality",1,17,30277,19,30330,1,825,0,180
"06/27/2021","Y","Y","Anchorage Municipality",20,"Anchorage Municipality",1,14,30291,13,30343,1,826,0,180
"06/28/2021","Y","Y","Anchorage Municipality",20,"Anchorage Municipality",1,20,30311,30,30373,0,826,0,180
"06/29/2021","Y","Y","Anchorage Municipality",20,"Anchorage Municipality",1,35,30346,21,30394,0,826,0,180
"06/30/2021","Y","Y","Anchorage Municipality",20,"Anchorage Municipality",1,24,30370,25,30419,0,826,0,180
"07/01/2021","Y","Y","Anchorage Municipality",20,"Anchorage Municipality",1,23,30393,34,30453,1,827,0,180
"07/02/2021","Y","Y","Anchorage Municipality",20,"Anchorage Municipality",1,22,30415,18,30471,2,829,2,182
"07/03/2021","Y","Y","Anchorage Municipality",20,"Anchorage Municipality",1,26,30441,26,30497,4,833,0,182
"07/04/2021","Y","Y","Anchorage Municipality",20,"Anchorage Municipality",1,24,30465,15,30512,3,836,0,182
"07/05/2021","Y","Y","Anchorage Municipality",20,"Anchorage Municipality",1,10,30475,31,30543,2,838,1,183
"07/06/2021","Y","Y","Anchorage Municipality",20,"Anchorage Municipality",1,38,30513,44,30587,1,839,0,183
"07/07/2021","Y","Y","Anchorage Municipality",20,"Anchorage Municipality",1,41,30554,35,30622,0,839,0,183
"07/08/2021","Y","Y","Anchorage Municipality",20,"Anchorage Municipality",1,31,30585,37,30659,3,842,0,183
"07/09/2021","Y","Y","Anchorage Municipality",20,"Anchorage Municipality",1,41,30626,28,30687,0,842,0,183
"07/10/2021","Y","Y","Anchorage Municipality",20,"Anchorage Municipality",1,23,30649,28,30715,2,844,0,183
"07/11/2021","Y","Y","Anchorage Municipality",20,"Anchorage Municipality",1,19,30668,33,30748,7,851,0,183
"07/12/2021","Y","Y","Anchorage Municipality",20,"Anchorage Municipality",1,46,30714,83,30831,3,854,0,183
"07/13/2021","Y","Y","Anchorage Municipality",20,"Anchorage Municipality",1,81,30795,67,30898,3,857,0,183
"07/14/2021","Y","Y","Anchorage Municipality",20,"Anchorage Municipality",1,50,30845,75,30973,5,862,0,183
"07/15/2021","Y","Y","Anchorage Municipality",20,"Anchorage Municipality",1,72,30917,100,31073,1,863,0,183
"07/16/2021","Y","Y","Anchorage Municipality",20,"Anchorage Municipality",1,95,31012,91,31164,0,863,0,183
"07/17/2021","Y","Y","Anchorage Municipality",20,"Anchorage Municipality",1,96,31108,58,31222,1,864,0,183
"07/18/2021","Y","Y","Anchorage Municipality",20,"Anchorage Municipality",1,54,31162,66,31288,5,869,0,183
"07/19/2021","Y","Y","Anchorage Municipality",20,"Anchorage Municipality",1,73,31235,105,31393,6,875,0,183
"07/20/2021","Y","Y","Anchorage Municipality",20,"Anchorage Municipality",1,85,31320,72,31465,4,879,2,185
"07/21/2021","Y","Y","Anchorage Municipality",20,"Anchorage Municipality",1,75,31395,82,31547,1,880,0,185
"07/22/2021","Y","Y","Anchorage Municipality",20,"Anchorage Municipality",1,77,31472,89,31636,2,882,0,185
"07/23/2021","Y","Y","Anchorage Municipality",20,"Anchorage Municipality",1,79,31551,96,31732,2,884,1,186
"07/24/2021","Y","Y","Anchorage Municipality",20,"Anchorage Municipality",1,87,31638,62,31794,2,886,0,186
"07/25/2021","Y","Y","Anchorage Municipality",20,"Anchorage Municipality",1,66,31704,70,31864,2,888,2,188
"07/26/2021","Y","Y","Anchorage Municipality",20,"Anchorage Municipality",1,59,31763,106,31970,2,890,1,189
"07/27/2021","Y","Y","Anchorage Municipality",20,"Anchorage Municipality",1,149,31912,97,32067,4,894,1,190
"07/28/2021","Y","Y","Anchorage Municipality",20,"Anchorage Municipality",1,112,32024,102,32169,5,899,2,192
"07/29/2021","Y","Y","Anchorage Municipality",20,"Anchorage Municipality",1,82,32106,137,32306,3,902,0,192
"07/30/2021","Y","Y","Anchorage Municipality",20,"Anchorage Municipality",1,91,32197,158,32464,1,903,1,193
"07/31/2021","Y","Y","Anchorage Municipality",20,"Anchorage Municipality",1,109,32306,84,32548,5,908,1,194
"08/01/2021","Y","Y","Anchorage Municipality",20,"Anchorage Municipality",1,120,32426,102,32650,3,911,3,197
"08/02/2021","Y","Y","Anchorage Municipality",20,"Anchorage Municipality",1,133,32559,162,32812,2,913,1,198
"08/03/2021","Y","Y","Anchorage Municipality",20,"Anchorage Municipality",1,140,32699,159,32971,4,917,1,199
"08/04/2021","Y","Y","Anchorage Municipality",20,"Anchorage Municipality",1,78,32777,173,33144,3,920,1,200
"08/05/2021","Y","Y","Anchorage Municipality",20,"Anchorage Municipality",1,140,32917,205,33349,2,922,1,201
"08/06/2021","Y","Y","Anchorage Municipality",20,"Anchorage Municipality",1,125,33042,163,33512,3,925,1,202
"08/07/2021","Y","Y","Anchorage Municipality",20,"Anchorage Municipality",1,168,33210,97,33609,6,931,1,203
"08/08/2021","Y","Y","Anchorage Municipality",20,"Anchorage Municipality",1,102,33312,100,33709,6,937,2,205
"08/09/2021","Y","Y","Anchorage Municipality",20,"Anchorage Municipality",1,83,33395,183,33892,2,939,1,206
"08/10/2021","Y","Y","Anchorage Municipality",20,"Anchorage Municipality",1,129,33524,141,34033,5,944,0,206
"08/11/2021","Y","Y","Anchorage Municipality",20,"Anchorage Municipality",1,171,33695,206,34239,1,945,0,206
"08/12/2021","Y","Y","Anchorage Municipality",20,"Anchorage Municipality",1,136,33831,145,34384,3,948,1,207
"08/13/2021","Y","Y","Anchorage Municipality",20,"Anchorage Municipality",1,145,33976,164,34548,7,955,0,207
"08/14/2021","Y","Y","Anchorage Municipality",20,"Anchorage Municipality",1,162,34138,94,34642,10,965,3,210
"08/15/2021","Y","Y","Anchorage Municipality",20,"Anchorage Municipality",1,88,34226,138,34780,3,968,1,211
"08/16/2021","Y","Y","Anchorage Municipality",20,"Anchorage Municipality",1,146,34372,258,35038,6,974,3,214
"08/17/2021","Y","Y","Anchorage Municipality",20,"Anchorage Municipality",1,191,34563,170,35208,7,981,0,214
"08/18/2021","Y","Y","Anchorage Municipality",20,"Anchorage Municipality",1,237,34800,254,35462,5,986,0,214
"08/19/2021","Y","Y","Anchorage Municipality",20,"Anchorage Municipality",1,156,34956,227,35689,5,991,0,214
"08/20/2021","Y","Y","Anchorage Municipality",20,"Anchorage Municipality",1,198,35154,215,35904,4,995,0,214
"08/21/2021","Y","Y","Anchorage Municipality",20,"Anchorage Municipality",1,130,35284,117,36021,3,998,3,217
"08/22/2021","Y","Y","Anchorage Municipality",20,"Anchorage Municipality",1,114,35398,128,36149,6,1004,0,217
"08/23/2021","Y","Y","Anchorage Municipality",20,"Anchorage Municipality",1,200,35598,299,36448,4,1008,0,217
"08/24/2021","Y","Y","Anchorage Municipality",20,"Anchorage Municipality",1,237,35835,311,36759,4,1012,2,219
"08/25/2021","Y","Y","Anchorage Municipality",20,"Anchorage Municipality",1,306,36141,307,37066,6,1018,2,221
"08/26/2021","Y","Y","Anchorage Municipality",20,"Anchorage Municipality",1,195,36336,250,37316,7,1025,2,223
"08/27/2021","Y","Y","Anchorage Municipality",20,"Anchorage Municipality",1,227,36563,176,37492,7,1032,1,224
"08/28/2021","Y","Y","Anchorage Municipality",20,"Anchorage Municipality",1,101,36664,153,37645,7,1039,0,224
"08/29/2021","Y","Y","Anchorage Municipality",20,"Anchorage Municipality",1,51,36715,166,37811,3,1042,3,227
"08/30/2021","Y","Y","Anchorage Municipality",20,"Anchorage Municipality",1,182,36897,290,38101,8,1050,4,231
"08/31/2021","Y","Y","Anchorage Municipality",20,"Anchorage Municipality",1,281,37178,287,38388,16,1066,4,235
"09/01/2021","Y","Y","Anchorage Municipality",20,"Anchorage Municipality",1,248,37426,264,38652,7,1073,2,237
"09/02/2021","Y","Y","Anchorage Municipality",20,"Anchorage Municipality",1,267,37693,297,38949,4,1077,0,237
"09/03/2021","Y","Y","Anchorage Municipality",20,"Anchorage Municipality",1,245,37938,282,39231,7,1084,2,239
"09/04/2021","Y","Y","Anchorage Municipality",20,"Anchorage Municipality",1,155,38093,176,39407,10,1094,5,244
"09/05/2021","Y","Y","Anchorage Municipality",20,"Anchorage Municipality",1,90,38183,162,39569,11,1105,2,246
"09/06/2021","Y","Y","Anchorage Municipality",20,"Anchorage Municipality",1,104,38287,252,39821,8,1113,2,248
"09/07/2021","Y","Y","Anchorage Municipality",20,"Anchorage Municipality",1,350,38637,407,40228,9,1122,0,248
"09/08/2021","Y","Y","Anchorage Municipality",20,"Anchorage Municipality",1,296,38933,417,40645,18,1140,1,249
"09/09/2021","Y","Y","Anchorage Municipality",20,"Anchorage Municipality",1,205,39138,370,41015,3,1143,2,251
"09/10/2021","Y","Y","Anchorage Municipality",20,"Anchorage Municipality",1,347,39485,354,41369,16,1159,3,254
"09/11/2021","Y","Y","Anchorage Municipality",20,"Anchorage Municipality",1,131,39616,177,41546,4,1163,3,257
"09/12/2021","Y","Y","Anchorage Municipality",20,"Anchorage Municipality",1,140,39756,209,41755,4,1167,3,260
"09/13/2021","Y","Y","Anchorage Municipality",20,"Anchorage Municipality",1,270,40026,409,42164,7,1174,2,262
"09/14/2021","Y","Y","Anchorage Municipality",20,"Anchorage Municipality",1,535,40561,402,42566,6,1180,1,263
"09/15/2021","Y","Y","Anchorage Municipality",20,"Anchorage Municipality",1,434,40995,430,42996,10,1190,1,264
"09/16/2021","Y","Y","Anchorage Municipality",20,"Anchorage Municipality",1,324,41319,384,43380,11,1201,3,267
"09/17/2021","Y","Y","Anchorage Municipality",20,"Anchorage Municipality",1,448,41767,325,43705,6,1207,2,269
"09/18/2021","Y","Y","Anchorage Municipality",20,"Anchorage Municipality",1,278,42045,211,43916,11,1218,3,272
"09/19/2021","Y","Y","Anchorage Municipality",20,"Anchorage Municipality",1,273,42318,193,44109,4,1222,1,273
"09/20/2021","Y","Y","Anchorage Municipality",20,"Anchorage Municipality",1,391,42709,421,44530,7,1229,2,275
"09/21/2021","Y","Y","Anchorage Municipality",20,"Anchorage Municipality",1,475,43184,360,44890,13,1242,8,283
"09/22/2021","Y","Y","Anchorage Municipality",20,"Anchorage Municipality",1,366,43550,325,45215,9,1251,0,283
"09/23/2021","Y","Y","Anchorage Municipality",20,"Anchorage Municipality",1,530,44080,289,45504,4,1255,5,288
"09/24/2021","Y","Y","Anchorage Municipality",20,"Anchorage Municipality",1,360,44440,246,45750,7,1262,2,290
"09/25/2021","Y","Y","Anchorage Municipality",20,"Anchorage Municipality",1,458,44898,149,45899,5,1267,4,294
"09/26/2021","Y","Y","Anchorage Municipality",20,"Anchorage Municipality",1,524,45422,201,46100,2,1269,5,299
"09/27/2021","Y","Y","Anchorage Municipality",20,"Anchorage Municipality",1,239,45661,439,46539,7,1276,4,303
"09/28/2021","Y","Y","Anchorage Municipality",20,"Anchorage Municipality",1,390,46051,356,46895,6,1282,2,305
"09/29/2021","Y","Y","Anchorage Municipality",20,"Anchorage Municipality",1,461,46512,332,47227,6,1288,2,307
"09/30/2021","Y","Y","Anchorage Municipality",20,"Anchorage Municipality",1,314,46826,277,47504,6,1294,3,310
"10/01/2021","Y","Y","Anchorage Municipality",20,"Anchorage Municipality",1,322,47148,297,47801,4,1298,4,314
"10/02/2021","Y","Y","Anchorage Municipality",20,"Anchorage Municipality",1,291,47439,213,48014,2,1300,4,318
"10/03/2021","Y","Y","Anchorage Municipality",20,"Anchorage Municipality",1,236,47675,227,48241,1,1301,1,319
"10/04/2021","Y","Y","Anchorage Municipality",20,"Anchorage Municipality",1,279,47954,510,48751,2,1303,4,323
"10/05/2021","Y","Y","Anchorage Municipality",20,"Anchorage Municipality",1,423,48377,376,49127,6,1309,2,325
"10/06/2021","Y","Y","Anchorage Municipality",20,"Anchorage Municipality",1,269,48646,445,49572,10,1319,2,327
"10/07/2021","Y","Y","Anchorage Municipality",20,"Anchorage Municipality",1,384,49030,329,49901,9,1328,1,328
"10/08/2021","Y","Y","Anchorage Municipality",20,"Anchorage Municipality",1,380,49410,288,50189,4,1332,0,328
"10/09/2021","Y","Y","Anchorage Municipality",20,"Anchorage Municipality",1,432,49842,258,50447,7,1339,6,334
"10/10/2021","Y","Y","Anchorage Municipality",20,"Anchorage Municipality",1,277,50119,213,50660,9,1348,3,337
"10/11/2021","Y","Y","Anchorage Municipality",20,"Anchorage Municipality",1,177,50296,397,51057,6,1354,3,340
"10/12/2021","Y","Y","Anchorage Municipality",20,"Anchorage Municipality",1,433,50729,392,51449,7,1361,1,341
"10/13/2021","Y","Y","Anchorage Municipality",20,"Anchorage Municipality",1,418,51147,393,51842,9,1370,2,343
"10/14/2021","Y","Y","Anchorage Municipality",20,"Anchorage Municipality",1,423,51570,344,52186,5,1375,1,344
"10/15/2021","Y","Y","Anchorage Municipality",20,"Anchorage Municipality",1,271,51841,330,52516,6,1381,4,348
"10/16/2021","Y","Y","Anchorage Municipality",20,"Anchorage Municipality",1,386,52227,196,52712,5,1386,1,349
"10/17/2021","Y","Y","Anchorage Municipality",20,"Anchorage Municipality",1,223,52450,208,52920,1,1387,1,350
"10/18/2021","Y","Y","Anchorage Municipality",20,"Anchorage Municipality",1,174,52624,407,53327,2,1389,3,353
"10/19/2021","Y","Y","Anchorage Municipality",20,"Anchorage Municipality",1,310,52934,313,53640,11,1400,3,356
"10/20/2021","Y","Y","Anchorage Municipality",20,"Anchorage Municipality",1,447,53381,355,53995,3,1403,0,356
"10/21/2021","Y","Y","Anchorage Municipality",20,"Anchorage Municipality",1,303,53684,260,54255,8,1411,3,359
"10/22/2021","Y","Y","Anchorage Municipality",20,"Anchorage Municipality",1,219,53903,215,54470,4,1415,3,362
"10/23/2021","Y","Y","Anchorage Municipality",20,"Anchorage Municipality",1,299,54202,146,54616,6,1421,1,363
"10/24/2021","Y","Y","Anchorage Municipality",20,"Anchorage Municipality",1,169,54371,170,54786,5,1426,1,364
"10/25/2021","Y","Y","Anchorage Municipality",20,"Anchorage Municipality",1,220,54591,334,55120,6,1432,4,368
"10/26/2021","Y","Y","Anchorage Municipality",20,"Anchorage Municipality",1,269,54860,300,55420,5,1437,3,371
"10/27/2021","Y","Y","Anchorage Municipality",20,"Anchorage Municipality",1,266,55126,257,55677,5,1442,4,375
"10/28/2021","Y","Y","Anchorage Municipality",20,"Anchorage Municipality",1,290,55416,206,55883,4,1446,3,378
"10/29/2021","Y","Y","Anchorage Municipality",20,"Anchorage Municipality",1,251,55667,213,56096,3,1449,1,379
"10/30/2021","Y","Y","Anchorage Municipality",20,"Anchorage Municipality",1,203,55870,147,56243,2,1451,5,384
"10/31/2021","Y","Y","Anchorage Municipality",20,"Anchorage Municipality",1,139,56009,159,56402,4,1455,3,387
"11/01/2021","Y","Y","Anchorage Municipality",20,"Anchorage Municipality",1,172,56181,255,56657,2,1457,2,389
"11/02/2021","Y","Y","Anchorage Municipality",20,"Anchorage Municipality",1,230,56411,198,56855,2,1459,1,390
"11/03/2021","Y","Y","Anchorage Municipality",20,"Anchorage Municipality",1,203,56614,210,57065,2,1461,1,391
"11/04/2021","Y","Y","Anchorage Municipality",20,"Anchorage Municipality",1,288,56902,185,57250,6,1467,3,394
"11/05/2021","Y","Y","Anchorage Municipality",20,"Anchorage Municipality",1,173,57075,166,57416,7,1474,5,399
"11/06/2021","Y","Y","Anchorage Municipality",20,"Anchorage Municipality",1,193,57268,99,57515,1,1475,1,400
"11/07/2021","Y","Y","Anchorage Municipality",20,"Anchorage Municipality",1,119,57387,128,57643,3,1478,0,400
"11/08/2021","Y","Y","Anchorage Municipality",20,"Anchorage Municipality",1,125,57512,206,57849,4,1482,1,401
"11/09/2021","Y","Y","Anchorage Municipality",20,"Anchorage Municipality",1,181,57693,142,57991,1,1483,3,404
"11/10/2021","Y","Y","Anchorage Municipality",20,"Anchorage Municipality",1,135,57828,157,58148,2,1485,2,406
"11/11/2021","Y","Y","Anchorage Municipality",20,"Anchorage Municipality",1,177,58005,101,58249,5,1490,2,408
"11/12/2021","Y","Y","Anchorage Municipality",20,"Anchorage Municipality",1,116,58121,105,58354,5,1495,2,410
"11/13/2021","Y","Y","Anchorage Municipality",20,"Anchorage Municipality",1,88,58209,64,58418,2,1497,2,412
"11/14/2021","Y","Y","Anchorage Municipality",20,"Anchorage Municipality",1,89,58298,91,58509,2,1499,1,413
"11/15/2021","Y","Y","Anchorage Municipality",20,"Anchorage Municipality",1,97,58395,175,58684,0,1499,0,413
"11/16/2021","Y","Y","Anchorage Municipality",20,"Anchorage Municipality",1,158,58553,123,58807,3,1502,3,416
"11/17/2021","Y","Y","Anchorage Municipality",20,"Anchorage Municipality",1,160,58713,114,58921,2,1504,2,418
"11/18/2021","Y","Y","Anchorage Municipality",20,"Anchorage Municipality",1,141,58854,104,59025,7,1511,0,418
"11/19/2021","Y","Y","Anchorage Municipality",20,"Anchorage Municipality",1,89,58943,110,59135,4,1515,6,424
"11/20/2021","Y","Y","Anchorage Municipality",20,"Anchorage Municipality",1,93,59036,71,59206,0,1515,1,425
"11/21/2021","Y","Y","Anchorage Municipality",20,"Anchorage Municipality",1,49,59085,64,59270,1,1516,2,427
"11/22/2021","Y","Y","Anchorage Municipality",20,"Anchorage Municipality",1,39,59124,128,59398,3,1519,5,432
"11/23/2021","Y","Y","Anchorage Municipality",20,"Anchorage Municipality",1,152,59276,138,59536,2,1521,1,433
"11/24/2021","Y","Y","Anchorage Municipality",20,"Anchorage Municipality",1,125,59401,134,59670,3,1524,1,434
"11/25/2021","Y","Y","Anchorage Municipality",20,"Anchorage Municipality",1,63,59464,19,59689,0,1524,1,435
"11/26/2021","Y","Y","Anchorage Municipality",20,"Anchorage Municipality",1,139,59603,75,59764,2,1526,1,436
"11/27/2021","Y","Y","Anchorage Municipality",20,"Anchorage Municipality",1,81,59684,68,59832,2,1528,0,436
"11/28/2021","Y","Y","Anchorage Municipality",20,"Anchorage Municipality",1,46,59730,78,59910,2,1530,0,436
"11/29/2021","Y","Y","Anchorage Municipality",20,"Anchorage Municipality",1,53,59783,101,60011,2,1532,1,437
"11/30/2021","Y","Y","Anchorage Municipality",20,"Anchorage Municipality",1,135,59918,123,60134,2,1534,1,438
"12/01/2021","Y","Y","Anchorage Municipality",20,"Anchorage Municipality",1,120,60038,83,60217,3,1537,0,438
"12/02/2021","Y","Y","Anchorage Municipality",20,"Anchorage Municipality",1,78,60116,60,60277,0,1537,1,439
"12/03/2021","Y","Y","Anchorage Municipality",20,"Anchorage Municipality",1,115,60231,86,60363,1,1538,1,440
"12/04/2021","Y","Y","Anchorage Municipality",20,"Anchorage Municipality",1,21,60252,41,60404,2,1540,0,440
"12/05/2021","Y","Y","Anchorage Municipality",20,"Anchorage Municipality",1,49,60301,51,60455,1,1541,1,441
"12/06/2021","Y","Y","Anchorage Municipality",20,"Anchorage Municipality",1,66,60367,82,60537,0,1541,1,442
"12/07/2021","Y","Y","Anchorage Municipality",20,"Anchorage Municipality",1,108,60475,64,60601,8,1549,0,442
"12/08/2021","Y","Y","Anchorage Municipality",20,"Anchorage Municipality",1,74,60549,77,60678,1,1550,2,444
"12/09/2021","Y","Y","Anchorage Municipality",20,"Anchorage Municipality",1,66,60615,55,60733,2,1552,1,445
"12/10/2021","Y","Y","Anchorage Municipality",20,"Anchorage Municipality",1,86,60701,78,60811,1,1553,2,447
"12/11/2021","Y","Y","Anchorage Municipality",20,"Anchorage Municipality",1,45,60746,25,60836,3,1556,0,447
"12/12/2021","Y","Y","Anchorage Municipality",20,"Anchorage Municipality",1,20,60766,25,60861,1,1557,0,447
"12/13/2021","Y","Y","Anchorage Municipality",20,"Anchorage Municipality",1,17,60783,53,60914,3,1560,1,448
"12/14/2021","Y","Y","Anchorage Municipality",20,"Anchorage Municipality",1,101,60884,67,60981,2,1562,1,449
"12/15/2021","Y","Y","Anchorage Municipality",20,"Anchorage Municipality",1,83,60967,61,61042,4,1566,1,450
"12/16/2021","Y","Y","Anchorage Municipality",20,"Anchorage Municipality",1,52,61019,63,61105,4,1570,0,450
"12/17/2021","Y","Y","Anchorage Municipality",20,"Anchorage Municipality",1,71,61090,76,61181,2,1572,0,450
"12/18/2021","Y","Y","Anchorage Municipality",20,"Anchorage Municipality",1,50,61140,30,61211,3,1575,0,450
"12/19/2021","Y","Y","Anchorage Municipality",20,"Anchorage Municipality",1,61,61201,44,61255,0,1575,0,450
"12/20/2021","Y","Y","Anchorage Municipality",20,"Anchorage Municipality",1,47,61248,48,61303,0,1575,0,450
"12/21/2021","Y","Y","Anchorage Municipality",20,"Anchorage Municipality",1,46,61294,65,61368,0,1575,1,451
"12/22/2021","Y","Y","Anchorage Municipality",20,"Anchorage Municipality",1,86,61380,102,61470,1,1576,0,451
"12/23/2021","Y","Y","Anchorage Municipality",20,"Anchorage Municipality",1,109,61489,166,61636,4,1580,1,452
"12/24/2021","Y","Y","Anchorage Municipality",20,"Anchorage Municipality",1,44,61533,99,61735,0,1580,0,452
"12/25/2021","Y","Y","Anchorage Municipality",20,"Anchorage Municipality",1,21,61554,28,61763,3,1583,0,452
"12/26/2021","Y","Y","Anchorage Municipality",20,"Anchorage Municipality",1,37,61591,97,61860,0,1583,1,453
"12/27/2021","Y","Y","Anchorage Municipality",20,"Anchorage Municipality",1,259,61850,377,62237,2,1585,0,453
"12/28/2021","Y","Y","Anchorage Municipality",20,"Anchorage Municipality",1,244,62094,386,62623,4,1589,1,454
"12/29/2021","Y","Y","Anchorage Municipality",20,"Anchorage Municipality",1,285,62379,427,63050,6,1595,0,454
"12/30/2021","Y","Y","Anchorage Municipality",20,"Anchorage Municipality",1,474,62853,513,63563,4,1599,0,454
"12/31/2021","Y","Y","Anchorage Municipality",20,"Anchorage Municipality",1,157,63010,379,63942,0,1599,3,457
"01/01/2022","Y","Y","Anchorage Municipality",20,"Anchorage Municipality",1,636,63646,145,64087,3,1602,0,457
"01/02/2022","Y","Y","Anchorage Municipality",20,"Anchorage Municipality",1,119,63765,220,64307,2,1604,1,458
"01/03/2022","Y","Y","Anchorage Municipality",20,"Anchorage Municipality",1,292,64057,443,64750,2,1606,1,459
"01/04/2022","Y","Y","Anchorage Municipality",20,"Anchorage Municipality",1,430,64487,658,65408,2,1608,0,459
"01/05/2022","Y","Y","Anchorage Municipality",20,"Anchorage Municipality",1,1180,65667,1000,66408,4,1612,1,460
"01/06/2022","Y","Y","Anchorage Municipality",20,"Anchorage Municipality",1,1033,66700,1147,67555,5,1617,2,462
"01/07/2022","Y","Y","Anchorage Municipality",20,"Anchorage Municipality",1,857,67557,895,68450,4,1621,1,463
"01/08/2022","Y","Y","Anchorage Municipality",20,"Anchorage Municipality",1,483,68040,420,68870,1,1622,1,464
"01/09/2022","Y","Y","Anchorage Municipality",20,"Anchorage Municipality",1,418,68458,468,69338,2,1624,1,465
"01/10/2022","Y","Y","Anchorage Municipality",20,"Anchorage Municipality",1,1156,69614,1236,70574,6,1630,0,465
"01/11/2022","Y","Y","Anchorage Municipality",20,"Anchorage Municipality",1,1233,70847,1271,71845,5,1635,2,467
"01/12/2022","Y","Y","Anchorage Municipality",20,"Anchorage Municipality",1,1614,72461,1628,73473,1,1636,0,467
"01/13/2022","Y","Y","Anchorage Municipality",20,"Anchorage Municipality",1,1319,73780,1323,74796,4,1640,2,469
"01/14/2022","Y","Y","Anchorage Municipality",20,"Anchorage Municipality",1,1465,75245,1432,76228,6,1646,1,470
"01/15/2022","Y","Y","Anchorage Municipality",20,"Anchorage Municipality",1,1187,76432,1056,77284,5,1651,1,471
"01/16/2022","Y","Y","Anchorage Municipality",20,"Anchorage Municipality",1,698,77130,714,77998,2,1653,1,472
"01/17/2022","Y","Y","Anchorage Municipality",20,"Anchorage Municipality",1,698,77828,872,78870,5,1658,0,472
"01/18/2022","Y","Y","Anchorage Municipality",20,"Anchorage Municipality",1,1347,79175,1368,80238,10,1668,1,473
"01/19/2022","Y","Y","Anchorage Municipality",20,"Anchorage Municipality",1,1684,80859,1550,81788,11,1679,3,476
"01/20/2022","Y","Y","Anchorage Municipality",20,"Anchorage Municipality",1,1236,82095,1203,82991,7,1686,0,476
"01/21/2022","Y","Y","Anchorage Municipality",20,"Anchorage Municipality",1,1332,83427,1282,84273,6,1692,2,478
"01/22/2022","Y","Y","Anchorage Municipality",20,"Anchorage Municipality",1,599,84026,612,84885,9,1701,1,479
"01/23/2022","Y","Y","Anchorage Municipality",20,"Anchorage Municipality",1,416,84442,484,85369,5,1706,1,480
"01/24/2022","Y","Y","Anchorage Municipality",20,"Anchorage Municipality",1,1200,85642,1449,86818,8,1714,1,481
"01/25/2022","Y","Y","Anchorage Municipality",20,"Anchorage Municipality",1,1109,86751,982,87800,12,1726,2,483
"01/26/2022","Y","Y","Anchorage Municipality",20,"Anchorage Municipality",1,960,87711,874,88674,1,1727,0,483
"01/27/2022","Y","Y","Anchorage Municipality",20,"Anchorage Municipality",1,1177,88888,933,89607,5,1732,0,483
"01/28/2022","Y","Y","Anchorage Municipality",20,"Anchorage Municipality",1,869,89757,675,90282,4,1736,0,483
"01/29/2022","Y","Y","Anchorage Municipality",20,"Anchorage Municipality",1,708,90465,642,90924,0,1736,1,484
"01/30/2022","Y","Y","Anchorage Municipality",20,"Anchorage Municipality",1,226,90691,255,91179,2,1738,0,484
"01/31/2022","Y","Y","Anchorage Municipality",20,"Anchorage Municipality",1,683,91374,665,91844,0,1738,0,484
"02/01/2022","Y","Y","Anchorage Municipality",20,"Anchorage Municipality",1,633,92007,566,92410,0,1738,0,484
"02/02/2022","Y","Y","Anchorage Municipality",20,"Anchorage Municipality",1,694,92701,630,93040,4,1742,1,485
"02/03/2022","Y","Y","Anchorage Municipality",20,"Anchorage Municipality",1,554,93255,507,93547,1,1743,3,488
"02/04/2022","Y","Y","Anchorage Municipality",20,"Anchorage Municipality",1,621,93876,575,94122,1,1744,1,489
"02/05/2022","Y","Y","Anchorage Municipality",20,"Anchorage Municipality",1,292,94168,261,94383,3,1747,1,490
"02/06/2022","Y","Y","Anchorage Municipality",20,"Anchorage Municipality",1,176,94344,153,94536,1,1748,1,491
"02/07/2022","Y","Y","Anchorage Municipality",20,"Anchorage Municipality",1,319,94663,298,94834,1,1749,1,492
"02/08/2022","Y","Y","Anchorage Municipality",20,"Anchorage Municipality",1,409,95072,384,95218,1,1750,0,492
"02/09/2022","Y","Y","Anchorage Municipality",20,"Anchorage Municipality",1,376,95448,367,95585,1,1751,2,494
"02/10/2022","Y","Y","Anchorage Municipality",20,"Anchorage Municipality",1,261,95709,259,95844,2,1753,0,494
"02/11/2022","Y","Y","Anchorage Municipality",20,"Anchorage Municipality",1,354,96063,351,96195,1,1754,2,496
"02/12/2022","Y","Y","Anchorage Municipality",20,"Anchorage Municipality",1,130,96193,133,96328,4,1758,0,496
"02/13/2022","Y","Y","Anchorage Municipality",20,"Anchorage Municipality",1,209,96402,192,96520,2,1760,2,498
"02/14/2022","Y","Y","Anchorage Municipality",20,"Anchorage Municipality",1,123,96525,138,96658,0,1760,0,498
"02/15/2022","Y","Y","Anchorage Municipality",20,"Anchorage Municipality",1,166,96691,148,96806,2,1762,0,498
"02/16/2022","Y","Y","Anchorage Municipality",20,"Anchorage Municipality",1,145,96836,168,96974,1,1763,0,498
"02/17/2022","Y","Y","Anchorage Municipality",20,"Anchorage Municipality",1,143,96979,124,97098,1,1764,1,499
"02/18/2022","Y","Y","Anchorage Municipality",20,"Anchorage Municipality",1,232,97211,233,97331,2,1766,0,499
"02/19/2022","Y","Y","Anchorage Municipality",20,"Anchorage Municipality",1,102,97313,50,97381,0,1766,1,500
"02/20/2022","Y","Y","Anchorage Municipality",20,"Anchorage Municipality",1,46,97359,42,97423,1,1767,0,500
"02/21/2022","Y","Y","Anchorage Municipality",20,"Anchorage Municipality",1,139,97498,149,97572,1,1768,0,500
"02/22/2022","Y","Y","Anchorage Municipality",20,"Anchorage Municipality",1,110,97608,109,97681,3,1771,1,501
"02/23/2022","Y","Y","Anchorage Municipality",20,"Anchorage Municipality",1,71,97679,86,97767,1,1772,0,501
"02/24/2022","Y","Y","Anchorage Municipality",20,"Anchorage Municipality",1,126,97805,123,97890,0,1772,1,502
"02/25/2022","Y","Y","Anchorage Municipality",20,"Anchorage Municipality",1,124,97929,94,97984,0,1772,0,502
"02/26/2022","Y","Y","Anchorage Municipality",20,"Anchorage Municipality",1,49,97978,42,98026,0,1772,0,502
"02/27/2022","Y","Y","Anchorage Municipality",20,"Anchorage Municipality",1,34,98012,39,98065,1,1773,0,502
"02/28/2022","Y","Y","Anchorage Municipality",20,"Anchorage Municipality",1,74,98086,58,98123,1,1774,0,502
"03/01/2022","Y","Y","Anchorage Municipality",20,"Anchorage Municipality",1,86,98172,85,98208,0,1774,0,502
"03/02/2022","Y","Y","Anchorage Municipality",20,"Anchorage Municipality",1,88,98260,91,98299,0,1774,0,502
"03/03/2022","Y","Y","Anchorage Municipality",20,"Anchorage Municipality",1,81,98341,78,98377,1,1775,1,503
"03/04/2022","Y","Y","Anchorage Municipality",20,"Anchorage Municipality",1,62,98403,68,98445,0,1775,0,503
"03/05/2022","Y","Y","Anchorage Municipality",20,"Anchorage Municipality",1,19,98422,20,98465,2,1777,0,503
"03/06/2022","Y","Y","Anchorage Municipality",20,"Anchorage Municipality",1,27,98449,26,98491,0,1777,0,503
"03/07/2022","Y","Y","Anchorage Municipality",20,"Anchorage Municipality",1,72,98521,73,98564,1,1778,1,504
"03/08/2022","Y","Y","Anchorage Municipality",20,"Anchorage Municipality",1,85,98606,82,98646,1,1779,0,504
"03/09/2022","Y","Y","Anchorage Municipality",20,"Anchorage Municipality",1,64,98670,64,98710,1,1780,1,505
"03/10/2022","Y","Y","Anchorage Municipality",20,"Anchorage Municipality",1,47,98717,42,98752,0,1780,0,505
"03/11/2022","Y","Y","Anchorage Municipality",20,"Anchorage Municipality",1,80,98797,78,98830,0,1780,0,505
"03/12/2022","Y","Y","Anchorage Municipality",20,"Anchorage Municipality",1,49,98846,50,98880,0,1780,0,505
"03/13/2022","Y","Y","Anchorage Municipality",20,"Anchorage Municipality",1,15,98861,12,98892,1,1781,0,505
"03/14/2022","Y","Y","Anchorage Municipality",20,"Anchorage Municipality",1,92,98953,101,98993,1,1782,0,505
"03/15/2022","Y","Y","Anchorage Municipality",20,"Anchorage Municipality",1,71,99024,60,99053,0,1782,0,505
"03/16/2022","Y","Y","Anchorage Municipality",20,"Anchorage Municipality",1,54,99078,54,99107,1,1783,1,506
"03/17/2022","Y","Y","Anchorage Municipality",20,"Anchorage Municipality",1,94,99172,93,99200,0,1783,1,507
"03/18/2022","Y","Y","Anchorage Municipality",20,"Anchorage Municipality",1,57,99229,59,99259,0,1783,0,507
"03/19/2022","Y","Y","Anchorage Municipality",20,"Anchorage Municipality",1,37,99266,44,99303,0,1783,0,507
"03/20/2022","Y","Y","Anchorage Municipality",20,"Anchorage Municipality",1,22,99288,19,99322,0,1783,2,509
"03/21/2022","Y","Y","Anchorage Municipality",20,"Anchorage Municipality",1,87,99375,84,99406,0,1783,1,510
"03/22/2022","Y","Y","Anchorage Municipality",20,"Anchorage Municipality",1,94,99469,97,99503,0,1783,0,510
"03/23/2022","Y","Y","Anchorage Municipality",20,"Anchorage Municipality",1,50,99519,54,99557,0,1783,1,511
"03/24/2022","Y","Y","Anchorage Municipality",20,"Anchorage Municipality",1,131,99650,123,99680,0,1783,0,511
"03/25/2022","Y","Y","Anchorage Municipality",20,"Anchorage Municipality",1,72,99722,70,99750,0,1783,0,511
"03/26/2022","Y","Y","Anchorage Municipality",20,"Anchorage Municipality",1,55,99777,55,99805,0,1783,0,511
"03/27/2022","Y","Y","Anchorage Municipality",20,"Anchorage Municipality",1,26,99803,49,99854,0,1783,0,511
"03/28/2022","Y","Y","Anchorage Municipality",20,"Anchorage Municipality",1,32,99835,40,99894,0,1783,0,511
"03/29/2022","Y","Y","Anchorage Municipality",20,"Anchorage Municipality",1,129,99964,120,100014,0,1783,0,511
"03/30/2022","Y","Y","Anchorage Municipality",20,"Anchorage Municipality",1,94,100058,98,100112,1,1784,1,512
"03/31/2022","Y","Y","Anchorage Municipality",20,"Anchorage Municipality",1,67,100125,77,100189,0,1784,0,512
"04/01/2022","Y","Y","Anchorage Municipality",20,"Anchorage Municipality",1,107,100232,100,100289,0,1784,0,512
"04/02/2022","Y","Y","Anchorage Municipality",20,"Anchorage Municipality",1,77,100309,66,100355,1,1785,0,512
"04/03/2022","Y","Y","Anchorage Municipality",20,"Anchorage Municipality",1,38,100347,42,100397,0,1785,0,512
"04/04/2022","Y","Y","Anchorage Municipality",20,"Anchorage Municipality",1,52,100399,55,100452,0,1785,0,512
"04/05/2022","Y","Y","Anchorage Municipality",20,"Anchorage Municipality",1,134,100533,139,100591,0,1785,0,512
"04/06/2022","Y","Y","Anchorage Municipality",20,"Anchorage Municipality",1,100,100633,104,100695,0,1785,0,512
"04/07/2022","Y","Y","Anchorage Municipality",20,"Anchorage Municipality",1,81,100714,87,100782,0,1785,0,512
"04/08/2022","Y","Y","Anchorage Municipality",20,"Anchorage Municipality",1,71,100785,88,100870,0,1785,0,512
"04/09/2022","Y","Y","Anchorage Municipality",20,"Anchorage Municipality",1,77,100862,39,100909,0,1785,0,512
"04/10/2022","Y","Y","Anchorage Municipality",20,"Anchorage Municipality",1,41,100903,32,100941,0,1785,0,512
"04/11/2022","Y","Y","Anchorage Municipality",20,"Anchorage Municipality",1,74,100977,112,101053,0,1785,0,512
"04/12/2022","Y","Y","Anchorage Municipality",20,"Anchorage Municipality",1,94,101071,123,101176,0,1785,0,512
"04/13/2022","Y","Y","Anchorage Municipality",20,"Anchorage Municipality",1,94,101165,62,101238,0,1785,0,512
"04/14/2022","Y","Y","Anchorage Municipality",20,"Anchorage Municipality",1,57,101222,64,101302,0,1785,0,512
"04/15/2022","Y","Y","Anchorage Municipality",20,"Anchorage Municipality",1,111,101333,91,101393,0,1785,0,512
"04/16/2022","Y","Y","Anchorage Municipality",20,"Anchorage Municipality",1,88,101421,60,101453,0,1785,0,512
"04/17/2022","Y","Y","Anchorage Municipality",20,"Anchorage Municipality",1,28,101449,11,101464,0,1785,0,512
"04/18/2022","Y","Y","Anchorage Municipality",20,"Anchorage Municipality",1,58,101507,77,101541,0,1785,0,512
"04/19/2022","Y","Y","Anchorage Municipality",20,"Anchorage Municipality",1,104,101611,148,101689,0,1785,0,512
"04/20/2022","Y","Y","Anchorage Municipality",20,"Anchorage Municipality",1,84,101695,61,101750,0,1785,0,512
"04/21/2022","Y","Y","Anchorage Municipality",20,"Anchorage Municipality",1,91,101786,44,101794,0,1785,0,512
"04/22/2022","Y","Y","Anchorage Municipality",20,"Anchorage Municipality",1,82,101868,86,101880,0,1785,0,512
"04/23/2022","Y","Y","Anchorage Municipality",20,"Anchorage Municipality",1,61,101929,57,101937,0,1785,0,512
"04/24/2022","Y","Y","Anchorage Municipality",20,"Anchorage Municipality",1,47,101976,46,101983,0,1785,0,512
"04/25/2022","Y","Y","Anchorage Municipality",20,"Anchorage Municipality",1,93,102069,97,102080,0,1785,0,512
"04/26/2022","Y","Y","Anchorage Municipality",20,"Anchorage Municipality",1,114,102183,103,102183,0,1785,0,512
"03/26/2020","Y","Y","Bethel Census Area",50,"Y-K Delta Region",10,0,0,1,1,0,0,0,0
"04/06/2020","Y","Y","Bethel Census Area",50,"Y-K Delta Region",10,1,1,0,1,0,0,0,0
"05/12/2020","Y","Y","Bethel Census Area",50,"Y-K Delta Region",10,0,1,1,2,0,0,0,0
"05/15/2020","Y","Y","Bethel Census Area",50,"Y-K Delta Region",10,1,2,0,2,0,0,0,0
"05/19/2020","Y","Y","Bethel Census Area",50,"Y-K Delta Region",10,0,2,1,3,0,0,0,0
"05/26/2020","Y","Y","Bethel Census Area",50,"Y-K Delta Region",10,1,3,0,3,0,0,0,0
"06/12/2020","Y","Y","Bethel Census Area",50,"Y-K Delta Region",10,1,4,1,4,0,0,0,0
"06/15/2020","Y","Y","Bethel Census Area",50,"Y-K Delta Region",10,1,5,1,5,0,0,0,0
"06/16/2020","Y","Y","Bethel Census Area",50,"Y-K Delta Region",10,0,5,2,7,0,0,0,0
"06/18/2020","Y","Y","Bethel Census Area",50,"Y-K Delta Region",10,1,6,0,7,0,0,0,0
"06/22/2020","Y","Y","Bethel Census Area",50,"Y-K Delta Region",10,1,7,1,8,0,0,0,0
"06/23/2020","Y","Y","Bethel Census Area",50,"Y-K Delta Region",10,0,7,1,9,0,0,0,0
"06/24/2020","Y","Y","Bethel Census Area",50,"Y-K Delta Region",10,1,8,0,9,0,0,0,0
"06/26/2020","Y","Y","Bethel Census Area",50,"Y-K Delta Region",10,1,9,0,9,0,0,0,0
"06/28/2020","Y","Y","Bethel Census Area",50,"Y-K Delta Region",10,0,9,1,10,0,0,0,0
"06/29/2020","Y","Y","Bethel Census Area",50,"Y-K Delta Region",10,0,9,1,11,0,0,0,0
"07/01/2020","Y","Y","Bethel Census Area",50,"Y-K Delta Region",10,0,9,1,12,0,0,0,0
"07/02/2020","Y","Y","Bethel Census Area",50,"Y-K Delta Region",10,1,10,0,12,0,0,0,0
"07/03/2020","Y","Y","Bethel Census Area",50,"Y-K Delta Region",10,1,11,0,12,0,0,0,0
"07/04/2020","Y","Y","Bethel Census Area",50,"Y-K Delta Region",10,0,11,1,13,0,0,0,0
"07/05/2020","Y","Y","Bethel Census Area",50,"Y-K Delta Region",10,0,11,1,14,0,0,0,0
"07/07/2020","Y","Y","Bethel Census Area",50,"Y-K Delta Region",10,0,11,1,15,0,0,0,0
"07/08/2020","Y","Y","Bethel Census Area",50,"Y-K Delta Region",10,1,12,0,15,0,0,0,0
"07/10/2020","Y","Y","Bethel Census Area",50,"Y-K Delta Region",10,1,13,1,16,0,0,0,0
"07/11/2020","Y","Y","Bethel Census Area",50,"Y-K Delta Region",10,1,14,0,16,0,0,0,0
"07/12/2020","Y","Y","Bethel Census Area",50,"Y-K Delta Region",10,2,16,0,16,0,0,0,0
"07/20/2020","Y","Y","Bethel Census Area",50,"Y-K Delta Region",10,1,17,2,18,0,0,0,0
"07/23/2020","Y","Y","Bethel Census Area",50,"Y-K Delta Region",10,1,18,2,20,0,0,0,0
"07/27/2020","Y","Y","Bethel Census Area",50,"Y-K Delta Region",10,0,18,1,21,0,0,0,0
"07/29/2020","Y","Y","Bethel Census Area",50,"Y-K Delta Region",10,1,19,0,21,0,0,0,0
"07/30/2020","Y","Y","Bethel Census Area",50,"Y-K Delta Region",10,0,19,1,22,0,0,0,0
"07/31/2020","Y","Y","Bethel Census Area",50,"Y-K Delta Region",10,1,20,0,22,0,0,0,0
"08/01/2020","Y","Y","Bethel Census Area",50,"Y-K Delta Region",10,1,21,0,22,0,0,0,0
"08/02/2020","Y","Y","Bethel Census Area",50,"Y-K Delta Region",10,1,22,0,22,0,0,0,0
"08/04/2020","Y","Y","Bethel Census Area",50,"Y-K Delta Region",10,0,22,1,23,0,0,0,0
"08/10/2020","Y","Y","Bethel Census Area",50,"Y-K Delta Region",10,1,23,1,24,0,0,0,0
"08/11/2020","Y","Y","Bethel Census Area",50,"Y-K Delta Region",10,0,23,3,27,0,0,0,0
"08/12/2020","Y","Y","Bethel Census Area",50,"Y-K Delta Region",10,0,23,2,29,0,0,0,0
"08/13/2020","Y","Y","Bethel Census Area",50,"Y-K Delta Region",10,0,23,2,31,0,0,0,0
"08/14/2020","Y","Y","Bethel Census Area",50,"Y-K Delta Region",10,5,28,2,33,0,0,0,0
"08/15/2020","Y","Y","Bethel Census Area",50,"Y-K Delta Region",10,2,30,1,34,0,0,0,0
"08/16/2020","Y","Y","Bethel Census Area",50,"Y-K Delta Region",10,2,32,1,35,0,0,0,0
"08/17/2020","Y","Y","Bethel Census Area",50,"Y-K Delta Region",10,0,32,1,36,0,0,0,0
"08/18/2020","Y","Y","Bethel Census Area",50,"Y-K Delta Region",10,2,34,3,39,0,0,0,0
"08/19/2020","Y","Y","Bethel Census Area",50,"Y-K Delta Region",10,2,36,1,40,1,1,1,1
"08/20/2020","Y","Y","Bethel Census Area",50,"Y-K Delta Region",10,0,36,1,41,0,1,0,1
"08/21/2020","Y","Y","Bethel Census Area",50,"Y-K Delta Region",10,1,37,3,44,0,1,0,1
"08/22/2020","Y","Y","Bethel Census Area",50,"Y-K Delta Region",10,1,38,4,48,0,1,0,1
"08/23/2020","Y","Y","Bethel Census Area",50,"Y-K Delta Region",10,15,53,1,49,0,1,0,1
"08/24/2020","Y","Y","Bethel Census Area",50,"Y-K Delta Region",10,0,53,1,50,0,1,0,1
"08/25/2020","Y","Y","Bethel Census Area",50,"Y-K Delta Region",10,0,53,2,52,0,1,0,1
"08/26/2020","Y","Y","Bethel Census Area",50,"Y-K Delta Region",10,0,53,2,54,0,1,0,1
"08/27/2020","Y","Y","Bethel Census Area",50,"Y-K Delta Region",10,3,56,2,56,0,1,0,1
"08/29/2020","Y","Y","Bethel Census Area",50,"Y-K Delta Region",10,2,58,4,60,0,1,0,1
"09/01/2020","Y","Y","Bethel Census Area",50,"Y-K Delta Region",10,0,58,5,65,0,1,0,1
"09/02/2020","Y","Y","Bethel Census Area",50,"Y-K Delta Region",10,0,58,4,69,0,1,0,1
"09/03/2020","Y","Y","Bethel Census Area",50,"Y-K Delta Region",10,0,58,1,70,0,1,0,1
"09/04/2020","Y","Y","Bethel Census Area",50,"Y-K Delta Region",10,0,58,3,73,0,1,0,1
"09/05/2020","Y","Y","Bethel Census Area",50,"Y-K Delta Region",10,8,66,0,73,0,1,0,1
"09/06/2020","Y","Y","Bethel Census Area",50,"Y-K Delta Region",10,4,70,0,73,0,1,0,1
"09/08/2020","Y","Y","Bethel Census Area",50,"Y-K Delta Region",10,1,71,3,76,0,1,0,1
"09/09/2020","Y","Y","Bethel Census Area",50,"Y-K Delta Region",10,2,73,0,76,0,1,0,1
"09/10/2020","Y","Y","Bethel Census Area",50,"Y-K Delta Region",10,0,73,5,81,0,1,0,1
"09/11/2020","Y","Y","Bethel Census Area",50,"Y-K Delta Region",10,6,79,3,84,0,1,0,1
"09/14/2020","Y","Y","Bethel Census Area",50,"Y-K Delta Region",10,5,84,1,85,0,1,0,1
"09/15/2020","Y","Y","Bethel Census Area",50,"Y-K Delta Region",10,0,84,8,93,0,1,0,1
"09/16/2020","Y","Y","Bethel Census Area",50,"Y-K Delta Region",10,1,85,0,93,0,1,0,1
"09/17/2020","Y","Y","Bethel Census Area",50,"Y-K Delta Region",10,2,87,1,94,0,1,0,1
"09/18/2020","Y","Y","Bethel Census Area",50,"Y-K Delta Region",10,2,89,3,97,0,1,0,1
"09/19/2020","Y","Y","Bethel Census Area",50,"Y-K Delta Region",10,5,94,0,97,0,1,0,1
"09/20/2020","Y","Y","Bethel Census Area",50,"Y-K Delta Region",10,0,94,4,101,0,1,0,1
"09/21/2020","Y","Y","Bethel Census Area",50,"Y-K Delta Region",10,0,94,4,105,0,1,0,1
"09/22/2020","Y","Y","Bethel Census Area",50,"Y-K Delta Region",10,1,95,7,112,0,1,0,1
"09/23/2020","Y","Y","Bethel Census Area",50,"Y-K Delta Region",10,6,101,3,115,0,1,0,1
"09/24/2020","Y","Y","Bethel Census Area",50,"Y-K Delta Region",10,2,103,1,116,0,1,0,1
"09/25/2020","Y","Y","Bethel Census Area",50,"Y-K Delta Region",10,2,105,0,116,0,1,0,1
"09/26/2020","Y","Y","Bethel Census Area",50,"Y-K Delta Region",10,2,107,1,117,0,1,0,1
"09/27/2020","Y","Y","Bethel Census Area",50,"Y-K Delta Region",10,2,109,0,117,0,1,0,1
"09/28/2020","Y","Y","Bethel Census Area",50,"Y-K Delta Region",10,0,109,7,124,0,1,0,1
"09/29/2020","Y","Y","Bethel Census Area",50,"Y-K Delta Region",10,4,113,20,144,0,1,0,1
"09/30/2020","Y","Y","Bethel Census Area",50,"Y-K Delta Region",10,1,114,4,148,0,1,0,1
"10/01/2020","Y","Y","Bethel Census Area",50,"Y-K Delta Region",10,3,117,0,148,0,1,0,1
"10/02/2020","Y","Y","Bethel Census Area",50,"Y-K Delta Region",10,0,117,1,149,0,1,0,1
"10/03/2020","Y","Y","Bethel Census Area",50,"Y-K Delta Region",10,0,117,4,153,0,1,0,1
"10/04/2020","Y","Y","Bethel Census Area",50,"Y-K Delta Region",10,4,121,5,158,1,2,0,1
"10/05/2020","Y","Y","Bethel Census Area",50,"Y-K Delta Region",10,15,136,2,160,0,2,0,1
"10/06/2020","Y","Y","Bethel Census Area",50,"Y-K Delta Region",10,1,137,8,168,0,2,0,1
"10/07/2020","Y","Y","Bethel Census Area",50,"Y-K Delta Region",10,15,152,10,178,0,2,0,1
"10/08/2020","Y","Y","Bethel Census Area",50,"Y-K Delta Region",10,10,162,13,191,0,2,0,1
"10/09/2020","Y","Y","Bethel Census Area",50,"Y-K Delta Region",10,5,167,5,196,0,2,0,1
"10/10/2020","Y","Y","Bethel Census Area",50,"Y-K Delta Region",10,12,179,3,199,0,2,0,1
"10/11/2020","Y","Y","Bethel Census Area",50,"Y-K Delta Region",10,3,182,1,200,0,2,0,1
"10/12/2020","Y","Y","Bethel Census Area",50,"Y-K Delta Region",10,4,186,18,218,0,2,0,1
"10/13/2020","Y","Y","Bethel Census Area",50,"Y-K Delta Region",10,2,188,37,255,0,2,0,1
"10/14/2020","Y","Y","Bethel Census Area",50,"Y-K Delta Region",10,28,216,40,295,1,3,0,1
"10/15/2020","Y","Y","Bethel Census Area",50,"Y-K Delta Region",10,14,230,15,310,0,3,0,1
"10/16/2020","Y","Y","Bethel Census Area",50,"Y-K Delta Region",10,7,237,20,330,1,4,0,1
"10/17/2020","Y","Y","Bethel Census Area",50,"Y-K Delta Region",10,19,256,0,330,0,4,1,2
"10/18/2020","Y","Y","Bethel Census Area",50,"Y-K Delta Region",10,4,260,3,333,0,4,0,2
"10/19/2020","Y","Y","Bethel Census Area",50,"Y-K Delta Region",10,13,273,25,358,0,4,1,3
"10/20/2020","Y","Y","Bethel Census Area",50,"Y-K Delta Region",10,12,285,27,385,0,4,0,3
"10/21/2020","Y","Y","Bethel Census Area",50,"Y-K Delta Region",10,46,331,24,409,0,4,0,3
"10/22/2020","Y","Y","Bethel Census Area",50,"Y-K Delta Region",10,6,337,15,424,1,5,0,3
"10/23/2020","Y","Y","Bethel Census Area",50,"Y-K Delta Region",10,28,365,11,435,0,5,0,3
"10/24/2020","Y","Y","Bethel Census Area",50,"Y-K Delta Region",10,20,385,2,437,0,5,0,3
"10/25/2020","Y","Y","Bethel Census Area",50,"Y-K Delta Region",10,2,387,1,438,0,5,0,3
"10/26/2020","Y","Y","Bethel Census Area",50,"Y-K Delta Region",10,9,396,30,468,0,5,0,3
"10/27/2020","Y","Y","Bethel Census Area",50,"Y-K Delta Region",10,7,403,20,488,0,5,0,3
"10/28/2020","Y","Y","Bethel Census Area",50,"Y-K Delta Region",10,14,417,94,582,1,6,0,3
"10/29/2020","Y","Y","Bethel Census Area",50,"Y-K Delta Region",10,20,437,20,602,0,6,0,3
"10/30/2020","Y","Y","Bethel Census Area",50,"Y-K Delta Region",10,34,471,34,636,3,9,0,3
"10/31/2020","Y","Y","Bethel Census Area",50,"Y-K Delta Region",10,9,480,1,637,0,9,0,3
"11/01/2020","Y","Y","Bethel Census Area",50,"Y-K Delta Region",10,13,493,8,645,1,10,0,3
"11/02/2020","Y","Y","Bethel Census Area",50,"Y-K Delta Region",10,26,519,73,718,2,12,0,3
"11/03/2020","Y","Y","Bethel Census Area",50,"Y-K Delta Region",10,20,539,52,770,2,14,0,3
"11/04/2020","Y","Y","Bethel Census Area",50,"Y-K Delta Region",10,39,578,36,806,1,15,0,3
"11/05/2020","Y","Y","Bethel Census Area",50,"Y-K Delta Region",10,29,607,26,832,1,16,0,3
"11/06/2020","Y","Y","Bethel Census Area",50,"Y-K Delta Region",10,28,635,32,864,0,16,0,3
"11/07/2020","Y","Y","Bethel Census Area",50,"Y-K Delta Region",10,29,664,44,908,1,17,0,3
"11/08/2020","Y","Y","Bethel Census Area",50,"Y-K Delta Region",10,41,705,7,915,3,20,0,3
"11/09/2020","Y","Y","Bethel Census Area",50,"Y-K Delta Region",10,72,777,43,958,1,21,0,3
"11/10/2020","Y","Y","Bethel Census Area",50,"Y-K Delta Region",10,50,827,37,995,2,23,1,4
"11/11/2020","Y","Y","Bethel Census Area",50,"Y-K Delta Region",10,24,851,20,1015,1,24,0,4
"11/12/2020","Y","Y","Bethel Census Area",50,"Y-K Delta Region",10,57,908,168,1183,1,25,1,5
"11/13/2020","Y","Y","Bethel Census Area",50,"Y-K Delta Region",10,46,954,118,1301,2,27,0,5
"11/14/2020","Y","Y","Bethel Census Area",50,"Y-K Delta Region",10,17,971,19,1320,1,28,1,6
"11/15/2020","Y","Y","Bethel Census Area",50,"Y-K Delta Region",10,51,1022,159,1479,1,29,0,6
"11/16/2020","Y","Y","Bethel Census Area",50,"Y-K Delta Region",10,16,1038,84,1563,4,33,1,7
"11/17/2020","Y","Y","Bethel Census Area",50,"Y-K Delta Region",10,68,1106,46,1609,0,33,0,7
"11/18/2020","Y","Y","Bethel Census Area",50,"Y-K Delta Region",10,42,1148,30,1639,2,35,0,7
"11/19/2020","Y","Y","Bethel Census Area",50,"Y-K Delta Region",10,32,1180,56,1695,0,35,0,7
"11/20/2020","Y","Y","Bethel Census Area",50,"Y-K Delta Region",10,51,1231,52,1747,0,35,2,9
"11/21/2020","Y","Y","Bethel Census Area",50,"Y-K Delta Region",10,30,1261,24,1771,0,35,0,9
"11/22/2020","Y","Y","Bethel Census Area",50,"Y-K Delta Region",10,71,1332,12,1783,0,35,0,9
"11/23/2020","Y","Y","Bethel Census Area",50,"Y-K Delta Region",10,45,1377,37,1820,0,35,1,10
"11/24/2020","Y","Y","Bethel Census Area",50,"Y-K Delta Region",10,84,1461,14,1834,1,36,0,10
"11/25/2020","Y","Y","Bethel Census Area",50,"Y-K Delta Region",10,36,1497,47,1881,1,37,0,10
"11/26/2020","Y","Y","Bethel Census Area",50,"Y-K Delta Region",10,35,1532,14,1895,0,37,0,10
"11/27/2020","Y","Y","Bethel Census Area",50,"Y-K Delta Region",10,69,1601,31,1926,0,37,0,10
"11/28/2020","Y","Y","Bethel Census Area",50,"Y-K Delta Region",10,92,1693,6,1932,0,37,0,10
"11/29/2020","Y","Y","Bethel Census Area",50,"Y-K Delta Region",10,49,1742,5,1937,1,38,1,11
"11/30/2020","Y","Y","Bethel Census Area",50,"Y-K Delta Region",10,30,1772,29,1966,0,38,1,12
"12/01/2020","Y","Y","Bethel Census Area",50,"Y-K Delta Region",10,22,1794,32,1998,0,38,0,12
"12/02/2020","Y","Y","Bethel Census Area",50,"Y-K Delta Region",10,27,1821,22,2020,1,39,0,12
"12/03/2020","Y","Y","Bethel Census Area",50,"Y-K Delta Region",10,23,1844,32,2052,1,40,0,12
"12/04/2020","Y","Y","Bethel Census Area",50,"Y-K Delta Region",10,53,1897,14,2066,0,40,0,12
"12/05/2020","Y","Y","Bethel Census Area",50,"Y-K Delta Region",10,20,1917,7,2073,0,40,1,13
"12/06/2020","Y","Y","Bethel Census Area",50,"Y-K Delta Region",10,23,1940,34,2107,0,40,0,13
"12/07/2020","Y","Y","Bethel Census Area",50,"Y-K Delta Region",10,76,2016,41,2148,0,40,0,13
"12/08/2020","Y","Y","Bethel Census Area",50,"Y-K Delta Region",10,26,2042,17,2165,0,40,0,13
"12/09/2020","Y","Y","Bethel Census Area",50,"Y-K Delta Region",10,16,2058,56,2221,0,40,0,13
"12/10/2020","Y","Y","Bethel Census Area",50,"Y-K Delta Region",10,24,2082,25,2246,0,40,0,13
"12/11/2020","Y","Y","Bethel Census Area",50,"Y-K Delta Region",10,60,2142,22,2268,0,40,0,13
"12/12/2020","Y","Y","Bethel Census Area",50,"Y-K Delta Region",10,26,2168,22,2290,1,41,0,13
"12/13/2020","Y","Y","Bethel Census Area",50,"Y-K Delta Region",10,13,2181,8,2298,0,41,0,13
"12/14/2020","Y","Y","Bethel Census Area",50,"Y-K Delta Region",10,4,2185,28,2326,0,41,0,13
"12/15/2020","Y","Y","Bethel Census Area",50,"Y-K Delta Region",10,24,2209,29,2355,1,42,0,13
"12/16/2020","Y","Y","Bethel Census Area",50,"Y-K Delta Region",10,21,2230,23,2378,2,44,0,13
"12/17/2020","Y","Y","Bethel Census Area",50,"Y-K Delta Region",10,7,2237,20,2398,0,44,0,13
"12/18/2020","Y","Y","Bethel Census Area",50,"Y-K Delta Region",10,37,2274,25,2423,0,44,0,13
"12/19/2020","Y","Y","Bethel Census Area",50,"Y-K Delta Region",10,14,2288,3,2426,0,44,0,13
"12/20/2020","Y","Y","Bethel Census Area",50,"Y-K Delta Region",10,8,2296,14,2440,1,45,0,13
"12/21/2020","Y","Y","Bethel Census Area",50,"Y-K Delta Region",10,22,2318,42,2482,0,45,1,14
"12/22/2020","Y","Y","Bethel Census Area",50,"Y-K Delta Region",10,18,2336,21,2503,0,45,0,14
"12/23/2020","Y","Y","Bethel Census Area",50,"Y-K Delta Region",10,6,2342,18,2521,0,45,0,14
"12/24/2020","Y","Y","Bethel Census Area",50,"Y-K Delta Region",10,10,2352,6,2527,0,45,1,15
"12/25/2020","Y","Y","Bethel Census Area",50,"Y-K Delta Region",10,14,2366,4,2531,2,47,0,15
"12/26/2020","Y","Y","Bethel Census Area",50,"Y-K Delta Region",10,30,2396,10,2541,0,47,0,15
"12/27/2020","Y","Y","Bethel Census Area",50,"Y-K Delta Region",10,2,2398,11,2552,0,47,0,15
"12/28/2020","Y","Y","Bethel Census Area",50,"Y-K Delta Region",10,5,2403,19,2571,1,48,0,15
"12/29/2020","Y","Y","Bethel Census Area",50,"Y-K Delta Region",10,32,2435,56,2627,0,48,0,15
"12/30/2020","Y","Y","Bethel Census Area",50,"Y-K Delta Region",10,61,2496,15,2642,0,48,0,15
"12/31/2020","Y","Y","Bethel Census Area",50,"Y-K Delta Region",10,46,2542,38,2680,1,49,0,15
"01/01/2021","Y","Y","Bethel Census Area",50,"Y-K Delta Region",10,22,2564,7,2687,1,50,0,15
"01/02/2021","Y","Y","Bethel Census Area",50,"Y-K Delta Region",10,57,2621,4,2691,1,51,0,15
"01/03/2021","Y","Y","Bethel Census Area",50,"Y-K Delta Region",10,26,2647,11,2702,2,53,0,15
"01/04/2021","Y","Y","Bethel Census Area",50,"Y-K Delta Region",10,27,2674,28,2730,1,54,0,15
"01/05/2021","Y","Y","Bethel Census Area",50,"Y-K Delta Region",10,6,2680,46,2776,0,54,0,15
"01/06/2021","Y","Y","Bethel Census Area",50,"Y-K Delta Region",10,10,2690,27,2803,1,55,1,16
"01/07/2021","Y","Y","Bethel Census Area",50,"Y-K Delta Region",10,42,2732,33,2836,1,56,1,17
"01/08/2021","Y","Y","Bethel Census Area",50,"Y-K Delta Region",10,15,2747,43,2879,0,56,0,17
"01/09/2021","Y","Y","Bethel Census Area",50,"Y-K Delta Region",10,28,2775,6,2885,0,56,0,17
"01/10/2021","Y","Y","Bethel Census Area",50,"Y-K Delta Region",10,22,2797,10,2895,0,56,0,17
"01/11/2021","Y","Y","Bethel Census Area",50,"Y-K Delta Region",10,22,2819,35,2930,1,57,0,17
"01/12/2021","Y","Y","Bethel Census Area",50,"Y-K Delta Region",10,45,2864,28,2958,1,58,0,17
"01/13/2021","Y","Y","Bethel Census Area",50,"Y-K Delta Region",10,25,2889,13,2971,0,58,0,17
"01/14/2021","Y","Y","Bethel Census Area",50,"Y-K Delta Region",10,28,2917,47,3018,0,58,0,17
"01/15/2021","Y","Y","Bethel Census Area",50,"Y-K Delta Region",10,21,2938,28,3046,0,58,0,17
"01/16/2021","Y","Y","Bethel Census Area",50,"Y-K Delta Region",10,51,2989,14,3060,0,58,0,17
"01/17/2021","Y","Y","Bethel Census Area",50,"Y-K Delta Region",10,15,3004,8,3068,0,58,0,17
"01/18/2021","Y","Y","Bethel Census Area",50,"Y-K Delta Region",10,26,3030,6,3074,0,58,1,18
"01/19/2021","Y","Y","Bethel Census Area",50,"Y-K Delta Region",10,6,3036,49,3123,0,58,0,18
"01/20/2021","Y","Y","Bethel Census Area",50,"Y-K Delta Region",10,11,3047,40,3163,0,58,0,18
"01/21/2021","Y","Y","Bethel Census Area",50,"Y-K Delta Region",10,18,3065,27,3190,0,58,0,18
"01/22/2021","Y","Y","Bethel Census Area",50,"Y-K Delta Region",10,80,3145,33,3223,1,59,0,18
"01/23/2021","Y","Y","Bethel Census Area",50,"Y-K Delta Region",10,42,3187,9,3232,1,60,0,18
"01/24/2021","Y","Y","Bethel Census Area",50,"Y-K Delta Region",10,4,3191,1,3233,0,60,1,19
"01/25/2021","Y","Y","Bethel Census Area",50,"Y-K Delta Region",10,14,3205,44,3277,0,60,0,19
"01/26/2021","Y","Y","Bethel Census Area",50,"Y-K Delta Region",10,30,3235,37,3314,0,60,1,20
"01/27/2021","Y","Y","Bethel Census Area",50,"Y-K Delta Region",10,47,3282,25,3339,1,61,0,20
"01/28/2021","Y","Y","Bethel Census Area",50,"Y-K Delta Region",10,11,3293,29,3368,0,61,0,20
"01/29/2021","Y","Y","Bethel Census Area",50,"Y-K Delta Region",10,29,3322,18,3386,1,62,0,20
"01/30/2021","Y","Y","Bethel Census Area",50,"Y-K Delta Region",10,24,3346,23,3409,0,62,0,20
"01/31/2021","Y","Y","Bethel Census Area",50,"Y-K Delta Region",10,1,3347,1,3410,0,62,0,20
"02/01/2021","Y","Y","Bethel Census Area",50,"Y-K Delta Region",10,0,3347,11,3421,0,62,0,20
"02/02/2021","Y","Y","Bethel Census Area",50,"Y-K Delta Region",10,7,3354,23,3444,1,63,0,20
"02/03/2021","Y","Y","Bethel Census Area",50,"Y-K Delta Region",10,37,3391,14,3458,1,64,0,20
"02/04/2021","Y","Y","Bethel Census Area",50,"Y-K Delta Region",10,27,3418,24,3482,0,64,0,20
"02/05/2021","Y","Y","Bethel Census Area",50,"Y-K Delta Region",10,13,3431,16,3498,0,64,0,20
"02/06/2021","Y","Y","Bethel Census Area",50,"Y-K Delta Region",10,10,3441,2,3500,0,64,0,20
"02/07/2021","Y","Y","Bethel Census Area",50,"Y-K Delta Region",10,14,3455,4,3504,1,65,0,20
"02/08/2021","Y","Y","Bethel Census Area",50,"Y-K Delta Region",10,24,3479,5,3509,0,65,0,20
"02/09/2021","Y","Y","Bethel Census Area",50,"Y-K Delta Region",10,18,3497,3,3512,0,65,0,20
"02/10/2021","Y","Y","Bethel Census Area",50,"Y-K Delta Region",10,6,3503,1,3513,0,65,0,20
"02/11/2021","Y","Y","Bethel Census Area",50,"Y-K Delta Region",10,2,3505,0,3513,0,65,0,20
"02/12/2021","Y","Y","Bethel Census Area",50,"Y-K Delta Region",10,2,3507,12,3525,0,65,0,20
"02/13/2021","Y","Y","Bethel Census Area",50,"Y-K Delta Region",10,5,3512,2,3527,0,65,0,20
"02/14/2021","Y","Y","Bethel Census Area",50,"Y-K Delta Region",10,0,3512,4,3531,0,65,0,20
"02/15/2021","Y","Y","Bethel Census Area",50,"Y-K Delta Region",10,0,3512,0,3531,0,65,1,21
"02/16/2021","Y","Y","Bethel Census Area",50,"Y-K Delta Region",10,0,3512,10,3541,0,65,0,21
"02/17/2021","Y","Y","Bethel Census Area",50,"Y-K Delta Region",10,16,3528,9,3550,0,65,0,21
"02/18/2021","Y","Y","Bethel Census Area",50,"Y-K Delta Region",10,10,3538,7,3557,0,65,0,21
"02/19/2021","Y","Y","Bethel Census Area",50,"Y-K Delta Region",10,0,3538,4,3561,0,65,0,21
"02/20/2021","Y","Y","Bethel Census Area",50,"Y-K Delta Region",10,18,3556,2,3563,0,65,0,21
"02/21/2021","Y","Y","Bethel Census Area",50,"Y-K Delta Region",10,3,3559,1,3564,0,65,0,21
"02/22/2021","Y","Y","Bethel Census Area",50,"Y-K Delta Region",10,0,3559,5,3569,0,65,0,21
"02/23/2021","Y","Y","Bethel Census Area",50,"Y-K Delta Region",10,6,3565,2,3571,0,65,0,21
"02/24/2021","Y","Y","Bethel Census Area",50,"Y-K Delta Region",10,3,3568,5,3576,0,65,0,21
"02/25/2021","Y","Y","Bethel Census Area",50,"Y-K Delta Region",10,0,3568,5,3581,0,65,0,21
"02/26/2021","Y","Y","Bethel Census Area",50,"Y-K Delta Region",10,5,3573,4,3585,0,65,0,21
"02/27/2021","Y","Y","Bethel Census Area",50,"Y-K Delta Region",10,1,3574,2,3587,0,65,1,22
"03/01/2021","Y","Y","Bethel Census Area",50,"Y-K Delta Region",10,7,3581,9,3596,0,65,0,22
"03/02/2021","Y","Y","Bethel Census Area",50,"Y-K Delta Region",10,11,3592,3,3599,0,65,0,22
"03/03/2021","Y","Y","Bethel Census Area",50,"Y-K Delta Region",10,2,3594,4,3603,0,65,0,22
"03/04/2021","Y","Y","Bethel Census Area",50,"Y-K Delta Region",10,5,3599,4,3607,0,65,0,22
"03/05/2021","Y","Y","Bethel Census Area",50,"Y-K Delta Region",10,2,3601,15,3622,0,65,0,22
"03/07/2021","Y","Y","Bethel Census Area",50,"Y-K Delta Region",10,1,3602,0,3622,0,65,0,22
"03/08/2021","Y","Y","Bethel Census Area",50,"Y-K Delta Region",10,13,3615,16,3638,0,65,0,22
"03/09/2021","Y","Y","Bethel Census Area",50,"Y-K Delta Region",10,5,3620,13,3651,0,65,0,22
"03/10/2021","Y","Y","Bethel Census Area",50,"Y-K Delta Region",10,31,3651,7,3658,0,65,0,22
"03/11/2021","Y","Y","Bethel Census Area",50,"Y-K Delta Region",10,0,3651,10,3668,0,65,0,22
"03/12/2021","Y","Y","Bethel Census Area",50,"Y-K Delta Region",10,17,3668,6,3674,0,65,0,22
"03/13/2021","Y","Y","Bethel Census Area",50,"Y-K Delta Region",10,0,3668,7,3681,0,65,0,22
"03/15/2021","Y","Y","Bethel Census Area",50,"Y-K Delta Region",10,10,3678,14,3695,0,65,0,22
"03/16/2021","Y","Y","Bethel Census Area",50,"Y-K Delta Region",10,1,3679,5,3700,0,65,0,22
"03/17/2021","Y","Y","Bethel Census Area",50,"Y-K Delta Region",10,15,3694,11,3711,0,65,0,22
"03/18/2021","Y","Y","Bethel Census Area",50,"Y-K Delta Region",10,0,3694,10,3721,0,65,0,22
"03/19/2021","Y","Y","Bethel Census Area",50,"Y-K Delta Region",10,25,3719,12,3733,0,65,0,22
"03/20/2021","Y","Y","Bethel Census Area",50,"Y-K Delta Region",10,0,3719,1,3734,0,65,0,22
"03/21/2021","Y","Y","Bethel Census Area",50,"Y-K Delta Region",10,0,3719,11,3745,0,65,0,22
"03/22/2021","Y","Y","Bethel Census Area",50,"Y-K Delta Region",10,14,3733,15,3760,0,65,0,22
"03/23/2021","Y","Y","Bethel Census Area",50,"Y-K Delta Region",10,25,3758,5,3765,0,65,0,22
"03/24/2021","Y","Y","Bethel Census Area",50,"Y-K Delta Region",10,0,3758,3,3768,0,65,0,22
"03/25/2021","Y","Y","Bethel Census Area",50,"Y-K Delta Region",10,1,3759,4,3772,0,65,0,22
"03/26/2021","Y","Y","Bethel Census Area",50,"Y-K Delta Region",10,10,3769,10,3782,0,65,0,22
"03/27/2021","Y","Y","Bethel Census Area",50,"Y-K Delta Region",10,1,3770,0,3782,0,65,0,22
"03/28/2021","Y","Y","Bethel Census Area",50,"Y-K Delta Region",10,2,3772,2,3784,0,65,0,22
"03/29/2021","Y","Y","Bethel Census Area",50,"Y-K Delta Region",10,1,3773,6,3790,0,65,0,22
"03/30/2021","Y","Y","Bethel Census Area",50,"Y-K Delta Region",10,0,3773,4,3794,0,65,0,22
"03/31/2021","Y","Y","Bethel Census Area",50,"Y-K Delta Region",10,15,3788,10,3804,0,65,0,22
"04/01/2021","Y","Y","Bethel Census Area",50,"Y-K Delta Region",10,13,3801,6,3810,0,65,0,22
"04/02/2021","Y","Y","Bethel Census Area",50,"Y-K Delta Region",10,7,3808,7,3817,0,65,0,22
"04/03/2021","Y","Y","Bethel Census Area",50,"Y-K Delta Region",10,0,3808,2,3819,0,65,0,22
"04/05/2021","Y","Y","Bethel Census Area",50,"Y-K Delta Region",10,10,3818,5,3824,0,65,0,22
"04/06/2021","Y","Y","Bethel Census Area",50,"Y-K Delta Region",10,5,3823,5,3829,0,65,0,22
"04/07/2021","Y","Y","Bethel Census Area",50,"Y-K Delta Region",10,4,3827,0,3829,0,65,0,22
"04/08/2021","Y","Y","Bethel Census Area",50,"Y-K Delta Region",10,0,3827,7,3836,0,65,0,22
"04/09/2021","Y","Y","Bethel Census Area",50,"Y-K Delta Region",10,8,3835,1,3837,0,65,0,22
"04/12/2021","Y","Y","Bethel Census Area",50,"Y-K Delta Region",10,0,3835,1,3838,0,65,0,22
"04/13/2021","Y","Y","Bethel Census Area",50,"Y-K Delta Region",10,2,3837,1,3839,0,65,0,22
"04/14/2021","Y","Y","Bethel Census Area",50,"Y-K Delta Region",10,1,3838,3,3842,0,65,0,22
"04/15/2021","Y","Y","Bethel Census Area",50,"Y-K Delta Region",10,3,3841,2,3844,0,65,0,22
"04/17/2021","Y","Y","Bethel Census Area",50,"Y-K Delta Region",10,0,3841,1,3845,0,65,0,22
"04/19/2021","Y","Y","Bethel Census Area",50,"Y-K Delta Region",10,0,3841,5,3850,0,65,0,22
"04/20/2021","Y","Y","Bethel Census Area",50,"Y-K Delta Region",10,6,3847,5,3855,0,65,0,22
"04/21/2021","Y","Y","Bethel Census Area",50,"Y-K Delta Region",10,4,3851,2,3857,0,65,0,22
"04/22/2021","Y","Y","Bethel Census Area",50,"Y-K Delta Region",10,5,3856,2,3859,0,65,0,22
"04/23/2021","Y","Y","Bethel Census Area",50,"Y-K Delta Region",10,2,3858,3,3862,0,65,0,22
"04/27/2021","Y","Y","Bethel Census Area",50,"Y-K Delta Region",10,3,3861,1,3863,0,65,0,22
"04/28/2021","Y","Y","Bethel Census Area",50,"Y-K Delta Region",10,1,3862,1,3864,0,65,0,22
"04/29/2021","Y","Y","Bethel Census Area",50,"Y-K Delta Region",10,1,3863,0,3864,0,65,0,22
"05/02/2021","Y","Y","Bethel Census Area",50,"Y-K Delta Region",10,0,3863,1,3865,0,65,0,22
"05/03/2021","Y","Y","Bethel Census Area",50,"Y-K Delta Region",10,2,3865,6,3871,0,65,0,22
"05/04/2021","Y","Y","Bethel Census Area",50,"Y-K Delta Region",10,5,3870,0,3871,0,65,0,22
"05/07/2021","Y","Y","Bethel Census Area",50,"Y-K Delta Region",10,0,3870,2,3873,0,65,0,22
"05/09/2021","Y","Y","Bethel Census Area",50,"Y-K Delta Region",10,0,3870,1,3874,0,65,0,22
"05/10/2021","Y","Y","Bethel Census Area",50,"Y-K Delta Region",10,2,3872,1,3875,0,65,0,22
"05/11/2021","Y","Y","Bethel Census Area",50,"Y-K Delta Region",10,1,3873,5,3880,0,65,0,22
"05/13/2021","Y","Y","Bethel Census Area",50,"Y-K Delta Region",10,5,3878,1,3881,0,65,0,22
"05/14/2021","Y","Y","Bethel Census Area",50,"Y-K Delta Region",10,0,3878,1,3882,0,65,0,22
"05/17/2021","Y","Y","Bethel Census Area",50,"Y-K Delta Region",10,2,3880,2,3884,0,65,0,22
"05/18/2021","Y","Y","Bethel Census Area",50,"Y-K Delta Region",10,2,3882,0,3884,0,65,0,22
"05/19/2021","Y","Y","Bethel Census Area",50,"Y-K Delta Region",10,0,3882,1,3885,0,65,0,22
"05/20/2021","Y","Y","Bethel Census Area",50,"Y-K Delta Region",10,1,3883,0,3885,0,65,0,22
"05/21/2021","Y","Y","Bethel Census Area",50,"Y-K Delta Region",10,0,3883,1,3886,0,65,0,22
"05/24/2021","Y","Y","Bethel Census Area",50,"Y-K Delta Region",10,1,3884,1,3887,0,65,0,22
"05/25/2021","Y","Y","Bethel Census Area",50,"Y-K Delta Region",10,2,3886,1,3888,0,65,0,22
"05/26/2021","Y","Y","Bethel Census Area",50,"Y-K Delta Region",10,1,3887,1,3889,0,65,0,22
"05/27/2021","Y","Y","Bethel Census Area",50,"Y-K Delta Region",10,1,3888,0,3889,0,65,0,22
"05/28/2021","Y","Y","Bethel Census Area",50,"Y-K Delta Region",10,0,3888,0,3889,0,65,1,23
"05/30/2021","Y","Y","Bethel Census Area",50,"Y-K Delta Region",10,0,3888,1,3890,0,65,0,23
"05/31/2021","Y","Y","Bethel Census Area",50,"Y-K Delta Region",10,1,3889,0,3890,0,65,0,23
"06/02/2021","Y","Y","Bethel Census Area",50,"Y-K Delta Region",10,0,3889,2,3892,0,65,0,23
"06/03/2021","Y","Y","Bethel Census Area",50,"Y-K Delta Region",10,2,3891,1,3893,0,65,0,23
"06/04/2021","Y","Y","Bethel Census Area",50,"Y-K Delta Region",10,1,3892,0,3893,0,65,0,23
"06/08/2021","Y","Y","Bethel Census Area",50,"Y-K Delta Region",10,0,3892,2,3895,0,65,0,23
"06/09/2021","Y","Y","Bethel Census Area",50,"Y-K Delta Region",10,2,3894,1,3896,0,65,0,23
"06/10/2021","Y","Y","Bethel Census Area",50,"Y-K Delta Region",10,1,3895,0,3896,0,65,0,23
"06/15/2021","Y","Y","Bethel Census Area",50,"Y-K Delta Region",10,0,3895,2,3898,0,65,0,23
"06/16/2021","Y","Y","Bethel Census Area",50,"Y-K Delta Region",10,1,3896,1,3899,0,65,0,23
"06/17/2021","Y","Y","Bethel Census Area",50,"Y-K Delta Region",10,2,3898,1,3900,0,65,0,23
"06/18/2021","Y","Y","Bethel Census Area",50,"Y-K Delta Region",10,0,3898,2,3902,0,65,0,23
"06/19/2021","Y","Y","Bethel Census Area",50,"Y-K Delta Region",10,1,3899,0,3902,0,65,0,23
"06/21/2021","Y","Y","Bethel Census Area",50,"Y-K Delta Region",10,2,3901,2,3904,0,65,0,23
"06/22/2021","Y","Y","Bethel Census Area",50,"Y-K Delta Region",10,1,3902,0,3904,0,65,0,23
"06/24/2021","Y","Y","Bethel Census Area",50,"Y-K Delta Region",10,1,3903,5,3909,0,65,0,23
"06/25/2021","Y","Y","Bethel Census Area",50,"Y-K Delta Region",10,4,3907,1,3910,0,65,0,23
"06/26/2021","Y","Y","Bethel Census Area",50,"Y-K Delta Region",10,1,3908,0,3910,0,65,0,23
"06/28/2021","Y","Y","Bethel Census Area",50,"Y-K Delta Region",10,1,3909,1,3911,0,65,0,23
"06/29/2021","Y","Y","Bethel Census Area",50,"Y-K Delta Region",10,0,3909,1,3912,0,65,0,23
"06/30/2021","Y","Y","Bethel Census Area",50,"Y-K Delta Region",10,2,3911,0,3912,0,65,0,23
"07/05/2021","Y","Y","Bethel Census Area",50,"Y-K Delta Region",10,0,3911,1,3913,0,65,0,23
"07/06/2021","Y","Y","Bethel Census Area",50,"Y-K Delta Region",10,1,3912,4,3917,0,65,0,23
"07/07/2021","Y","Y","Bethel Census Area",50,"Y-K Delta Region",10,4,3916,1,3918,0,65,0,23
"07/08/2021","Y","Y","Bethel Census Area",50,"Y-K Delta Region",10,1,3917,2,3920,0,65,0,23
"07/09/2021","Y","Y","Bethel Census Area",50,"Y-K Delta Region",10,2,3919,1,3921,0,65,0,23
"07/12/2021","Y","Y","Bethel Census Area",50,"Y-K Delta Region",10,1,3920,0,3921,0,65,0,23
"07/13/2021","Y","Y","Bethel Census Area",50,"Y-K Delta Region",10,0,3920,2,3923,0,65,0,23
"07/14/2021","Y","Y","Bethel Census Area",50,"Y-K Delta Region",10,3,3923,2,3925,0,65,0,23
"07/15/2021","Y","Y","Bethel Census Area",50,"Y-K Delta Region",10,1,3924,0,3925,0,65,0,23
"07/16/2021","Y","Y","Bethel Census Area",50,"Y-K Delta Region",10,1,3925,4,3929,0,65,0,23
"07/17/2021","Y","Y","Bethel Census Area",50,"Y-K Delta Region",10,1,3926,0,3929,0,65,0,23
"07/19/2021","Y","Y","Bethel Census Area",50,"Y-K Delta Region",10,0,3926,13,3942,0,65,0,23
"07/20/2021","Y","Y","Bethel Census Area",50,"Y-K Delta Region",10,13,3939,16,3958,0,65,0,23
"07/21/2021","Y","Y","Bethel Census Area",50,"Y-K Delta Region",10,3,3942,11,3969,0,65,0,23
"07/22/2021","Y","Y","Bethel Census Area",50,"Y-K Delta Region",10,16,3958,9,3978,0,65,0,23
"07/23/2021","Y","Y","Bethel Census Area",50,"Y-K Delta Region",10,10,3968,14,3992,0,65,0,23
"07/25/2021","Y","Y","Bethel Census Area",50,"Y-K Delta Region",10,0,3968,1,3993,0,65,0,23
"07/26/2021","Y","Y","Bethel Census Area",50,"Y-K Delta Region",10,0,3968,14,4007,0,65,0,23
"07/27/2021","Y","Y","Bethel Census Area",50,"Y-K Delta Region",10,25,3993,4,4011,0,65,0,23
"07/28/2021","Y","Y","Bethel Census Area",50,"Y-K Delta Region",10,13,4006,2,4013,0,65,0,23
"07/29/2021","Y","Y","Bethel Census Area",50,"Y-K Delta Region",10,5,4011,13,4026,0,65,0,23
"07/30/2021","Y","Y","Bethel Census Area",50,"Y-K Delta Region",10,6,4017,9,4035,0,65,0,23
"07/31/2021","Y","Y","Bethel Census Area",50,"Y-K Delta Region",10,1,4018,2,4037,0,65,0,23
"08/01/2021","Y","Y","Bethel Census Area",50,"Y-K Delta Region",10,0,4018,3,4040,0,65,0,23
"08/02/2021","Y","Y","Bethel Census Area",50,"Y-K Delta Region",10,20,4038,3,4043,1,66,0,23
"08/03/2021","Y","Y","Bethel Census Area",50,"Y-K Delta Region",10,3,4041,3,4046,1,67,0,23
"08/04/2021","Y","Y","Bethel Census Area",50,"Y-K Delta Region",10,2,4043,4,4050,0,67,0,23
"08/05/2021","Y","Y","Bethel Census Area",50,"Y-K Delta Region",10,2,4045,8,4058,0,67,0,23
"08/06/2021","Y","Y","Bethel Census Area",50,"Y-K Delta Region",10,3,4048,7,4065,0,67,0,23
"08/07/2021","Y","Y","Bethel Census Area",50,"Y-K Delta Region",10,2,4050,3,4068,0,67,0,23
"08/08/2021","Y","Y","Bethel Census Area",50,"Y-K Delta Region",10,8,4058,4,4072,1,68,0,23
"08/09/2021","Y","Y","Bethel Census Area",50,"Y-K Delta Region",10,3,4061,13,4085,0,68,0,23
"08/10/2021","Y","Y","Bethel Census Area",50,"Y-K Delta Region",10,4,4065,14,4099,0,68,0,23
"08/11/2021","Y","Y","Bethel Census Area",50,"Y-K Delta Region",10,1,4066,8,4107,0,68,0,23
"08/12/2021","Y","Y","Bethel Census Area",50,"Y-K Delta Region",10,3,4069,14,4121,0,68,0,23
"08/13/2021","Y","Y","Bethel Census Area",50,"Y-K Delta Region",10,14,4083,18,4139,0,68,0,23
"08/14/2021","Y","Y","Bethel Census Area",50,"Y-K Delta Region",10,13,4096,2,4141,0,68,0,23
"08/15/2021","Y","Y","Bethel Census Area",50,"Y-K Delta Region",10,4,4100,1,4142,0,68,0,23
"08/16/2021","Y","Y","Bethel Census Area",50,"Y-K Delta Region",10,3,4103,38,4180,0,68,0,23
"08/17/2021","Y","Y","Bethel Census Area",50,"Y-K Delta Region",10,8,4111,20,4200,0,68,0,23
"08/18/2021","Y","Y","Bethel Census Area",50,"Y-K Delta Region",10,18,4129,13,4213,0,68,1,24
"08/19/2021","Y","Y","Bethel Census Area",50,"Y-K Delta Region",10,35,4164,28,4241,0,68,0,24
"08/20/2021","Y","Y","Bethel Census Area",50,"Y-K Delta Region",10,35,4199,12,4253,0,68,0,24
"08/21/2021","Y","Y","Bethel Census Area",50,"Y-K Delta Region",10,4,4203,2,4255,0,68,0,24
"08/22/2021","Y","Y","Bethel Census Area",50,"Y-K Delta Region",10,10,4213,8,4263,0,68,0,24
"08/23/2021","Y","Y","Bethel Census Area",50,"Y-K Delta Region",10,7,4220,32,4295,0,68,1,25
"08/24/2021","Y","Y","Bethel Census Area",50,"Y-K Delta Region",10,1,4221,21,4316,0,68,0,25
"08/25/2021","Y","Y","Bethel Census Area",50,"Y-K Delta Region",10,5,4226,18,4334,0,68,0,25
"08/26/2021","Y","Y","Bethel Census Area",50,"Y-K Delta Region",10,24,4250,33,4367,0,68,0,25
"08/27/2021","Y","Y","Bethel Census Area",50,"Y-K Delta Region",10,104,4354,31,4398,0,68,0,25
"08/28/2021","Y","Y","Bethel Census Area",50,"Y-K Delta Region",10,4,4358,12,4410,0,68,0,25
"08/29/2021","Y","Y","Bethel Census Area",50,"Y-K Delta Region",10,2,4360,0,4410,0,68,0,25
"08/30/2021","Y","Y","Bethel Census Area",50,"Y-K Delta Region",10,28,4388,24,4434,0,68,0,25
"08/31/2021","Y","Y","Bethel Census Area",50,"Y-K Delta Region",10,28,4416,13,4447,0,68,0,25
"09/01/2021","Y","Y","Bethel Census Area",50,"Y-K Delta Region",10,14,4430,21,4468,0,68,0,25
"09/02/2021","Y","Y","Bethel Census Area",50,"Y-K Delta Region",10,2,4432,31,4499,0,68,0,25
"09/03/2021","Y","Y","Bethel Census Area",50,"Y-K Delta Region",10,58,4490,30,4529,0,68,0,25
"09/04/2021","Y","Y","Bethel Census Area",50,"Y-K Delta Region",10,1,4491,2,4531,0,68,0,25
"09/05/2021","Y","Y","Bethel Census Area",50,"Y-K Delta Region",10,3,4494,6,4537,0,68,0,25
"09/06/2021","Y","Y","Bethel Census Area",50,"Y-K Delta Region",10,4,4498,7,4544,0,68,0,25
"09/07/2021","Y","Y","Bethel Census Area",50,"Y-K Delta Region",10,6,4504,61,4605,0,68,0,25
"09/08/2021","Y","Y","Bethel Census Area",50,"Y-K Delta Region",10,53,4557,36,4641,0,68,0,25
"09/09/2021","Y","Y","Bethel Census Area",50,"Y-K Delta Region",10,51,4608,31,4672,0,68,0,25
"09/10/2021","Y","Y","Bethel Census Area",50,"Y-K Delta Region",10,26,4634,9,4681,0,68,0,25
"09/11/2021","Y","Y","Bethel Census Area",50,"Y-K Delta Region",10,6,4640,1,4682,0,68,0,25
"09/12/2021","Y","Y","Bethel Census Area",50,"Y-K Delta Region",10,2,4642,4,4686,0,68,1,26
"09/13/2021","Y","Y","Bethel Census Area",50,"Y-K Delta Region",10,3,4645,49,4735,0,68,0,26
"09/14/2021","Y","Y","Bethel Census Area",50,"Y-K Delta Region",10,39,4684,46,4781,0,68,0,26
"09/15/2021","Y","Y","Bethel Census Area",50,"Y-K Delta Region",10,46,4730,35,4816,1,69,0,26
"09/16/2021","Y","Y","Bethel Census Area",50,"Y-K Delta Region",10,51,4781,32,4848,0,69,0,26
"09/17/2021","Y","Y","Bethel Census Area",50,"Y-K Delta Region",10,25,4806,25,4873,1,70,0,26
"09/18/2021","Y","Y","Bethel Census Area",50,"Y-K Delta Region",10,10,4816,7,4880,0,70,0,26
"09/19/2021","Y","Y","Bethel Census Area",50,"Y-K Delta Region",10,3,4819,1,4881,0,70,0,26
"09/20/2021","Y","Y","Bethel Census Area",50,"Y-K Delta Region",10,25,4844,41,4922,0,70,0,26
"09/21/2021","Y","Y","Bethel Census Area",50,"Y-K Delta Region",10,38,4882,37,4959,1,71,0,26
"09/22/2021","Y","Y","Bethel Census Area",50,"Y-K Delta Region",10,42,4924,25,4984,0,71,0,26
"09/23/2021","Y","Y","Bethel Census Area",50,"Y-K Delta Region",10,27,4951,23,5007,0,71,0,26
"09/24/2021","Y","Y","Bethel Census Area",50,"Y-K Delta Region",10,22,4973,27,5034,0,71,0,26
"09/25/2021","Y","Y","Bethel Census Area",50,"Y-K Delta Region",10,11,4984,7,5041,0,71,0,26
"09/26/2021","Y","Y","Bethel Census Area",50,"Y-K Delta Region",10,8,4992,7,5048,0,71,0,26
"09/27/2021","Y","Y","Bethel Census Area",50,"Y-K Delta Region",10,35,5027,32,5080,0,71,0,26
"09/28/2021","Y","Y","Bethel Census Area",50,"Y-K Delta Region",10,28,5055,41,5121,0,71,0,26
"09/29/2021","Y","Y","Bethel Census Area",50,"Y-K Delta Region",10,55,5110,65,5186,1,72,1,27
"09/30/2021","Y","Y","Bethel Census Area",50,"Y-K Delta Region",10,66,5176,25,5211,0,72,1,28
"10/01/2021","Y","Y","Bethel Census Area",50,"Y-K Delta Region",10,28,5204,39,5250,1,73,0,28
"10/02/2021","Y","Y","Bethel Census Area",50,"Y-K Delta Region",10,9,5213,5,5255,0,73,0,28
"10/03/2021","Y","Y","Bethel Census Area",50,"Y-K Delta Region",10,1,5214,27,5282,0,73,0,28
"10/04/2021","Y","Y","Bethel Census Area",50,"Y-K Delta Region",10,61,5275,46,5328,0,73,0,28
"10/05/2021","Y","Y","Bethel Census Area",50,"Y-K Delta Region",10,38,5313,42,5370,0,73,1,29
"10/06/2021","Y","Y","Bethel Census Area",50,"Y-K Delta Region",10,49,5362,47,5417,0,73,0,29
"10/07/2021","Y","Y","Bethel Census Area",50,"Y-K Delta Region",10,47,5409,29,5446,0,73,0,29
"10/08/2021","Y","Y","Bethel Census Area",50,"Y-K Delta Region",10,31,5440,55,5501,0,73,0,29
"10/09/2021","Y","Y","Bethel Census Area",50,"Y-K Delta Region",10,5,5445,4,5505,0,73,1,30
"10/10/2021","Y","Y","Bethel Census Area",50,"Y-K Delta Region",10,2,5447,5,5510,1,74,0,30
"10/11/2021","Y","Y","Bethel Census Area",50,"Y-K Delta Region",10,56,5503,43,5553,0,74,0,30
"10/12/2021","Y","Y","Bethel Census Area",50,"Y-K Delta Region",10,42,5545,29,5582,1,75,0,30
"10/13/2021","Y","Y","Bethel Census Area",50,"Y-K Delta Region",10,29,5574,36,5618,0,75,0,30
"10/14/2021","Y","Y","Bethel Census Area",50,"Y-K Delta Region",10,34,5608,66,5684,0,75,0,30
"10/15/2021","Y","Y","Bethel Census Area",50,"Y-K Delta Region",10,66,5674,32,5716,0,75,0,30
"10/16/2021","Y","Y","Bethel Census Area",50,"Y-K Delta Region",10,10,5684,8,5724,0,75,0,30
"10/17/2021","Y","Y","Bethel Census Area",50,"Y-K Delta Region",10,5,5689,4,5728,0,75,0,30
"10/18/2021","Y","Y","Bethel Census Area",50,"Y-K Delta Region",10,3,5692,44,5772,0,75,0,30
"10/19/2021","Y","Y","Bethel Census Area",50,"Y-K Delta Region",10,67,5759,28,5800,0,75,0,30
"10/20/2021","Y","Y","Bethel Census Area",50,"Y-K Delta Region",10,28,5787,17,5817,1,76,1,31
"10/21/2021","Y","Y","Bethel Census Area",50,"Y-K Delta Region",10,23,5810,27,5844,0,76,0,31
"10/22/2021","Y","Y","Bethel Census Area",50,"Y-K Delta Region",10,28,5838,22,5866,0,76,0,31
"10/23/2021","Y","Y","Bethel Census Area",50,"Y-K Delta Region",10,1,5839,10,5876,0,76,0,31
"10/24/2021","Y","Y","Bethel Census Area",50,"Y-K Delta Region",10,3,5842,2,5878,0,76,1,32
"10/25/2021","Y","Y","Bethel Census Area",50,"Y-K Delta Region",10,23,5865,25,5903,0,76,0,32
"10/26/2021","Y","Y","Bethel Census Area",50,"Y-K Delta Region",10,15,5880,41,5944,1,77,0,32
"10/27/2021","Y","Y","Bethel Census Area",50,"Y-K Delta Region",10,21,5901,32,5976,0,77,0,32
"10/28/2021","Y","Y","Bethel Census Area",50,"Y-K Delta Region",10,68,5969,24,6000,0,77,0,32
"10/29/2021","Y","Y","Bethel Census Area",50,"Y-K Delta Region",10,7,5976,64,6064,0,77,0,32
"10/30/2021","Y","Y","Bethel Census Area",50,"Y-K Delta Region",10,16,5992,6,6070,0,77,1,33
"10/31/2021","Y","Y","Bethel Census Area",50,"Y-K Delta Region",10,10,6002,5,6075,0,77,0,33
"11/01/2021","Y","Y","Bethel Census Area",50,"Y-K Delta Region",10,2,6004,46,6121,0,77,1,34
"11/02/2021","Y","Y","Bethel Census Area",50,"Y-K Delta Region",10,4,6008,43,6164,0,77,0,34
"11/03/2021","Y","Y","Bethel Census Area",50,"Y-K Delta Region",10,152,6160,31,6195,1,78,0,34
"11/04/2021","Y","Y","Bethel Census Area",50,"Y-K Delta Region",10,30,6190,18,6213,0,78,0,34
"11/05/2021","Y","Y","Bethel Census Area",50,"Y-K Delta Region",10,3,6193,34,6247,0,78,1,35
"11/06/2021","Y","Y","Bethel Census Area",50,"Y-K Delta Region",10,21,6214,12,6259,0,78,0,35
"11/07/2021","Y","Y","Bethel Census Area",50,"Y-K Delta Region",10,12,6226,2,6261,0,78,0,35
"11/08/2021","Y","Y","Bethel Census Area",50,"Y-K Delta Region",10,24,6250,68,6329,1,79,0,35
"11/09/2021","Y","Y","Bethel Census Area",50,"Y-K Delta Region",10,71,6321,26,6355,0,79,0,35
"11/10/2021","Y","Y","Bethel Census Area",50,"Y-K Delta Region",10,13,6334,35,6390,0,79,0,35
"11/11/2021","Y","Y","Bethel Census Area",50,"Y-K Delta Region",10,17,6351,4,6394,0,79,0,35
"11/12/2021","Y","Y","Bethel Census Area",50,"Y-K Delta Region",10,35,6386,56,6450,0,79,0,35
"11/13/2021","Y","Y","Bethel Census Area",50,"Y-K Delta Region",10,5,6391,4,6454,0,79,0,35
"11/14/2021","Y","Y","Bethel Census Area",50,"Y-K Delta Region",10,22,6413,7,6461,0,79,0,35
"11/15/2021","Y","Y","Bethel Census Area",50,"Y-K Delta Region",10,43,6456,44,6505,0,79,1,36
"11/16/2021","Y","Y","Bethel Census Area",50,"Y-K Delta Region",10,38,6494,53,6558,0,79,0,36
"11/17/2021","Y","Y","Bethel Census Area",50,"Y-K Delta Region",10,46,6540,28,6586,0,79,0,36
"11/18/2021","Y","Y","Bethel Census Area",50,"Y-K Delta Region",10,42,6582,20,6606,0,79,0,36
"11/19/2021","Y","Y","Bethel Census Area",50,"Y-K Delta Region",10,19,6601,21,6627,0,79,0,36
"11/20/2021","Y","Y","Bethel Census Area",50,"Y-K Delta Region",10,9,6610,5,6632,0,79,1,37
"11/21/2021","Y","Y","Bethel Census Area",50,"Y-K Delta Region",10,4,6614,4,6636,0,79,0,37
"11/22/2021","Y","Y","Bethel Census Area",50,"Y-K Delta Region",10,18,6632,32,6668,0,79,0,37
"11/23/2021","Y","Y","Bethel Census Area",50,"Y-K Delta Region",10,30,6662,33,6701,0,79,0,37
"11/24/2021","Y","Y","Bethel Census Area",50,"Y-K Delta Region",10,23,6685,32,6733,0,79,0,37
"11/25/2021","Y","Y","Bethel Census Area",50,"Y-K Delta Region",10,9,6694,2,6735,0,79,0,37
"11/26/2021","Y","Y","Bethel Census Area",50,"Y-K Delta Region",10,32,6726,21,6756,0,79,0,37
"11/27/2021","Y","Y","Bethel Census Area",50,"Y-K Delta Region",10,10,6736,2,6758,0,79,1,38
"11/28/2021","Y","Y","Bethel Census Area",50,"Y-K Delta Region",10,7,6743,3,6761,0,79,0,38
"11/29/2021","Y","Y","Bethel Census Area",50,"Y-K Delta Region",10,15,6758,9,6770,0,79,0,38
"11/30/2021","Y","Y","Bethel Census Area",50,"Y-K Delta Region",10,17,6775,11,6781,0,79,0,38
"12/01/2021","Y","Y","Bethel Census Area",50,"Y-K Delta Region",10,18,6793,25,6806,0,79,0,38
"12/02/2021","Y","Y","Bethel Census Area",50,"Y-K Delta Region",10,19,6812,9,6815,0,79,0,38
"12/03/2021","Y","Y","Bethel Census Area",50,"Y-K Delta Region",10,8,6820,8,6823,0,79,0,38
"12/04/2021","Y","Y","Bethel Census Area",50,"Y-K Delta Region",10,1,6821,1,6824,0,79,0,38
"12/05/2021","Y","Y","Bethel Census Area",50,"Y-K Delta Region",10,1,6822,0,6824,0,79,1,39
"12/06/2021","Y","Y","Bethel Census Area",50,"Y-K Delta Region",10,7,6829,9,6833,0,79,0,39
"12/07/2021","Y","Y","Bethel Census Area",50,"Y-K Delta Region",10,5,6834,5,6838,0,79,0,39
"12/08/2021","Y","Y","Bethel Census Area",50,"Y-K Delta Region",10,6,6840,5,6843,0,79,0,39
"12/09/2021","Y","Y","Bethel Census Area",50,"Y-K Delta Region",10,5,6845,7,6850,0,79,0,39
"12/10/2021","Y","Y","Bethel Census Area",50,"Y-K Delta Region",10,17,6862,14,6864,0,79,0,39
"12/11/2021","Y","Y","Bethel Census Area",50,"Y-K Delta Region",10,0,6862,1,6865,0,79,0,39
"12/13/2021","Y","Y","Bethel Census Area",50,"Y-K Delta Region",10,0,6862,3,6868,0,79,0,39
"12/14/2021","Y","Y","Bethel Census Area",50,"Y-K Delta Region",10,12,6874,9,6877,0,79,0,39
"12/15/2021","Y","Y","Bethel Census Area",50,"Y-K Delta Region",10,4,6878,3,6880,0,79,0,39
"12/16/2021","Y","Y","Bethel Census Area",50,"Y-K Delta Region",10,4,6882,5,6885,0,79,0,39
"12/17/2021","Y","Y","Bethel Census Area",50,"Y-K Delta Region",10,7,6889,5,6890,0,79,0,39
"12/18/2021","Y","Y","Bethel Census Area",50,"Y-K Delta Region",10,0,6889,4,6894,0,79,0,39
"12/19/2021","Y","Y","Bethel Census Area",50,"Y-K Delta Region",10,4,6893,3,6897,0,79,0,39
"12/20/2021","Y","Y","Bethel Census Area",50,"Y-K Delta Region",10,4,6897,5,6902,0,79,0,39
"12/21/2021","Y","Y","Bethel Census Area",50,"Y-K Delta Region",10,2,6899,0,6902,0,79,0,39
"12/22/2021","Y","Y","Bethel Census Area",50,"Y-K Delta Region",10,8,6907,7,6909,0,79,0,39
"12/23/2021","Y","Y","Bethel Census Area",50,"Y-K Delta Region",10,2,6909,2,6911,0,79,0,39
"12/24/2021","Y","Y","Bethel Census Area",50,"Y-K Delta Region",10,1,6910,2,6913,0,79,0,39
"12/26/2021","Y","Y","Bethel Census Area",50,"Y-K Delta Region",10,1,6911,0,6913,0,79,0,39
"12/27/2021","Y","Y","Bethel Census Area",50,"Y-K Delta Region",10,2,6913,9,6922,0,79,0,39
"12/28/2021","Y","Y","Bethel Census Area",50,"Y-K Delta Region",10,15,6928,10,6932,0,79,0,39
"12/29/2021","Y","Y","Bethel Census Area",50,"Y-K Delta Region",10,1,6929,3,6935,0,79,0,39
"12/30/2021","Y","Y","Bethel Census Area",50,"Y-K Delta Region",10,15,6944,16,6951,0,79,0,39
"12/31/2021","Y","Y","Bethel Census Area",50,"Y-K Delta Region",10,4,6948,7,6958,0,79,0,39
"01/01/2022","Y","Y","Bethel Census Area",50,"Y-K Delta Region",10,2,6950,0,6958,0,79,0,39
"01/02/2022","Y","Y","Bethel Census Area",50,"Y-K Delta Region",10,1,6951,1,6959,0,79,0,39
"01/03/2022","Y","Y","Bethel Census Area",50,"Y-K Delta Region",10,7,6958,17,6976,0,79,0,39
"01/04/2022","Y","Y","Bethel Census Area",50,"Y-K Delta Region",10,16,6974,14,6990,0,79,0,39
"01/05/2022","Y","Y","Bethel Census Area",50,"Y-K Delta Region",10,19,6993,18,7008,0,79,0,39
"01/06/2022","Y","Y","Bethel Census Area",50,"Y-K Delta Region",10,38,7031,40,7048,0,79,0,39
"01/07/2022","Y","Y","Bethel Census Area",50,"Y-K Delta Region",10,21,7052,37,7085,0,79,0,39
"01/08/2022","Y","Y","Bethel Census Area",50,"Y-K Delta Region",10,6,7058,10,7095,1,80,0,39
"01/09/2022","Y","Y","Bethel Census Area",50,"Y-K Delta Region",10,12,7070,7,7102,0,80,0,39
"01/10/2022","Y","Y","Bethel Census Area",50,"Y-K Delta Region",10,35,7105,56,7158,0,80,0,39
"01/11/2022","Y","Y","Bethel Census Area",50,"Y-K Delta Region",10,51,7156,50,7208,0,80,0,39
"01/12/2022","Y","Y","Bethel Census Area",50,"Y-K Delta Region",10,65,7221,64,7272,0,80,0,39
"01/13/2022","Y","Y","Bethel Census Area",50,"Y-K Delta Region",10,63,7284,68,7340,0,80,0,39
"01/14/2022","Y","Y","Bethel Census Area",50,"Y-K Delta Region",10,44,7328,48,7388,0,80,0,39
"01/15/2022","Y","Y","Bethel Census Area",50,"Y-K Delta Region",10,25,7353,18,7406,0,80,0,39
"01/16/2022","Y","Y","Bethel Census Area",50,"Y-K Delta Region",10,10,7363,5,7411,0,80,0,39
"01/17/2022","Y","Y","Bethel Census Area",50,"Y-K Delta Region",10,19,7382,20,7431,0,80,0,39
"01/18/2022","Y","Y","Bethel Census Area",50,"Y-K Delta Region",10,79,7461,89,7520,0,80,0,39
"01/19/2022","Y","Y","Bethel Census Area",50,"Y-K Delta Region",10,72,7533,77,7597,1,81,0,39
"01/20/2022","Y","Y","Bethel Census Area",50,"Y-K Delta Region",10,74,7607,70,7667,0,81,0,39
"01/21/2022","Y","Y","Bethel Census Area",50,"Y-K Delta Region",10,45,7652,67,7734,0,81,0,39
"01/22/2022","Y","Y","Bethel Census Area",50,"Y-K Delta Region",10,29,7681,7,7741,0,81,0,39
"01/23/2022","Y","Y","Bethel Census Area",50,"Y-K Delta Region",10,14,7695,13,7754,0,81,0,39
"01/24/2022","Y","Y","Bethel Census Area",50,"Y-K Delta Region",10,70,7765,97,7851,0,81,0,39
"01/25/2022","Y","Y","Bethel Census Area",50,"Y-K Delta Region",10,91,7856,80,7931,0,81,0,39
"01/26/2022","Y","Y","Bethel Census Area",50,"Y-K Delta Region",10,62,7918,73,8004,0,81,0,39
"01/27/2022","Y","Y","Bethel Census Area",50,"Y-K Delta Region",10,62,7980,64,8068,0,81,0,39
"01/28/2022","Y","Y","Bethel Census Area",50,"Y-K Delta Region",10,25,8005,48,8116,1,82,0,39
"01/29/2022","Y","Y","Bethel Census Area",50,"Y-K Delta Region",10,58,8063,15,8131,1,83,0,39
"01/30/2022","Y","Y","Bethel Census Area",50,"Y-K Delta Region",10,3,8066,13,8144,0,83,0,39
"01/31/2022","Y","Y","Bethel Census Area",50,"Y-K Delta Region",10,106,8172,123,8267,0,83,0,39
"02/01/2022","Y","Y","Bethel Census Area",50,"Y-K Delta Region",10,81,8253,75,8342,0,83,0,39
"02/02/2022","Y","Y","Bethel Census Area",50,"Y-K Delta Region",10,148,8401,137,8479,0,83,0,39
"02/03/2022","Y","Y","Bethel Census Area",50,"Y-K Delta Region",10,84,8485,66,8545,0,83,0,39
"02/04/2022","Y","Y","Bethel Census Area",50,"Y-K Delta Region",10,118,8603,143,8688,0,83,1,40
"02/05/2022","Y","Y","Bethel Census Area",50,"Y-K Delta Region",10,26,8629,15,8703,0,83,0,40
"02/06/2022","Y","Y","Bethel Census Area",50,"Y-K Delta Region",10,23,8652,10,8713,0,83,0,40
"02/07/2022","Y","Y","Bethel Census Area",50,"Y-K Delta Region",10,23,8675,106,8819,0,83,0,40
"02/08/2022","Y","Y","Bethel Census Area",50,"Y-K Delta Region",10,39,8714,57,8876,0,83,0,40
"02/09/2022","Y","Y","Bethel Census Area",50,"Y-K Delta Region",10,40,8754,94,8970,0,83,0,40
"02/10/2022","Y","Y","Bethel Census Area",50,"Y-K Delta Region",10,9,8763,37,9007,0,83,0,40
"02/11/2022","Y","Y","Bethel Census Area",50,"Y-K Delta Region",10,29,8792,48,9055,0,83,0,40
"02/12/2022","Y","Y","Bethel Census Area",50,"Y-K Delta Region",10,16,8808,15,9070,0,83,0,40
"02/13/2022","Y","Y","Bethel Census Area",50,"Y-K Delta Region",10,4,8812,9,9079,0,83,0,40
"02/14/2022","Y","Y","Bethel Census Area",50,"Y-K Delta Region",10,12,8824,98,9177,0,83,0,40
"02/15/2022","Y","Y","Bethel Census Area",50,"Y-K Delta Region",10,14,8838,79,9256,0,83,0,40
"02/16/2022","Y","Y","Bethel Census Area",50,"Y-K Delta Region",10,17,8855,54,9310,0,83,0,40
"02/17/2022","Y","Y","Bethel Census Area",50,"Y-K Delta Region",10,21,8876,56,9366,0,83,0,40
"02/18/2022","Y","Y","Bethel Census Area",50,"Y-K Delta Region",10,18,8894,44,9410,0,83,0,40
"02/19/2022","Y","Y","Bethel Census Area",50,"Y-K Delta Region",10,10,8904,8,9418,0,83,0,40
"02/20/2022","Y","Y","Bethel Census Area",50,"Y-K Delta Region",10,11,8915,16,9434,0,83,0,40
"02/21/2022","Y","Y","Bethel Census Area",50,"Y-K Delta Region",10,5,8920,17,9451,0,83,0,40
"02/22/2022","Y","Y","Bethel Census Area",50,"Y-K Delta Region",10,4,8924,56,9507,0,83,0,40
"02/23/2022","Y","Y","Bethel Census Area",50,"Y-K Delta Region",10,8,8932,33,9540,1,84,0,40
"02/24/2022","Y","Y","Bethel Census Area",50,"Y-K Delta Region",10,21,8953,16,9556,0,84,0,40
"02/25/2022","Y","Y","Bethel Census Area",50,"Y-K Delta Region",10,6,8959,22,9578,0,84,0,40
"02/26/2022","Y","Y","Bethel Census Area",50,"Y-K Delta Region",10,6,8965,7,9585,0,84,0,40
"02/27/2022","Y","Y","Bethel Census Area",50,"Y-K Delta Region",10,2,8967,6,9591,0,84,0,40
"02/28/2022","Y","Y","Bethel Census Area",50,"Y-K Delta Region",10,2,8969,31,9622,0,84,0,40
"03/01/2022","Y","Y","Bethel Census Area",50,"Y-K Delta Region",10,0,8969,9,9631,0,84,1,41
"03/02/2022","Y","Y","Bethel Census Area",50,"Y-K Delta Region",10,4,8973,13,9644,0,84,0,41
"03/03/2022","Y","Y","Bethel Census Area",50,"Y-K Delta Region",10,5,8978,24,9668,0,84,0,41
"03/04/2022","Y","Y","Bethel Census Area",50,"Y-K Delta Region",10,7,8985,18,9686,0,84,0,41
"03/05/2022","Y","Y","Bethel Census Area",50,"Y-K Delta Region",10,0,8985,3,9689,0,84,0,41
"03/06/2022","Y","Y","Bethel Census Area",50,"Y-K Delta Region",10,1,8986,2,9691,0,84,0,41
"03/07/2022","Y","Y","Bethel Census Area",50,"Y-K Delta Region",10,1,8987,22,9713,0,84,0,41
"03/08/2022","Y","Y","Bethel Census Area",50,"Y-K Delta Region",10,642,9629,1,9714,0,84,0,41
"03/09/2022","Y","Y","Bethel Census Area",50,"Y-K Delta Region",10,89,9718,6,9720,0,84,0,41
"03/10/2022","Y","Y","Bethel Census Area",50,"Y-K Delta Region",10,19,9737,23,9743,0,84,0,41
"03/11/2022","Y","Y","Bethel Census Area",50,"Y-K Delta Region",10,14,9751,10,9753,0,84,0,41
"03/13/2022","Y","Y","Bethel Census Area",50,"Y-K Delta Region",10,1,9752,1,9754,0,84,0,41
"03/14/2022","Y","Y","Bethel Census Area",50,"Y-K Delta Region",10,11,9763,17,9771,0,84,0,41
"03/15/2022","Y","Y","Bethel Census Area",50,"Y-K Delta Region",10,14,9777,12,9783,0,84,0,41
"03/16/2022","Y","Y","Bethel Census Area",50,"Y-K Delta Region",10,12,9789,10,9793,0,84,0,41
"03/17/2022","Y","Y","Bethel Census Area",50,"Y-K Delta Region",10,13,9802,12,9805,0,84,0,41
"03/18/2022","Y","Y","Bethel Census Area",50,"Y-K Delta Region",10,16,9818,16,9821,0,84,0,41
"03/19/2022","Y","Y","Bethel Census Area",50,"Y-K Delta Region",10,1,9819,1,9822,0,84,0,41
"03/20/2022","Y","Y","Bethel Census Area",50,"Y-K Delta Region",10,2,9821,2,9824,0,84,0,41
"03/21/2022","Y","Y","Bethel Census Area",50,"Y-K Delta Region",10,12,9833,21,9845,0,84,0,41
"03/22/2022","Y","Y","Bethel Census Area",50,"Y-K Delta Region",10,34,9867,28,9873,0,84,0,41
"03/23/2022","Y","Y","Bethel Census Area",50,"Y-K Delta Region",10,13,9880,8,9881,0,84,0,41
"03/24/2022","Y","Y","Bethel Census Area",50,"Y-K Delta Region",10,6,9886,11,9892,0,84,0,41
"03/25/2022","Y","Y","Bethel Census Area",50,"Y-K Delta Region",10,9,9895,13,9905,0,84,0,41
"03/26/2022","Y","Y","Bethel Census Area",50,"Y-K Delta Region",10,6,9901,1,9906,0,84,0,41
"03/27/2022","Y","Y","Bethel Census Area",50,"Y-K Delta Region",10,1,9902,0,9906,0,84,0,41
"03/28/2022","Y","Y","Bethel Census Area",50,"Y-K Delta Region",10,11,9913,11,9917,0,84,0,41
"03/29/2022","Y","Y","Bethel Census Area",50,"Y-K Delta Region",10,16,9929,16,9933,0,84,0,41
"03/30/2022","Y","Y","Bethel Census Area",50,"Y-K Delta Region",10,7,9936,6,9939,0,84,0,41
"03/31/2022","Y","Y","Bethel Census Area",50,"Y-K Delta Region",10,8,9944,8,9947,0,84,0,41
"04/01/2022","Y","Y","Bethel Census Area",50,"Y-K Delta Region",10,6,9950,6,9953,0,84,0,41
"04/02/2022","Y","Y","Bethel Census Area",50,"Y-K Delta Region",10,1,9951,1,9954,0,84,0,41
"04/04/2022","Y","Y","Bethel Census Area",50,"Y-K Delta Region",10,0,9951,4,9958,0,84,0,41
"04/05/2022","Y","Y","Bethel Census Area",50,"Y-K Delta Region",10,19,9970,19,9977,0,84,0,41
"04/06/2022","Y","Y","Bethel Census Area",50,"Y-K Delta Region",10,10,9980,7,9984,0,84,0,41
"04/07/2022","Y","Y","Bethel Census Area",50,"Y-K Delta Region",10,12,9992,12,9996,0,84,0,41
"04/08/2022","Y","Y","Bethel Census Area",50,"Y-K Delta Region",10,2,9994,9,10005,0,84,0,41
"04/09/2022","Y","Y","Bethel Census Area",50,"Y-K Delta Region",10,10,10004,3,10008,0,84,0,41
"04/10/2022","Y","Y","Bethel Census Area",50,"Y-K Delta Region",10,1,10005,1,10009,0,84,0,41
"04/11/2022","Y","Y","Bethel Census Area",50,"Y-K Delta Region",10,7,10012,7,10016,0,84,0,41
"04/12/2022","Y","Y","Bethel Census Area",50,"Y-K Delta Region",10,6,10018,8,10024,0,84,0,41
"04/13/2022","Y","Y","Bethel Census Area",50,"Y-K Delta Region",10,12,10030,9,10033,0,84,0,41
"04/14/2022","Y","Y","Bethel Census Area",50,"Y-K Delta Region",10,14,10044,14,10047,0,84,0,41
"04/15/2022","Y","Y","Bethel Census Area",50,"Y-K Delta Region",10,12,10056,12,10059,0,84,0,41
"04/17/2022","Y","Y","Bethel Census Area",50,"Y-K Delta Region",10,4,10060,4,10063,0,84,0,41
"04/18/2022","Y","Y","Bethel Census Area",50,"Y-K Delta Region",10,6,10066,3,10066,0,84,0,41
"04/19/2022","Y","Y","Bethel Census Area",50,"Y-K Delta Region",10,16,10082,20,10086,0,84,0,41
"04/20/2022","Y","Y","Bethel Census Area",50,"Y-K Delta Region",10,7,10089,6,10092,0,84,0,41
"04/21/2022","Y","Y","Bethel Census Area",50,"Y-K Delta Region",10,8,10097,6,10098,0,84,0,41
"04/22/2022","Y","Y","Bethel Census Area",50,"Y-K Delta Region",10,9,10106,9,10107,0,84,0,41
"04/23/2022","Y","Y","Bethel Census Area",50,"Y-K Delta Region",10,13,10119,12,10119,0,84,0,41
"04/25/2022","Y","Y","Bethel Census Area",50,"Y-K Delta Region",10,29,10148,29,10148,0,84,0,41
"04/26/2022","Y","Y","Bethel Census Area",50,"Y-K Delta Region",10,35,10183,35,10183,0,84,0,41
"05/01/2020","Y","Y","Bristol Bay plus Lake and Peninsula",300,"Southwest Region",11,0,0,1,1,0,0,0,0
"05/19/2020","Y","Y","Bristol Bay plus Lake and Peninsula",300,"Southwest Region",11,1,1,0,1,1,1,0,0
"06/16/2020","Y","Y","Bristol Bay plus Lake and Peninsula",300,"Southwest Region",11,0,1,1,2,0,1,0,0
"06/17/2020","Y","Y","Bristol Bay plus Lake and Peninsula",300,"Southwest Region",11,1,2,0,2,0,1,0,0
"06/30/2020","Y","Y","Bristol Bay plus Lake and Peninsula",300,"Southwest Region",11,0,2,1,3,0,1,0,0
"07/03/2020","Y","Y","Bristol Bay plus Lake and Peninsula",300,"Southwest Region",11,1,3,0,3,0,1,0,0
"07/09/2020","Y","Y","Bristol Bay plus Lake and Peninsula",300,"Southwest Region",11,0,3,2,5,0,1,0,0
"07/12/2020","Y","Y","Bristol Bay plus Lake and Peninsula",300,"Southwest Region",11,2,5,0,5,0,1,0,0
"07/17/2020","Y","Y","Bristol Bay plus Lake and Peninsula",300,"Southwest Region",11,0,5,1,6,0,1,0,0
"07/19/2020","Y","Y","Bristol Bay plus Lake and Peninsula",300,"Southwest Region",11,1,6,0,6,0,1,0,0
"08/05/2020","Y","Y","Bristol Bay plus Lake and Peninsula",300,"Southwest Region",11,0,6,1,7,0,1,0,0
"08/06/2020","Y","Y","Bristol Bay plus Lake and Peninsula",300,"Southwest Region",11,2,8,1,8,0,1,0,0
"08/11/2020","Y","Y","Bristol Bay plus Lake and Peninsula",300,"Southwest Region",11,0,8,1,9,0,1,0,0
"08/18/2020","Y","Y","Bristol Bay plus Lake and Peninsula",300,"Southwest Region",11,1,9,0,9,0,1,0,0
"08/19/2020","Y","Y","Bristol Bay plus Lake and Peninsula",300,"Southwest Region",11,0,9,1,10,0,1,0,0
"08/31/2020","Y","Y","Bristol Bay plus Lake and Peninsula",300,"Southwest Region",11,1,10,1,11,0,1,0,0
"09/04/2020","Y","Y","Bristol Bay plus Lake and Peninsula",300,"Southwest Region",11,0,10,3,14,0,1,0,0
"09/05/2020","Y","Y","Bristol Bay plus Lake and Peninsula",300,"Southwest Region",11,3,13,2,16,0,1,0,0
"09/09/2020","Y","Y","Bristol Bay plus Lake and Peninsula",300,"Southwest Region",11,3,16,1,17,0,1,0,0
"09/10/2020","Y","Y","Bristol Bay plus Lake and Peninsula",300,"Southwest Region",11,1,17,1,18,0,1,0,0
"09/13/2020","Y","Y","Bristol Bay plus Lake and Peninsula",300,"Southwest Region",11,0,17,1,19,0,1,0,0
"09/14/2020","Y","Y","Bristol Bay plus Lake and Peninsula",300,"Southwest Region",11,1,18,2,21,0,1,0,0
"09/15/2020","Y","Y","Bristol Bay plus Lake and Peninsula",300,"Southwest Region",11,1,19,0,21,0,1,0,0
"09/16/2020","Y","Y","Bristol Bay plus Lake and Peninsula",300,"Southwest Region",11,0,19,1,22,0,1,0,0
"09/17/2020","Y","Y","Bristol Bay plus Lake and Peninsula",300,"Southwest Region",11,2,21,0,22,0,1,0,0
"09/19/2020","Y","Y","Bristol Bay plus Lake and Peninsula",300,"Southwest Region",11,0,21,1,23,0,1,0,0
"09/21/2020","Y","Y","Bristol Bay plus Lake and Peninsula",300,"Southwest Region",11,0,21,1,24,0,1,0,0
"09/22/2020","Y","Y","Bristol Bay plus Lake and Peninsula",300,"Southwest Region",11,1,22,0,24,0,1,0,0
"09/24/2020","Y","Y","Bristol Bay plus Lake and Peninsula",300,"Southwest Region",11,1,23,0,24,0,1,0,0
"09/26/2020","Y","Y","Bristol Bay plus Lake and Peninsula",300,"Southwest Region",11,1,24,2,26,0,1,0,0
"09/27/2020","Y","Y","Bristol Bay plus Lake and Peninsula",300,"Southwest Region",11,0,24,1,27,0,1,0,0
"09/28/2020","Y","Y","Bristol Bay plus Lake and Peninsula",300,"Southwest Region",11,1,25,0,27,0,1,0,0
"10/02/2020","Y","Y","Bristol Bay plus Lake and Peninsula",300,"Southwest Region",11,1,26,0,27,0,1,0,0
"10/05/2020","Y","Y","Bristol Bay plus Lake and Peninsula",300,"Southwest Region",11,0,26,1,28,0,1,0,0
"10/10/2020","Y","Y","Bristol Bay plus Lake and Peninsula",300,"Southwest Region",11,1,27,0,28,0,1,0,0
"10/12/2020","Y","Y","Bristol Bay plus Lake and Peninsula",300,"Southwest Region",11,0,27,1,29,0,1,0,0
"10/13/2020","Y","Y","Bristol Bay plus Lake and Peninsula",300,"Southwest Region",11,1,28,0,29,0,1,0,0
"10/14/2020","Y","Y","Bristol Bay plus Lake and Peninsula",300,"Southwest Region",11,0,28,2,31,0,1,0,0
"10/15/2020","Y","Y","Bristol Bay plus Lake and Peninsula",300,"Southwest Region",11,1,29,3,34,0,1,0,0
"10/17/2020","Y","Y","Bristol Bay plus Lake and Peninsula",300,"Southwest Region",11,1,30,0,34,0,1,0,0
"10/18/2020","Y","Y","Bristol Bay plus Lake and Peninsula",300,"Southwest Region",11,1,31,0,34,0,1,0,0
"10/20/2020","Y","Y","Bristol Bay plus Lake and Peninsula",300,"Southwest Region",11,3,34,0,34,0,1,0,0
"10/24/2020","Y","Y","Bristol Bay plus Lake and Peninsula",300,"Southwest Region",11,0,34,2,36,0,1,0,0
"10/25/2020","Y","Y","Bristol Bay plus Lake and Peninsula",300,"Southwest Region",11,1,35,3,39,0,1,0,0
"10/27/2020","Y","Y","Bristol Bay plus Lake and Peninsula",300,"Southwest Region",11,1,36,1,40,0,1,0,0
"10/29/2020","Y","Y","Bristol Bay plus Lake and Peninsula",300,"Southwest Region",11,2,38,2,42,0,1,0,0
"10/30/2020","Y","Y","Bristol Bay plus Lake and Peninsula",300,"Southwest Region",11,3,41,3,45,0,1,0,0
"10/31/2020","Y","Y","Bristol Bay plus Lake and Peninsula",300,"Southwest Region",11,0,41,1,46,0,1,0,0
"11/01/2020","Y","Y","Bristol Bay plus Lake and Peninsula",300,"Southwest Region",11,0,41,1,47,0,1,0,0
"11/02/2020","Y","Y","Bristol Bay plus Lake and Peninsula",300,"Southwest Region",11,2,43,1,48,0,1,0,0
"11/05/2020","Y","Y","Bristol Bay plus Lake and Peninsula",300,"Southwest Region",11,1,44,0,48,0,1,0,0
"11/06/2020","Y","Y","Bristol Bay plus Lake and Peninsula",300,"Southwest Region",11,0,44,1,49,0,1,0,0
"11/07/2020","Y","Y","Bristol Bay plus Lake and Peninsula",300,"Southwest Region",11,1,45,2,51,0,1,0,0
"11/08/2020","Y","Y","Bristol Bay plus Lake and Peninsula",300,"Southwest Region",11,4,49,1,52,0,1,0,0
"11/09/2020","Y","Y","Bristol Bay plus Lake and Peninsula",300,"Southwest Region",11,0,49,6,58,0,1,0,0
"11/11/2020","Y","Y","Bristol Bay plus Lake and Peninsula",300,"Southwest Region",11,1,50,2,60,0,1,0,0
"11/12/2020","Y","Y","Bristol Bay plus Lake and Peninsula",300,"Southwest Region",11,1,51,1,61,0,1,0,0
"11/13/2020","Y","Y","Bristol Bay plus Lake and Peninsula",300,"Southwest Region",11,1,52,5,66,0,1,0,0
"11/14/2020","Y","Y","Bristol Bay plus Lake and Peninsula",300,"Southwest Region",11,4,56,0,66,0,1,0,0
"11/15/2020","Y","Y","Bristol Bay plus Lake and Peninsula",300,"Southwest Region",11,0,56,1,67,1,2,0,0
"11/16/2020","Y","Y","Bristol Bay plus Lake and Peninsula",300,"Southwest Region",11,4,60,3,70,0,2,0,0
"11/17/2020","Y","Y","Bristol Bay plus Lake and Peninsula",300,"Southwest Region",11,1,61,0,70,0,2,0,0
"11/18/2020","Y","Y","Bristol Bay plus Lake and Peninsula",300,"Southwest Region",11,6,67,0,70,0,2,0,0
"11/19/2020","Y","Y","Bristol Bay plus Lake and Peninsula",300,"Southwest Region",11,1,68,0,70,0,2,0,0
"11/20/2020","Y","Y","Bristol Bay plus Lake and Peninsula",300,"Southwest Region",11,1,69,2,72,0,2,0,0
"11/21/2020","Y","Y","Bristol Bay plus Lake and Peninsula",300,"Southwest Region",11,2,71,0,72,0,2,0,0
"11/23/2020","Y","Y","Bristol Bay plus Lake and Peninsula",300,"Southwest Region",11,0,71,1,73,0,2,0,0
"11/24/2020","Y","Y","Bristol Bay plus Lake and Peninsula",300,"Southwest Region",11,1,72,2,75,0,2,0,0
"11/28/2020","Y","Y","Bristol Bay plus Lake and Peninsula",300,"Southwest Region",11,0,72,1,76,0,2,0,0
"12/01/2020","Y","Y","Bristol Bay plus Lake and Peninsula",300,"Southwest Region",11,1,73,0,76,0,2,0,0
"12/02/2020","Y","Y","Bristol Bay plus Lake and Peninsula",300,"Southwest Region",11,0,73,2,78,0,2,0,0
"12/03/2020","Y","Y","Bristol Bay plus Lake and Peninsula",300,"Southwest Region",11,2,75,1,79,0,2,0,0
"12/05/2020","Y","Y","Bristol Bay plus Lake and Peninsula",300,"Southwest Region",11,2,77,1,80,0,2,0,0
"12/06/2020","Y","Y","Bristol Bay plus Lake and Peninsula",300,"Southwest Region",11,0,77,1,81,0,2,0,0
"12/07/2020","Y","Y","Bristol Bay plus Lake and Peninsula",300,"Southwest Region",11,1,78,0,81,0,2,0,0
"12/09/2020","Y","Y","Bristol Bay plus Lake and Peninsula",300,"Southwest Region",11,1,79,0,81,0,2,0,0
"12/10/2020","Y","Y","Bristol Bay plus Lake and Peninsula",300,"Southwest Region",11,0,79,1,82,0,2,0,0
"12/11/2020","Y","Y","Bristol Bay plus Lake and Peninsula",300,"Southwest Region",11,1,80,0,82,1,3,0,0
"12/13/2020","Y","Y","Bristol Bay plus Lake and Peninsula",300,"Southwest Region",11,1,81,1,83,0,3,0,0
"12/17/2020","Y","Y","Bristol Bay plus Lake and Peninsula",300,"Southwest Region",11,0,81,1,84,0,3,0,0
"12/18/2020","Y","Y","Bristol Bay plus Lake and Peninsula",300,"Southwest Region",11,1,82,1,85,0,3,0,0
"12/20/2020","Y","Y","Bristol Bay plus Lake and Peninsula",300,"Southwest Region",11,0,82,0,85,1,4,0,0
"12/21/2020","Y","Y","Bristol Bay plus Lake and Peninsula",300,"Southwest Region",11,1,83,0,85,0,4,0,0
"12/29/2020","Y","Y","Bristol Bay plus Lake and Peninsula",300,"Southwest Region",11,0,83,1,86,0,4,0,0
"12/30/2020","Y","Y","Bristol Bay plus Lake and Peninsula",300,"Southwest Region",11,0,83,1,87,0,4,0,0
"12/31/2020","Y","Y","Bristol Bay plus Lake and Peninsula",300,"Southwest Region",11,2,85,0,87,0,4,0,0
"01/04/2021","Y","Y","Bristol Bay plus Lake and Peninsula",300,"Southwest Region",11,0,85,1,88,0,4,0,0
"01/05/2021","Y","Y","Bristol Bay plus Lake and Peninsula",300,"Southwest Region",11,0,85,1,89,0,4,0,0
"01/07/2021","Y","Y","Bristol Bay plus Lake and Peninsula",300,"Southwest Region",11,3,88,0,89,0,4,0,0
"01/10/2021","Y","Y","Bristol Bay plus Lake and Peninsula",300,"Southwest Region",11,0,88,1,90,0,4,0,0
"01/11/2021","Y","Y","Bristol Bay plus Lake and Peninsula",300,"Southwest Region",11,1,89,2,92,0,4,0,0
"01/13/2021","Y","Y","Bristol Bay plus Lake and Peninsula",300,"Southwest Region",11,1,90,5,97,0,4,0,0
"01/14/2021","Y","Y","Bristol Bay plus Lake and Peninsula",300,"Southwest Region",11,1,91,1,98,0,4,0,0
"01/16/2021","Y","Y","Bristol Bay plus Lake and Peninsula",300,"Southwest Region",11,5,96,0,98,0,4,0,0
"01/17/2021","Y","Y","Bristol Bay plus Lake and Peninsula",300,"Southwest Region",11,1,97,0,98,0,4,0,0
"01/20/2021","Y","Y","Bristol Bay plus Lake and Peninsula",300,"Southwest Region",11,0,97,1,99,0,4,0,0
"01/21/2021","Y","Y","Bristol Bay plus Lake and Peninsula",300,"Southwest Region",11,1,98,0,99,0,4,0,0
"01/22/2021","Y","Y","Bristol Bay plus Lake and Peninsula",300,"Southwest Region",11,1,99,0,99,0,4,0,0
"02/01/2021","Y","Y","Bristol Bay plus Lake and Peninsula",300,"Southwest Region",11,0,99,2,101,0,4,0,0
"02/03/2021","Y","Y","Bristol Bay plus Lake and Peninsula",300,"Southwest Region",11,0,99,1,102,0,4,0,0
"02/04/2021","Y","Y","Bristol Bay plus Lake and Peninsula",300,"Southwest Region",11,0,99,1,103,0,4,0,0
"02/05/2021","Y","Y","Bristol Bay plus Lake and Peninsula",300,"Southwest Region",11,1,100,0,103,0,4,0,0
"02/06/2021","Y","Y","Bristol Bay plus Lake and Peninsula",300,"Southwest Region",11,1,101,2,105,0,4,0,0
"02/07/2021","Y","Y","Bristol Bay plus Lake and Peninsula",300,"Southwest Region",11,1,102,0,105,0,4,0,0
"02/08/2021","Y","Y","Bristol Bay plus Lake and Peninsula",300,"Southwest Region",11,1,103,0,105,0,4,0,0
"02/09/2021","Y","Y","Bristol Bay plus Lake and Peninsula",300,"Southwest Region",11,2,105,0,105,0,4,0,0
"02/10/2021","Y","Y","Bristol Bay plus Lake and Peninsula",300,"Southwest Region",11,0,105,2,107,0,4,0,0
"02/11/2021","Y","Y","Bristol Bay plus Lake and Peninsula",300,"Southwest Region",11,2,107,1,108,0,4,0,0
"02/13/2021","Y","Y","Bristol Bay plus Lake and Peninsula",300,"Southwest Region",11,1,108,0,108,0,4,0,0
"03/09/2021","Y","Y","Bristol Bay plus Lake and Peninsula",300,"Southwest Region",11,0,108,1,109,0,4,0,0
"03/15/2021","Y","Y","Bristol Bay plus Lake and Peninsula",300,"Southwest Region",11,0,108,1,110,0,4,0,0
"03/16/2021","Y","Y","Bristol Bay plus Lake and Peninsula",300,"Southwest Region",11,0,108,1,111,0,4,0,0
"03/18/2021","Y","Y","Bristol Bay plus Lake and Peninsula",300,"Southwest Region",11,0,108,1,112,0,4,0,0
"03/19/2021","Y","Y","Bristol Bay plus Lake and Peninsula",300,"Southwest Region",11,1,109,4,116,0,4,0,0
"03/20/2021","Y","Y","Bristol Bay plus Lake and Peninsula",300,"Southwest Region",11,7,116,0,116,0,4,0,0
"03/29/2021","Y","Y","Bristol Bay plus Lake and Peninsula",300,"Southwest Region",11,0,116,2,118,0,4,0,0
"03/30/2021","Y","Y","Bristol Bay plus Lake and Peninsula",300,"Southwest Region",11,2,118,0,118,0,4,0,0
"03/31/2021","Y","Y","Bristol Bay plus Lake and Peninsula",300,"Southwest Region",11,0,118,1,119,0,4,0,0
"04/12/2021","Y","Y","Bristol Bay plus Lake and Peninsula",300,"Southwest Region",11,1,119,1,120,0,4,0,0
"04/13/2021","Y","Y","Bristol Bay plus Lake and Peninsula",300,"Southwest Region",11,1,120,0,120,0,4,0,0
"05/12/2021","Y","Y","Bristol Bay plus Lake and Peninsula",300,"Southwest Region",11,0,120,1,121,0,4,0,0
"05/16/2021","Y","Y","Bristol Bay plus Lake and Peninsula",300,"Southwest Region",11,1,121,0,121,0,4,0,0
"05/24/2021","Y","Y","Bristol Bay plus Lake and Peninsula",300,"Southwest Region",11,0,121,1,122,0,4,0,0
"06/04/2021","Y","Y","Bristol Bay plus Lake and Peninsula",300,"Southwest Region",11,1,122,0,122,0,4,0,0
"06/05/2021","Y","Y","Bristol Bay plus Lake and Peninsula",300,"Southwest Region",11,0,122,1,123,0,4,0,0
"06/06/2021","Y","Y","Bristol Bay plus Lake and Peninsula",300,"Southwest Region",11,1,123,1,124,0,4,0,0
"06/08/2021","Y","Y","Bristol Bay plus Lake and Peninsula",300,"Southwest Region",11,1,124,1,125,0,4,0,0
"06/09/2021","Y","Y","Bristol Bay plus Lake and Peninsula",300,"Southwest Region",11,1,125,0,125,0,4,0,0
"07/19/2021","Y","Y","Bristol Bay plus Lake and Peninsula",300,"Southwest Region",11,1,126,1,126,0,4,0,0
"07/21/2021","Y","Y","Bristol Bay plus Lake and Peninsula",300,"Southwest Region",11,0,126,1,127,0,4,0,0
"07/24/2021","Y","Y","Bristol Bay plus Lake and Peninsula",300,"Southwest Region",11,1,127,0,127,0,4,0,0
"07/25/2021","Y","Y","Bristol Bay plus Lake and Peninsula",300,"Southwest Region",11,0,127,1,128,0,4,0,0
"07/27/2021","Y","Y","Bristol Bay plus Lake and Peninsula",300,"Southwest Region",11,1,128,0,128,0,4,0,0
"07/28/2021","Y","Y","Bristol Bay plus Lake and Peninsula",300,"Southwest Region",11,0,128,2,130,0,4,0,0
"07/29/2021","Y","Y","Bristol Bay plus Lake and Peninsula",300,"Southwest Region",11,1,129,0,130,0,4,0,0
"07/30/2021","Y","Y","Bristol Bay plus Lake and Peninsula",300,"Southwest Region",11,1,130,0,130,0,4,0,0
"08/05/2021","Y","Y","Bristol Bay plus Lake and Peninsula",300,"Southwest Region",11,0,130,1,131,0,4,0,0
"08/07/2021","Y","Y","Bristol Bay plus Lake and Peninsula",300,"Southwest Region",11,1,131,0,131,0,4,0,0
"08/08/2021","Y","Y","Bristol Bay plus Lake and Peninsula",300,"Southwest Region",11,0,131,2,133,0,4,0,0
"08/09/2021","Y","Y","Bristol Bay plus Lake and Peninsula",300,"Southwest Region",11,1,132,2,135,0,4,0,0
"08/11/2021","Y","Y","Bristol Bay plus Lake and Peninsula",300,"Southwest Region",11,1,133,2,137,0,4,0,0
"08/13/2021","Y","Y","Bristol Bay plus Lake and Peninsula",300,"Southwest Region",11,1,134,0,137,0,4,0,0
"08/14/2021","Y","Y","Bristol Bay plus Lake and Peninsula",300,"Southwest Region",11,1,135,0,137,0,4,0,0
"08/16/2021","Y","Y","Bristol Bay plus Lake and Peninsula",300,"Southwest Region",11,0,135,1,138,0,4,0,0
"08/17/2021","Y","Y","Bristol Bay plus Lake and Peninsula",300,"Southwest Region",11,1,136,0,138,0,4,0,0
"08/19/2021","Y","Y","Bristol Bay plus Lake and Peninsula",300,"Southwest Region",11,1,137,0,138,0,4,0,0
"08/23/2021","Y","Y","Bristol Bay plus Lake and Peninsula",300,"Southwest Region",11,0,137,4,142,0,4,0,0
"08/24/2021","Y","Y","Bristol Bay plus Lake and Peninsula",300,"Southwest Region",11,1,138,0,142,0,4,0,0
"08/26/2021","Y","Y","Bristol Bay plus Lake and Peninsula",300,"Southwest Region",11,0,138,3,145,0,4,0,0
"08/27/2021","Y","Y","Bristol Bay plus Lake and Peninsula",300,"Southwest Region",11,3,141,3,148,0,4,0,0
"08/28/2021","Y","Y","Bristol Bay plus Lake and Peninsula",300,"Southwest Region",11,1,142,0,148,0,4,0,0
"08/30/2021","Y","Y","Bristol Bay plus Lake and Peninsula",300,"Southwest Region",11,0,142,1,149,0,4,0,0
"08/31/2021","Y","Y","Bristol Bay plus Lake and Peninsula",300,"Southwest Region",11,0,142,1,150,0,4,0,0
"09/01/2021","Y","Y","Bristol Bay plus Lake and Peninsula",300,"Southwest Region",11,0,142,1,151,0,4,0,0
"09/02/2021","Y","Y","Bristol Bay plus Lake and Peninsula",300,"Southwest Region",11,6,148,0,151,0,4,0,0
"09/04/2021","Y","Y","Bristol Bay plus Lake and Peninsula",300,"Southwest Region",11,0,148,1,152,0,4,0,0
"09/05/2021","Y","Y","Bristol Bay plus Lake and Peninsula",300,"Southwest Region",11,1,149,1,153,0,4,0,0
"09/06/2021","Y","Y","Bristol Bay plus Lake and Peninsula",300,"Southwest Region",11,1,150,1,154,0,4,0,0
"09/07/2021","Y","Y","Bristol Bay plus Lake and Peninsula",300,"Southwest Region",11,1,151,1,155,0,4,0,0
"09/08/2021","Y","Y","Bristol Bay plus Lake and Peninsula",300,"Southwest Region",11,0,151,1,156,0,4,0,0
"09/09/2021","Y","Y","Bristol Bay plus Lake and Peninsula",300,"Southwest Region",11,0,151,2,158,0,4,0,0
"09/10/2021","Y","Y","Bristol Bay plus Lake and Peninsula",300,"Southwest Region",11,0,151,1,159,0,4,0,0
"09/13/2021","Y","Y","Bristol Bay plus Lake and Peninsula",300,"Southwest Region",11,0,151,1,160,0,4,0,0
"09/14/2021","Y","Y","Bristol Bay plus Lake and Peninsula",300,"Southwest Region",11,1,152,1,161,0,4,0,0
"09/15/2021","Y","Y","Bristol Bay plus Lake and Peninsula",300,"Southwest Region",11,2,154,3,164,0,4,0,0
"09/16/2021","Y","Y","Bristol Bay plus Lake and Peninsula",300,"Southwest Region",11,1,155,12,176,0,4,0,0
"09/17/2021","Y","Y","Bristol Bay plus Lake and Peninsula",300,"Southwest Region",11,4,159,13,189,0,4,0,0
"09/18/2021","Y","Y","Bristol Bay plus Lake and Peninsula",300,"Southwest Region",11,10,169,0,189,0,4,0,0
"09/19/2021","Y","Y","Bristol Bay plus Lake and Peninsula",300,"Southwest Region",11,0,169,1,190,0,4,0,0
"09/20/2021","Y","Y","Bristol Bay plus Lake and Peninsula",300,"Southwest Region",11,14,183,22,212,0,4,0,0
"09/21/2021","Y","Y","Bristol Bay plus Lake and Peninsula",300,"Southwest Region",11,0,183,1,213,0,4,0,0
"09/22/2021","Y","Y","Bristol Bay plus Lake and Peninsula",300,"Southwest Region",11,21,204,28,241,0,4,0,0
"09/23/2021","Y","Y","Bristol Bay plus Lake and Peninsula",300,"Southwest Region",11,0,204,1,242,0,4,0,0
"09/24/2021","Y","Y","Bristol Bay plus Lake and Peninsula",300,"Southwest Region",11,1,205,5,247,0,4,0,0
"09/25/2021","Y","Y","Bristol Bay plus Lake and Peninsula",300,"Southwest Region",11,9,214,0,247,0,4,0,0
"09/26/2021","Y","Y","Bristol Bay plus Lake and Peninsula",300,"Southwest Region",11,18,232,0,247,0,4,0,0
"09/27/2021","Y","Y","Bristol Bay plus Lake and Peninsula",300,"Southwest Region",11,0,232,3,250,0,4,0,0
"09/28/2021","Y","Y","Bristol Bay plus Lake and Peninsula",300,"Southwest Region",11,10,242,3,253,0,4,0,0
"09/29/2021","Y","Y","Bristol Bay plus Lake and Peninsula",300,"Southwest Region",11,7,249,13,266,0,4,0,0
"09/30/2021","Y","Y","Bristol Bay plus Lake and Peninsula",300,"Southwest Region",11,0,249,1,267,0,4,0,0
"10/01/2021","Y","Y","Bristol Bay plus Lake and Peninsula",300,"Southwest Region",11,0,249,3,270,0,4,0,0
"10/02/2021","Y","Y","Bristol Bay plus Lake and Peninsula",300,"Southwest Region",11,14,263,0,270,0,4,0,0
"10/03/2021","Y","Y","Bristol Bay plus Lake and Peninsula",300,"Southwest Region",11,1,264,1,271,0,4,0,0
"10/04/2021","Y","Y","Bristol Bay plus Lake and Peninsula",300,"Southwest Region",11,2,266,6,277,0,4,0,0
"10/05/2021","Y","Y","Bristol Bay plus Lake and Peninsula",300,"Southwest Region",11,1,267,1,278,0,4,0,0
"10/06/2021","Y","Y","Bristol Bay plus Lake and Peninsula",300,"Southwest Region",11,7,274,21,299,0,4,0,0
"10/07/2021","Y","Y","Bristol Bay plus Lake and Peninsula",300,"Southwest Region",11,1,275,3,302,0,4,0,0
"10/08/2021","Y","Y","Bristol Bay plus Lake and Peninsula",300,"Southwest Region",11,0,275,3,305,0,4,0,0
"10/09/2021","Y","Y","Bristol Bay plus Lake and Peninsula",300,"Southwest Region",11,3,278,0,305,0,4,0,0
"10/10/2021","Y","Y","Bristol Bay plus Lake and Peninsula",300,"Southwest Region",11,1,279,0,305,0,4,0,0
"10/11/2021","Y","Y","Bristol Bay plus Lake and Peninsula",300,"Southwest Region",11,10,289,0,305,0,4,0,0
"10/12/2021","Y","Y","Bristol Bay plus Lake and Peninsula",300,"Southwest Region",11,12,301,4,309,0,4,0,0
"10/13/2021","Y","Y","Bristol Bay plus Lake and Peninsula",300,"Southwest Region",11,1,302,6,315,0,4,0,0
"10/14/2021","Y","Y","Bristol Bay plus Lake and Peninsula",300,"Southwest Region",11,5,307,0,315,0,4,0,0
"10/15/2021","Y","Y","Bristol Bay plus Lake and Peninsula",300,"Southwest Region",11,0,307,8,323,0,4,0,0
"10/16/2021","Y","Y","Bristol Bay plus Lake and Peninsula",300,"Southwest Region",11,6,313,0,323,0,4,0,0
"10/17/2021","Y","Y","Bristol Bay plus Lake and Peninsula",300,"Southwest Region",11,1,314,1,324,0,4,0,0
"10/18/2021","Y","Y","Bristol Bay plus Lake and Peninsula",300,"Southwest Region",11,2,316,7,331,0,4,0,0
"10/19/2021","Y","Y","Bristol Bay plus Lake and Peninsula",300,"Southwest Region",11,1,317,5,336,0,4,0,0
"10/20/2021","Y","Y","Bristol Bay plus Lake and Peninsula",300,"Southwest Region",11,15,332,5,341,0,4,0,0
"10/21/2021","Y","Y","Bristol Bay plus Lake and Peninsula",300,"Southwest Region",11,4,336,4,345,0,4,0,0
"10/22/2021","Y","Y","Bristol Bay plus Lake and Peninsula",300,"Southwest Region",11,8,344,8,353,0,4,0,0
"10/23/2021","Y","Y","Bristol Bay plus Lake and Peninsula",300,"Southwest Region",11,2,346,1,354,1,5,0,0
"10/24/2021","Y","Y","Bristol Bay plus Lake and Peninsula",300,"Southwest Region",11,4,350,2,356,0,5,0,0
"10/25/2021","Y","Y","Bristol Bay plus Lake and Peninsula",300,"Southwest Region",11,3,353,12,368,0,5,0,0
"10/26/2021","Y","Y","Bristol Bay plus Lake and Peninsula",300,"Southwest Region",11,5,358,0,368,0,5,0,0
"10/27/2021","Y","Y","Bristol Bay plus Lake and Peninsula",300,"Southwest Region",11,3,361,8,376,0,5,0,0
"10/28/2021","Y","Y","Bristol Bay plus Lake and Peninsula",300,"Southwest Region",11,7,368,0,376,0,5,0,0
"10/29/2021","Y","Y","Bristol Bay plus Lake and Peninsula",300,"Southwest Region",11,7,375,2,378,0,5,0,0
"10/30/2021","Y","Y","Bristol Bay plus Lake and Peninsula",300,"Southwest Region",11,2,377,0,378,0,5,0,0
"11/01/2021","Y","Y","Bristol Bay plus Lake and Peninsula",300,"Southwest Region",11,1,378,2,380,0,5,0,0
"11/02/2021","Y","Y","Bristol Bay plus Lake and Peninsula",300,"Southwest Region",11,0,378,2,382,0,5,0,0
"11/03/2021","Y","Y","Bristol Bay plus Lake and Peninsula",300,"Southwest Region",11,2,380,3,385,0,5,0,0
"11/04/2021","Y","Y","Bristol Bay plus Lake and Peninsula",300,"Southwest Region",11,2,382,1,386,0,5,0,0
"11/05/2021","Y","Y","Bristol Bay plus Lake and Peninsula",300,"Southwest Region",11,3,385,1,387,0,5,0,0
"11/07/2021","Y","Y","Bristol Bay plus Lake and Peninsula",300,"Southwest Region",11,2,387,0,387,0,5,0,0
"11/08/2021","Y","Y","Bristol Bay plus Lake and Peninsula",300,"Southwest Region",11,0,387,1,388,0,5,0,0
"11/09/2021","Y","Y","Bristol Bay plus Lake and Peninsula",300,"Southwest Region",11,1,388,4,392,0,5,0,0
"11/10/2021","Y","Y","Bristol Bay plus Lake and Peninsula",300,"Southwest Region",11,0,388,6,398,0,5,0,0
"11/12/2021","Y","Y","Bristol Bay plus Lake and Peninsula",300,"Southwest Region",11,5,393,3,401,0,5,0,0
"11/13/2021","Y","Y","Bristol Bay plus Lake and Peninsula",300,"Southwest Region",11,5,398,0,401,0,5,0,0
"11/14/2021","Y","Y","Bristol Bay plus Lake and Peninsula",300,"Southwest Region",11,2,400,0,401,0,5,0,0
"11/15/2021","Y","Y","Bristol Bay plus Lake and Peninsula",300,"Southwest Region",11,2,402,4,405,1,6,0,0
"11/16/2021","Y","Y","Bristol Bay plus Lake and Peninsula",300,"Southwest Region",11,3,405,4,409,0,6,0,0
"11/17/2021","Y","Y","Bristol Bay plus Lake and Peninsula",300,"Southwest Region",11,2,407,0,409,0,6,0,0
"11/18/2021","Y","Y","Bristol Bay plus Lake and Peninsula",300,"Southwest Region",11,2,409,0,409,0,6,0,0
"11/20/2021","Y","Y","Bristol Bay plus Lake and Peninsula",300,"Southwest Region",11,1,410,1,410,0,6,0,0
"11/21/2021","Y","Y","Bristol Bay plus Lake and Peninsula",300,"Southwest Region",11,0,410,1,411,0,6,0,0
"11/22/2021","Y","Y","Bristol Bay plus Lake and Peninsula",300,"Southwest Region",11,0,410,2,413,0,6,1,1
"11/23/2021","Y","Y","Bristol Bay plus Lake and Peninsula",300,"Southwest Region",11,1,411,1,414,0,6,0,1
"11/25/2021","Y","Y","Bristol Bay plus Lake and Peninsula",300,"Southwest Region",11,2,413,0,414,0,6,0,1
"11/26/2021","Y","Y","Bristol Bay plus Lake and Peninsula",300,"Southwest Region",11,1,414,0,414,0,6,0,1
"11/28/2021","Y","Y","Bristol Bay plus Lake and Peninsula",300,"Southwest Region",11,0,414,1,415,0,6,0,1
"11/29/2021","Y","Y","Bristol Bay plus Lake and Peninsula",300,"Southwest Region",11,0,414,3,418,0,6,0,1
"11/30/2021","Y","Y","Bristol Bay plus Lake and Peninsula",300,"Southwest Region",11,2,416,1,419,0,6,0,1
"12/01/2021","Y","Y","Bristol Bay plus Lake and Peninsula",300,"Southwest Region",11,2,418,0,419,0,6,0,1
"12/02/2021","Y","Y","Bristol Bay plus Lake and Peninsula",300,"Southwest Region",11,1,419,0,419,0,6,0,1
"12/03/2021","Y","Y","Bristol Bay plus Lake and Peninsula",300,"Southwest Region",11,1,420,7,426,0,6,0,1
"12/05/2021","Y","Y","Bristol Bay plus Lake and Peninsula",300,"Southwest Region",11,4,424,0,426,0,6,0,1
"12/06/2021","Y","Y","Bristol Bay plus Lake and Peninsula",300,"Southwest Region",11,1,425,2,428,0,6,0,1
"12/07/2021","Y","Y","Bristol Bay plus Lake and Peninsula",300,"Southwest Region",11,2,427,1,429,0,6,0,1
"12/08/2021","Y","Y","Bristol Bay plus Lake and Peninsula",300,"Southwest Region",11,1,428,1,430,0,6,0,1
"12/09/2021","Y","Y","Bristol Bay plus Lake and Peninsula",300,"Southwest Region",11,1,429,0,430,0,6,0,1
"12/15/2021","Y","Y","Bristol Bay plus Lake and Peninsula",300,"Southwest Region",11,1,430,1,431,0,6,0,1
"12/17/2021","Y","Y","Bristol Bay plus Lake and Peninsula",300,"Southwest Region",11,1,431,0,431,0,6,0,1
"12/20/2021","Y","Y","Bristol Bay plus Lake and Peninsula",300,"Southwest Region",11,0,431,1,432,0,6,0,1
"12/21/2021","Y","Y","Bristol Bay plus Lake and Peninsula",300,"Southwest Region",11,1,432,1,433,0,6,0,1
"12/22/2021","Y","Y","Bristol Bay plus Lake and Peninsula",300,"Southwest Region",11,2,434,1,434,0,6,0,1
"12/23/2021","Y","Y","Bristol Bay plus Lake and Peninsula",300,"Southwest Region",11,1,435,1,435,0,6,0,1
"12/28/2021","Y","Y","Bristol Bay plus Lake and Peninsula",300,"Southwest Region",11,0,435,1,436,0,6,0,1
"12/30/2021","Y","Y","Bristol Bay plus Lake and Peninsula",300,"Southwest Region",11,2,437,3,439,0,6,0,1
"12/31/2021","Y","Y","Bristol Bay plus Lake and Peninsula",300,"Southwest Region",11,2,439,3,442,0,6,0,1
"01/01/2022","Y","Y","Bristol Bay plus Lake and Peninsula",300,"Southwest Region",11,2,441,3,445,0,6,0,1
"01/02/2022","Y","Y","Bristol Bay plus Lake and Peninsula",300,"Southwest Region",11,0,441,1,446,0,6,0,1
"01/03/2022","Y","Y","Bristol Bay plus Lake and Peninsula",300,"Southwest Region",11,3,444,9,455,0,6,0,1
"01/04/2022","Y","Y","Bristol Bay plus Lake and Peninsula",300,"Southwest Region",11,1,445,3,458,0,6,0,1
"01/05/2022","Y","Y","Bristol Bay plus Lake and Peninsula",300,"Southwest Region",11,2,447,0,458,0,6,0,1
"01/06/2022","Y","Y","Bristol Bay plus Lake and Peninsula",300,"Southwest Region",11,7,454,7,465,0,6,0,1
"01/07/2022","Y","Y","Bristol Bay plus Lake and Peninsula",300,"Southwest Region",11,2,456,6,471,0,6,0,1
"01/08/2022","Y","Y","Bristol Bay plus Lake and Peninsula",300,"Southwest Region",11,1,457,0,471,0,6,0,1
"01/09/2022","Y","Y","Bristol Bay plus Lake and Peninsula",300,"Southwest Region",11,1,458,0,471,0,6,0,1
"01/10/2022","Y","Y","Bristol Bay plus Lake and Peninsula",300,"Southwest Region",11,9,467,12,483,0,6,0,1
"01/11/2022","Y","Y","Bristol Bay plus Lake and Peninsula",300,"Southwest Region",11,3,470,7,490,0,6,0,1
"01/12/2022","Y","Y","Bristol Bay plus Lake and Peninsula",300,"Southwest Region",11,11,481,6,496,0,6,0,1
"01/13/2022","Y","Y","Bristol Bay plus Lake and Peninsula",300,"Southwest Region",11,8,489,4,500,0,6,0,1
"01/14/2022","Y","Y","Bristol Bay plus Lake and Peninsula",300,"Southwest Region",11,1,490,3,503,0,6,0,1
"01/15/2022","Y","Y","Bristol Bay plus Lake and Peninsula",300,"Southwest Region",11,8,498,6,509,0,6,0,1
"01/16/2022","Y","Y","Bristol Bay plus Lake and Peninsula",300,"Southwest Region",11,3,501,0,509,0,6,0,1
"01/17/2022","Y","Y","Bristol Bay plus Lake and Peninsula",300,"Southwest Region",11,0,501,1,510,0,6,0,1
"01/18/2022","Y","Y","Bristol Bay plus Lake and Peninsula",300,"Southwest Region",11,3,504,8,518,0,6,0,1
"01/19/2022","Y","Y","Bristol Bay plus Lake and Peninsula",300,"Southwest Region",11,2,506,3,521,0,6,0,1
"01/20/2022","Y","Y","Bristol Bay plus Lake and Peninsula",300,"Southwest Region",11,9,515,12,533,0,6,0,1
"01/21/2022","Y","Y","Bristol Bay plus Lake and Peninsula",300,"Southwest Region",11,1,516,4,537,0,6,0,1
"01/22/2022","Y","Y","Bristol Bay plus Lake and Peninsula",300,"Southwest Region",11,9,525,9,546,0,6,0,1
"01/23/2022","Y","Y","Bristol Bay plus Lake and Peninsula",300,"Southwest Region",11,4,529,4,550,0,6,0,1
"01/24/2022","Y","Y","Bristol Bay plus Lake and Peninsula",300,"Southwest Region",11,1,530,11,561,0,6,0,1
"01/25/2022","Y","Y","Bristol Bay plus Lake and Peninsula",300,"Southwest Region",11,11,541,3,564,1,7,0,1
"01/26/2022","Y","Y","Bristol Bay plus Lake and Peninsula",300,"Southwest Region",11,28,569,22,586,0,7,0,1
"01/27/2022","Y","Y","Bristol Bay plus Lake and Peninsula",300,"Southwest Region",11,14,583,13,599,0,7,0,1
"01/28/2022","Y","Y","Bristol Bay plus Lake and Peninsula",300,"Southwest Region",11,0,583,2,601,0,7,0,1
"01/29/2022","Y","Y","Bristol Bay plus Lake and Peninsula",300,"Southwest Region",11,18,601,15,616,0,7,0,1
"01/30/2022","Y","Y","Bristol Bay plus Lake and Peninsula",300,"Southwest Region",11,5,606,2,618,0,7,0,1
"01/31/2022","Y","Y","Bristol Bay plus Lake and Peninsula",300,"Southwest Region",11,3,609,4,622,0,7,0,1
"02/01/2022","Y","Y","Bristol Bay plus Lake and Peninsula",300,"Southwest Region",11,1,610,6,628,0,7,0,1
"02/02/2022","Y","Y","Bristol Bay plus Lake and Peninsula",300,"Southwest Region",11,3,613,4,632,0,7,0,1
"02/03/2022","Y","Y","Bristol Bay plus Lake and Peninsula",300,"Southwest Region",11,7,620,1,633,0,7,0,1
"02/04/2022","Y","Y","Bristol Bay plus Lake and Peninsula",300,"Southwest Region",11,5,625,5,638,0,7,0,1
"02/06/2022","Y","Y","Bristol Bay plus Lake and Peninsula",300,"Southwest Region",11,0,625,1,639,0,7,0,1
"02/07/2022","Y","Y","Bristol Bay plus Lake and Peninsula",300,"Southwest Region",11,11,636,6,645,0,7,0,1
"02/08/2022","Y","Y","Bristol Bay plus Lake and Peninsula",300,"Southwest Region",11,5,641,1,646,0,7,0,1
"02/09/2022","Y","Y","Bristol Bay plus Lake and Peninsula",300,"Southwest Region",11,3,644,2,648,0,7,0,1
"02/10/2022","Y","Y","Bristol Bay plus Lake and Peninsula",300,"Southwest Region",11,1,645,0,648,0,7,0,1
"02/11/2022","Y","Y","Bristol Bay plus Lake and Peninsula",300,"Southwest Region",11,0,645,2,650,0,7,0,1
"02/12/2022","Y","Y","Bristol Bay plus Lake and Peninsula",300,"Southwest Region",11,1,646,1,651,0,7,0,1
"02/15/2022","Y","Y","Bristol Bay plus Lake and Peninsula",300,"Southwest Region",11,4,650,3,654,0,7,0,1
"02/17/2022","Y","Y","Bristol Bay plus Lake and Peninsula",300,"Southwest Region",11,3,653,1,655,0,7,0,1
"02/19/2022","Y","Y","Bristol Bay plus Lake and Peninsula",300,"Southwest Region",11,1,654,1,656,0,7,0,1
"02/21/2022","Y","Y","Bristol Bay plus Lake and Peninsula",300,"Southwest Region",11,1,655,1,657,0,7,0,1
"02/22/2022","Y","Y","Bristol Bay plus Lake and Peninsula",300,"Southwest Region",11,0,655,1,658,0,7,0,1
"02/23/2022","Y","Y","Bristol Bay plus Lake and Peninsula",300,"Southwest Region",11,1,656,3,661,0,7,0,1
"02/24/2022","Y","Y","Bristol Bay plus Lake and Peninsula",300,"Southwest Region",11,1,657,0,661,0,7,0,1
"02/25/2022","Y","Y","Bristol Bay plus Lake and Peninsula",300,"Southwest Region",11,3,660,1,662,0,7,0,1
"02/28/2022","Y","Y","Bristol Bay plus Lake and Peninsula",300,"Southwest Region",11,2,662,4,666,0,7,0,1
"03/01/2022","Y","Y","Bristol Bay plus Lake and Peninsula",300,"Southwest Region",11,1,663,3,669,0,7,0,1
"03/02/2022","Y","Y","Bristol Bay plus Lake and Peninsula",300,"Southwest Region",11,4,667,4,673,0,7,0,1
"03/03/2022","Y","Y","Bristol Bay plus Lake and Peninsula",300,"Southwest Region",11,2,669,1,674,0,7,0,1
"03/04/2022","Y","Y","Bristol Bay plus Lake and Peninsula",300,"Southwest Region",11,0,669,3,677,0,7,0,1
"03/06/2022","Y","Y","Bristol Bay plus Lake and Peninsula",300,"Southwest Region",11,0,669,2,679,0,7,0,1
"03/07/2022","Y","Y","Bristol Bay plus Lake and Peninsula",300,"Southwest Region",11,3,672,1,680,0,7,0,1
"03/09/2022","Y","Y","Bristol Bay plus Lake and Peninsula",300,"Southwest Region",11,5,677,0,680,0,7,0,1
"03/10/2022","Y","Y","Bristol Bay plus Lake and Peninsula",300,"Southwest Region",11,2,679,0,680,0,7,0,1
"03/11/2022","Y","Y","Bristol Bay plus Lake and Peninsula",300,"Southwest Region",11,1,680,3,683,0,7,0,1
"03/14/2022","Y","Y","Bristol Bay plus Lake and Peninsula",300,"Southwest Region",11,1,681,1,684,0,7,0,1
"03/15/2022","Y","Y","Bristol Bay plus Lake and Peninsula",300,"Southwest Region",11,4,685,5,689,0,7,0,1
"03/16/2022","Y","Y","Bristol Bay plus Lake and Peninsula",300,"Southwest Region",11,0,685,2,691,0,7,0,1
"03/17/2022","Y","Y","Bristol Bay plus Lake and Peninsula",300,"Southwest Region",11,1,686,2,693,0,7,0,1
"03/18/2022","Y","Y","Bristol Bay plus Lake and Peninsula",300,"Southwest Region",11,4,690,0,693,0,7,0,1
"03/19/2022","Y","Y","Bristol Bay plus Lake and Peninsula",300,"Southwest Region",11,2,692,0,693,0,7,0,1
"03/21/2022","Y","Y","Bristol Bay plus Lake and Peninsula",300,"Southwest Region",11,0,692,2,695,0,7,0,1
"03/23/2022","Y","Y","Bristol Bay plus Lake and Peninsula",300,"Southwest Region",11,0,692,3,698,0,7,0,1
"03/24/2022","Y","Y","Bristol Bay plus Lake and Peninsula",300,"Southwest Region",11,5,697,6,704,0,7,0,1
"03/28/2022","Y","Y","Bristol Bay plus Lake and Peninsula",300,"Southwest Region",11,0,697,1,705,0,7,0,1
"03/29/2022","Y","Y","Bristol Bay plus Lake and Peninsula",300,"Southwest Region",11,7,704,0,705,0,7,0,1
"03/30/2022","Y","Y","Bristol Bay plus Lake and Peninsula",300,"Southwest Region",11,0,704,1,706,0,7,0,1
"03/31/2022","Y","Y","Bristol Bay plus Lake and Peninsula",300,"Southwest Region",11,0,704,1,707,0,7,0,1
"04/01/2022","Y","Y","Bristol Bay plus Lake and Peninsula",300,"Southwest Region",11,1,705,0,707,0,7,0,1
"04/03/2022","Y","Y","Bristol Bay plus Lake and Peninsula",300,"Southwest Region",11,1,706,0,707,0,7,0,1
"04/05/2022","Y","Y","Bristol Bay plus Lake and Peninsula",300,"Southwest Region",11,0,706,7,714,0,7,0,1
"04/06/2022","Y","Y","Bristol Bay plus Lake and Peninsula",300,"Southwest Region",11,7,713,1,715,0,7,0,1
"04/07/2022","Y","Y","Bristol Bay plus Lake and Peninsula",300,"Southwest Region",11,0,713,2,717,0,7,0,1
"04/08/2022","Y","Y","Bristol Bay plus Lake and Peninsula",300,"Southwest Region",11,0,713,4,721,0,7,0,1
"04/09/2022","Y","Y","Bristol Bay plus Lake and Peninsula",300,"Southwest Region",11,2,715,0,721,0,7,0,1
"04/10/2022","Y","Y","Bristol Bay plus Lake and Peninsula",300,"Southwest Region",11,4,719,0,721,0,7,0,1
"04/11/2022","Y","Y","Bristol Bay plus Lake and Peninsula",300,"Southwest Region",11,0,719,2,723,0,7,0,1
"04/12/2022","Y","Y","Bristol Bay plus Lake and Peninsula",300,"Southwest Region",11,2,721,1,724,0,7,0,1
"04/13/2022","Y","Y","Bristol Bay plus Lake and Peninsula",300,"Southwest Region",11,0,721,2,726,0,7,0,1
"04/14/2022","Y","Y","Bristol Bay plus Lake and Peninsula",300,"Southwest Region",11,1,722,0,726,0,7,0,1
"04/15/2022","Y","Y","Bristol Bay plus Lake and Peninsula",300,"Southwest Region",11,4,726,2,728,0,7,0,1
"04/16/2022","Y","Y","Bristol Bay plus Lake and Peninsula",300,"Southwest Region",11,1,727,0,728,0,7,0,1
"04/17/2022","Y","Y","Bristol Bay plus Lake and Peninsula",300,"Southwest Region",11,1,728,0,728,0,7,0,1
"04/20/2022","Y","Y","Bristol Bay plus Lake and Peninsula",300,"Southwest Region",11,0,728,2,730,0,7,0,1
"04/21/2022","Y","Y","Bristol Bay plus Lake and Peninsula",300,"Southwest Region",11,1,729,0,730,0,7,0,1
"04/22/2022","Y","Y","Bristol Bay plus Lake and Peninsula",300,"Southwest Region",11,1,730,0,730,0,7,0,1
"04/24/2022","Y","Y","Bristol Bay plus Lake and Peninsula",300,"Southwest Region",11,1,731,1,731,0,7,0,1
"04/25/2022","Y","Y","Bristol Bay plus Lake and Peninsula",300,"Southwest Region",11,1,732,1,732,0,7,0,1
"06/24/2020","Y","Y","Chugach Census Area",63,"Other Interior Region",7,1,1,2,2,0,0,0,0
"06/27/2020","Y","Y","Chugach Census Area",63,"Other Interior Region",7,1,2,0,2,0,0,0,0
"07/06/2020","Y","Y","Chugach Census Area",63,"Other Interior Region",7,1,3,1,3,0,0,0,0
"07/07/2020","Y","Y","Chugach Census Area",63,"Other Interior Region",7,1,4,1,4,0,0,0,0
"07/08/2020","Y","Y","Chugach Census Area",63,"Other Interior Region",7,0,4,3,7,0,0,0,0
"07/11/2020","Y","Y","Chugach Census Area",63,"Other Interior Region",7,2,6,0,7,0,0,0,0
"07/19/2020","Y","Y","Chugach Census Area",63,"Other Interior Region",7,0,6,1,8,0,0,0,0
"07/20/2020","Y","Y","Chugach Census Area",63,"Other Interior Region",7,0,6,1,9,0,0,0,0
"07/21/2020","Y","Y","Chugach Census Area",63,"Other Interior Region",7,0,6,1,10,0,0,0,0
"07/22/2020","Y","Y","Chugach Census Area",63,"Other Interior Region",7,1,7,1,11,0,0,0,0
"07/23/2020","Y","Y","Chugach Census Area",63,"Other Interior Region",7,1,8,0,11,0,0,0,0
"07/24/2020","Y","Y","Chugach Census Area",63,"Other Interior Region",7,2,10,2,13,0,0,0,0
"07/26/2020","Y","Y","Chugach Census Area",63,"Other Interior Region",7,0,10,1,14,0,0,0,0
"07/27/2020","Y","Y","Chugach Census Area",63,"Other Interior Region",7,1,11,0,14,0,0,0,0
"07/28/2020","Y","Y","Chugach Census Area",63,"Other Interior Region",7,1,12,0,14,0,0,0,0
"07/29/2020","Y","Y","Chugach Census Area",63,"Other Interior Region",7,0,12,1,15,0,0,0,0
"07/30/2020","Y","Y","Chugach Census Area",63,"Other Interior Region",7,1,13,0,15,0,0,0,0
"07/31/2020","Y","Y","Chugach Census Area",63,"Other Interior Region",7,1,14,2,17,0,0,0,0
"08/01/2020","Y","Y","Chugach Census Area",63,"Other Interior Region",7,3,17,1,18,0,0,0,0
"08/05/2020","Y","Y","Chugach Census Area",63,"Other Interior Region",7,0,17,1,19,0,0,0,0
"08/07/2020","Y","Y","Chugach Census Area",63,"Other Interior Region",7,1,18,0,19,0,0,0,0
"08/08/2020","Y","Y","Chugach Census Area",63,"Other Interior Region",7,0,18,2,21,0,0,0,0
"08/09/2020","Y","Y","Chugach Census Area",63,"Other Interior Region",7,1,19,0,21,0,0,0,0
"08/10/2020","Y","Y","Chugach Census Area",63,"Other Interior Region",7,0,19,4,25,0,0,0,0
"08/11/2020","Y","Y","Chugach Census Area",63,"Other Interior Region",7,6,25,0,25,0,0,0,0
"08/14/2020","Y","Y","Chugach Census Area",63,"Other Interior Region",7,0,25,1,26,0,0,0,0
"08/15/2020","Y","Y","Chugach Census Area",63,"Other Interior Region",7,1,26,0,26,0,0,0,0
"08/17/2020","Y","Y","Chugach Census Area",63,"Other Interior Region",7,0,26,1,27,0,0,0,0
"08/20/2020","Y","Y","Chugach Census Area",63,"Other Interior Region",7,1,27,2,29,0,0,0,0
"08/21/2020","Y","Y","Chugach Census Area",63,"Other Interior Region",7,0,27,1,30,0,0,0,0
"08/22/2020","Y","Y","Chugach Census Area",63,"Other Interior Region",7,1,28,0,30,0,0,0,0
"08/23/2020","Y","Y","Chugach Census Area",63,"Other Interior Region",7,1,29,0,30,0,0,0,0
"08/25/2020","Y","Y","Chugach Census Area",63,"Other Interior Region",7,0,29,1,31,0,0,0,0
"08/26/2020","Y","Y","Chugach Census Area",63,"Other Interior Region",7,1,30,1,32,0,0,0,0
"08/27/2020","Y","Y","Chugach Census Area",63,"Other Interior Region",7,1,31,0,32,0,0,0,0
"09/02/2020","Y","Y","Chugach Census Area",63,"Other Interior Region",7,1,32,0,32,0,0,0,0
"09/21/2020","Y","Y","Chugach Census Area",63,"Other Interior Region",7,0,32,1,33,0,0,0,0
"09/22/2020","Y","Y","Chugach Census Area",63,"Other Interior Region",7,0,32,1,34,0,0,0,0
"09/28/2020","Y","Y","Chugach Census Area",63,"Other Interior Region",7,2,34,2,36,1,1,0,0
"09/30/2020","Y","Y","Chugach Census Area",63,"Other Interior Region",7,2,36,2,38,0,1,0,0
"10/02/2020","Y","Y","Chugach Census Area",63,"Other Interior Region",7,1,37,1,39,0,1,0,0
"10/03/2020","Y","Y","Chugach Census Area",63,"Other Interior Region",7,0,37,1,40,0,1,0,0
"10/05/2020","Y","Y","Chugach Census Area",63,"Other Interior Region",7,0,37,3,43,0,1,0,0
"10/06/2020","Y","Y","Chugach Census Area",63,"Other Interior Region",7,0,37,3,46,0,1,0,0
"10/07/2020","Y","Y","Chugach Census Area",63,"Other Interior Region",7,3,40,0,46,0,1,0,0
"10/08/2020","Y","Y","Chugach Census Area",63,"Other Interior Region",7,1,41,0,46,0,1,0,0
"10/09/2020","Y","Y","Chugach Census Area",63,"Other Interior Region",7,1,42,3,49,0,1,0,0
"10/10/2020","Y","Y","Chugach Census Area",63,"Other Interior Region",7,2,44,0,49,0,1,0,0
"10/11/2020","Y","Y","Chugach Census Area",63,"Other Interior Region",7,1,45,3,52,0,1,0,0
"10/12/2020","Y","Y","Chugach Census Area",63,"Other Interior Region",7,4,49,1,53,0,1,0,0
"10/13/2020","Y","Y","Chugach Census Area",63,"Other Interior Region",7,1,50,4,57,0,1,0,0
"10/14/2020","Y","Y","Chugach Census Area",63,"Other Interior Region",7,0,50,0,57,0,1,1,1
"10/15/2020","Y","Y","Chugach Census Area",63,"Other Interior Region",7,3,53,0,57,0,1,0,1
"10/16/2020","Y","Y","Chugach Census Area",63,"Other Interior Region",7,1,54,1,58,0,1,0,1
"10/17/2020","Y","Y","Chugach Census Area",63,"Other Interior Region",7,0,54,1,59,0,1,0,1
"10/18/2020","Y","Y","Chugach Census Area",63,"Other Interior Region",7,1,55,1,60,0,1,0,1
"10/19/2020","Y","Y","Chugach Census Area",63,"Other Interior Region",7,2,57,1,61,0,1,0,1
"10/20/2020","Y","Y","Chugach Census Area",63,"Other Interior Region",7,0,57,1,62,0,1,0,1
"10/21/2020","Y","Y","Chugach Census Area",63,"Other Interior Region",7,2,59,2,64,0,1,0,1
"10/23/2020","Y","Y","Chugach Census Area",63,"Other Interior Region",7,1,60,0,64,0,1,0,1
"10/24/2020","Y","Y","Chugach Census Area",63,"Other Interior Region",7,1,61,0,64,0,1,0,1
"10/25/2020","Y","Y","Chugach Census Area",63,"Other Interior Region",7,1,62,0,64,0,1,0,1
"10/26/2020","Y","Y","Chugach Census Area",63,"Other Interior Region",7,1,63,1,65,0,1,0,1
"10/29/2020","Y","Y","Chugach Census Area",63,"Other Interior Region",7,0,63,1,66,0,1,0,1
"10/30/2020","Y","Y","Chugach Census Area",63,"Other Interior Region",7,1,64,0,66,0,1,0,1
"10/31/2020","Y","Y","Chugach Census Area",63,"Other Interior Region",7,1,65,0,66,0,1,0,1
"11/01/2020","Y","Y","Chugach Census Area",63,"Other Interior Region",7,0,65,1,67,0,1,0,1
"11/03/2020","Y","Y","Chugach Census Area",63,"Other Interior Region",7,1,66,2,69,0,1,0,1
"11/04/2020","Y","Y","Chugach Census Area",63,"Other Interior Region",7,0,66,1,70,0,1,0,1
"11/05/2020","Y","Y","Chugach Census Area",63,"Other Interior Region",7,0,66,2,72,0,1,0,1
"11/06/2020","Y","Y","Chugach Census Area",63,"Other Interior Region",7,2,68,0,72,0,1,0,1
"11/07/2020","Y","Y","Chugach Census Area",63,"Other Interior Region",7,2,70,1,73,0,1,0,1
"11/09/2020","Y","Y","Chugach Census Area",63,"Other Interior Region",7,1,71,1,74,0,1,0,1
"11/10/2020","Y","Y","Chugach Census Area",63,"Other Interior Region",7,1,72,0,74,0,1,0,1
"11/11/2020","Y","Y","Chugach Census Area",63,"Other Interior Region",7,1,73,2,76,0,1,0,1
"11/12/2020","Y","Y","Chugach Census Area",63,"Other Interior Region",7,3,76,3,79,0,1,0,1
"11/13/2020","Y","Y","Chugach Census Area",63,"Other Interior Region",7,2,78,1,80,0,1,0,1
"11/14/2020","Y","Y","Chugach Census Area",63,"Other Interior Region",7,0,78,2,82,0,1,0,1
"11/15/2020","Y","Y","Chugach Census Area",63,"Other Interior Region",7,4,82,5,87,1,2,0,1
"11/16/2020","Y","Y","Chugach Census Area",63,"Other Interior Region",7,0,82,3,90,0,2,0,1
"11/17/2020","Y","Y","Chugach Census Area",63,"Other Interior Region",7,4,86,3,93,0,2,0,1
"11/18/2020","Y","Y","Chugach Census Area",63,"Other Interior Region",7,0,86,0,93,0,2,1,2
"11/19/2020","Y","Y","Chugach Census Area",63,"Other Interior Region",7,5,91,5,98,1,3,0,2
"11/20/2020","Y","Y","Chugach Census Area",63,"Other Interior Region",7,0,91,1,99,0,3,0,2
"11/21/2020","Y","Y","Chugach Census Area",63,"Other Interior Region",7,2,93,4,103,0,3,0,2
"11/22/2020","Y","Y","Chugach Census Area",63,"Other Interior Region",7,6,99,3,106,1,4,0,2
"11/23/2020","Y","Y","Chugach Census Area",63,"Other Interior Region",7,5,104,1,107,1,5,0,2
"11/24/2020","Y","Y","Chugach Census Area",63,"Other Interior Region",7,3,107,2,109,0,5,0,2
"11/25/2020","Y","Y","Chugach Census Area",63,"Other Interior Region",7,0,107,5,114,0,5,0,2
"11/28/2020","Y","Y","Chugach Census Area",63,"Other Interior Region",7,2,109,2,116,0,5,0,2
"11/29/2020","Y","Y","Chugach Census Area",63,"Other Interior Region",7,3,112,4,120,0,5,0,2
"11/30/2020","Y","Y","Chugach Census Area",63,"Other Interior Region",7,0,112,1,121,0,5,0,2
"12/01/2020","Y","Y","Chugach Census Area",63,"Other Interior Region",7,1,113,6,127,0,5,0,2
"12/02/2020","Y","Y","Chugach Census Area",63,"Other Interior Region",7,2,115,0,127,0,5,0,2
"12/03/2020","Y","Y","Chugach Census Area",63,"Other Interior Region",7,1,116,0,127,0,5,0,2
"12/04/2020","Y","Y","Chugach Census Area",63,"Other Interior Region",7,5,121,3,130,1,6,0,2
"12/05/2020","Y","Y","Chugach Census Area",63,"Other Interior Region",7,3,124,2,132,0,6,0,2
"12/06/2020","Y","Y","Chugach Census Area",63,"Other Interior Region",7,5,129,1,133,0,6,0,2
"12/07/2020","Y","Y","Chugach Census Area",63,"Other Interior Region",7,1,130,1,134,0,6,0,2
"12/08/2020","Y","Y","Chugach Census Area",63,"Other Interior Region",7,2,132,6,140,0,6,0,2
"12/09/2020","Y","Y","Chugach Census Area",63,"Other Interior Region",7,2,134,0,140,0,6,0,2
"12/10/2020","Y","Y","Chugach Census Area",63,"Other Interior Region",7,3,137,1,141,1,7,0,2
"12/11/2020","Y","Y","Chugach Census Area",63,"Other Interior Region",7,1,138,2,143,0,7,0,2
"12/12/2020","Y","Y","Chugach Census Area",63,"Other Interior Region",7,1,139,2,145,1,8,0,2
"12/13/2020","Y","Y","Chugach Census Area",63,"Other Interior Region",7,1,140,2,147,0,8,0,2
"12/14/2020","Y","Y","Chugach Census Area",63,"Other Interior Region",7,1,141,1,148,0,8,0,2
"12/15/2020","Y","Y","Chugach Census Area",63,"Other Interior Region",7,8,149,2,150,0,8,0,2
"12/16/2020","Y","Y","Chugach Census Area",63,"Other Interior Region",7,0,149,1,151,0,8,0,2
"12/17/2020","Y","Y","Chugach Census Area",63,"Other Interior Region",7,1,150,1,152,0,8,0,2
"12/18/2020","Y","Y","Chugach Census Area",63,"Other Interior Region",7,0,150,3,155,0,8,0,2
"12/21/2020","Y","Y","Chugach Census Area",63,"Other Interior Region",7,2,152,0,155,0,8,0,2
"12/22/2020","Y","Y","Chugach Census Area",63,"Other Interior Region",7,3,155,1,156,0,8,0,2
"12/23/2020","Y","Y","Chugach Census Area",63,"Other Interior Region",7,2,157,1,157,0,8,0,2
"12/28/2020","Y","Y","Chugach Census Area",63,"Other Interior Region",7,0,157,2,159,0,8,0,2
"12/29/2020","Y","Y","Chugach Census Area",63,"Other Interior Region",7,10,167,8,167,0,8,0,2
"12/30/2020","Y","Y","Chugach Census Area",63,"Other Interior Region",7,1,168,3,170,0,8,0,2
"12/31/2020","Y","Y","Chugach Census Area",63,"Other Interior Region",7,1,169,0,170,0,8,0,2
"01/02/2021","Y","Y","Chugach Census Area",63,"Other Interior Region",7,1,170,0,170,0,8,0,2
"01/04/2021","Y","Y","Chugach Census Area",63,"Other Interior Region",7,0,170,2,172,0,8,0,2
"01/05/2021","Y","Y","Chugach Census Area",63,"Other Interior Region",7,2,172,1,173,0,8,0,2
"01/06/2021","Y","Y","Chugach Census Area",63,"Other Interior Region",7,0,172,3,176,0,8,0,2
"01/07/2021","Y","Y","Chugach Census Area",63,"Other Interior Region",7,3,175,0,176,0,8,0,2
"01/08/2021","Y","Y","Chugach Census Area",63,"Other Interior Region",7,1,176,2,178,0,8,0,2
"01/09/2021","Y","Y","Chugach Census Area",63,"Other Interior Region",7,2,178,0,178,0,8,0,2
"01/10/2021","Y","Y","Chugach Census Area",63,"Other Interior Region",7,0,178,1,179,0,8,0,2
"01/11/2021","Y","Y","Chugach Census Area",63,"Other Interior Region",7,0,178,5,184,0,8,0,2
"01/12/2021","Y","Y","Chugach Census Area",63,"Other Interior Region",7,2,180,0,184,0,8,0,2
"01/13/2021","Y","Y","Chugach Census Area",63,"Other Interior Region",7,2,182,3,187,0,8,0,2
"01/14/2021","Y","Y","Chugach Census Area",63,"Other Interior Region",7,6,188,3,190,0,8,0,2
"01/15/2021","Y","Y","Chugach Census Area",63,"Other Interior Region",7,0,188,4,194,0,8,0,2
"01/16/2021","Y","Y","Chugach Census Area",63,"Other Interior Region",7,4,192,0,194,0,8,0,2
"01/17/2021","Y","Y","Chugach Census Area",63,"Other Interior Region",7,1,193,0,194,0,8,0,2
"01/19/2021","Y","Y","Chugach Census Area",63,"Other Interior Region",7,1,194,0,194,0,8,0,2
"01/20/2021","Y","Y","Chugach Census Area",63,"Other Interior Region",7,0,194,1,195,0,8,0,2
"01/21/2021","Y","Y","Chugach Census Area",63,"Other Interior Region",7,1,195,2,197,0,8,0,2
"01/22/2021","Y","Y","Chugach Census Area",63,"Other Interior Region",7,2,197,4,201,0,8,0,2
"01/23/2021","Y","Y","Chugach Census Area",63,"Other Interior Region",7,4,201,2,203,0,8,0,2
"01/25/2021","Y","Y","Chugach Census Area",63,"Other Interior Region",7,1,202,2,205,0,8,0,2
"01/26/2021","Y","Y","Chugach Census Area",63,"Other Interior Region",7,1,203,1,206,0,8,0,2
"01/27/2021","Y","Y","Chugach Census Area",63,"Other Interior Region",7,1,204,0,206,0,8,0,2
"01/28/2021","Y","Y","Chugach Census Area",63,"Other Interior Region",7,1,205,0,206,0,8,0,2
"02/01/2021","Y","Y","Chugach Census Area",63,"Other Interior Region",7,0,205,1,207,0,8,0,2
"02/02/2021","Y","Y","Chugach Census Area",63,"Other Interior Region",7,1,206,0,207,0,8,0,2
"02/04/2021","Y","Y","Chugach Census Area",63,"Other Interior Region",7,1,207,0,207,0,8,0,2
"02/08/2021","Y","Y","Chugach Census Area",63,"Other Interior Region",7,0,207,1,208,0,8,0,2
"02/10/2021","Y","Y","Chugach Census Area",63,"Other Interior Region",7,1,208,0,208,0,8,0,2
"02/17/2021","Y","Y","Chugach Census Area",63,"Other Interior Region",7,0,208,1,209,0,8,0,2
"02/18/2021","Y","Y","Chugach Census Area",63,"Other Interior Region",7,0,208,2,211,0,8,0,2
"02/20/2021","Y","Y","Chugach Census Area",63,"Other Interior Region",7,2,210,0,211,0,8,0,2
"02/21/2021","Y","Y","Chugach Census Area",63,"Other Interior Region",7,0,210,2,213,0,8,0,2
"02/22/2021","Y","Y","Chugach Census Area",63,"Other Interior Region",7,0,210,5,218,0,8,0,2
"02/23/2021","Y","Y","Chugach Census Area",63,"Other Interior Region",7,2,212,9,227,0,8,0,2
"02/24/2021","Y","Y","Chugach Census Area",63,"Other Interior Region",7,11,223,3,230,0,8,0,2
"02/25/2021","Y","Y","Chugach Census Area",63,"Other Interior Region",7,2,225,0,230,0,8,0,2
"02/26/2021","Y","Y","Chugach Census Area",63,"Other Interior Region",7,0,225,1,231,0,8,0,2
"02/27/2021","Y","Y","Chugach Census Area",63,"Other Interior Region",7,3,228,1,232,0,8,0,2
"02/28/2021","Y","Y","Chugach Census Area",63,"Other Interior Region",7,1,229,0,232,0,8,0,2
"03/01/2021","Y","Y","Chugach Census Area",63,"Other Interior Region",7,1,230,4,236,0,8,0,2
"03/02/2021","Y","Y","Chugach Census Area",63,"Other Interior Region",7,2,232,2,238,0,8,0,2
"03/03/2021","Y","Y","Chugach Census Area",63,"Other Interior Region",7,4,236,4,242,0,8,0,2
"03/04/2021","Y","Y","Chugach Census Area",63,"Other Interior Region",7,5,241,1,243,0,8,0,2
"03/05/2021","Y","Y","Chugach Census Area",63,"Other Interior Region",7,1,242,0,243,0,8,0,2
"03/07/2021","Y","Y","Chugach Census Area",63,"Other Interior Region",7,0,242,1,244,0,8,0,2
"03/08/2021","Y","Y","Chugach Census Area",63,"Other Interior Region",7,0,242,1,245,0,8,0,2
"03/09/2021","Y","Y","Chugach Census Area",63,"Other Interior Region",7,1,243,2,247,0,8,0,2
"03/10/2021","Y","Y","Chugach Census Area",63,"Other Interior Region",7,0,243,1,248,0,8,0,2
"03/14/2021","Y","Y","Chugach Census Area",63,"Other Interior Region",7,1,244,1,249,0,8,0,2
"03/15/2021","Y","Y","Chugach Census Area",63,"Other Interior Region",7,3,247,1,250,0,8,0,2
"03/16/2021","Y","Y","Chugach Census Area",63,"Other Interior Region",7,1,248,4,254,0,8,0,2
"03/17/2021","Y","Y","Chugach Census Area",63,"Other Interior Region",7,1,249,2,256,0,8,0,2
"03/18/2021","Y","Y","Chugach Census Area",63,"Other Interior Region",7,2,251,5,261,0,8,0,2
"03/19/2021","Y","Y","Chugach Census Area",63,"Other Interior Region",7,4,255,1,262,0,8,0,2
"03/20/2021","Y","Y","Chugach Census Area",63,"Other Interior Region",7,3,258,0,262,0,8,0,2
"03/21/2021","Y","Y","Chugach Census Area",63,"Other Interior Region",7,0,258,1,263,0,8,0,2
"03/22/2021","Y","Y","Chugach Census Area",63,"Other Interior Region",7,0,258,3,266,0,8,0,2
"03/23/2021","Y","Y","Chugach Census Area",63,"Other Interior Region",7,1,259,6,272,0,8,0,2
"03/24/2021","Y","Y","Chugach Census Area",63,"Other Interior Region",7,1,260,2,274,0,8,0,2
"03/25/2021","Y","Y","Chugach Census Area",63,"Other Interior Region",7,2,262,5,279,0,8,0,2
"03/26/2021","Y","Y","Chugach Census Area",63,"Other Interior Region",7,7,269,0,279,0,8,0,2
"03/27/2021","Y","Y","Chugach Census Area",63,"Other Interior Region",7,5,274,4,283,0,8,0,2
"03/28/2021","Y","Y","Chugach Census Area",63,"Other Interior Region",7,0,274,3,286,0,8,0,2
"03/29/2021","Y","Y","Chugach Census Area",63,"Other Interior Region",7,1,275,7,293,0,8,0,2
"03/30/2021","Y","Y","Chugach Census Area",63,"Other Interior Region",7,3,278,9,302,0,8,0,2
"03/31/2021","Y","Y","Chugach Census Area",63,"Other Interior Region",7,1,279,3,305,0,8,0,2
"04/01/2021","Y","Y","Chugach Census Area",63,"Other Interior Region",7,0,279,2,307,1,9,0,2
"04/02/2021","Y","Y","Chugach Census Area",63,"Other Interior Region",7,17,296,1,308,0,9,0,2
"04/03/2021","Y","Y","Chugach Census Area",63,"Other Interior Region",7,3,299,0,308,0,9,0,2
"04/04/2021","Y","Y","Chugach Census Area",63,"Other Interior Region",7,1,300,2,310,0,9,0,2
"04/05/2021","Y","Y","Chugach Census Area",63,"Other Interior Region",7,4,304,4,314,0,9,0,2
"04/06/2021","Y","Y","Chugach Census Area",63,"Other Interior Region",7,0,304,4,318,0,9,0,2
"04/07/2021","Y","Y","Chugach Census Area",63,"Other Interior Region",7,5,309,1,319,0,9,0,2
"04/08/2021","Y","Y","Chugach Census Area",63,"Other Interior Region",7,6,315,3,322,0,9,0,2
"04/09/2021","Y","Y","Chugach Census Area",63,"Other Interior Region",7,5,320,2,324,0,9,0,2
"04/10/2021","Y","Y","Chugach Census Area",63,"Other Interior Region",7,0,320,2,326,0,9,0,2
"04/12/2021","Y","Y","Chugach Census Area",63,"Other Interior Region",7,0,320,1,327,0,9,0,2
"04/13/2021","Y","Y","Chugach Census Area",63,"Other Interior Region",7,3,323,0,327,0,9,0,2
"04/14/2021","Y","Y","Chugach Census Area",63,"Other Interior Region",7,1,324,1,328,0,9,0,2
"04/15/2021","Y","Y","Chugach Census Area",63,"Other Interior Region",7,1,325,2,330,1,10,0,2
"04/16/2021","Y","Y","Chugach Census Area",63,"Other Interior Region",7,3,328,3,333,0,10,0,2
"04/17/2021","Y","Y","Chugach Census Area",63,"Other Interior Region",7,1,329,1,334,0,10,0,2
"04/18/2021","Y","Y","Chugach Census Area",63,"Other Interior Region",7,1,330,0,334,0,10,0,2
"04/19/2021","Y","Y","Chugach Census Area",63,"Other Interior Region",7,1,331,1,335,0,10,0,2
"04/20/2021","Y","Y","Chugach Census Area",63,"Other Interior Region",7,1,332,0,335,0,10,0,2
"04/23/2021","Y","Y","Chugach Census Area",63,"Other Interior Region",7,1,333,0,335,0,10,0,2
"04/26/2021","Y","Y","Chugach Census Area",63,"Other Interior Region",7,0,333,1,336,0,10,0,2
"04/27/2021","Y","Y","Chugach Census Area",63,"Other Interior Region",7,1,334,2,338,0,10,0,2
"04/29/2021","Y","Y","Chugach Census Area",63,"Other Interior Region",7,1,335,0,338,0,10,0,2
"04/30/2021","Y","Y","Chugach Census Area",63,"Other Interior Region",7,1,336,0,338,0,10,0,2
"05/03/2021","Y","Y","Chugach Census Area",63,"Other Interior Region",7,1,337,3,341,0,10,0,2
"05/04/2021","Y","Y","Chugach Census Area",63,"Other Interior Region",7,0,337,1,342,0,10,0,2
"05/05/2021","Y","Y","Chugach Census Area",63,"Other Interior Region",7,1,338,0,342,0,10,0,2
"05/07/2021","Y","Y","Chugach Census Area",63,"Other Interior Region",7,0,338,1,343,0,10,0,2
"05/10/2021","Y","Y","Chugach Census Area",63,"Other Interior Region",7,0,338,2,345,1,11,0,2
"05/12/2021","Y","Y","Chugach Census Area",63,"Other Interior Region",7,2,340,1,346,0,11,0,2
"05/13/2021","Y","Y","Chugach Census Area",63,"Other Interior Region",7,0,340,8,354,0,11,0,2
"05/14/2021","Y","Y","Chugach Census Area",63,"Other Interior Region",7,0,340,3,357,0,11,0,2
"05/15/2021","Y","Y","Chugach Census Area",63,"Other Interior Region",7,1,341,9,366,0,11,0,2
"05/16/2021","Y","Y","Chugach Census Area",63,"Other Interior Region",7,18,359,1,367,0,11,0,2
"05/17/2021","Y","Y","Chugach Census Area",63,"Other Interior Region",7,0,359,1,368,0,11,0,2
"05/18/2021","Y","Y","Chugach Census Area",63,"Other Interior Region",7,8,367,2,370,0,11,0,2
"05/19/2021","Y","Y","Chugach Census Area",63,"Other Interior Region",7,0,367,1,371,0,11,0,2
"05/20/2021","Y","Y","Chugach Census Area",63,"Other Interior Region",7,1,368,0,371,0,11,0,2
"05/21/2021","Y","Y","Chugach Census Area",63,"Other Interior Region",7,2,370,1,372,0,11,0,2
"05/25/2021","Y","Y","Chugach Census Area",63,"Other Interior Region",7,1,371,0,372,0,11,0,2
"06/10/2021","Y","Y","Chugach Census Area",63,"Other Interior Region",7,0,371,1,373,0,11,0,2
"06/11/2021","Y","Y","Chugach Census Area",63,"Other Interior Region",7,1,372,0,373,0,11,0,2
"06/27/2021","Y","Y","Chugach Census Area",63,"Other Interior Region",7,0,372,1,374,0,11,0,2
"06/28/2021","Y","Y","Chugach Census Area",63,"Other Interior Region",7,0,372,2,376,0,11,0,2
"06/30/2021","Y","Y","Chugach Census Area",63,"Other Interior Region",7,3,375,0,376,0,11,0,2
"07/01/2021","Y","Y","Chugach Census Area",63,"Other Interior Region",7,0,375,1,377,0,11,0,2
"07/02/2021","Y","Y","Chugach Census Area",63,"Other Interior Region",7,0,375,3,380,0,11,0,2
"07/03/2021","Y","Y","Chugach Census Area",63,"Other Interior Region",7,2,377,1,381,0,11,0,2
"07/04/2021","Y","Y","Chugach Census Area",63,"Other Interior Region",7,2,379,0,381,0,11,0,2
"07/05/2021","Y","Y","Chugach Census Area",63,"Other Interior Region",7,0,379,2,383,0,11,0,2
"07/07/2021","Y","Y","Chugach Census Area",63,"Other Interior Region",7,3,382,7,390,0,11,0,2
"07/08/2021","Y","Y","Chugach Census Area",63,"Other Interior Region",7,5,387,1,391,0,11,0,2
"07/09/2021","Y","Y","Chugach Census Area",63,"Other Interior Region",7,2,389,4,395,1,12,0,2
"07/10/2021","Y","Y","Chugach Census Area",63,"Other Interior Region",7,3,392,0,395,0,12,0,2
"07/12/2021","Y","Y","Chugach Census Area",63,"Other Interior Region",7,2,394,9,404,0,12,0,2
"07/13/2021","Y","Y","Chugach Census Area",63,"Other Interior Region",7,7,401,11,415,0,12,0,2
"07/14/2021","Y","Y","Chugach Census Area",63,"Other Interior Region",7,13,414,4,419,0,12,0,2
"07/15/2021","Y","Y","Chugach Census Area",63,"Other Interior Region",7,4,418,2,421,0,12,0,2
"07/16/2021","Y","Y","Chugach Census Area",63,"Other Interior Region",7,0,418,11,432,0,12,0,2
"07/17/2021","Y","Y","Chugach Census Area",63,"Other Interior Region",7,13,431,8,440,0,12,0,2
"07/18/2021","Y","Y","Chugach Census Area",63,"Other Interior Region",7,3,434,1,441,0,12,0,2
"07/19/2021","Y","Y","Chugach Census Area",63,"Other Interior Region",7,7,441,14,455,0,12,0,2
"07/20/2021","Y","Y","Chugach Census Area",63,"Other Interior Region",7,13,454,1,456,0,12,0,2
"07/21/2021","Y","Y","Chugach Census Area",63,"Other Interior Region",7,2,456,11,467,0,12,0,2
"07/22/2021","Y","Y","Chugach Census Area",63,"Other Interior Region",7,10,466,4,471,0,12,0,2
"07/23/2021","Y","Y","Chugach Census Area",63,"Other Interior Region",7,2,468,8,479,0,12,0,2
"07/24/2021","Y","Y","Chugach Census Area",63,"Other Interior Region",7,4,472,2,481,0,12,0,2
"07/25/2021","Y","Y","Chugach Census Area",63,"Other Interior Region",7,2,474,2,483,0,12,0,2
"07/26/2021","Y","Y","Chugach Census Area",63,"Other Interior Region",7,1,475,8,491,1,13,0,2
"07/27/2021","Y","Y","Chugach Census Area",63,"Other Interior Region",7,18,493,17,508,0,13,0,2
"07/28/2021","Y","Y","Chugach Census Area",63,"Other Interior Region",7,3,496,10,518,0,13,0,2
"07/29/2021","Y","Y","Chugach Census Area",63,"Other Interior Region",7,22,518,4,522,0,13,0,2
"07/30/2021","Y","Y","Chugach Census Area",63,"Other Interior Region",7,4,522,1,523,0,13,0,2
"07/31/2021","Y","Y","Chugach Census Area",63,"Other Interior Region",7,4,526,3,526,0,13,0,2
"08/01/2021","Y","Y","Chugach Census Area",63,"Other Interior Region",7,1,527,3,529,0,13,0,2
"08/02/2021","Y","Y","Chugach Census Area",63,"Other Interior Region",7,2,529,4,533,0,13,0,2
"08/03/2021","Y","Y","Chugach Census Area",63,"Other Interior Region",7,3,532,13,546,0,13,0,2
"08/04/2021","Y","Y","Chugach Census Area",63,"Other Interior Region",7,12,544,3,549,0,13,0,2
"08/05/2021","Y","Y","Chugach Census Area",63,"Other Interior Region",7,4,548,4,553,0,13,0,2
"08/06/2021","Y","Y","Chugach Census Area",63,"Other Interior Region",7,1,549,9,562,0,13,0,2
"08/07/2021","Y","Y","Chugach Census Area",63,"Other Interior Region",7,9,558,0,562,0,13,0,2
"08/08/2021","Y","Y","Chugach Census Area",63,"Other Interior Region",7,1,559,3,565,0,13,0,2
"08/09/2021","Y","Y","Chugach Census Area",63,"Other Interior Region",7,7,566,4,569,0,13,0,2
"08/10/2021","Y","Y","Chugach Census Area",63,"Other Interior Region",7,0,566,3,572,0,13,0,2
"08/11/2021","Y","Y","Chugach Census Area",63,"Other Interior Region",7,4,570,10,582,0,13,0,2
"08/12/2021","Y","Y","Chugach Census Area",63,"Other Interior Region",7,6,576,1,583,0,13,0,2
"08/13/2021","Y","Y","Chugach Census Area",63,"Other Interior Region",7,0,576,9,592,0,13,0,2
"08/14/2021","Y","Y","Chugach Census Area",63,"Other Interior Region",7,2,578,2,594,0,13,0,2
"08/15/2021","Y","Y","Chugach Census Area",63,"Other Interior Region",7,4,582,7,601,0,13,0,2
"08/16/2021","Y","Y","Chugach Census Area",63,"Other Interior Region",7,11,593,5,606,0,13,0,2
"08/17/2021","Y","Y","Chugach Census Area",63,"Other Interior Region",7,10,603,11,617,0,13,0,2
"08/18/2021","Y","Y","Chugach Census Area",63,"Other Interior Region",7,2,605,4,621,0,13,0,2
"08/19/2021","Y","Y","Chugach Census Area",63,"Other Interior Region",7,7,612,4,625,0,13,0,2
"08/20/2021","Y","Y","Chugach Census Area",63,"Other Interior Region",7,6,618,3,628,0,13,0,2
"08/21/2021","Y","Y","Chugach Census Area",63,"Other Interior Region",7,5,623,0,628,0,13,0,2
"08/23/2021","Y","Y","Chugach Census Area",63,"Other Interior Region",7,2,625,9,637,0,13,0,2
"08/24/2021","Y","Y","Chugach Census Area",63,"Other Interior Region",7,1,626,5,642,1,14,0,2
"08/25/2021","Y","Y","Chugach Census Area",63,"Other Interior Region",7,2,628,3,645,0,14,0,2
"08/26/2021","Y","Y","Chugach Census Area",63,"Other Interior Region",7,13,641,1,646,0,14,0,2
"08/27/2021","Y","Y","Chugach Census Area",63,"Other Interior Region",7,4,645,4,650,1,15,0,2
"08/29/2021","Y","Y","Chugach Census Area",63,"Other Interior Region",7,0,645,1,651,0,15,0,2
"08/30/2021","Y","Y","Chugach Census Area",63,"Other Interior Region",7,6,651,12,663,0,15,0,2
"08/31/2021","Y","Y","Chugach Census Area",63,"Other Interior Region",7,0,651,5,668,0,15,0,2
"09/01/2021","Y","Y","Chugach Census Area",63,"Other Interior Region",7,5,656,5,673,1,16,0,2
"09/02/2021","Y","Y","Chugach Census Area",63,"Other Interior Region",7,4,660,4,677,0,16,1,3
"09/03/2021","Y","Y","Chugach Census Area",63,"Other Interior Region",7,2,662,1,678,0,16,0,3
"09/04/2021","Y","Y","Chugach Census Area",63,"Other Interior Region",7,0,662,1,679,0,16,0,3
"09/05/2021","Y","Y","Chugach Census Area",63,"Other Interior Region",7,2,664,3,682,1,17,0,3
"09/06/2021","Y","Y","Chugach Census Area",63,"Other Interior Region",7,8,672,3,685,0,17,0,3
"09/07/2021","Y","Y","Chugach Census Area",63,"Other Interior Region",7,6,678,8,693,0,17,0,3
"09/08/2021","Y","Y","Chugach Census Area",63,"Other Interior Region",7,5,683,6,699,0,17,0,3
"09/09/2021","Y","Y","Chugach Census Area",63,"Other Interior Region",7,3,686,9,708,0,17,0,3
"09/10/2021","Y","Y","Chugach Census Area",63,"Other Interior Region",7,0,686,2,710,0,17,0,3
"09/11/2021","Y","Y","Chugach Census Area",63,"Other Interior Region",7,4,690,1,711,0,17,0,3
"09/12/2021","Y","Y","Chugach Census Area",63,"Other Interior Region",7,0,690,7,718,0,17,0,3
"09/13/2021","Y","Y","Chugach Census Area",63,"Other Interior Region",7,2,692,10,728,0,17,0,3
"09/14/2021","Y","Y","Chugach Census Area",63,"Other Interior Region",7,1,693,14,742,0,17,0,3
"09/15/2021","Y","Y","Chugach Census Area",63,"Other Interior Region",7,7,700,9,751,0,17,0,3
"09/16/2021","Y","Y","Chugach Census Area",63,"Other Interior Region",7,6,706,6,757,0,17,0,3
"09/17/2021","Y","Y","Chugach Census Area",63,"Other Interior Region",7,6,712,14,771,0,17,0,3
"09/18/2021","Y","Y","Chugach Census Area",63,"Other Interior Region",7,1,713,0,771,0,17,0,3
"09/19/2021","Y","Y","Chugach Census Area",63,"Other Interior Region",7,0,713,18,789,0,17,0,3
"09/20/2021","Y","Y","Chugach Census Area",63,"Other Interior Region",7,3,716,13,802,1,18,0,3
"09/21/2021","Y","Y","Chugach Census Area",63,"Other Interior Region",7,13,729,6,808,0,18,0,3
"09/22/2021","Y","Y","Chugach Census Area",63,"Other Interior Region",7,18,747,3,811,0,18,0,3
"09/23/2021","Y","Y","Chugach Census Area",63,"Other Interior Region",7,6,753,6,817,0,18,0,3
"09/24/2021","Y","Y","Chugach Census Area",63,"Other Interior Region",7,35,788,8,825,1,19,0,3
"09/25/2021","Y","Y","Chugach Census Area",63,"Other Interior Region",7,8,796,0,825,0,19,1,4
"09/26/2021","Y","Y","Chugach Census Area",63,"Other Interior Region",7,9,805,8,833,1,20,0,4
"09/27/2021","Y","Y","Chugach Census Area",63,"Other Interior Region",7,10,815,18,851,2,22,0,4
"09/28/2021","Y","Y","Chugach Census Area",63,"Other Interior Region",7,19,834,7,858,1,23,0,4
"09/29/2021","Y","Y","Chugach Census Area",63,"Other Interior Region",7,0,834,10,868,0,23,0,4
"09/30/2021","Y","Y","Chugach Census Area",63,"Other Interior Region",7,15,849,5,873,0,23,0,4
"10/01/2021","Y","Y","Chugach Census Area",63,"Other Interior Region",7,8,857,4,877,0,23,0,4
"10/02/2021","Y","Y","Chugach Census Area",63,"Other Interior Region",7,2,859,1,878,0,23,0,4
"10/03/2021","Y","Y","Chugach Census Area",63,"Other Interior Region",7,3,862,2,880,0,23,0,4
"10/04/2021","Y","Y","Chugach Census Area",63,"Other Interior Region",7,7,869,11,891,0,23,0,4
"10/05/2021","Y","Y","Chugach Census Area",63,"Other Interior Region",7,6,875,17,908,0,23,0,4
"10/06/2021","Y","Y","Chugach Census Area",63,"Other Interior Region",7,20,895,7,915,0,23,3,7
"10/07/2021","Y","Y","Chugach Census Area",63,"Other Interior Region",7,12,907,6,921,0,23,0,7
"10/08/2021","Y","Y","Chugach Census Area",63,"Other Interior Region",7,5,912,9,930,0,23,0,7
"10/09/2021","Y","Y","Chugach Census Area",63,"Other Interior Region",7,7,919,2,932,0,23,0,7
"10/10/2021","Y","Y","Chugach Census Area",63,"Other Interior Region",7,2,921,0,932,0,23,0,7
"10/11/2021","Y","Y","Chugach Census Area",63,"Other Interior Region",7,9,930,18,950,0,23,0,7
"10/12/2021","Y","Y","Chugach Census Area",63,"Other Interior Region",7,4,934,9,959,0,23,0,7
"10/13/2021","Y","Y","Chugach Census Area",63,"Other Interior Region",7,20,954,14,973,0,23,0,7
"10/14/2021","Y","Y","Chugach Census Area",63,"Other Interior Region",7,15,969,10,983,0,23,0,7
"10/15/2021","Y","Y","Chugach Census Area",63,"Other Interior Region",7,15,984,19,1002,0,23,0,7
"10/16/2021","Y","Y","Chugach Census Area",63,"Other Interior Region",7,12,996,2,1004,0,23,0,7
"10/17/2021","Y","Y","Chugach Census Area",63,"Other Interior Region",7,0,996,9,1013,0,23,0,7
"10/18/2021","Y","Y","Chugach Census Area",63,"Other Interior Region",7,9,1005,12,1025,0,23,0,7
"10/19/2021","Y","Y","Chugach Census Area",63,"Other Interior Region",7,5,1010,9,1034,0,23,0,7
"10/20/2021","Y","Y","Chugach Census Area",63,"Other Interior Region",7,9,1019,5,1039,0,23,0,7
"10/21/2021","Y","Y","Chugach Census Area",63,"Other Interior Region",7,15,1034,5,1044,0,23,0,7
"10/22/2021","Y","Y","Chugach Census Area",63,"Other Interior Region",7,8,1042,5,1049,0,23,0,7
"10/23/2021","Y","Y","Chugach Census Area",63,"Other Interior Region",7,1,1043,0,1049,0,23,0,7
"10/24/2021","Y","Y","Chugach Census Area",63,"Other Interior Region",7,1,1044,9,1058,0,23,0,7
"10/25/2021","Y","Y","Chugach Census Area",63,"Other Interior Region",7,12,1056,9,1067,1,24,0,7
"10/26/2021","Y","Y","Chugach Census Area",63,"Other Interior Region",7,2,1058,6,1073,0,24,0,7
"10/27/2021","Y","Y","Chugach Census Area",63,"Other Interior Region",7,9,1067,4,1077,0,24,0,7
"10/28/2021","Y","Y","Chugach Census Area",63,"Other Interior Region",7,6,1073,5,1082,0,24,0,7
"10/29/2021","Y","Y","Chugach Census Area",63,"Other Interior Region",7,2,1075,5,1087,0,24,0,7
"10/30/2021","Y","Y","Chugach Census Area",63,"Other Interior Region",7,5,1080,3,1090,0,24,0,7
"10/31/2021","Y","Y","Chugach Census Area",63,"Other Interior Region",7,4,1084,2,1092,0,24,0,7
"11/01/2021","Y","Y","Chugach Census Area",63,"Other Interior Region",7,1,1085,10,1102,0,24,0,7
"11/02/2021","Y","Y","Chugach Census Area",63,"Other Interior Region",7,14,1099,4,1106,0,24,0,7
"11/03/2021","Y","Y","Chugach Census Area",63,"Other Interior Region",7,1,1100,5,1111,0,24,0,7
"11/04/2021","Y","Y","Chugach Census Area",63,"Other Interior Region",7,4,1104,2,1113,0,24,0,7
"11/05/2021","Y","Y","Chugach Census Area",63,"Other Interior Region",7,3,1107,7,1120,0,24,0,7
"11/06/2021","Y","Y","Chugach Census Area",63,"Other Interior Region",7,6,1113,0,1120,0,24,0,7
"11/07/2021","Y","Y","Chugach Census Area",63,"Other Interior Region",7,2,1115,2,1122,0,24,0,7
"11/08/2021","Y","Y","Chugach Census Area",63,"Other Interior Region",7,7,1122,7,1129,0,24,0,7
"11/09/2021","Y","Y","Chugach Census Area",63,"Other Interior Region",7,0,1122,5,1134,0,24,0,7
"11/10/2021","Y","Y","Chugach Census Area",63,"Other Interior Region",7,1,1123,1,1135,0,24,0,7
"11/11/2021","Y","Y","Chugach Census Area",63,"Other Interior Region",7,2,1125,2,1137,0,24,0,7
"11/12/2021","Y","Y","Chugach Census Area",63,"Other Interior Region",7,4,1129,4,1141,0,24,0,7
"11/13/2021","Y","Y","Chugach Census Area",63,"Other Interior Region",7,3,1132,1,1142,0,24,0,7
"11/14/2021","Y","Y","Chugach Census Area",63,"Other Interior Region",7,2,1134,0,1142,0,24,0,7
"11/15/2021","Y","Y","Chugach Census Area",63,"Other Interior Region",7,10,1144,7,1149,0,24,0,7
"11/16/2021","Y","Y","Chugach Census Area",63,"Other Interior Region",7,5,1149,6,1155,0,24,0,7
"11/17/2021","Y","Y","Chugach Census Area",63,"Other Interior Region",7,2,1151,3,1158,0,24,0,7
"11/18/2021","Y","Y","Chugach Census Area",63,"Other Interior Region",7,8,1159,5,1163,0,24,0,7
"11/20/2021","Y","Y","Chugach Census Area",63,"Other Interior Region",7,0,1159,1,1164,0,24,0,7
"11/21/2021","Y","Y","Chugach Census Area",63,"Other Interior Region",7,4,1163,1,1165,0,24,0,7
"11/22/2021","Y","Y","Chugach Census Area",63,"Other Interior Region",7,3,1166,8,1173,0,24,0,7
"11/23/2021","Y","Y","Chugach Census Area",63,"Other Interior Region",7,6,1172,0,1173,0,24,0,7
"11/24/2021","Y","Y","Chugach Census Area",63,"Other Interior Region",7,0,1172,2,1175,0,24,0,7
"11/26/2021","Y","Y","Chugach Census Area",63,"Other Interior Region",7,1,1173,1,1176,0,24,0,7
"11/27/2021","Y","Y","Chugach Census Area",63,"Other Interior Region",7,1,1174,0,1176,0,24,0,7
"11/28/2021","Y","Y","Chugach Census Area",63,"Other Interior Region",7,1,1175,0,1176,0,24,0,7
"11/29/2021","Y","Y","Chugach Census Area",63,"Other Interior Region",7,1,1176,2,1178,1,25,0,7
"11/30/2021","Y","Y","Chugach Census Area",63,"Other Interior Region",7,2,1178,2,1180,0,25,0,7
"12/01/2021","Y","Y","Chugach Census Area",63,"Other Interior Region",7,1,1179,0,1180,0,25,0,7
"12/02/2021","Y","Y","Chugach Census Area",63,"Other Interior Region",7,1,1180,1,1181,0,25,0,7
"12/03/2021","Y","Y","Chugach Census Area",63,"Other Interior Region",7,1,1181,0,1181,0,25,0,7
"12/05/2021","Y","Y","Chugach Census Area",63,"Other Interior Region",7,1,1182,1,1182,0,25,0,7
"12/06/2021","Y","Y","Chugach Census Area",63,"Other Interior Region",7,0,1182,1,1183,0,25,0,7
"12/07/2021","Y","Y","Chugach Census Area",63,"Other Interior Region",7,1,1183,0,1183,0,25,0,7
"12/13/2021","Y","Y","Chugach Census Area",63,"Other Interior Region",7,0,1183,3,1186,0,25,0,7
"12/14/2021","Y","Y","Chugach Census Area",63,"Other Interior Region",7,1,1184,6,1192,0,25,0,7
"12/15/2021","Y","Y","Chugach Census Area",63,"Other Interior Region",7,1,1185,1,1193,0,25,0,7
"12/16/2021","Y","Y","Chugach Census Area",63,"Other Interior Region",7,2,1187,3,1196,0,25,0,7
"12/17/2021","Y","Y","Chugach Census Area",63,"Other Interior Region",7,6,1193,1,1197,0,25,0,7
"12/20/2021","Y","Y","Chugach Census Area",63,"Other Interior Region",7,0,1193,1,1198,0,25,0,7
"12/23/2021","Y","Y","Chugach Census Area",63,"Other Interior Region",7,1,1194,0,1198,0,25,0,7
"12/25/2021","Y","Y","Chugach Census Area",63,"Other Interior Region",7,1,1195,1,1199,0,25,0,7
"12/27/2021","Y","Y","Chugach Census Area",63,"Other Interior Region",7,0,1195,1,1200,0,25,0,7
"12/28/2021","Y","Y","Chugach Census Area",63,"Other Interior Region",7,2,1197,2,1202,0,25,0,7
"12/30/2021","Y","Y","Chugach Census Area",63,"Other Interior Region",7,1,1198,3,1205,0,25,0,7
"12/31/2021","Y","Y","Chugach Census Area",63,"Other Interior Region",7,0,1198,1,1206,0,25,0,7
"01/01/2022","Y","Y","Chugach Census Area",63,"Other Interior Region",7,0,1198,1,1207,0,25,0,7
"01/02/2022","Y","Y","Chugach Census Area",63,"Other Interior Region",7,2,1200,3,1210,0,25,0,7
"01/03/2022","Y","Y","Chugach Census Area",63,"Other Interior Region",7,2,1202,13,1223,0,25,0,7
"01/04/2022","Y","Y","Chugach Census Area",63,"Other Interior Region",7,3,1205,8,1231,0,25,0,7
"01/05/2022","Y","Y","Chugach Census Area",63,"Other Interior Region",7,1,1206,14,1245,0,25,0,7
"01/06/2022","Y","Y","Chugach Census Area",63,"Other Interior Region",7,1,1207,5,1250,0,25,0,7
"01/07/2022","Y","Y","Chugach Census Area",63,"Other Interior Region",7,5,1212,8,1258,0,25,0,7
"01/08/2022","Y","Y","Chugach Census Area",63,"Other Interior Region",7,8,1220,0,1258,0,25,0,7
"01/09/2022","Y","Y","Chugach Census Area",63,"Other Interior Region",7,1,1221,0,1258,0,25,0,7
"01/10/2022","Y","Y","Chugach Census Area",63,"Other Interior Region",7,5,1226,23,1281,0,25,0,7
"01/11/2022","Y","Y","Chugach Census Area",63,"Other Interior Region",7,26,1252,15,1296,0,25,0,7
"01/12/2022","Y","Y","Chugach Census Area",63,"Other Interior Region",7,8,1260,12,1308,0,25,0,7
"01/13/2022","Y","Y","Chugach Census Area",63,"Other Interior Region",7,3,1263,6,1314,0,25,0,7
"01/14/2022","Y","Y","Chugach Census Area",63,"Other Interior Region",7,13,1276,8,1322,0,25,0,7
"01/15/2022","Y","Y","Chugach Census Area",63,"Other Interior Region",7,14,1290,9,1331,0,25,0,7
"01/16/2022","Y","Y","Chugach Census Area",63,"Other Interior Region",7,4,1294,7,1338,0,25,0,7
"01/17/2022","Y","Y","Chugach Census Area",63,"Other Interior Region",7,1,1295,11,1349,0,25,0,7
"01/18/2022","Y","Y","Chugach Census Area",63,"Other Interior Region",7,16,1311,32,1381,0,25,0,7
"01/19/2022","Y","Y","Chugach Census Area",63,"Other Interior Region",7,8,1319,21,1402,0,25,0,7
"01/20/2022","Y","Y","Chugach Census Area",63,"Other Interior Region",7,37,1356,23,1425,0,25,0,7
"01/21/2022","Y","Y","Chugach Census Area",63,"Other Interior Region",7,27,1383,27,1452,0,25,0,7
"01/22/2022","Y","Y","Chugach Census Area",63,"Other Interior Region",7,2,1385,1,1453,0,25,0,7
"01/23/2022","Y","Y","Chugach Census Area",63,"Other Interior Region",7,1,1386,14,1467,0,25,0,7
"01/24/2022","Y","Y","Chugach Census Area",63,"Other Interior Region",7,3,1389,20,1487,1,26,0,7
"01/25/2022","Y","Y","Chugach Census Area",63,"Other Interior Region",7,15,1404,26,1513,0,26,0,7
"01/26/2022","Y","Y","Chugach Census Area",63,"Other Interior Region",7,16,1420,25,1538,0,26,0,7
"01/27/2022","Y","Y","Chugach Census Area",63,"Other Interior Region",7,8,1428,13,1551,0,26,0,7
"01/28/2022","Y","Y","Chugach Census Area",63,"Other Interior Region",7,64,1492,22,1573,1,27,0,7
"01/29/2022","Y","Y","Chugach Census Area",63,"Other Interior Region",7,5,1497,2,1575,0,27,0,7
"01/30/2022","Y","Y","Chugach Census Area",63,"Other Interior Region",7,0,1497,7,1582,0,27,0,7
"01/31/2022","Y","Y","Chugach Census Area",63,"Other Interior Region",7,28,1525,13,1595,0,27,0,7
"02/01/2022","Y","Y","Chugach Census Area",63,"Other Interior Region",7,22,1547,20,1615,1,28,0,7
"02/02/2022","Y","Y","Chugach Census Area",63,"Other Interior Region",7,7,1554,21,1636,0,28,0,7
"02/03/2022","Y","Y","Chugach Census Area",63,"Other Interior Region",7,20,1574,8,1644,0,28,0,7
"02/04/2022","Y","Y","Chugach Census Area",63,"Other Interior Region",7,0,1574,1,1645,0,28,0,7
"02/05/2022","Y","Y","Chugach Census Area",63,"Other Interior Region",7,6,1580,4,1649,0,28,0,7
"02/06/2022","Y","Y","Chugach Census Area",63,"Other Interior Region",7,6,1586,8,1657,0,28,0,7
"02/07/2022","Y","Y","Chugach Census Area",63,"Other Interior Region",7,1,1587,2,1659,0,28,0,7
"02/08/2022","Y","Y","Chugach Census Area",63,"Other Interior Region",7,2,1589,5,1664,0,28,0,7
"02/09/2022","Y","Y","Chugach Census Area",63,"Other Interior Region",7,64,1653,6,1670,0,28,0,7
"02/10/2022","Y","Y","Chugach Census Area",63,"Other Interior Region",7,28,1681,20,1690,0,28,0,7
"02/11/2022","Y","Y","Chugach Census Area",63,"Other Interior Region",7,1,1682,2,1692,0,28,0,7
"02/12/2022","Y","Y","Chugach Census Area",63,"Other Interior Region",7,6,1688,1,1693,0,28,0,7
"02/13/2022","Y","Y","Chugach Census Area",63,"Other Interior Region",7,3,1691,4,1697,0,28,0,7
"02/14/2022","Y","Y","Chugach Census Area",63,"Other Interior Region",7,5,1696,5,1702,0,28,0,7
"02/15/2022","Y","Y","Chugach Census Area",63,"Other Interior Region",7,9,1705,6,1708,0,28,0,7
"02/16/2022","Y","Y","Chugach Census Area",63,"Other Interior Region",7,0,1705,2,1710,0,28,0,7
"02/17/2022","Y","Y","Chugach Census Area",63,"Other Interior Region",7,2,1707,2,1712,0,28,0,7
"02/18/2022","Y","Y","Chugach Census Area",63,"Other Interior Region",7,12,1719,13,1725,0,28,0,7
"02/19/2022","Y","Y","Chugach Census Area",63,"Other Interior Region",7,1,1720,1,1726,0,28,0,7
"02/20/2022","Y","Y","Chugach Census Area",63,"Other Interior Region",7,3,1723,6,1732,0,28,0,7
"02/21/2022","Y","Y","Chugach Census Area",63,"Other Interior Region",7,0,1723,2,1734,0,28,0,7
"02/22/2022","Y","Y","Chugach Census Area",63,"Other Interior Region",7,1,1724,2,1736,0,28,0,7
"02/23/2022","Y","Y","Chugach Census Area",63,"Other Interior Region",7,2,1726,9,1745,0,28,0,7
"02/24/2022","Y","Y","Chugach Census Area",63,"Other Interior Region",7,1,1727,3,1748,0,28,0,7
"02/25/2022","Y","Y","Chugach Census Area",63,"Other Interior Region",7,7,1734,8,1756,0,28,0,7
"02/26/2022","Y","Y","Chugach Census Area",63,"Other Interior Region",7,2,1736,1,1757,0,28,0,7
"02/28/2022","Y","Y","Chugach Census Area",63,"Other Interior Region",7,0,1736,3,1760,0,28,0,7
"03/01/2022","Y","Y","Chugach Census Area",63,"Other Interior Region",7,2,1738,7,1767,0,28,0,7
"03/02/2022","Y","Y","Chugach Census Area",63,"Other Interior Region",7,6,1744,0,1767,0,28,0,7
"03/03/2022","Y","Y","Chugach Census Area",63,"Other Interior Region",7,0,1744,6,1773,0,28,0,7
"03/04/2022","Y","Y","Chugach Census Area",63,"Other Interior Region",7,7,1751,10,1783,0,28,0,7
"03/05/2022","Y","Y","Chugach Census Area",63,"Other Interior Region",7,1,1752,0,1783,0,28,0,7
"03/06/2022","Y","Y","Chugach Census Area",63,"Other Interior Region",7,1,1753,4,1787,0,28,0,7
"03/07/2022","Y","Y","Chugach Census Area",63,"Other Interior Region",7,1,1754,4,1791,0,28,0,7
"03/08/2022","Y","Y","Chugach Census Area",63,"Other Interior Region",7,14,1768,0,1791,0,28,0,7
"03/09/2022","Y","Y","Chugach Census Area",63,"Other Interior Region",7,18,1786,4,1795,0,28,0,7
"03/10/2022","Y","Y","Chugach Census Area",63,"Other Interior Region",7,3,1789,7,1802,0,28,0,7
"03/11/2022","Y","Y","Chugach Census Area",63,"Other Interior Region",7,4,1793,3,1805,0,28,0,7
"03/12/2022","Y","Y","Chugach Census Area",63,"Other Interior Region",7,1,1794,0,1805,0,28,0,7
"03/13/2022","Y","Y","Chugach Census Area",63,"Other Interior Region",7,0,1794,3,1808,0,28,0,7
"03/14/2022","Y","Y","Chugach Census Area",63,"Other Interior Region",7,8,1802,5,1813,0,28,0,7
"03/15/2022","Y","Y","Chugach Census Area",63,"Other Interior Region",7,2,1804,4,1817,1,29,0,7
"03/16/2022","Y","Y","Chugach Census Area",63,"Other Interior Region",7,5,1809,2,1819,0,29,0,7
"03/17/2022","Y","Y","Chugach Census Area",63,"Other Interior Region",7,2,1811,3,1822,0,29,0,7
"03/18/2022","Y","Y","Chugach Census Area",63,"Other Interior Region",7,0,1811,1,1823,0,29,0,7
"03/21/2022","Y","Y","Chugach Census Area",63,"Other Interior Region",7,10,1821,0,1823,0,29,0,7
"03/22/2022","Y","Y","Chugach Census Area",63,"Other Interior Region",7,2,1823,0,1823,0,29,0,7
"03/25/2022","Y","Y","Chugach Census Area",63,"Other Interior Region",7,1,1824,2,1825,0,29,0,7
"03/28/2022","Y","Y","Chugach Census Area",63,"Other Interior Region",7,1,1825,1,1826,0,29,0,7
"03/30/2022","Y","Y","Chugach Census Area",63,"Other Interior Region",7,2,1827,4,1830,0,29,0,7
"03/31/2022","Y","Y","Chugach Census Area",63,"Other Interior Region",7,1,1828,0,1830,0,29,0,7
"04/01/2022","Y","Y","Chugach Census Area",63,"Other Interior Region",7,3,1831,3,1833,0,29,0,7
"04/02/2022","Y","Y","Chugach Census Area",63,"Other Interior Region",7,3,1834,2,1835,0,29,1,8
"04/04/2022","Y","Y","Chugach Census Area",63,"Other Interior Region",7,1,1835,0,1835,0,29,0,8
"04/05/2022","Y","Y","Chugach Census Area",63,"Other Interior Region",7,1,1836,2,1837,0,29,0,8
"04/06/2022","Y","Y","Chugach Census Area",63,"Other Interior Region",7,1,1837,0,1837,0,29,0,8
"04/08/2022","Y","Y","Chugach Census Area",63,"Other Interior Region",7,6,1843,6,1843,0,29,0,8
"04/10/2022","Y","Y","Chugach Census Area",63,"Other Interior Region",7,1,1844,1,1844,0,29,0,8
"04/12/2022","Y","Y","Chugach Census Area",63,"Other Interior Region",7,0,1844,1,1845,0,29,0,8
"04/14/2022","Y","Y","Chugach Census Area",63,"Other Interior Region",7,1,1845,0,1845,0,29,0,8
"04/15/2022","Y","Y","Chugach Census Area",63,"Other Interior Region",7,1,1846,1,1846,0,29,0,8
"04/17/2022","Y","Y","Chugach Census Area",63,"Other Interior Region",7,1,1847,1,1847,0,29,0,8
"04/19/2022","Y","Y","Chugach Census Area",63,"Other Interior Region",7,6,1853,6,1853,0,29,0,8
"04/20/2022","Y","Y","Chugach Census Area",63,"Other Interior Region",7,2,1855,2,1855,0,29,0,8
"04/21/2022","Y","Y","Chugach Census Area",63,"Other Interior Region",7,1,1856,1,1856,0,29,0,8
"04/22/2022","Y","Y","Chugach Census Area",63,"Other Interior Region",7,1,1857,1,1857,0,29,0,8
"04/23/2022","Y","Y","Chugach Census Area",63,"Other Interior Region",7,1,1858,1,1858,1,30,0,8
"04/26/2022","Y","Y","Chugach Census Area",63,"Other Interior Region",7,2,1860,2,1860,0,30,0,8
"06/18/2020","Y","Y","Copper River Census Area",66,"Other Interior Region",7,0,0,1,1,0,0,0,0
"06/24/2020","Y","Y","Copper River Census Area",66,"Other Interior Region",7,0,0,1,2,0,0,0,0
"06/29/2020","Y","Y","Copper River Census Area",66,"Other Interior Region",7,1,1,0,2,0,0,0,0
"07/02/2020","Y","Y","Copper River Census Area",66,"Other Interior Region",7,1,2,0,2,0,0,0,0
"07/08/2020","Y","Y","Copper River Census Area",66,"Other Interior Region",7,0,2,1,3,0,0,0,0
"07/10/2020","Y","Y","Copper River Census Area",66,"Other Interior Region",7,0,2,3,6,0,0,0,0
"07/11/2020","Y","Y","Copper River Census Area",66,"Other Interior Region",7,0,2,3,9,0,0,0,0
"07/13/2020","Y","Y","Copper River Census Area",66,"Other Interior Region",7,2,4,0,9,0,0,0,0
"07/14/2020","Y","Y","Copper River Census Area",66,"Other Interior Region",7,3,7,3,12,0,0,0,0
"07/15/2020","Y","Y","Copper River Census Area",66,"Other Interior Region",7,2,9,2,14,0,0,0,0
"07/16/2020","Y","Y","Copper River Census Area",66,"Other Interior Region",7,0,9,1,15,0,0,0,0
"07/17/2020","Y","Y","Copper River Census Area",66,"Other Interior Region",7,2,11,5,20,0,0,0,0
"07/19/2020","Y","Y","Copper River Census Area",66,"Other Interior Region",7,0,11,3,23,0,0,0,0
"07/20/2020","Y","Y","Copper River Census Area",66,"Other Interior Region",7,0,11,3,26,0,0,0,0
"07/21/2020","Y","Y","Copper River Census Area",66,"Other Interior Region",7,11,22,1,27,0,0,0,0
"07/22/2020","Y","Y","Copper River Census Area",66,"Other Interior Region",7,3,25,1,28,2,2,0,0
"07/23/2020","Y","Y","Copper River Census Area",66,"Other Interior Region",7,1,26,1,29,1,3,0,0
"07/24/2020","Y","Y","Copper River Census Area",66,"Other Interior Region",7,1,27,0,29,0,3,0,0
"07/27/2020","Y","Y","Copper River Census Area",66,"Other Interior Region",7,1,28,0,29,0,3,0,0
"07/28/2020","Y","Y","Copper River Census Area",66,"Other Interior Region",7,0,28,1,30,2,5,0,0
"07/29/2020","Y","Y","Copper River Census Area",66,"Other Interior Region",7,0,28,0,30,1,6,0,0
"07/30/2020","Y","Y","Copper River Census Area",66,"Other Interior Region",7,1,29,0,30,0,6,0,0
"08/04/2020","Y","Y","Copper River Census Area",66,"Other Interior Region",7,0,29,1,31,0,6,0,0
"08/05/2020","Y","Y","Copper River Census Area",66,"Other Interior Region",7,1,30,0,31,0,6,0,0
"08/08/2020","Y","Y","Copper River Census Area",66,"Other Interior Region",7,0,30,1,32,0,6,0,0
"08/13/2020","Y","Y","Copper River Census Area",66,"Other Interior Region",7,0,30,2,34,0,6,0,0
"08/14/2020","Y","Y","Copper River Census Area",66,"Other Interior Region",7,0,30,3,37,0,6,0,0
"08/15/2020","Y","Y","Copper River Census Area",66,"Other Interior Region",7,2,32,0,37,0,6,0,0
"08/17/2020","Y","Y","Copper River Census Area",66,"Other Interior Region",7,1,33,0,37,0,6,0,0
"08/18/2020","Y","Y","Copper River Census Area",66,"Other Interior Region",7,1,34,0,37,0,6,0,0
"08/19/2020","Y","Y","Copper River Census Area",66,"Other Interior Region",7,1,35,1,38,0,6,0,0
"08/20/2020","Y","Y","Copper River Census Area",66,"Other Interior Region",7,3,38,0,38,0,6,0,0
"08/26/2020","Y","Y","Copper River Census Area",66,"Other Interior Region",7,0,38,1,39,0,6,0,0
"08/28/2020","Y","Y","Copper River Census Area",66,"Other Interior Region",7,1,39,0,39,0,6,0,0
"09/02/2020","Y","Y","Copper River Census Area",66,"Other Interior Region",7,0,39,1,40,0,6,0,0
"09/03/2020","Y","Y","Copper River Census Area",66,"Other Interior Region",7,1,40,0,40,0,6,0,0
"10/09/2020","Y","Y","Copper River Census Area",66,"Other Interior Region",7,0,40,1,41,0,6,0,0
"10/10/2020","Y","Y","Copper River Census Area",66,"Other Interior Region",7,0,40,1,42,0,6,0,0
"10/11/2020","Y","Y","Copper River Census Area",66,"Other Interior Region",7,0,40,1,43,0,6,0,0
"10/12/2020","Y","Y","Copper River Census Area",66,"Other Interior Region",7,0,40,1,44,0,6,0,0
"10/13/2020","Y","Y","Copper River Census Area",66,"Other Interior Region",7,0,40,1,45,0,6,0,0
"10/14/2020","Y","Y","Copper River Census Area",66,"Other Interior Region",7,1,41,2,47,0,6,0,0
"10/15/2020","Y","Y","Copper River Census Area",66,"Other Interior Region",7,2,43,1,48,0,6,0,0
"10/17/2020","Y","Y","Copper River Census Area",66,"Other Interior Region",7,0,43,1,49,0,6,0,0
"10/18/2020","Y","Y","Copper River Census Area",66,"Other Interior Region",7,0,43,1,50,0,6,0,0
"10/19/2020","Y","Y","Copper River Census Area",66,"Other Interior Region",7,2,45,0,50,0,6,0,0
"10/20/2020","Y","Y","Copper River Census Area",66,"Other Interior Region",7,2,47,0,50,0,6,0,0
"10/21/2020","Y","Y","Copper River Census Area",66,"Other Interior Region",7,1,48,1,51,0,6,0,0
"10/22/2020","Y","Y","Copper River Census Area",66,"Other Interior Region",7,0,48,2,53,0,6,0,0
"10/23/2020","Y","Y","Copper River Census Area",66,"Other Interior Region",7,0,48,1,54,0,6,0,0
"10/24/2020","Y","Y","Copper River Census Area",66,"Other Interior Region",7,2,50,0,54,0,6,0,0
"10/26/2020","Y","Y","Copper River Census Area",66,"Other Interior Region",7,2,52,1,55,0,6,0,0
"10/27/2020","Y","Y","Copper River Census Area",66,"Other Interior Region",7,0,52,2,57,0,6,0,0
"10/28/2020","Y","Y","Copper River Census Area",66,"Other Interior Region",7,0,52,3,60,0,6,0,0
"10/29/2020","Y","Y","Copper River Census Area",66,"Other Interior Region",7,5,57,2,62,0,6,0,0
"10/30/2020","Y","Y","Copper River Census Area",66,"Other Interior Region",7,0,57,5,67,0,6,0,0
"10/31/2020","Y","Y","Copper River Census Area",66,"Other Interior Region",7,5,62,1,68,0,6,0,0
"11/02/2020","Y","Y","Copper River Census Area",66,"Other Interior Region",7,2,64,5,73,0,6,0,0
"11/03/2020","Y","Y","Copper River Census Area",66,"Other Interior Region",7,2,66,0,73,0,6,0,0
"11/04/2020","Y","Y","Copper River Census Area",66,"Other Interior Region",7,3,69,5,78,0,6,0,0
"11/05/2020","Y","Y","Copper River Census Area",66,"Other Interior Region",7,2,71,2,80,0,6,0,0
"11/06/2020","Y","Y","Copper River Census Area",66,"Other Interior Region",7,4,75,0,80,0,6,0,0
"11/07/2020","Y","Y","Copper River Census Area",66,"Other Interior Region",7,2,77,0,80,0,6,0,0
"11/08/2020","Y","Y","Copper River Census Area",66,"Other Interior Region",7,2,79,0,80,0,6,0,0
"11/09/2020","Y","Y","Copper River Census Area",66,"Other Interior Region",7,3,82,3,83,0,6,0,0
"11/10/2020","Y","Y","Copper River Census Area",66,"Other Interior Region",7,1,83,3,86,0,6,0,0
"11/11/2020","Y","Y","Copper River Census Area",66,"Other Interior Region",7,0,83,1,87,0,6,0,0
"11/12/2020","Y","Y","Copper River Census Area",66,"Other Interior Region",7,3,86,2,89,0,6,0,0
"11/13/2020","Y","Y","Copper River Census Area",66,"Other Interior Region",7,1,87,1,90,0,6,0,0
"11/14/2020","Y","Y","Copper River Census Area",66,"Other Interior Region",7,0,87,1,91,0,6,0,0
"11/15/2020","Y","Y","Copper River Census Area",66,"Other Interior Region",7,2,89,1,92,0,6,0,0
"11/16/2020","Y","Y","Copper River Census Area",66,"Other Interior Region",7,3,92,4,96,0,6,0,0
"11/17/2020","Y","Y","Copper River Census Area",66,"Other Interior Region",7,0,92,3,99,0,6,0,0
"11/18/2020","Y","Y","Copper River Census Area",66,"Other Interior Region",7,3,95,3,102,0,6,0,0
"11/19/2020","Y","Y","Copper River Census Area",66,"Other Interior Region",7,3,98,1,103,0,6,0,0
"11/20/2020","Y","Y","Copper River Census Area",66,"Other Interior Region",7,2,100,4,107,0,6,0,0
"11/21/2020","Y","Y","Copper River Census Area",66,"Other Interior Region",7,1,101,1,108,0,6,0,0
"11/22/2020","Y","Y","Copper River Census Area",66,"Other Interior Region",7,3,104,0,108,0,6,0,0
"11/24/2020","Y","Y","Copper River Census Area",66,"Other Interior Region",7,0,104,1,109,0,6,0,0
"11/25/2020","Y","Y","Copper River Census Area",66,"Other Interior Region",7,1,105,1,110,0,6,0,0
"11/27/2020","Y","Y","Copper River Census Area",66,"Other Interior Region",7,1,106,0,110,0,6,0,0
"11/28/2020","Y","Y","Copper River Census Area",66,"Other Interior Region",7,2,108,0,110,0,6,0,0
"11/30/2020","Y","Y","Copper River Census Area",66,"Other Interior Region",7,1,109,3,113,0,6,0,0
"12/01/2020","Y","Y","Copper River Census Area",66,"Other Interior Region",7,2,111,3,116,0,6,0,0
"12/02/2020","Y","Y","Copper River Census Area",66,"Other Interior Region",7,2,113,6,122,1,7,0,0
"12/03/2020","Y","Y","Copper River Census Area",66,"Other Interior Region",7,6,119,2,124,0,7,0,0
"12/04/2020","Y","Y","Copper River Census Area",66,"Other Interior Region",7,2,121,0,124,0,7,0,0
"12/08/2020","Y","Y","Copper River Census Area",66,"Other Interior Region",7,0,121,3,127,0,7,0,0
"12/09/2020","Y","Y","Copper River Census Area",66,"Other Interior Region",7,3,124,0,127,0,7,0,0
"12/10/2020","Y","Y","Copper River Census Area",66,"Other Interior Region",7,1,125,1,128,0,7,0,0
"12/11/2020","Y","Y","Copper River Census Area",66,"Other Interior Region",7,1,126,0,128,0,7,0,0
"12/14/2020","Y","Y","Copper River Census Area",66,"Other Interior Region",7,1,127,1,129,0,7,0,0
"12/17/2020","Y","Y","Copper River Census Area",66,"Other Interior Region",7,1,128,1,130,0,7,0,0
"12/22/2020","Y","Y","Copper River Census Area",66,"Other Interior Region",7,0,128,2,132,0,7,0,0
"12/23/2020","Y","Y","Copper River Census Area",66,"Other Interior Region",7,3,131,1,133,0,7,0,0
"12/26/2020","Y","Y","Copper River Census Area",66,"Other Interior Region",7,0,131,2,135,0,7,0,0
"12/27/2020","Y","Y","Copper River Census Area",66,"Other Interior Region",7,1,132,0,135,0,7,0,0
"12/28/2020","Y","Y","Copper River Census Area",66,"Other Interior Region",7,3,135,4,139,0,7,0,0
"12/29/2020","Y","Y","Copper River Census Area",66,"Other Interior Region",7,2,137,1,140,0,7,0,0
"12/30/2020","Y","Y","Copper River Census Area",66,"Other Interior Region",7,1,138,6,146,0,7,0,0
"12/31/2020","Y","Y","Copper River Census Area",66,"Other Interior Region",7,8,146,7,153,0,7,0,0
"01/01/2021","Y","Y","Copper River Census Area",66,"Other Interior Region",7,5,151,0,153,0,7,0,0
"01/03/2021","Y","Y","Copper River Census Area",66,"Other Interior Region",7,1,152,0,153,0,7,0,0
"01/04/2021","Y","Y","Copper River Census Area",66,"Other Interior Region",7,0,152,4,157,0,7,0,0
"01/05/2021","Y","Y","Copper River Census Area",66,"Other Interior Region",7,1,153,4,161,0,7,0,0
"01/06/2021","Y","Y","Copper River Census Area",66,"Other Interior Region",7,4,157,1,162,0,7,0,0
"01/07/2021","Y","Y","Copper River Census Area",66,"Other Interior Region",7,5,162,0,162,0,7,0,0
"01/08/2021","Y","Y","Copper River Census Area",66,"Other Interior Region",7,1,163,2,164,0,7,0,0
"01/10/2021","Y","Y","Copper River Census Area",66,"Other Interior Region",7,1,164,0,164,0,7,0,0
"01/11/2021","Y","Y","Copper River Census Area",66,"Other Interior Region",7,0,164,3,167,0,7,0,0
"01/12/2021","Y","Y","Copper River Census Area",66,"Other Interior Region",7,1,165,1,168,0,7,0,0
"01/13/2021","Y","Y","Copper River Census Area",66,"Other Interior Region",7,2,167,1,169,0,7,0,0
"01/14/2021","Y","Y","Copper River Census Area",66,"Other Interior Region",7,1,168,0,169,0,7,0,0
"01/15/2021","Y","Y","Copper River Census Area",66,"Other Interior Region",7,2,170,2,171,0,7,0,0
"01/16/2021","Y","Y","Copper River Census Area",66,"Other Interior Region",7,1,171,0,171,0,7,0,0
"01/19/2021","Y","Y","Copper River Census Area",66,"Other Interior Region",7,0,171,1,172,0,7,0,0
"01/21/2021","Y","Y","Copper River Census Area",66,"Other Interior Region",7,1,172,0,172,0,7,0,0
"01/22/2021","Y","Y","Copper River Census Area",66,"Other Interior Region",7,2,174,2,174,0,7,0,0
"01/26/2021","Y","Y","Copper River Census Area",66,"Other Interior Region",7,1,175,1,175,0,7,0,0
"01/27/2021","Y","Y","Copper River Census Area",66,"Other Interior Region",7,0,175,2,177,0,7,0,0
"01/28/2021","Y","Y","Copper River Census Area",66,"Other Interior Region",7,0,175,3,180,0,7,0,0
"01/29/2021","Y","Y","Copper River Census Area",66,"Other Interior Region",7,2,177,3,183,0,7,0,0
"01/30/2021","Y","Y","Copper River Census Area",66,"Other Interior Region",7,4,181,2,185,0,7,0,0
"01/31/2021","Y","Y","Copper River Census Area",66,"Other Interior Region",7,1,182,1,186,0,7,0,0
"02/02/2021","Y","Y","Copper River Census Area",66,"Other Interior Region",7,3,185,1,187,0,7,0,0
"02/03/2021","Y","Y","Copper River Census Area",66,"Other Interior Region",7,2,187,0,187,0,7,0,0
"02/04/2021","Y","Y","Copper River Census Area",66,"Other Interior Region",7,0,187,1,188,0,7,0,0
"02/05/2021","Y","Y","Copper River Census Area",66,"Other Interior Region",7,1,188,3,191,0,7,0,0
"02/06/2021","Y","Y","Copper River Census Area",66,"Other Interior Region",7,2,190,1,192,0,7,0,0
"02/08/2021","Y","Y","Copper River Census Area",66,"Other Interior Region",7,0,190,2,194,0,7,0,0
"02/09/2021","Y","Y","Copper River Census Area",66,"Other Interior Region",7,0,190,1,195,0,7,0,0
"02/11/2021","Y","Y","Copper River Census Area",66,"Other Interior Region",7,4,194,0,195,0,7,0,0
"02/12/2021","Y","Y","Copper River Census Area",66,"Other Interior Region",7,1,195,1,196,0,7,0,0
"02/13/2021","Y","Y","Copper River Census Area",66,"Other Interior Region",7,1,196,2,198,0,7,0,0
"02/14/2021","Y","Y","Copper River Census Area",66,"Other Interior Region",7,1,197,1,199,0,7,0,0
"02/16/2021","Y","Y","Copper River Census Area",66,"Other Interior Region",7,0,197,1,200,0,7,0,0
"02/18/2021","Y","Y","Copper River Census Area",66,"Other Interior Region",7,2,199,0,200,0,7,0,0
"02/19/2021","Y","Y","Copper River Census Area",66,"Other Interior Region",7,1,200,1,201,0,7,0,0
"02/26/2021","Y","Y","Copper River Census Area",66,"Other Interior Region",7,0,200,1,202,0,7,0,0
"03/02/2021","Y","Y","Copper River Census Area",66,"Other Interior Region",7,0,200,2,204,1,8,0,0
"03/03/2021","Y","Y","Copper River Census Area",66,"Other Interior Region",7,2,202,0,204,0,8,0,0
"03/05/2021","Y","Y","Copper River Census Area",66,"Other Interior Region",7,1,203,3,207,0,8,0,0
"03/06/2021","Y","Y","Copper River Census Area",66,"Other Interior Region",7,0,203,2,209,0,8,0,0
"03/07/2021","Y","Y","Copper River Census Area",66,"Other Interior Region",7,1,204,0,209,0,8,0,0
"03/08/2021","Y","Y","Copper River Census Area",66,"Other Interior Region",7,3,207,1,210,0,8,0,0
"03/09/2021","Y","Y","Copper River Census Area",66,"Other Interior Region",7,0,207,2,212,0,8,0,0
"03/10/2021","Y","Y","Copper River Census Area",66,"Other Interior Region",7,4,211,1,213,0,8,0,0
"03/12/2021","Y","Y","Copper River Census Area",66,"Other Interior Region",7,1,212,0,213,0,8,0,0
"03/14/2021","Y","Y","Copper River Census Area",66,"Other Interior Region",7,0,212,1,214,0,8,0,0
"03/15/2021","Y","Y","Copper River Census Area",66,"Other Interior Region",7,1,213,2,216,0,8,0,0
"03/16/2021","Y","Y","Copper River Census Area",66,"Other Interior Region",7,2,215,0,216,0,8,0,0
"03/17/2021","Y","Y","Copper River Census Area",66,"Other Interior Region",7,1,216,2,218,0,8,0,0
"03/19/2021","Y","Y","Copper River Census Area",66,"Other Interior Region",7,0,216,1,219,0,8,0,0
"03/22/2021","Y","Y","Copper River Census Area",66,"Other Interior Region",7,3,219,1,220,0,8,0,0
"03/23/2021","Y","Y","Copper River Census Area",66,"Other Interior Region",7,0,219,1,221,0,8,0,0
"03/25/2021","Y","Y","Copper River Census Area",66,"Other Interior Region",7,1,220,2,223,0,8,0,0
"03/26/2021","Y","Y","Copper River Census Area",66,"Other Interior Region",7,0,220,1,224,0,8,0,0
"03/27/2021","Y","Y","Copper River Census Area",66,"Other Interior Region",7,2,222,0,224,0,8,0,0
"03/28/2021","Y","Y","Copper River Census Area",66,"Other Interior Region",7,1,223,0,224,0,8,0,0
"04/01/2021","Y","Y","Copper River Census Area",66,"Other Interior Region",7,0,223,1,225,0,8,0,0
"04/04/2021","Y","Y","Copper River Census Area",66,"Other Interior Region",7,2,225,0,225,0,8,0,0
"04/05/2021","Y","Y","Copper River Census Area",66,"Other Interior Region",7,1,226,1,226,0,8,0,0
"04/08/2021","Y","Y","Copper River Census Area",66,"Other Interior Region",7,0,226,2,228,0,8,0,0
"04/09/2021","Y","Y","Copper River Census Area",66,"Other Interior Region",7,0,226,1,229,0,8,0,0
"04/10/2021","Y","Y","Copper River Census Area",66,"Other Interior Region",7,1,227,0,229,0,8,0,0
"04/12/2021","Y","Y","Copper River Census Area",66,"Other Interior Region",7,1,228,0,229,0,8,0,0
"04/14/2021","Y","Y","Copper River Census Area",66,"Other Interior Region",7,0,228,1,230,0,8,0,0
"04/16/2021","Y","Y","Copper River Census Area",66,"Other Interior Region",7,1,229,1,231,0,8,0,0
"04/21/2021","Y","Y","Copper River Census Area",66,"Other Interior Region",7,1,230,1,232,0,8,0,0
"04/23/2021","Y","Y","Copper River Census Area",66,"Other Interior Region",7,1,231,0,232,0,8,0,0
"04/24/2021","Y","Y","Copper River Census Area",66,"Other Interior Region",7,1,232,0,232,0,8,0,0
"04/26/2021","Y","Y","Copper River Census Area",66,"Other Interior Region",7,0,232,1,233,0,8,0,0
"04/27/2021","Y","Y","Copper River Census Area",66,"Other Interior Region",7,1,233,1,234,0,8,0,0
"04/30/2021","Y","Y","Copper River Census Area",66,"Other Interior Region",7,0,233,1,235,0,8,0,0
"05/01/2021","Y","Y","Copper River Census Area",66,"Other Interior Region",7,1,234,0,235,0,8,0,0
"05/04/2021","Y","Y","Copper River Census Area",66,"Other Interior Region",7,1,235,0,235,0,8,0,0
"05/21/2021","Y","Y","Copper River Census Area",66,"Other Interior Region",7,0,235,1,236,0,8,0,0
"05/22/2021","Y","Y","Copper River Census Area",66,"Other Interior Region",7,1,236,0,236,0,8,0,0
"05/30/2021","Y","Y","Copper River Census Area",66,"Other Interior Region",7,1,237,0,236,0,8,0,0
"06/01/2021","Y","Y","Copper River Census Area",66,"Other Interior Region",7,0,237,1,237,0,8,0,0
"06/05/2021","Y","Y","Copper River Census Area",66,"Other Interior Region",7,0,237,0,237,1,9,0,0
"06/07/2021","Y","Y","Copper River Census Area",66,"Other Interior Region",7,3,240,3,240,0,9,0,0
"06/09/2021","Y","Y","Copper River Census Area",66,"Other Interior Region",7,0,240,1,241,0,9,0,0
"06/10/2021","Y","Y","Copper River Census Area",66,"Other Interior Region",7,0,240,2,243,0,9,0,0
"06/12/2021","Y","Y","Copper River Census Area",66,"Other Interior Region",7,1,241,2,245,0,9,0,0
"06/15/2021","Y","Y","Copper River Census Area",66,"Other Interior Region",7,3,244,0,245,0,9,0,0
"06/16/2021","Y","Y","Copper River Census Area",66,"Other Interior Region",7,1,245,0,245,0,9,0,0
"06/22/2021","Y","Y","Copper River Census Area",66,"Other Interior Region",7,2,247,2,247,0,9,0,0
"07/18/2021","Y","Y","Copper River Census Area",66,"Other Interior Region",7,0,247,1,248,0,9,0,0
"07/19/2021","Y","Y","Copper River Census Area",66,"Other Interior Region",7,1,248,0,248,0,9,0,0
"07/20/2021","Y","Y","Copper River Census Area",66,"Other Interior Region",7,0,248,3,251,0,9,0,0
"07/21/2021","Y","Y","Copper River Census Area",66,"Other Interior Region",7,4,252,18,269,0,9,0,0
"07/22/2021","Y","Y","Copper River Census Area",66,"Other Interior Region",7,6,258,3,272,0,9,0,0
"07/23/2021","Y","Y","Copper River Census Area",66,"Other Interior Region",7,13,271,6,278,0,9,0,0
"07/24/2021","Y","Y","Copper River Census Area",66,"Other Interior Region",7,2,273,0,278,0,9,0,0
"07/25/2021","Y","Y","Copper River Census Area",66,"Other Interior Region",7,4,277,3,281,2,11,0,0
"07/26/2021","Y","Y","Copper River Census Area",66,"Other Interior Region",7,2,279,6,287,0,11,0,0
"07/27/2021","Y","Y","Copper River Census Area",66,"Other Interior Region",7,10,289,8,295,0,11,0,0
"07/28/2021","Y","Y","Copper River Census Area",66,"Other Interior Region",7,3,292,0,295,0,11,0,0
"07/30/2021","Y","Y","Copper River Census Area",66,"Other Interior Region",7,2,294,1,296,0,11,0,0
"08/01/2021","Y","Y","Copper River Census Area",66,"Other Interior Region",7,0,294,1,297,0,11,0,0
"08/02/2021","Y","Y","Copper River Census Area",66,"Other Interior Region",7,1,295,1,298,0,11,0,0
"08/03/2021","Y","Y","Copper River Census Area",66,"Other Interior Region",7,2,297,2,300,0,11,0,0
"08/04/2021","Y","Y","Copper River Census Area",66,"Other Interior Region",7,3,300,2,302,0,11,0,0
"08/05/2021","Y","Y","Copper River Census Area",66,"Other Interior Region",7,2,302,1,303,0,11,0,0
"08/09/2021","Y","Y","Copper River Census Area",66,"Other Interior Region",7,1,303,0,303,0,11,0,0
"08/12/2021","Y","Y","Copper River Census Area",66,"Other Interior Region",7,0,303,3,306,0,11,0,0
"08/13/2021","Y","Y","Copper River Census Area",66,"Other Interior Region",7,1,304,0,306,0,11,0,0
"08/15/2021","Y","Y","Copper River Census Area",66,"Other Interior Region",7,1,305,0,306,0,11,0,0
"08/16/2021","Y","Y","Copper River Census Area",66,"Other Interior Region",7,1,306,6,312,0,11,0,0
"08/17/2021","Y","Y","Copper River Census Area",66,"Other Interior Region",7,1,307,2,314,0,11,0,0
"08/18/2021","Y","Y","Copper River Census Area",66,"Other Interior Region",7,4,311,1,315,0,11,0,0
"08/19/2021","Y","Y","Copper River Census Area",66,"Other Interior Region",7,2,313,2,317,0,11,0,0
"08/20/2021","Y","Y","Copper River Census Area",66,"Other Interior Region",7,1,314,1,318,0,11,0,0
"08/21/2021","Y","Y","Copper River Census Area",66,"Other Interior Region",7,1,315,2,320,0,11,0,0
"08/22/2021","Y","Y","Copper River Census Area",66,"Other Interior Region",7,4,319,0,320,0,11,0,0
"08/23/2021","Y","Y","Copper River Census Area",66,"Other Interior Region",7,2,321,7,327,0,11,0,0
"08/24/2021","Y","Y","Copper River Census Area",66,"Other Interior Region",7,3,324,4,331,0,11,0,0
"08/25/2021","Y","Y","Copper River Census Area",66,"Other Interior Region",7,5,329,4,335,0,11,0,0
"08/26/2021","Y","Y","Copper River Census Area",66,"Other Interior Region",7,0,329,3,338,0,11,0,0
"08/27/2021","Y","Y","Copper River Census Area",66,"Other Interior Region",7,1,330,2,340,0,11,0,0
"08/28/2021","Y","Y","Copper River Census Area",66,"Other Interior Region",7,2,332,0,340,0,11,0,0
"08/29/2021","Y","Y","Copper River Census Area",66,"Other Interior Region",7,1,333,0,340,0,11,0,0
"08/30/2021","Y","Y","Copper River Census Area",66,"Other Interior Region",7,2,335,3,343,0,11,0,0
"08/31/2021","Y","Y","Copper River Census Area",66,"Other Interior Region",7,4,339,2,345,0,11,0,0
"09/01/2021","Y","Y","Copper River Census Area",66,"Other Interior Region",7,1,340,12,357,2,13,0,0
"09/02/2021","Y","Y","Copper River Census Area",66,"Other Interior Region",7,10,350,3,360,0,13,0,0
"09/03/2021","Y","Y","Copper River Census Area",66,"Other Interior Region",7,1,351,4,364,0,13,0,0
"09/04/2021","Y","Y","Copper River Census Area",66,"Other Interior Region",7,6,357,0,364,0,13,0,0
"09/06/2021","Y","Y","Copper River Census Area",66,"Other Interior Region",7,1,358,0,364,0,13,0,0
"09/07/2021","Y","Y","Copper River Census Area",66,"Other Interior Region",7,0,358,13,377,1,14,0,0
"09/08/2021","Y","Y","Copper River Census Area",66,"Other Interior Region",7,6,364,8,385,0,14,0,0
"09/09/2021","Y","Y","Copper River Census Area",66,"Other Interior Region",7,9,373,8,393,0,14,0,0
"09/10/2021","Y","Y","Copper River Census Area",66,"Other Interior Region",7,8,381,5,398,0,14,0,0
"09/11/2021","Y","Y","Copper River Census Area",66,"Other Interior Region",7,0,381,1,399,0,14,0,0
"09/12/2021","Y","Y","Copper River Census Area",66,"Other Interior Region",7,1,382,0,399,0,14,0,0
"09/13/2021","Y","Y","Copper River Census Area",66,"Other Interior Region",7,1,383,12,411,0,14,0,0
"09/14/2021","Y","Y","Copper River Census Area",66,"Other Interior Region",7,0,383,9,420,0,14,0,0
"09/15/2021","Y","Y","Copper River Census Area",66,"Other Interior Region",7,1,384,1,421,0,14,0,0
"09/16/2021","Y","Y","Copper River Census Area",66,"Other Interior Region",7,3,387,5,426,0,14,0,0
"09/17/2021","Y","Y","Copper River Census Area",66,"Other Interior Region",7,2,389,5,431,0,14,0,0
"09/18/2021","Y","Y","Copper River Census Area",66,"Other Interior Region",7,9,398,0,431,0,14,0,0
"09/20/2021","Y","Y","Copper River Census Area",66,"Other Interior Region",7,1,399,8,439,0,14,0,0
"09/21/2021","Y","Y","Copper River Census Area",66,"Other Interior Region",7,14,413,5,444,0,14,0,0
"09/22/2021","Y","Y","Copper River Census Area",66,"Other Interior Region",7,3,416,3,447,0,14,0,0
"09/23/2021","Y","Y","Copper River Census Area",66,"Other Interior Region",7,5,421,4,451,0,14,0,0
"09/24/2021","Y","Y","Copper River Census Area",66,"Other Interior Region",7,11,432,2,453,1,15,0,0
"09/25/2021","Y","Y","Copper River Census Area",66,"Other Interior Region",7,2,434,0,453,0,15,0,0
"09/26/2021","Y","Y","Copper River Census Area",66,"Other Interior Region",7,3,437,0,453,0,15,1,1
"09/27/2021","Y","Y","Copper River Census Area",66,"Other Interior Region",7,6,443,9,462,0,15,0,1
"09/28/2021","Y","Y","Copper River Census Area",66,"Other Interior Region",7,1,444,5,467,0,15,0,1
"09/29/2021","Y","Y","Copper River Census Area",66,"Other Interior Region",7,5,449,2,469,0,15,0,1
"09/30/2021","Y","Y","Copper River Census Area",66,"Other Interior Region",7,17,466,1,470,0,15,0,1
"10/01/2021","Y","Y","Copper River Census Area",66,"Other Interior Region",7,0,466,3,473,0,15,0,1
"10/02/2021","Y","Y","Copper River Census Area",66,"Other Interior Region",7,1,467,0,473,0,15,0,1
"10/03/2021","Y","Y","Copper River Census Area",66,"Other Interior Region",7,2,469,0,473,0,15,0,1
"10/04/2021","Y","Y","Copper River Census Area",66,"Other Interior Region",7,2,471,10,483,0,15,0,1
"10/05/2021","Y","Y","Copper River Census Area",66,"Other Interior Region",7,2,473,5,488,0,15,0,1
"10/06/2021","Y","Y","Copper River Census Area",66,"Other Interior Region",7,0,473,4,492,0,15,0,1
"10/07/2021","Y","Y","Copper River Census Area",66,"Other Interior Region",7,7,480,1,493,0,15,0,1
"10/08/2021","Y","Y","Copper River Census Area",66,"Other Interior Region",7,5,485,4,497,0,15,0,1
"10/09/2021","Y","Y","Copper River Census Area",66,"Other Interior Region",7,1,486,0,497,0,15,0,1
"10/10/2021","Y","Y","Copper River Census Area",66,"Other Interior Region",7,9,495,1,498,0,15,0,1
"10/11/2021","Y","Y","Copper River Census Area",66,"Other Interior Region",7,0,495,8,506,0,15,0,1
"10/12/2021","Y","Y","Copper River Census Area",66,"Other Interior Region",7,1,496,1,507,0,15,0,1
"10/13/2021","Y","Y","Copper River Census Area",66,"Other Interior Region",7,3,499,0,507,0,15,0,1
"10/14/2021","Y","Y","Copper River Census Area",66,"Other Interior Region",7,4,503,6,513,1,16,0,1
"10/15/2021","Y","Y","Copper River Census Area",66,"Other Interior Region",7,2,505,7,520,0,16,0,1
"10/16/2021","Y","Y","Copper River Census Area",66,"Other Interior Region",7,6,511,0,520,0,16,0,1
"10/18/2021","Y","Y","Copper River Census Area",66,"Other Interior Region",7,0,511,12,532,0,16,0,1
"10/19/2021","Y","Y","Copper River Census Area",66,"Other Interior Region",7,3,514,8,540,1,17,0,1
"10/20/2021","Y","Y","Copper River Census Area",66,"Other Interior Region",7,9,523,5,545,0,17,0,1
"10/21/2021","Y","Y","Copper River Census Area",66,"Other Interior Region",7,1,524,3,548,1,18,0,1
"10/22/2021","Y","Y","Copper River Census Area",66,"Other Interior Region",7,13,537,6,554,1,19,0,1
"10/23/2021","Y","Y","Copper River Census Area",66,"Other Interior Region",7,7,544,0,554,0,19,0,1
"10/24/2021","Y","Y","Copper River Census Area",66,"Other Interior Region",7,1,545,1,555,0,19,0,1
"10/25/2021","Y","Y","Copper River Census Area",66,"Other Interior Region",7,3,548,10,565,0,19,0,1
"10/26/2021","Y","Y","Copper River Census Area",66,"Other Interior Region",7,1,549,7,572,0,19,0,1
"10/27/2021","Y","Y","Copper River Census Area",66,"Other Interior Region",7,3,552,3,575,0,19,0,1
"10/28/2021","Y","Y","Copper River Census Area",66,"Other Interior Region",7,1,553,2,577,0,19,0,1
"10/29/2021","Y","Y","Copper River Census Area",66,"Other Interior Region",7,12,565,1,578,0,19,1,2
"10/30/2021","Y","Y","Copper River Census Area",66,"Other Interior Region",7,2,567,0,578,0,19,0,2
"10/31/2021","Y","Y","Copper River Census Area",66,"Other Interior Region",7,4,571,0,578,0,19,0,2
"11/01/2021","Y","Y","Copper River Census Area",66,"Other Interior Region",7,1,572,7,585,0,19,0,2
"11/02/2021","Y","Y","Copper River Census Area",66,"Other Interior Region",7,1,573,5,590,0,19,0,2
"11/03/2021","Y","Y","Copper River Census Area",66,"Other Interior Region",7,2,575,2,592,0,19,0,2
"11/04/2021","Y","Y","Copper River Census Area",66,"Other Interior Region",7,12,587,2,594,0,19,0,2
"11/05/2021","Y","Y","Copper River Census Area",66,"Other Interior Region",7,4,591,1,595,0,19,0,2
"11/06/2021","Y","Y","Copper River Census Area",66,"Other Interior Region",7,2,593,1,596,0,19,0,2
"11/08/2021","Y","Y","Copper River Census Area",66,"Other Interior Region",7,0,593,10,606,0,19,0,2
"11/09/2021","Y","Y","Copper River Census Area",66,"Other Interior Region",7,1,594,3,609,0,19,0,2
"11/10/2021","Y","Y","Copper River Census Area",66,"Other Interior Region",7,1,595,7,616,0,19,0,2
"11/11/2021","Y","Y","Copper River Census Area",66,"Other Interior Region",7,0,595,0,616,1,20,0,2
"11/12/2021","Y","Y","Copper River Census Area",66,"Other Interior Region",7,19,614,2,618,0,20,0,2
"11/13/2021","Y","Y","Copper River Census Area",66,"Other Interior Region",7,1,615,1,619,1,21,0,2
"11/14/2021","Y","Y","Copper River Census Area",66,"Other Interior Region",7,1,616,1,620,0,21,0,2
"11/15/2021","Y","Y","Copper River Census Area",66,"Other Interior Region",7,8,624,8,628,0,21,0,2
"11/16/2021","Y","Y","Copper River Census Area",66,"Other Interior Region",7,1,625,5,633,0,21,1,3
"11/17/2021","Y","Y","Copper River Census Area",66,"Other Interior Region",7,1,626,5,638,0,21,0,3
"11/18/2021","Y","Y","Copper River Census Area",66,"Other Interior Region",7,5,631,4,642,0,21,0,3
"11/19/2021","Y","Y","Copper River Census Area",66,"Other Interior Region",7,0,631,1,643,1,22,0,3
"11/20/2021","Y","Y","Copper River Census Area",66,"Other Interior Region",7,9,640,0,643,0,22,0,3
"11/21/2021","Y","Y","Copper River Census Area",66,"Other Interior Region",7,1,641,0,643,0,22,0,3
"11/22/2021","Y","Y","Copper River Census Area",66,"Other Interior Region",7,1,642,14,657,0,22,0,3
"11/23/2021","Y","Y","Copper River Census Area",66,"Other Interior Region",7,2,644,6,663,0,22,0,3
"11/24/2021","Y","Y","Copper River Census Area",66,"Other Interior Region",7,12,656,1,664,0,22,0,3
"11/26/2021","Y","Y","Copper River Census Area",66,"Other Interior Region",7,5,661,0,664,0,22,0,3
"11/27/2021","Y","Y","Copper River Census Area",66,"Other Interior Region",7,3,664,0,664,0,22,1,4
"11/29/2021","Y","Y","Copper River Census Area",66,"Other Interior Region",7,1,665,10,674,0,22,0,4
"11/30/2021","Y","Y","Copper River Census Area",66,"Other Interior Region",7,1,666,5,679,0,22,0,4
"12/01/2021","Y","Y","Copper River Census Area",66,"Other Interior Region",7,5,671,0,679,0,22,0,4
"12/02/2021","Y","Y","Copper River Census Area",66,"Other Interior Region",7,3,674,2,681,0,22,0,4
"12/03/2021","Y","Y","Copper River Census Area",66,"Other Interior Region",7,5,679,2,683,0,22,0,4
"12/05/2021","Y","Y","Copper River Census Area",66,"Other Interior Region",7,2,681,1,684,1,23,0,4
"12/06/2021","Y","Y","Copper River Census Area",66,"Other Interior Region",7,0,681,1,685,0,23,0,4
"12/07/2021","Y","Y","Copper River Census Area",66,"Other Interior Region",7,1,682,1,686,0,23,0,4
"12/08/2021","Y","Y","Copper River Census Area",66,"Other Interior Region",7,2,684,1,687,0,23,0,4
"12/09/2021","Y","Y","Copper River Census Area",66,"Other Interior Region",7,1,685,0,687,0,23,1,5
"12/10/2021","Y","Y","Copper River Census Area",66,"Other Interior Region",7,2,687,1,688,0,23,0,5
"12/12/2021","Y","Y","Copper River Census Area",66,"Other Interior Region",7,1,688,0,688,0,23,0,5
"12/13/2021","Y","Y","Copper River Census Area",66,"Other Interior Region",7,0,688,1,689,0,23,0,5
"12/14/2021","Y","Y","Copper River Census Area",66,"Other Interior Region",7,0,688,1,690,0,23,0,5
"12/15/2021","Y","Y","Copper River Census Area",66,"Other Interior Region",7,1,689,0,690,0,23,0,5
"12/16/2021","Y","Y","Copper River Census Area",66,"Other Interior Region",7,2,691,1,691,1,24,0,5
"12/19/2021","Y","Y","Copper River Census Area",66,"Other Interior Region",7,0,691,0,691,0,24,1,6
"12/20/2021","Y","Y","Copper River Census Area",66,"Other Interior Region",7,1,692,4,695,0,24,0,6
"12/21/2021","Y","Y","Copper River Census Area",66,"Other Interior Region",7,0,692,2,697,0,24,0,6
"12/22/2021","Y","Y","Copper River Census Area",66,"Other Interior Region",7,4,696,0,697,0,24,0,6
"12/23/2021","Y","Y","Copper River Census Area",66,"Other Interior Region",7,1,697,0,697,0,24,0,6
"12/28/2021","Y","Y","Copper River Census Area",66,"Other Interior Region",7,0,697,3,700,1,25,0,6
"12/29/2021","Y","Y","Copper River Census Area",66,"Other Interior Region",7,1,698,2,702,0,25,0,6
"12/30/2021","Y","Y","Copper River Census Area",66,"Other Interior Region",7,3,701,1,703,0,25,0,6
"12/31/2021","Y","Y","Copper River Census Area",66,"Other Interior Region",7,1,702,2,705,0,25,0,6
"01/01/2022","Y","Y","Copper River Census Area",66,"Other Interior Region",7,2,704,1,706,0,25,0,6
"01/02/2022","Y","Y","Copper River Census Area",66,"Other Interior Region",7,0,704,1,707,0,25,0,6
"01/03/2022","Y","Y","Copper River Census Area",66,"Other Interior Region",7,3,707,4,711,0,25,0,6
"01/04/2022","Y","Y","Copper River Census Area",66,"Other Interior Region",7,0,707,2,713,0,25,0,6
"01/05/2022","Y","Y","Copper River Census Area",66,"Other Interior Region",7,0,707,3,716,0,25,0,6
"01/06/2022","Y","Y","Copper River Census Area",66,"Other Interior Region",7,6,713,2,718,0,25,0,6
"01/07/2022","Y","Y","Copper River Census Area",66,"Other Interior Region",7,3,716,8,726,0,25,0,6
"01/09/2022","Y","Y","Copper River Census Area",66,"Other Interior Region",7,1,717,0,726,0,25,0,6
"01/10/2022","Y","Y","Copper River Census Area",66,"Other Interior Region",7,7,724,7,733,0,25,0,6
"01/11/2022","Y","Y","Copper River Census Area",66,"Other Interior Region",7,3,727,4,737,0,25,0,6
"01/12/2022","Y","Y","Copper River Census Area",66,"Other Interior Region",7,7,734,4,741,0,25,0,6
"01/13/2022","Y","Y","Copper River Census Area",66,"Other Interior Region",7,1,735,6,747,0,25,0,6
"01/14/2022","Y","Y","Copper River Census Area",66,"Other Interior Region",7,2,737,6,753,0,25,0,6
"01/15/2022","Y","Y","Copper River Census Area",66,"Other Interior Region",7,2,739,4,757,0,25,0,6
"01/16/2022","Y","Y","Copper River Census Area",66,"Other Interior Region",7,1,740,1,758,0,25,1,7
"01/17/2022","Y","Y","Copper River Census Area",66,"Other Interior Region",7,3,743,0,758,0,25,0,7
"01/18/2022","Y","Y","Copper River Census Area",66,"Other Interior Region",7,13,756,18,776,0,25,0,7
"01/19/2022","Y","Y","Copper River Census Area",66,"Other Interior Region",7,4,760,3,779,0,25,0,7
"01/20/2022","Y","Y","Copper River Census Area",66,"Other Interior Region",7,9,769,5,784,0,25,0,7
"01/21/2022","Y","Y","Copper River Census Area",66,"Other Interior Region",7,8,777,10,794,0,25,0,7
"01/22/2022","Y","Y","Copper River Census Area",66,"Other Interior Region",7,5,782,3,797,0,25,0,7
"01/23/2022","Y","Y","Copper River Census Area",66,"Other Interior Region",7,3,785,2,799,0,25,0,7
"01/24/2022","Y","Y","Copper River Census Area",66,"Other Interior Region",7,8,793,19,818,1,26,0,7
"01/25/2022","Y","Y","Copper River Census Area",66,"Other Interior Region",7,2,795,7,825,0,26,0,7
"01/26/2022","Y","Y","Copper River Census Area",66,"Other Interior Region",7,10,805,3,828,0,26,0,7
"01/27/2022","Y","Y","Copper River Census Area",66,"Other Interior Region",7,13,818,5,833,0,26,0,7
"01/28/2022","Y","Y","Copper River Census Area",66,"Other Interior Region",7,2,820,5,838,0,26,1,8
"01/30/2022","Y","Y","Copper River Census Area",66,"Other Interior Region",7,0,820,1,839,0,26,0,8
"01/31/2022","Y","Y","Copper River Census Area",66,"Other Interior Region",7,4,824,7,846,0,26,0,8
"02/01/2022","Y","Y","Copper River Census Area",66,"Other Interior Region",7,17,841,4,850,0,26,0,8
"02/02/2022","Y","Y","Copper River Census Area",66,"Other Interior Region",7,7,848,2,852,0,26,0,8
"02/03/2022","Y","Y","Copper River Census Area",66,"Other Interior Region",7,0,848,3,855,0,26,0,8
"02/04/2022","Y","Y","Copper River Census Area",66,"Other Interior Region",7,1,849,4,859,0,26,0,8
"02/05/2022","Y","Y","Copper River Census Area",66,"Other Interior Region",7,4,853,0,859,0,26,0,8
"02/06/2022","Y","Y","Copper River Census Area",66,"Other Interior Region",7,7,860,1,860,0,26,0,8
"02/07/2022","Y","Y","Copper River Census Area",66,"Other Interior Region",7,0,860,9,869,0,26,0,8
"02/08/2022","Y","Y","Copper River Census Area",66,"Other Interior Region",7,3,863,12,881,0,26,0,8
"02/09/2022","Y","Y","Copper River Census Area",66,"Other Interior Region",7,10,873,1,882,0,26,0,8
"02/10/2022","Y","Y","Copper River Census Area",66,"Other Interior Region",7,9,882,3,885,0,26,0,8
"02/11/2022","Y","Y","Copper River Census Area",66,"Other Interior Region",7,1,883,4,889,0,26,0,8
"02/12/2022","Y","Y","Copper River Census Area",66,"Other Interior Region",7,3,886,0,889,0,26,0,8
"02/13/2022","Y","Y","Copper River Census Area",66,"Other Interior Region",7,3,889,0,889,0,26,0,8
"02/14/2022","Y","Y","Copper River Census Area",66,"Other Interior Region",7,0,889,4,893,0,26,0,8
"02/15/2022","Y","Y","Copper River Census Area",66,"Other Interior Region",7,0,889,1,894,1,27,0,8
"02/16/2022","Y","Y","Copper River Census Area",66,"Other Interior Region",7,3,892,5,899,0,27,0,8
"02/17/2022","Y","Y","Copper River Census Area",66,"Other Interior Region",7,2,894,6,905,0,27,0,8
"02/18/2022","Y","Y","Copper River Census Area",66,"Other Interior Region",7,1,895,1,906,0,27,0,8
"02/19/2022","Y","Y","Copper River Census Area",66,"Other Interior Region",7,12,907,2,908,0,27,0,8
"02/21/2022","Y","Y","Copper River Census Area",66,"Other Interior Region",7,1,908,1,909,1,28,0,8
"02/22/2022","Y","Y","Copper River Census Area",66,"Other Interior Region",7,1,909,9,918,0,28,0,8
"02/23/2022","Y","Y","Copper River Census Area",66,"Other Interior Region",7,9,918,2,920,0,28,0,8
"02/24/2022","Y","Y","Copper River Census Area",66,"Other Interior Region",7,1,919,1,921,1,29,0,8
"02/25/2022","Y","Y","Copper River Census Area",66,"Other Interior Region",7,1,920,2,923,0,29,0,8
"02/26/2022","Y","Y","Copper River Census Area",66,"Other Interior Region",7,1,921,0,923,0,29,0,8
"02/27/2022","Y","Y","Copper River Census Area",66,"Other Interior Region",7,2,923,0,923,0,29,1,9
"03/01/2022","Y","Y","Copper River Census Area",66,"Other Interior Region",7,0,923,1,924,0,29,0,9
"03/02/2022","Y","Y","Copper River Census Area",66,"Other Interior Region",7,1,924,1,925,0,29,0,9
"03/03/2022","Y","Y","Copper River Census Area",66,"Other Interior Region",7,0,924,1,926,0,29,0,9
"03/04/2022","Y","Y","Copper River Census Area",66,"Other Interior Region",7,1,925,0,926,0,29,0,9
"03/05/2022","Y","Y","Copper River Census Area",66,"Other Interior Region",7,1,926,0,926,0,29,0,9
"03/06/2022","Y","Y","Copper River Census Area",66,"Other Interior Region",7,1,927,1,927,0,29,0,9
"03/07/2022","Y","Y","Copper River Census Area",66,"Other Interior Region",7,0,927,1,928,0,29,0,9
"03/08/2022","Y","Y","Copper River Census Area",66,"Other Interior Region",7,2,929,2,930,0,29,0,9
"03/09/2022","Y","Y","Copper River Census Area",66,"Other Interior Region",7,1,930,1,931,0,29,0,9
"03/14/2022","Y","Y","Copper River Census Area",66,"Other Interior Region",7,1,931,1,932,0,29,0,9
"03/16/2022","Y","Y","Copper River Census Area",66,"Other Interior Region",7,1,932,0,932,0,29,0,9
"03/21/2022","Y","Y","Copper River Census Area",66,"Other Interior Region",7,1,933,1,933,0,29,0,9
"03/28/2022","Y","Y","Copper River Census Area",66,"Other Interior Region",7,0,933,1,934,0,29,0,9
"03/29/2022","Y","Y","Copper River Census Area",66,"Other Interior Region",7,1,934,0,934,0,29,0,9
"03/30/2022","Y","Y","Copper River Census Area",66,"Other Interior Region",7,1,935,1,935,0,29,0,9
"03/31/2022","Y","Y","Copper River Census Area",66,"Other Interior Region",7,0,935,2,937,0,29,0,9
"04/01/2022","Y","Y","Copper River Census Area",66,"Other Interior Region",7,0,935,2,939,0,29,0,9
"04/02/2022","Y","Y","Copper River Census Area",66,"Other Interior Region",7,3,938,0,939,0,29,0,9
"04/03/2022","Y","Y","Copper River Census Area",66,"Other Interior Region",7,1,939,1,940,0,29,0,9
"04/05/2022","Y","Y","Copper River Census Area",66,"Other Interior Region",7,1,940,0,940,0,29,0,9
"04/19/2022","Y","Y","Copper River Census Area",66,"Other Interior Region",7,1,941,1,941,0,29,0,9
"04/24/2022","Y","Y","Copper River Census Area",66,"Other Interior Region",7,1,942,1,942,0,29,0,9
"07/19/2020","Y","Y","Denali Borough",68,"Other Interior Region",7,1,1,1,1,0,0,0,0
"08/31/2020","Y","Y","Denali Borough",68,"Other Interior Region",7,1,2,0,1,0,0,0,0
"09/04/2020","Y","Y","Denali Borough",68,"Other Interior Region",7,0,2,1,2,0,0,0,0
"09/17/2020","Y","Y","Denali Borough",68,"Other Interior Region",7,0,2,1,3,0,0,0,0
"09/20/2020","Y","Y","Denali Borough",68,"Other Interior Region",7,0,2,1,4,0,0,0,0
"09/22/2020","Y","Y","Denali Borough",68,"Other Interior Region",7,0,2,2,6,0,0,0,0
"09/23/2020","Y","Y","Denali Borough",68,"Other Interior Region",7,1,3,1,7,0,0,0,0
"09/25/2020","Y","Y","Denali Borough",68,"Other Interior Region",7,3,6,1,8,0,0,0,0
"09/27/2020","Y","Y","Denali Borough",68,"Other Interior Region",7,1,7,2,10,0,0,0,0
"09/28/2020","Y","Y","Denali Borough",68,"Other Interior Region",7,0,7,1,11,0,0,0,0
"09/30/2020","Y","Y","Denali Borough",68,"Other Interior Region",7,2,9,0,11,0,0,0,0
"10/01/2020","Y","Y","Denali Borough",68,"Other Interior Region",7,1,10,0,11,0,0,0,0
"10/02/2020","Y","Y","Denali Borough",68,"Other Interior Region",7,0,10,1,12,0,0,0,0
"10/06/2020","Y","Y","Denali Borough",68,"Other Interior Region",7,1,11,1,13,0,0,0,0
"10/09/2020","Y","Y","Denali Borough",68,"Other Interior Region",7,2,13,0,13,0,0,0,0
"10/10/2020","Y","Y","Denali Borough",68,"Other Interior Region",7,0,13,1,14,0,0,0,0
"10/12/2020","Y","Y","Denali Borough",68,"Other Interior Region",7,0,13,1,15,0,0,0,0
"10/13/2020","Y","Y","Denali Borough",68,"Other Interior Region",7,0,13,2,17,0,0,0,0
"10/14/2020","Y","Y","Denali Borough",68,"Other Interior Region",7,0,13,1,18,0,0,0,0
"10/15/2020","Y","Y","Denali Borough",68,"Other Interior Region",7,2,15,0,18,0,0,0,0
"10/16/2020","Y","Y","Denali Borough",68,"Other Interior Region",7,2,17,2,20,0,0,0,0
"10/19/2020","Y","Y","Denali Borough",68,"Other Interior Region",7,2,19,0,20,0,0,0,0
"10/23/2020","Y","Y","Denali Borough",68,"Other Interior Region",7,1,20,6,26,0,0,0,0
"10/25/2020","Y","Y","Denali Borough",68,"Other Interior Region",7,0,20,1,27,0,0,0,0
"10/26/2020","Y","Y","Denali Borough",68,"Other Interior Region",7,7,27,1,28,0,0,0,0
"10/28/2020","Y","Y","Denali Borough",68,"Other Interior Region",7,0,27,1,29,0,0,0,0
"10/31/2020","Y","Y","Denali Borough",68,"Other Interior Region",7,0,27,4,33,0,0,0,0
"11/01/2020","Y","Y","Denali Borough",68,"Other Interior Region",7,0,27,1,34,0,0,0,0
"11/02/2020","Y","Y","Denali Borough",68,"Other Interior Region",7,1,28,0,34,0,0,0,0
"11/03/2020","Y","Y","Denali Borough",68,"Other Interior Region",7,1,29,0,34,0,0,0,0
"11/09/2020","Y","Y","Denali Borough",68,"Other Interior Region",7,3,32,1,35,0,0,0,0
"11/10/2020","Y","Y","Denali Borough",68,"Other Interior Region",7,1,33,0,35,0,0,0,0
"11/13/2020","Y","Y","Denali Borough",68,"Other Interior Region",7,1,34,0,35,0,0,0,0
"11/14/2020","Y","Y","Denali Borough",68,"Other Interior Region",7,0,34,2,37,0,0,0,0
"11/16/2020","Y","Y","Denali Borough",68,"Other Interior Region",7,1,35,0,37,0,0,0,0
"11/17/2020","Y","Y","Denali Borough",68,"Other Interior Region",7,0,35,1,38,0,0,0,0
"11/18/2020","Y","Y","Denali Borough",68,"Other Interior Region",7,1,36,2,40,0,0,0,0
"11/19/2020","Y","Y","Denali Borough",68,"Other Interior Region",7,0,36,1,41,0,0,0,0
"11/21/2020","Y","Y","Denali Borough",68,"Other Interior Region",7,1,37,0,41,0,0,0,0
"11/24/2020","Y","Y","Denali Borough",68,"Other Interior Region",7,1,38,0,41,0,0,0,0
"11/27/2020","Y","Y","Denali Borough",68,"Other Interior Region",7,1,39,0,41,0,0,0,0
"11/28/2020","Y","Y","Denali Borough",68,"Other Interior Region",7,1,40,2,43,0,0,0,0
"11/29/2020","Y","Y","Denali Borough",68,"Other Interior Region",7,0,40,1,44,0,0,0,0
"11/30/2020","Y","Y","Denali Borough",68,"Other Interior Region",7,0,40,3,47,0,0,0,0
"12/01/2020","Y","Y","Denali Borough",68,"Other Interior Region",7,1,41,1,48,0,0,0,0
"12/02/2020","Y","Y","Denali Borough",68,"Other Interior Region",7,2,43,2,50,0,0,0,0
"12/03/2020","Y","Y","Denali Borough",68,"Other Interior Region",7,0,43,1,51,0,0,0,0
"12/04/2020","Y","Y","Denali Borough",68,"Other Interior Region",7,1,44,0,51,0,0,0,0
"12/05/2020","Y","Y","Denali Borough",68,"Other Interior Region",7,1,45,1,52,0,0,0,0
"12/07/2020","Y","Y","Denali Borough",68,"Other Interior Region",7,1,46,0,52,0,0,0,0
"12/08/2020","Y","Y","Denali Borough",68,"Other Interior Region",7,4,50,0,52,0,0,0,0
"12/10/2020","Y","Y","Denali Borough",68,"Other Interior Region",7,0,50,1,53,0,0,0,0
"12/11/2020","Y","Y","Denali Borough",68,"Other Interior Region",7,0,50,1,54,0,0,0,0
"12/12/2020","Y","Y","Denali Borough",68,"Other Interior Region",7,2,52,0,54,0,0,0,0
"12/13/2020","Y","Y","Denali Borough",68,"Other Interior Region",7,1,53,0,54,0,0,0,0
"12/15/2020","Y","Y","Denali Borough",68,"Other Interior Region",7,1,54,2,56,0,0,0,0
"12/17/2020","Y","Y","Denali Borough",68,"Other Interior Region",7,2,56,0,56,0,0,0,0
"01/03/2021","Y","Y","Denali Borough",68,"Other Interior Region",7,0,56,1,57,0,0,0,0
"01/05/2021","Y","Y","Denali Borough",68,"Other Interior Region",7,0,56,1,58,0,0,0,0
"01/10/2021","Y","Y","Denali Borough",68,"Other Interior Region",7,1,57,0,58,0,0,0,0
"01/12/2021","Y","Y","Denali Borough",68,"Other Interior Region",7,1,58,0,58,0,0,0,0
"01/17/2021","Y","Y","Denali Borough",68,"Other Interior Region",7,0,58,1,59,0,0,0,0
"01/19/2021","Y","Y","Denali Borough",68,"Other Interior Region",7,0,58,1,60,0,0,0,0
"01/21/2021","Y","Y","Denali Borough",68,"Other Interior Region",7,1,59,2,62,0,0,0,0
"01/22/2021","Y","Y","Denali Borough",68,"Other Interior Region",7,0,59,1,63,0,0,0,0
"01/23/2021","Y","Y","Denali Borough",68,"Other Interior Region",7,3,62,0,63,0,0,0,0
"01/28/2021","Y","Y","Denali Borough",68,"Other Interior Region",7,1,63,0,63,0,0,0,0
"02/12/2021","Y","Y","Denali Borough",68,"Other Interior Region",7,0,63,1,64,0,0,0,0
"02/15/2021","Y","Y","Denali Borough",68,"Other Interior Region",7,0,63,1,65,0,0,0,0
"02/17/2021","Y","Y","Denali Borough",68,"Other Interior Region",7,1,64,2,67,0,0,0,0
"02/19/2021","Y","Y","Denali Borough",68,"Other Interior Region",7,3,67,0,67,0,0,0,0
"02/25/2021","Y","Y","Denali Borough",68,"Other Interior Region",7,1,68,1,68,0,0,0,0
"02/26/2021","Y","Y","Denali Borough",68,"Other Interior Region",7,1,69,1,69,0,0,0,0
"03/01/2021","Y","Y","Denali Borough",68,"Other Interior Region",7,0,69,1,70,0,0,0,0
"03/06/2021","Y","Y","Denali Borough",68,"Other Interior Region",7,0,69,1,71,0,0,0,0
"03/09/2021","Y","Y","Denali Borough",68,"Other Interior Region",7,1,70,0,71,0,0,0,0
"03/13/2021","Y","Y","Denali Borough",68,"Other Interior Region",7,0,70,0,71,1,1,0,0
"03/14/2021","Y","Y","Denali Borough",68,"Other Interior Region",7,1,71,0,71,0,1,0,0
"03/16/2021","Y","Y","Denali Borough",68,"Other Interior Region",7,0,71,2,73,0,1,0,0
"03/17/2021","Y","Y","Denali Borough",68,"Other Interior Region",7,1,72,1,74,0,1,0,0
"03/22/2021","Y","Y","Denali Borough",68,"Other Interior Region",7,1,73,6,80,0,1,0,0
"03/23/2021","Y","Y","Denali Borough",68,"Other Interior Region",7,1,74,0,80,0,1,0,0
"03/24/2021","Y","Y","Denali Borough",68,"Other Interior Region",7,1,75,1,81,0,1,0,0
"03/25/2021","Y","Y","Denali Borough",68,"Other Interior Region",7,4,79,1,82,0,1,0,0
"03/28/2021","Y","Y","Denali Borough",68,"Other Interior Region",7,1,80,1,83,0,1,0,0
"03/29/2021","Y","Y","Denali Borough",68,"Other Interior Region",7,1,81,1,84,0,1,0,0
"03/31/2021","Y","Y","Denali Borough",68,"Other Interior Region",7,1,82,0,84,0,1,0,0
"04/01/2021","Y","Y","Denali Borough",68,"Other Interior Region",7,2,84,0,84,0,1,0,0
"04/05/2021","Y","Y","Denali Borough",68,"Other Interior Region",7,0,84,1,85,0,1,0,0
"04/06/2021","Y","Y","Denali Borough",68,"Other Interior Region",7,1,85,1,86,0,1,0,0
"04/10/2021","Y","Y","Denali Borough",68,"Other Interior Region",7,0,85,1,87,0,1,0,0
"04/12/2021","Y","Y","Denali Borough",68,"Other Interior Region",7,1,86,2,89,0,1,0,0
"04/13/2021","Y","Y","Denali Borough",68,"Other Interior Region",7,1,87,0,89,0,1,0,0
"04/16/2021","Y","Y","Denali Borough",68,"Other Interior Region",7,2,89,0,89,0,1,0,0
"04/18/2021","Y","Y","Denali Borough",68,"Other Interior Region",7,0,89,1,90,0,1,0,0
"04/20/2021","Y","Y","Denali Borough",68,"Other Interior Region",7,1,90,1,91,0,1,0,0
"04/21/2021","Y","Y","Denali Borough",68,"Other Interior Region",7,0,90,1,92,0,1,0,0
"04/22/2021","Y","Y","Denali Borough",68,"Other Interior Region",7,1,91,0,92,0,1,0,0
"04/23/2021","Y","Y","Denali Borough",68,"Other Interior Region",7,1,92,1,93,0,1,0,0
"04/26/2021","Y","Y","Denali Borough",68,"Other Interior Region",7,0,92,1,94,0,1,0,0
"04/27/2021","Y","Y","Denali Borough",68,"Other Interior Region",7,1,93,0,94,0,1,0,0
"04/29/2021","Y","Y","Denali Borough",68,"Other Interior Region",7,1,94,0,94,0,1,0,0
"05/04/2021","Y","Y","Denali Borough",68,"Other Interior Region",7,0,94,1,95,0,1,0,0
"05/09/2021","Y","Y","Denali Borough",68,"Other Interior Region",7,1,95,0,95,0,1,0,0
"05/10/2021","Y","Y","Denali Borough",68,"Other Interior Region",7,0,95,2,97,0,1,0,0
"05/12/2021","Y","Y","Denali Borough",68,"Other Interior Region",7,3,98,2,99,0,1,0,0
"05/14/2021","Y","Y","Denali Borough",68,"Other Interior Region",7,0,98,1,100,0,1,0,0
"05/15/2021","Y","Y","Denali Borough",68,"Other Interior Region",7,0,98,1,101,0,1,0,0
"05/17/2021","Y","Y","Denali Borough",68,"Other Interior Region",7,0,98,1,102,0,1,0,0
"05/19/2021","Y","Y","Denali Borough",68,"Other Interior Region",7,2,100,0,102,0,1,0,0
"05/20/2021","Y","Y","Denali Borough",68,"Other Interior Region",7,1,101,0,102,0,1,0,0
"05/22/2021","Y","Y","Denali Borough",68,"Other Interior Region",7,1,102,0,102,0,1,0,0
"05/27/2021","Y","Y","Denali Borough",68,"Other Interior Region",7,0,102,1,103,0,1,0,0
"05/28/2021","Y","Y","Denali Borough",68,"Other Interior Region",7,1,103,0,103,0,1,0,0
"05/29/2021","Y","Y","Denali Borough",68,"Other Interior Region",7,0,103,1,104,0,1,0,0
"06/04/2021","Y","Y","Denali Borough",68,"Other Interior Region",7,1,104,0,104,0,1,0,0
"06/10/2021","Y","Y","Denali Borough",68,"Other Interior Region",7,1,105,1,105,0,1,0,0
"07/13/2021","Y","Y","Denali Borough",68,"Other Interior Region",7,0,105,1,106,0,1,0,0
"07/14/2021","Y","Y","Denali Borough",68,"Other Interior Region",7,1,106,0,106,0,1,0,0
"07/19/2021","Y","Y","Denali Borough",68,"Other Interior Region",7,0,106,1,107,0,1,0,0
"07/22/2021","Y","Y","Denali Borough",68,"Other Interior Region",7,1,107,0,107,0,1,0,0
"07/26/2021","Y","Y","Denali Borough",68,"Other Interior Region",7,0,107,1,108,0,1,0,0
"07/27/2021","Y","Y","Denali Borough",68,"Other Interior Region",7,1,108,0,108,0,1,0,0
"08/02/2021","Y","Y","Denali Borough",68,"Other Interior Region",7,0,108,3,111,0,1,0,0
"08/03/2021","Y","Y","Denali Borough",68,"Other Interior Region",7,1,109,2,113,0,1,0,0
"08/04/2021","Y","Y","Denali Borough",68,"Other Interior Region",7,2,111,0,113,0,1,0,0
"08/05/2021","Y","Y","Denali Borough",68,"Other Interior Region",7,0,111,2,115,0,1,0,0
"08/06/2021","Y","Y","Denali Borough",68,"Other Interior Region",7,4,115,0,115,1,2,0,0
"08/08/2021","Y","Y","Denali Borough",68,"Other Interior Region",7,0,115,2,117,0,2,0,0
"08/11/2021","Y","Y","Denali Borough",68,"Other Interior Region",7,1,116,1,118,0,2,0,0
"08/12/2021","Y","Y","Denali Borough",68,"Other Interior Region",7,1,117,1,119,0,2,0,0
"08/13/2021","Y","Y","Denali Borough",68,"Other Interior Region",7,0,117,3,122,0,2,0,0
"08/14/2021","Y","Y","Denali Borough",68,"Other Interior Region",7,1,118,0,122,0,2,0,0
"08/16/2021","Y","Y","Denali Borough",68,"Other Interior Region",7,0,118,1,123,0,2,0,0
"08/17/2021","Y","Y","Denali Borough",68,"Other Interior Region",7,2,120,1,124,0,2,0,0
"08/19/2021","Y","Y","Denali Borough",68,"Other Interior Region",7,1,121,1,125,1,3,0,0
"08/20/2021","Y","Y","Denali Borough",68,"Other Interior Region",7,1,122,1,126,0,3,0,0
"08/21/2021","Y","Y","Denali Borough",68,"Other Interior Region",7,1,123,2,128,0,3,0,0
"08/22/2021","Y","Y","Denali Borough",68,"Other Interior Region",7,0,123,1,129,0,3,0,0
"08/23/2021","Y","Y","Denali Borough",68,"Other Interior Region",7,2,125,1,130,0,3,0,0
"08/25/2021","Y","Y","Denali Borough",68,"Other Interior Region",7,4,129,0,130,0,3,0,0
"08/26/2021","Y","Y","Denali Borough",68,"Other Interior Region",7,0,129,3,133,0,3,0,0
"08/27/2021","Y","Y","Denali Borough",68,"Other Interior Region",7,0,129,1,134,0,3,0,0
"08/28/2021","Y","Y","Denali Borough",68,"Other Interior Region",7,0,129,1,135,0,3,0,0
"08/29/2021","Y","Y","Denali Borough",68,"Other Interior Region",7,0,129,1,136,0,3,0,0
"08/30/2021","Y","Y","Denali Borough",68,"Other Interior Region",7,0,129,3,139,0,3,0,0
"08/31/2021","Y","Y","Denali Borough",68,"Other Interior Region",7,4,133,1,140,0,3,0,0
"09/01/2021","Y","Y","Denali Borough",68,"Other Interior Region",7,1,134,0,140,0,3,0,0
"09/02/2021","Y","Y","Denali Borough",68,"Other Interior Region",7,2,136,3,143,0,3,0,0
"09/03/2021","Y","Y","Denali Borough",68,"Other Interior Region",7,1,137,1,144,0,3,0,0
"09/04/2021","Y","Y","Denali Borough",68,"Other Interior Region",7,1,138,0,144,0,3,0,0
"09/05/2021","Y","Y","Denali Borough",68,"Other Interior Region",7,0,138,1,145,0,3,0,0
"09/07/2021","Y","Y","Denali Borough",68,"Other Interior Region",7,1,139,1,146,0,3,0,0
"09/08/2021","Y","Y","Denali Borough",68,"Other Interior Region",7,0,139,2,148,0,3,0,0
"09/09/2021","Y","Y","Denali Borough",68,"Other Interior Region",7,0,139,2,150,0,3,0,0
"09/10/2021","Y","Y","Denali Borough",68,"Other Interior Region",7,2,141,6,156,0,3,0,0
"09/11/2021","Y","Y","Denali Borough",68,"Other Interior Region",7,2,143,0,156,0,3,0,0
"09/12/2021","Y","Y","Denali Borough",68,"Other Interior Region",7,0,143,1,157,0,3,0,0
"09/13/2021","Y","Y","Denali Borough",68,"Other Interior Region",7,2,145,1,158,0,3,0,0
"09/14/2021","Y","Y","Denali Borough",68,"Other Interior Region",7,3,148,3,161,0,3,0,0
"09/15/2021","Y","Y","Denali Borough",68,"Other Interior Region",7,1,149,3,164,0,3,0,0
"09/17/2021","Y","Y","Denali Borough",68,"Other Interior Region",7,2,151,2,166,0,3,0,0
"09/19/2021","Y","Y","Denali Borough",68,"Other Interior Region",7,1,152,0,166,0,3,0,0
"09/20/2021","Y","Y","Denali Borough",68,"Other Interior Region",7,2,154,0,166,0,3,0,0
"09/21/2021","Y","Y","Denali Borough",68,"Other Interior Region",7,2,156,1,167,0,3,0,0
"09/22/2021","Y","Y","Denali Borough",68,"Other Interior Region",7,4,160,4,171,0,3,0,0
"09/23/2021","Y","Y","Denali Borough",68,"Other Interior Region",7,2,162,0,171,0,3,0,0
"09/24/2021","Y","Y","Denali Borough",68,"Other Interior Region",7,1,163,1,172,0,3,0,0
"09/25/2021","Y","Y","Denali Borough",68,"Other Interior Region",7,2,165,0,172,0,3,0,0
"09/26/2021","Y","Y","Denali Borough",68,"Other Interior Region",7,3,168,1,173,0,3,0,0
"09/27/2021","Y","Y","Denali Borough",68,"Other Interior Region",7,3,171,0,173,0,3,0,0
"09/28/2021","Y","Y","Denali Borough",68,"Other Interior Region",7,0,171,1,174,0,3,0,0
"09/29/2021","Y","Y","Denali Borough",68,"Other Interior Region",7,1,172,2,176,0,3,0,0
"09/30/2021","Y","Y","Denali Borough",68,"Other Interior Region",7,3,175,0,176,0,3,0,0
"10/01/2021","Y","Y","Denali Borough",68,"Other Interior Region",7,0,175,1,177,0,3,0,0
"10/03/2021","Y","Y","Denali Borough",68,"Other Interior Region",7,1,176,1,178,0,3,0,0
"10/04/2021","Y","Y","Denali Borough",68,"Other Interior Region",7,1,177,11,189,0,3,0,0
"10/05/2021","Y","Y","Denali Borough",68,"Other Interior Region",7,7,184,2,191,0,3,0,0
"10/06/2021","Y","Y","Denali Borough",68,"Other Interior Region",7,4,188,2,193,0,3,0,0
"10/07/2021","Y","Y","Denali Borough",68,"Other Interior Region",7,1,189,0,193,0,3,0,0
"10/08/2021","Y","Y","Denali Borough",68,"Other Interior Region",7,3,192,0,193,0,3,0,0
"10/09/2021","Y","Y","Denali Borough",68,"Other Interior Region",7,1,193,1,194,0,3,0,0
"10/11/2021","Y","Y","Denali Borough",68,"Other Interior Region",7,0,193,2,196,0,3,0,0
"10/12/2021","Y","Y","Denali Borough",68,"Other Interior Region",7,2,195,1,197,0,3,0,0
"10/13/2021","Y","Y","Denali Borough",68,"Other Interior Region",7,0,195,1,198,0,3,0,0
"10/14/2021","Y","Y","Denali Borough",68,"Other Interior Region",7,1,196,2,200,0,3,0,0
"10/15/2021","Y","Y","Denali Borough",68,"Other Interior Region",7,2,198,1,201,0,3,0,0
"10/16/2021","Y","Y","Denali Borough",68,"Other Interior Region",7,2,200,0,201,0,3,0,0
"10/17/2021","Y","Y","Denali Borough",68,"Other Interior Region",7,0,200,1,202,0,3,0,0
"10/18/2021","Y","Y","Denali Borough",68,"Other Interior Region",7,1,201,1,203,0,3,0,0
"10/19/2021","Y","Y","Denali Borough",68,"Other Interior Region",7,0,201,3,206,0,3,0,0
"10/20/2021","Y","Y","Denali Borough",68,"Other Interior Region",7,2,203,0,206,0,3,0,0
"10/21/2021","Y","Y","Denali Borough",68,"Other Interior Region",7,2,205,1,207,0,3,0,0
"10/22/2021","Y","Y","Denali Borough",68,"Other Interior Region",7,1,206,1,208,0,3,0,0
"10/25/2021","Y","Y","Denali Borough",68,"Other Interior Region",7,1,207,0,208,0,3,0,0
"10/27/2021","Y","Y","Denali Borough",68,"Other Interior Region",7,2,209,1,209,0,3,0,0
"10/29/2021","Y","Y","Denali Borough",68,"Other Interior Region",7,0,209,1,210,0,3,0,0
"10/31/2021","Y","Y","Denali Borough",68,"Other Interior Region",7,1,210,1,211,0,3,0,0
"11/01/2021","Y","Y","Denali Borough",68,"Other Interior Region",7,0,210,3,214,0,3,0,0
"11/02/2021","Y","Y","Denali Borough",68,"Other Interior Region",7,2,212,2,216,0,3,0,0
"11/03/2021","Y","Y","Denali Borough",68,"Other Interior Region",7,2,214,1,217,0,3,0,0
"11/04/2021","Y","Y","Denali Borough",68,"Other Interior Region",7,4,218,2,219,0,3,0,0
"11/05/2021","Y","Y","Denali Borough",68,"Other Interior Region",7,0,218,3,222,0,3,0,0
"11/06/2021","Y","Y","Denali Borough",68,"Other Interior Region",7,3,221,0,222,0,3,0,0
"11/08/2021","Y","Y","Denali Borough",68,"Other Interior Region",7,1,222,2,224,0,3,0,0
"11/09/2021","Y","Y","Denali Borough",68,"Other Interior Region",7,3,225,1,225,0,3,0,0
"11/10/2021","Y","Y","Denali Borough",68,"Other Interior Region",7,0,225,1,226,0,3,0,0
"11/15/2021","Y","Y","Denali Borough",68,"Other Interior Region",7,0,225,1,227,0,3,0,0
"11/16/2021","Y","Y","Denali Borough",68,"Other Interior Region",7,2,227,2,229,0,3,0,0
"11/17/2021","Y","Y","Denali Borough",68,"Other Interior Region",7,0,227,1,230,0,3,0,0
"11/18/2021","Y","Y","Denali Borough",68,"Other Interior Region",7,4,231,1,231,0,3,0,0
"11/19/2021","Y","Y","Denali Borough",68,"Other Interior Region",7,0,231,1,232,0,3,0,0
"11/21/2021","Y","Y","Denali Borough",68,"Other Interior Region",7,1,232,0,232,0,3,0,0
"11/30/2021","Y","Y","Denali Borough",68,"Other Interior Region",7,0,232,1,233,0,3,0,0
"12/02/2021","Y","Y","Denali Borough",68,"Other Interior Region",7,1,233,0,233,0,3,0,0
"12/03/2021","Y","Y","Denali Borough",68,"Other Interior Region",7,1,234,1,234,0,3,0,0
"12/22/2021","Y","Y","Denali Borough",68,"Other Interior Region",7,0,234,1,235,0,3,0,0
"12/23/2021","Y","Y","Denali Borough",68,"Other Interior Region",7,1,235,0,235,0,3,0,0
"12/26/2021","Y","Y","Denali Borough",68,"Other Interior Region",7,0,235,2,237,0,3,0,0
"12/28/2021","Y","Y","Denali Borough",68,"Other Interior Region",7,1,236,0,237,0,3,0,0
"12/29/2021","Y","Y","Denali Borough",68,"Other Interior Region",7,1,237,1,238,0,3,0,0
"12/30/2021","Y","Y","Denali Borough",68,"Other Interior Region",7,1,238,0,238,0,3,0,0
"01/05/2022","Y","Y","Denali Borough",68,"Other Interior Region",7,0,238,1,239,0,3,0,0
"01/07/2022","Y","Y","Denali Borough",68,"Other Interior Region",7,1,239,2,241,0,3,0,0
"01/09/2022","Y","Y","Denali Borough",68,"Other Interior Region",7,0,239,1,242,0,3,0,0
"01/10/2022","Y","Y","Denali Borough",68,"Other Interior Region",7,3,242,6,248,0,3,0,0
"01/11/2022","Y","Y","Denali Borough",68,"Other Interior Region",7,1,243,2,250,0,3,0,0
"01/12/2022","Y","Y","Denali Borough",68,"Other Interior Region",7,0,243,2,252,0,3,0,0
"01/13/2022","Y","Y","Denali Borough",68,"Other Interior Region",7,4,247,6,258,0,3,0,0
"01/14/2022","Y","Y","Denali Borough",68,"Other Interior Region",7,2,249,1,259,0,3,0,0
"01/15/2022","Y","Y","Denali Borough",68,"Other Interior Region",7,1,250,0,259,0,3,0,0
"01/16/2022","Y","Y","Denali Borough",68,"Other Interior Region",7,1,251,0,259,0,3,0,0
"01/17/2022","Y","Y","Denali Borough",68,"Other Interior Region",7,0,251,1,260,0,3,0,0
"01/18/2022","Y","Y","Denali Borough",68,"Other Interior Region",7,4,255,6,266,0,3,0,0
"01/19/2022","Y","Y","Denali Borough",68,"Other Interior Region",7,4,259,9,275,0,3,0,0
"01/20/2022","Y","Y","Denali Borough",68,"Other Interior Region",7,3,262,5,280,0,3,0,0
"01/21/2022","Y","Y","Denali Borough",68,"Other Interior Region",7,8,270,3,283,0,3,0,0
"01/22/2022","Y","Y","Denali Borough",68,"Other Interior Region",7,3,273,1,284,0,3,0,0
"01/23/2022","Y","Y","Denali Borough",68,"Other Interior Region",7,2,275,0,284,0,3,0,0
"01/24/2022","Y","Y","Denali Borough",68,"Other Interior Region",7,2,277,5,289,0,3,0,0
"01/25/2022","Y","Y","Denali Borough",68,"Other Interior Region",7,3,280,4,293,0,3,0,0
"01/26/2022","Y","Y","Denali Borough",68,"Other Interior Region",7,4,284,2,295,0,3,0,0
"01/27/2022","Y","Y","Denali Borough",68,"Other Interior Region",7,1,285,1,296,0,3,0,0
"01/28/2022","Y","Y","Denali Borough",68,"Other Interior Region",7,0,285,1,297,0,3,0,0
"01/30/2022","Y","Y","Denali Borough",68,"Other Interior Region",7,2,287,1,298,0,3,0,0
"01/31/2022","Y","Y","Denali Borough",68,"Other Interior Region",7,6,293,3,301,0,3,0,0
"02/01/2022","Y","Y","Denali Borough",68,"Other Interior Region",7,1,294,0,301,0,3,0,0
"02/02/2022","Y","Y","Denali Borough",68,"Other Interior Region",7,2,296,2,303,0,3,0,0
"02/03/2022","Y","Y","Denali Borough",68,"Other Interior Region",7,2,298,1,304,0,3,0,0
"02/04/2022","Y","Y","Denali Borough",68,"Other Interior Region",7,5,303,0,304,0,3,0,0
"02/07/2022","Y","Y","Denali Borough",68,"Other Interior Region",7,1,304,3,307,0,3,0,0
"02/08/2022","Y","Y","Denali Borough",68,"Other Interior Region",7,1,305,1,308,0,3,0,0
"02/09/2022","Y","Y","Denali Borough",68,"Other Interior Region",7,3,308,4,312,0,3,0,0
"02/10/2022","Y","Y","Denali Borough",68,"Other Interior Region",7,1,309,0,312,0,3,0,0
"02/12/2022","Y","Y","Denali Borough",68,"Other Interior Region",7,3,312,0,312,0,3,0,0
"02/14/2022","Y","Y","Denali Borough",68,"Other Interior Region",7,0,312,1,313,0,3,0,0
"02/15/2022","Y","Y","Denali Borough",68,"Other Interior Region",7,1,313,0,313,0,3,0,0
"02/22/2022","Y","Y","Denali Borough",68,"Other Interior Region",7,0,313,1,314,0,3,0,0
"02/23/2022","Y","Y","Denali Borough",68,"Other Interior Region",7,1,314,0,314,0,3,0,0
"02/25/2022","Y","Y","Denali Borough",68,"Other Interior Region",7,1,315,1,315,0,3,0,0
"02/28/2022","Y","Y","Denali Borough",68,"Other Interior Region",7,0,315,1,316,0,3,0,0
"03/01/2022","Y","Y","Denali Borough",68,"Other Interior Region",7,1,316,1,317,0,3,0,0
"03/02/2022","Y","Y","Denali Borough",68,"Other Interior Region",7,1,317,0,317,0,3,0,0
"03/03/2022","Y","Y","Denali Borough",68,"Other Interior Region",7,0,317,1,318,0,3,0,0
"03/04/2022","Y","Y","Denali Borough",68,"Other Interior Region",7,1,318,1,319,0,3,0,0
"03/05/2022","Y","Y","Denali Borough",68,"Other Interior Region",7,0,318,1,320,0,3,0,0
"03/07/2022","Y","Y","Denali Borough",68,"Other Interior Region",7,1,319,3,323,0,3,0,0
"03/08/2022","Y","Y","Denali Borough",68,"Other Interior Region",7,3,322,1,324,1,4,0,0
"03/09/2022","Y","Y","Denali Borough",68,"Other Interior Region",7,1,323,0,324,0,4,0,0
"03/10/2022","Y","Y","Denali Borough",68,"Other Interior Region",7,2,325,2,326,0,4,0,0
"03/11/2022","Y","Y","Denali Borough",68,"Other Interior Region",7,0,325,1,327,0,4,0,0
"03/14/2022","Y","Y","Denali Borough",68,"Other Interior Region",7,3,328,1,328,0,4,0,0
"03/15/2022","Y","Y","Denali Borough",68,"Other Interior Region",7,2,330,3,331,0,4,0,0
"03/16/2022","Y","Y","Denali Borough",68,"Other Interior Region",7,1,331,1,332,0,4,0,0
"03/17/2022","Y","Y","Denali Borough",68,"Other Interior Region",7,1,332,0,332,0,4,0,0
"03/22/2022","Y","Y","Denali Borough",68,"Other Interior Region",7,0,332,1,333,0,4,0,0
"03/23/2022","Y","Y","Denali Borough",68,"Other Interior Region",7,1,333,0,333,0,4,0,0
"03/25/2022","Y","Y","Denali Borough",68,"Other Interior Region",7,1,334,1,334,0,4,0,0
"03/29/2022","Y","Y","Denali Borough",68,"Other Interior Region",7,1,335,1,335,0,4,0,0
"04/02/2022","Y","Y","Denali Borough",68,"Other Interior Region",7,1,336,1,336,0,4,0,0
"04/16/2022","Y","Y","Denali Borough",68,"Other Interior Region",7,0,336,1,337,0,4,0,0
"04/18/2022","Y","Y","Denali Borough",68,"Other Interior Region",7,1,337,1,338,0,4,0,0
"04/19/2022","Y","Y","Denali Borough",68,"Other Interior Region",7,2,339,1,339,0,4,0,0
"04/21/2022","Y","Y","Denali Borough",68,"Other Interior Region",7,2,341,2,341,0,4,0,0
"08/06/2020","Y","Y","Dillingham Census Area",70,"Southwest Region",11,0,0,1,1,0,0,0,0
"08/10/2020","Y","Y","Dillingham Census Area",70,"Southwest Region",11,1,1,1,2,0,0,0,0
"08/15/2020","Y","Y","Dillingham Census Area",70,"Southwest Region",11,2,3,1,3,0,0,0,0
"08/17/2020","Y","Y","Dillingham Census Area",70,"Southwest Region",11,0,3,1,4,0,0,0,0
"08/18/2020","Y","Y","Dillingham Census Area",70,"Southwest Region",11,1,4,0,4,0,0,0,0
"09/11/2020","Y","Y","Dillingham Census Area",70,"Southwest Region",11,1,5,1,5,0,0,0,0
"09/14/2020","Y","Y","Dillingham Census Area",70,"Southwest Region",11,0,5,1,6,0,0,0,0
"09/16/2020","Y","Y","Dillingham Census Area",70,"Southwest Region",11,1,6,0,6,0,0,0,0
"09/19/2020","Y","Y","Dillingham Census Area",70,"Southwest Region",11,0,6,1,7,0,0,0,0
"09/20/2020","Y","Y","Dillingham Census Area",70,"Southwest Region",11,1,7,1,8,0,0,0,0
"09/26/2020","Y","Y","Dillingham Census Area",70,"Southwest Region",11,1,8,1,9,0,0,0,0
"10/01/2020","Y","Y","Dillingham Census Area",70,"Southwest Region",11,0,8,1,10,0,0,0,0
"10/03/2020","Y","Y","Dillingham Census Area",70,"Southwest Region",11,0,8,1,11,0,0,0,0
"10/05/2020","Y","Y","Dillingham Census Area",70,"Southwest Region",11,1,9,0,11,0,0,0,0
"10/07/2020","Y","Y","Dillingham Census Area",70,"Southwest Region",11,0,9,1,12,0,0,0,0
"10/09/2020","Y","Y","Dillingham Census Area",70,"Southwest Region",11,2,11,0,12,0,0,0,0
"10/10/2020","Y","Y","Dillingham Census Area",70,"Southwest Region",11,0,11,1,13,0,0,0,0
"10/11/2020","Y","Y","Dillingham Census Area",70,"Southwest Region",11,0,11,1,14,0,0,0,0
"10/14/2020","Y","Y","Dillingham Census Area",70,"Southwest Region",11,0,11,2,16,0,0,0,0
"10/15/2020","Y","Y","Dillingham Census Area",70,"Southwest Region",11,3,14,1,17,0,0,0,0
"10/16/2020","Y","Y","Dillingham Census Area",70,"Southwest Region",11,0,14,6,23,0,0,0,0
"10/17/2020","Y","Y","Dillingham Census Area",70,"Southwest Region",11,0,14,2,25,0,0,0,0
"10/18/2020","Y","Y","Dillingham Census Area",70,"Southwest Region",11,8,22,0,25,0,0,0,0
"10/20/2020","Y","Y","Dillingham Census Area",70,"Southwest Region",11,0,22,1,26,0,0,0,0
"10/21/2020","Y","Y","Dillingham Census Area",70,"Southwest Region",11,0,22,3,29,0,0,0,0
"10/22/2020","Y","Y","Dillingham Census Area",70,"Southwest Region",11,0,22,2,31,0,0,0,0
"10/23/2020","Y","Y","Dillingham Census Area",70,"Southwest Region",11,0,22,2,33,0,0,0,0
"10/24/2020","Y","Y","Dillingham Census Area",70,"Southwest Region",11,3,25,0,33,0,0,0,0
"10/25/2020","Y","Y","Dillingham Census Area",70,"Southwest Region",11,2,27,0,33,0,0,0,0
"10/26/2020","Y","Y","Dillingham Census Area",70,"Southwest Region",11,3,30,4,37,0,0,0,0
"10/27/2020","Y","Y","Dillingham Census Area",70,"Southwest Region",11,5,35,0,37,0,0,0,0
"10/28/2020","Y","Y","Dillingham Census Area",70,"Southwest Region",11,0,35,1,38,1,1,0,0
"10/29/2020","Y","Y","Dillingham Census Area",70,"Southwest Region",11,1,36,0,38,0,1,0,0
"10/30/2020","Y","Y","Dillingham Census Area",70,"Southwest Region",11,0,36,2,40,0,1,0,0
"10/31/2020","Y","Y","Dillingham Census Area",70,"Southwest Region",11,0,36,1,41,0,1,0,0
"11/01/2020","Y","Y","Dillingham Census Area",70,"Southwest Region",11,1,37,0,41,0,1,0,0
"11/02/2020","Y","Y","Dillingham Census Area",70,"Southwest Region",11,1,38,0,41,0,1,0,0
"11/03/2020","Y","Y","Dillingham Census Area",70,"Southwest Region",11,0,38,3,44,1,2,0,0
"11/04/2020","Y","Y","Dillingham Census Area",70,"Southwest Region",11,0,38,2,46,0,2,0,0
"11/05/2020","Y","Y","Dillingham Census Area",70,"Southwest Region",11,0,38,2,48,0,2,0,0
"11/06/2020","Y","Y","Dillingham Census Area",70,"Southwest Region",11,4,42,2,50,0,2,0,0
"11/07/2020","Y","Y","Dillingham Census Area",70,"Southwest Region",11,3,45,3,53,0,2,0,0
"11/08/2020","Y","Y","Dillingham Census Area",70,"Southwest Region",11,0,45,2,55,0,2,0,0
"11/09/2020","Y","Y","Dillingham Census Area",70,"Southwest Region",11,1,46,3,58,0,2,0,0
"11/10/2020","Y","Y","Dillingham Census Area",70,"Southwest Region",11,5,51,1,59,0,2,0,0
"11/11/2020","Y","Y","Dillingham Census Area",70,"Southwest Region",11,1,52,1,60,0,2,0,0
"11/12/2020","Y","Y","Dillingham Census Area",70,"Southwest Region",11,1,53,1,61,0,2,0,0
"11/13/2020","Y","Y","Dillingham Census Area",70,"Southwest Region",11,0,53,1,62,0,2,0,0
"11/14/2020","Y","Y","Dillingham Census Area",70,"Southwest Region",11,1,54,0,62,0,2,0,0
"11/15/2020","Y","Y","Dillingham Census Area",70,"Southwest Region",11,0,54,1,63,0,2,0,0
"11/16/2020","Y","Y","Dillingham Census Area",70,"Southwest Region",11,4,58,4,67,0,2,0,0
"11/17/2020","Y","Y","Dillingham Census Area",70,"Southwest Region",11,0,58,1,68,0,2,0,0
"11/19/2020","Y","Y","Dillingham Census Area",70,"Southwest Region",11,5,63,2,70,0,2,0,0
"11/20/2020","Y","Y","Dillingham Census Area",70,"Southwest Region",11,4,67,1,71,0,2,0,0
"11/21/2020","Y","Y","Dillingham Census Area",70,"Southwest Region",11,1,68,1,72,1,3,1,1
"11/22/2020","Y","Y","Dillingham Census Area",70,"Southwest Region",11,0,68,2,74,0,3,0,1
"11/24/2020","Y","Y","Dillingham Census Area",70,"Southwest Region",11,2,70,0,74,0,3,0,1
"11/26/2020","Y","Y","Dillingham Census Area",70,"Southwest Region",11,1,71,2,76,0,3,0,1
"11/27/2020","Y","Y","Dillingham Census Area",70,"Southwest Region",11,2,73,1,77,0,3,0,1
"11/28/2020","Y","Y","Dillingham Census Area",70,"Southwest Region",11,1,74,0,77,0,3,0,1
"11/29/2020","Y","Y","Dillingham Census Area",70,"Southwest Region",11,1,75,0,77,0,3,0,1
"11/30/2020","Y","Y","Dillingham Census Area",70,"Southwest Region",11,0,75,1,78,0,3,0,1
"12/01/2020","Y","Y","Dillingham Census Area",70,"Southwest Region",11,1,76,0,78,0,3,0,1
"12/02/2020","Y","Y","Dillingham Census Area",70,"Southwest Region",11,0,76,3,81,0,3,0,1
"12/04/2020","Y","Y","Dillingham Census Area",70,"Southwest Region",11,3,79,0,81,0,3,0,1
"12/07/2020","Y","Y","Dillingham Census Area",70,"Southwest Region",11,0,79,1,82,0,3,0,1
"12/08/2020","Y","Y","Dillingham Census Area",70,"Southwest Region",11,0,79,1,83,0,3,0,1
"12/09/2020","Y","Y","Dillingham Census Area",70,"Southwest Region",11,2,81,0,83,0,3,0,1
"12/10/2020","Y","Y","Dillingham Census Area",70,"Southwest Region",11,0,81,1,84,0,3,0,1
"12/11/2020","Y","Y","Dillingham Census Area",70,"Southwest Region",11,0,81,3,87,0,3,0,1
"12/12/2020","Y","Y","Dillingham Census Area",70,"Southwest Region",11,1,82,0,87,0,3,0,1
"12/13/2020","Y","Y","Dillingham Census Area",70,"Southwest Region",11,2,84,0,87,0,3,0,1
"12/14/2020","Y","Y","Dillingham Census Area",70,"Southwest Region",11,1,85,0,87,0,3,0,1
"12/16/2020","Y","Y","Dillingham Census Area",70,"Southwest Region",11,0,85,1,88,0,3,0,1
"12/17/2020","Y","Y","Dillingham Census Area",70,"Southwest Region",11,0,85,1,89,0,3,0,1
"12/19/2020","Y","Y","Dillingham Census Area",70,"Southwest Region",11,0,85,1,90,0,3,0,1
"12/21/2020","Y","Y","Dillingham Census Area",70,"Southwest Region",11,1,86,2,92,0,3,0,1
"12/22/2020","Y","Y","Dillingham Census Area",70,"Southwest Region",11,2,88,2,94,0,3,0,1
"12/23/2020","Y","Y","Dillingham Census Area",70,"Southwest Region",11,0,88,1,95,0,3,0,1
"12/24/2020","Y","Y","Dillingham Census Area",70,"Southwest Region",11,1,89,0,95,0,3,0,1
"12/26/2020","Y","Y","Dillingham Census Area",70,"Southwest Region",11,0,89,2,97,0,3,0,1
"12/27/2020","Y","Y","Dillingham Census Area",70,"Southwest Region",11,0,89,3,100,0,3,0,1
"12/28/2020","Y","Y","Dillingham Census Area",70,"Southwest Region",11,5,94,4,104,0,3,0,1
"12/29/2020","Y","Y","Dillingham Census Area",70,"Southwest Region",11,1,95,0,104,0,3,0,1
"12/30/2020","Y","Y","Dillingham Census Area",70,"Southwest Region",11,0,95,16,120,0,3,0,1
"12/31/2020","Y","Y","Dillingham Census Area",70,"Southwest Region",11,1,96,2,122,0,3,0,1
"01/01/2021","Y","Y","Dillingham Census Area",70,"Southwest Region",11,4,100,0,122,0,3,0,1
"01/04/2021","Y","Y","Dillingham Census Area",70,"Southwest Region",11,0,100,0,122,1,4,0,1
"01/05/2021","Y","Y","Dillingham Census Area",70,"Southwest Region",11,1,101,2,124,0,4,0,1
"01/06/2021","Y","Y","Dillingham Census Area",70,"Southwest Region",11,2,103,0,124,0,4,0,1
"01/07/2021","Y","Y","Dillingham Census Area",70,"Southwest Region",11,17,120,1,125,0,4,0,1
"01/08/2021","Y","Y","Dillingham Census Area",70,"Southwest Region",11,2,122,1,126,0,4,0,1
"01/11/2021","Y","Y","Dillingham Census Area",70,"Southwest Region",11,0,122,0,126,1,5,0,1
"01/12/2021","Y","Y","Dillingham Census Area",70,"Southwest Region",11,0,122,2,128,0,5,0,1
"01/13/2021","Y","Y","Dillingham Census Area",70,"Southwest Region",11,2,124,1,129,0,5,0,1
"01/14/2021","Y","Y","Dillingham Census Area",70,"Southwest Region",11,1,125,1,130,0,5,0,1
"01/16/2021","Y","Y","Dillingham Census Area",70,"Southwest Region",11,4,129,1,131,0,5,0,1
"01/19/2021","Y","Y","Dillingham Census Area",70,"Southwest Region",11,2,131,2,133,0,5,0,1
"01/20/2021","Y","Y","Dillingham Census Area",70,"Southwest Region",11,1,132,2,135,0,5,0,1
"01/21/2021","Y","Y","Dillingham Census Area",70,"Southwest Region",11,4,136,4,139,0,5,0,1
"01/22/2021","Y","Y","Dillingham Census Area",70,"Southwest Region",11,2,138,1,140,0,5,0,1
"01/23/2021","Y","Y","Dillingham Census Area",70,"Southwest Region",11,1,139,0,140,0,5,0,1
"01/25/2021","Y","Y","Dillingham Census Area",70,"Southwest Region",11,0,139,4,144,0,5,0,1
"01/26/2021","Y","Y","Dillingham Census Area",70,"Southwest Region",11,1,140,1,145,0,5,0,1
"01/27/2021","Y","Y","Dillingham Census Area",70,"Southwest Region",11,4,144,0,145,0,5,0,1
"01/29/2021","Y","Y","Dillingham Census Area",70,"Southwest Region",11,0,144,6,151,0,5,0,1
"02/01/2021","Y","Y","Dillingham Census Area",70,"Southwest Region",11,0,144,2,153,0,5,0,1
"02/02/2021","Y","Y","Dillingham Census Area",70,"Southwest Region",11,5,149,2,155,0,5,0,1
"02/03/2021","Y","Y","Dillingham Census Area",70,"Southwest Region",11,3,152,4,159,0,5,0,1
"02/04/2021","Y","Y","Dillingham Census Area",70,"Southwest Region",11,1,153,0,159,0,5,0,1
"02/05/2021","Y","Y","Dillingham Census Area",70,"Southwest Region",11,6,159,5,164,0,5,0,1
"02/06/2021","Y","Y","Dillingham Census Area",70,"Southwest Region",11,3,162,0,164,0,5,0,1
"02/07/2021","Y","Y","Dillingham Census Area",70,"Southwest Region",11,2,164,3,167,0,5,0,1
"02/09/2021","Y","Y","Dillingham Census Area",70,"Southwest Region",11,0,164,1,168,0,5,0,1
"02/11/2021","Y","Y","Dillingham Census Area",70,"Southwest Region",11,3,167,0,168,0,5,0,1
"02/13/2021","Y","Y","Dillingham Census Area",70,"Southwest Region",11,0,167,4,172,0,5,0,1
"02/14/2021","Y","Y","Dillingham Census Area",70,"Southwest Region",11,2,169,1,173,0,5,0,1
"02/15/2021","Y","Y","Dillingham Census Area",70,"Southwest Region",11,2,171,0,173,0,5,0,1
"02/16/2021","Y","Y","Dillingham Census Area",70,"Southwest Region",11,0,171,0,173,0,5,1,2
"02/17/2021","Y","Y","Dillingham Census Area",70,"Southwest Region",11,0,171,2,175,0,5,0,2
"02/18/2021","Y","Y","Dillingham Census Area",70,"Southwest Region",11,1,172,1,176,0,5,0,2
"02/19/2021","Y","Y","Dillingham Census Area",70,"Southwest Region",11,2,174,0,176,0,5,0,2
"02/20/2021","Y","Y","Dillingham Census Area",70,"Southwest Region",11,1,175,0,176,0,5,0,2
"02/21/2021","Y","Y","Dillingham Census Area",70,"Southwest Region",11,0,175,1,177,0,5,0,2
"02/22/2021","Y","Y","Dillingham Census Area",70,"Southwest Region",11,2,177,2,179,0,5,0,2
"02/24/2021","Y","Y","Dillingham Census Area",70,"Southwest Region",11,1,178,0,179,0,5,0,2
"02/28/2021","Y","Y","Dillingham Census Area",70,"Southwest Region",11,0,178,1,180,0,5,0,2
"03/01/2021","Y","Y","Dillingham Census Area",70,"Southwest Region",11,1,179,0,180,0,5,0,2
"03/02/2021","Y","Y","Dillingham Census Area",70,"Southwest Region",11,1,180,4,184,0,5,0,2
"03/03/2021","Y","Y","Dillingham Census Area",70,"Southwest Region",11,3,183,0,184,0,5,0,2
"03/15/2021","Y","Y","Dillingham Census Area",70,"Southwest Region",11,0,183,1,185,0,5,0,2
"03/16/2021","Y","Y","Dillingham Census Area",70,"Southwest Region",11,1,184,0,185,0,5,0,2
"04/03/2021","Y","Y","Dillingham Census Area",70,"Southwest Region",11,0,184,1,186,0,5,0,2
"04/06/2021","Y","Y","Dillingham Census Area",70,"Southwest Region",11,1,185,1,187,0,5,0,2
"04/07/2021","Y","Y","Dillingham Census Area",70,"Southwest Region",11,0,185,11,198,0,5,0,2
"04/08/2021","Y","Y","Dillingham Census Area",70,"Southwest Region",11,2,187,2,200,0,5,0,2
"04/09/2021","Y","Y","Dillingham Census Area",70,"Southwest Region",11,13,200,1,201,0,5,0,2
"04/12/2021","Y","Y","Dillingham Census Area",70,"Southwest Region",11,1,201,2,203,0,5,0,2
"04/16/2021","Y","Y","Dillingham Census Area",70,"Southwest Region",11,1,202,0,203,0,5,0,2
"04/18/2021","Y","Y","Dillingham Census Area",70,"Southwest Region",11,0,202,1,204,0,5,0,2
"04/19/2021","Y","Y","Dillingham Census Area",70,"Southwest Region",11,2,204,1,205,0,5,0,2
"04/25/2021","Y","Y","Dillingham Census Area",70,"Southwest Region",11,1,205,1,206,0,5,0,2
"05/17/2021","Y","Y","Dillingham Census Area",70,"Southwest Region",11,0,205,1,207,0,5,0,2
"05/18/2021","Y","Y","Dillingham Census Area",70,"Southwest Region",11,1,206,0,207,0,5,0,2
"06/07/2021","Y","Y","Dillingham Census Area",70,"Southwest Region",11,1,207,2,209,0,5,0,2
"06/08/2021","Y","Y","Dillingham Census Area",70,"Southwest Region",11,1,208,0,209,0,5,0,2
"06/09/2021","Y","Y","Dillingham Census Area",70,"Southwest Region",11,0,208,1,210,0,5,0,2
"06/11/2021","Y","Y","Dillingham Census Area",70,"Southwest Region",11,1,209,0,210,0,5,0,2
"07/16/2021","Y","Y","Dillingham Census Area",70,"Southwest Region",11,2,211,4,214,0,5,0,2
"07/17/2021","Y","Y","Dillingham Census Area",70,"Southwest Region",11,3,214,1,215,0,5,0,2
"07/20/2021","Y","Y","Dillingham Census Area",70,"Southwest Region",11,0,214,1,216,0,5,0,2
"07/21/2021","Y","Y","Dillingham Census Area",70,"Southwest Region",11,3,217,2,218,0,5,0,2
"07/23/2021","Y","Y","Dillingham Census Area",70,"Southwest Region",11,0,217,1,219,0,5,0,2
"07/24/2021","Y","Y","Dillingham Census Area",70,"Southwest Region",11,1,218,0,219,0,5,0,2
"07/26/2021","Y","Y","Dillingham Census Area",70,"Southwest Region",11,0,218,1,220,0,5,0,2
"07/27/2021","Y","Y","Dillingham Census Area",70,"Southwest Region",11,1,219,0,220,0,5,0,2
"07/29/2021","Y","Y","Dillingham Census Area",70,"Southwest Region",11,0,219,2,222,0,5,0,2
"07/30/2021","Y","Y","Dillingham Census Area",70,"Southwest Region",11,1,220,0,222,0,5,0,2
"07/31/2021","Y","Y","Dillingham Census Area",70,"Southwest Region",11,2,222,1,223,0,5,0,2
"08/04/2021","Y","Y","Dillingham Census Area",70,"Southwest Region",11,0,222,13,236,0,5,0,2
"08/05/2021","Y","Y","Dillingham Census Area",70,"Southwest Region",11,0,222,1,237,0,5,0,2
"08/06/2021","Y","Y","Dillingham Census Area",70,"Southwest Region",11,3,225,2,239,0,5,0,2
"08/07/2021","Y","Y","Dillingham Census Area",70,"Southwest Region",11,0,225,2,241,0,5,0,2
"08/08/2021","Y","Y","Dillingham Census Area",70,"Southwest Region",11,11,236,0,241,0,5,0,2
"08/09/2021","Y","Y","Dillingham Census Area",70,"Southwest Region",11,0,236,2,243,0,5,0,2
"08/10/2021","Y","Y","Dillingham Census Area",70,"Southwest Region",11,7,243,6,249,0,5,0,2
"08/11/2021","Y","Y","Dillingham Census Area",70,"Southwest Region",11,3,246,2,251,0,5,0,2
"08/12/2021","Y","Y","Dillingham Census Area",70,"Southwest Region",11,2,248,17,268,0,5,0,2
"08/13/2021","Y","Y","Dillingham Census Area",70,"Southwest Region",11,1,249,10,278,0,5,0,2
"08/14/2021","Y","Y","Dillingham Census Area",70,"Southwest Region",11,3,252,3,281,0,5,0,2
"08/16/2021","Y","Y","Dillingham Census Area",70,"Southwest Region",11,13,265,2,283,0,5,0,2
"08/17/2021","Y","Y","Dillingham Census Area",70,"Southwest Region",11,14,279,20,303,0,5,0,2
"08/18/2021","Y","Y","Dillingham Census Area",70,"Southwest Region",11,3,282,3,306,0,5,0,2
"08/19/2021","Y","Y","Dillingham Census Area",70,"Southwest Region",11,2,284,5,311,0,5,0,2
"08/20/2021","Y","Y","Dillingham Census Area",70,"Southwest Region",11,2,286,2,313,0,5,0,2
"08/21/2021","Y","Y","Dillingham Census Area",70,"Southwest Region",11,3,289,2,315,1,6,0,2
"08/22/2021","Y","Y","Dillingham Census Area",70,"Southwest Region",11,0,289,2,317,0,6,0,2
"08/23/2021","Y","Y","Dillingham Census Area",70,"Southwest Region",11,8,297,8,325,1,7,0,2
"08/24/2021","Y","Y","Dillingham Census Area",70,"Southwest Region",11,3,300,4,329,0,7,0,2
"08/25/2021","Y","Y","Dillingham Census Area",70,"Southwest Region",11,5,305,6,335,0,7,1,3
"08/26/2021","Y","Y","Dillingham Census Area",70,"Southwest Region",11,4,309,5,340,0,7,0,3
"08/27/2021","Y","Y","Dillingham Census Area",70,"Southwest Region",11,7,316,12,352,1,8,0,3
"08/28/2021","Y","Y","Dillingham Census Area",70,"Southwest Region",11,7,323,7,359,0,8,0,3
"08/29/2021","Y","Y","Dillingham Census Area",70,"Southwest Region",11,3,326,4,363,0,8,0,3
"08/30/2021","Y","Y","Dillingham Census Area",70,"Southwest Region",11,9,335,17,380,0,8,0,3
"08/31/2021","Y","Y","Dillingham Census Area",70,"Southwest Region",11,3,338,21,401,0,8,0,3
"09/01/2021","Y","Y","Dillingham Census Area",70,"Southwest Region",11,8,346,6,407,0,8,0,3
"09/02/2021","Y","Y","Dillingham Census Area",70,"Southwest Region",11,11,357,15,422,0,8,0,3
"09/03/2021","Y","Y","Dillingham Census Area",70,"Southwest Region",11,14,371,6,428,0,8,1,4
"09/04/2021","Y","Y","Dillingham Census Area",70,"Southwest Region",11,8,379,1,429,0,8,0,4
"09/05/2021","Y","Y","Dillingham Census Area",70,"Southwest Region",11,16,395,1,430,0,8,0,4
"09/06/2021","Y","Y","Dillingham Census Area",70,"Southwest Region",11,4,399,3,433,0,8,0,4
"09/07/2021","Y","Y","Dillingham Census Area",70,"Southwest Region",11,9,408,17,450,0,8,0,4
"09/08/2021","Y","Y","Dillingham Census Area",70,"Southwest Region",11,15,423,9,459,1,9,0,4
"09/09/2021","Y","Y","Dillingham Census Area",70,"Southwest Region",11,2,425,8,467,0,9,0,4
"09/10/2021","Y","Y","Dillingham Census Area",70,"Southwest Region",11,6,431,6,473,0,9,1,5
"09/11/2021","Y","Y","Dillingham Census Area",70,"Southwest Region",11,1,432,5,478,0,9,0,5
"09/12/2021","Y","Y","Dillingham Census Area",70,"Southwest Region",11,2,434,3,481,0,9,0,5
"09/13/2021","Y","Y","Dillingham Census Area",70,"Southwest Region",11,2,436,7,488,0,9,0,5
"09/14/2021","Y","Y","Dillingham Census Area",70,"Southwest Region",11,8,444,9,497,0,9,0,5
"09/15/2021","Y","Y","Dillingham Census Area",70,"Southwest Region",11,6,450,1,498,0,9,1,6
"09/16/2021","Y","Y","Dillingham Census Area",70,"Southwest Region",11,4,454,6,504,1,10,0,6
"09/17/2021","Y","Y","Dillingham Census Area",70,"Southwest Region",11,10,464,8,512,0,10,0,6
"09/18/2021","Y","Y","Dillingham Census Area",70,"Southwest Region",11,13,477,5,517,0,10,0,6
"09/19/2021","Y","Y","Dillingham Census Area",70,"Southwest Region",11,0,477,4,521,0,10,0,6
"09/20/2021","Y","Y","Dillingham Census Area",70,"Southwest Region",11,6,483,4,525,0,10,0,6
"09/21/2021","Y","Y","Dillingham Census Area",70,"Southwest Region",11,14,497,8,533,1,11,0,6
"09/22/2021","Y","Y","Dillingham Census Area",70,"Southwest Region",11,14,511,6,539,1,12,0,6
"09/23/2021","Y","Y","Dillingham Census Area",70,"Southwest Region",11,13,524,6,545,1,13,0,6
"09/24/2021","Y","Y","Dillingham Census Area",70,"Southwest Region",11,2,526,12,557,0,13,0,6
"09/25/2021","Y","Y","Dillingham Census Area",70,"Southwest Region",11,5,531,4,561,0,13,0,6
"09/26/2021","Y","Y","Dillingham Census Area",70,"Southwest Region",11,19,550,2,563,0,13,0,6
"09/27/2021","Y","Y","Dillingham Census Area",70,"Southwest Region",11,5,555,13,576,0,13,0,6
"09/28/2021","Y","Y","Dillingham Census Area",70,"Southwest Region",11,3,558,6,582,0,13,0,6
"09/29/2021","Y","Y","Dillingham Census Area",70,"Southwest Region",11,18,576,17,599,0,13,0,6
"09/30/2021","Y","Y","Dillingham Census Area",70,"Southwest Region",11,10,586,9,608,0,13,0,6
"10/01/2021","Y","Y","Dillingham Census Area",70,"Southwest Region",11,11,597,17,625,1,14,0,6
"10/02/2021","Y","Y","Dillingham Census Area",70,"Southwest Region",11,12,609,3,628,0,14,0,6
"10/04/2021","Y","Y","Dillingham Census Area",70,"Southwest Region",11,13,622,19,647,0,14,0,6
"10/05/2021","Y","Y","Dillingham Census Area",70,"Southwest Region",11,7,629,10,657,0,14,0,6
"10/06/2021","Y","Y","Dillingham Census Area",70,"Southwest Region",11,0,629,10,667,0,14,0,6
"10/07/2021","Y","Y","Dillingham Census Area",70,"Southwest Region",11,15,644,4,671,0,14,1,7
"10/08/2021","Y","Y","Dillingham Census Area",70,"Southwest Region",11,10,654,10,681,0,14,0,7
"10/09/2021","Y","Y","Dillingham Census Area",70,"Southwest Region",11,8,662,4,685,0,14,0,7
"10/10/2021","Y","Y","Dillingham Census Area",70,"Southwest Region",11,8,670,1,686,0,14,0,7
"10/11/2021","Y","Y","Dillingham Census Area",70,"Southwest Region",11,11,681,14,700,1,15,1,8
"10/12/2021","Y","Y","Dillingham Census Area",70,"Southwest Region",11,11,692,32,732,0,15,0,8
"10/13/2021","Y","Y","Dillingham Census Area",70,"Southwest Region",11,5,697,8,740,0,15,0,8
"10/14/2021","Y","Y","Dillingham Census Area",70,"Southwest Region",11,8,705,9,749,0,15,0,8
"10/15/2021","Y","Y","Dillingham Census Area",70,"Southwest Region",11,26,731,16,765,0,15,0,8
"10/16/2021","Y","Y","Dillingham Census Area",70,"Southwest Region",11,9,740,0,765,0,15,0,8
"10/17/2021","Y","Y","Dillingham Census Area",70,"Southwest Region",11,1,741,2,767,0,15,0,8
"10/18/2021","Y","Y","Dillingham Census Area",70,"Southwest Region",11,5,746,19,786,0,15,0,8
"10/19/2021","Y","Y","Dillingham Census Area",70,"Southwest Region",11,12,758,13,799,0,15,1,9
"10/20/2021","Y","Y","Dillingham Census Area",70,"Southwest Region",11,7,765,30,829,0,15,0,9
"10/21/2021","Y","Y","Dillingham Census Area",70,"Southwest Region",11,11,776,9,838,0,15,0,9
"10/22/2021","Y","Y","Dillingham Census Area",70,"Southwest Region",11,39,815,10,848,0,15,0,9
"10/23/2021","Y","Y","Dillingham Census Area",70,"Southwest Region",11,13,828,0,848,0,15,0,9
"10/24/2021","Y","Y","Dillingham Census Area",70,"Southwest Region",11,4,832,1,849,0,15,0,9
"10/25/2021","Y","Y","Dillingham Census Area",70,"Southwest Region",11,13,845,14,863,0,15,0,9
"10/26/2021","Y","Y","Dillingham Census Area",70,"Southwest Region",11,6,851,5,868,1,16,0,9
"10/27/2021","Y","Y","Dillingham Census Area",70,"Southwest Region",11,10,861,2,870,0,16,0,9
"10/28/2021","Y","Y","Dillingham Census Area",70,"Southwest Region",11,1,862,1,871,0,16,1,10
"10/29/2021","Y","Y","Dillingham Census Area",70,"Southwest Region",11,8,870,5,876,0,16,0,10
"10/30/2021","Y","Y","Dillingham Census Area",70,"Southwest Region",11,3,873,0,876,0,16,0,10
"10/31/2021","Y","Y","Dillingham Census Area",70,"Southwest Region",11,1,874,0,876,0,16,0,10
"11/01/2021","Y","Y","Dillingham Census Area",70,"Southwest Region",11,2,876,3,879,0,16,0,10
"11/02/2021","Y","Y","Dillingham Census Area",70,"Southwest Region",11,1,877,2,881,0,16,0,10
"11/03/2021","Y","Y","Dillingham Census Area",70,"Southwest Region",11,2,879,1,882,0,16,0,10
"11/04/2021","Y","Y","Dillingham Census Area",70,"Southwest Region",11,3,882,1,883,0,16,0,10
"11/05/2021","Y","Y","Dillingham Census Area",70,"Southwest Region",11,0,882,1,884,0,16,0,10
"11/06/2021","Y","Y","Dillingham Census Area",70,"Southwest Region",11,1,883,0,884,0,16,0,10
"11/07/2021","Y","Y","Dillingham Census Area",70,"Southwest Region",11,1,884,0,884,0,16,0,10
"11/08/2021","Y","Y","Dillingham Census Area",70,"Southwest Region",11,0,884,6,890,0,16,0,10
"11/09/2021","Y","Y","Dillingham Census Area",70,"Southwest Region",11,4,888,1,891,0,16,0,10
"11/10/2021","Y","Y","Dillingham Census Area",70,"Southwest Region",11,0,888,1,892,0,16,0,10
"11/11/2021","Y","Y","Dillingham Census Area",70,"Southwest Region",11,2,890,2,894,0,16,0,10
"11/12/2021","Y","Y","Dillingham Census Area",70,"Southwest Region",11,2,892,3,897,0,16,0,10
"11/13/2021","Y","Y","Dillingham Census Area",70,"Southwest Region",11,4,896,2,899,1,17,0,10
"11/14/2021","Y","Y","Dillingham Census Area",70,"Southwest Region",11,2,898,0,899,0,17,0,10
"11/15/2021","Y","Y","Dillingham Census Area",70,"Southwest Region",11,0,898,4,903,0,17,0,10
"11/16/2021","Y","Y","Dillingham Census Area",70,"Southwest Region",11,2,900,2,905,0,17,0,10
"11/17/2021","Y","Y","Dillingham Census Area",70,"Southwest Region",11,4,904,2,907,0,17,0,10
"11/18/2021","Y","Y","Dillingham Census Area",70,"Southwest Region",11,2,906,1,908,0,17,0,10
"11/19/2021","Y","Y","Dillingham Census Area",70,"Southwest Region",11,1,907,2,910,0,17,0,10
"11/20/2021","Y","Y","Dillingham Census Area",70,"Southwest Region",11,3,910,1,911,0,17,0,10
"11/21/2021","Y","Y","Dillingham Census Area",70,"Southwest Region",11,1,911,1,912,0,17,0,10
"11/22/2021","Y","Y","Dillingham Census Area",70,"Southwest Region",11,1,912,3,915,0,17,0,10
"11/23/2021","Y","Y","Dillingham Census Area",70,"Southwest Region",11,2,914,1,916,0,17,0,10
"11/24/2021","Y","Y","Dillingham Census Area",70,"Southwest Region",11,0,914,2,918,0,17,0,10
"11/26/2021","Y","Y","Dillingham Census Area",70,"Southwest Region",11,2,916,1,919,0,17,1,11
"11/27/2021","Y","Y","Dillingham Census Area",70,"Southwest Region",11,1,917,3,922,0,17,0,11
"11/28/2021","Y","Y","Dillingham Census Area",70,"Southwest Region",11,3,920,2,924,0,17,0,11
"11/29/2021","Y","Y","Dillingham Census Area",70,"Southwest Region",11,3,923,10,934,0,17,0,11
"11/30/2021","Y","Y","Dillingham Census Area",70,"Southwest Region",11,9,932,0,934,0,17,0,11
"12/01/2021","Y","Y","Dillingham Census Area",70,"Southwest Region",11,2,934,3,937,0,17,0,11
"12/02/2021","Y","Y","Dillingham Census Area",70,"Southwest Region",11,1,935,1,938,0,17,0,11
"12/03/2021","Y","Y","Dillingham Census Area",70,"Southwest Region",11,3,938,6,944,0,17,0,11
"12/04/2021","Y","Y","Dillingham Census Area",70,"Southwest Region",11,0,938,2,946,0,17,0,11
"12/05/2021","Y","Y","Dillingham Census Area",70,"Southwest Region",11,5,943,0,946,0,17,0,11
"12/06/2021","Y","Y","Dillingham Census Area",70,"Southwest Region",11,6,949,5,951,0,17,0,11
"12/07/2021","Y","Y","Dillingham Census Area",70,"Southwest Region",11,2,951,2,953,0,17,0,11
"12/08/2021","Y","Y","Dillingham Census Area",70,"Southwest Region",11,1,952,0,953,0,17,0,11
"12/09/2021","Y","Y","Dillingham Census Area",70,"Southwest Region",11,1,953,0,953,0,17,0,11
"12/10/2021","Y","Y","Dillingham Census Area",70,"Southwest Region",11,0,953,1,954,0,17,0,11
"12/11/2021","Y","Y","Dillingham Census Area",70,"Southwest Region",11,3,956,2,956,0,17,0,11
"12/12/2021","Y","Y","Dillingham Census Area",70,"Southwest Region",11,0,956,1,957,0,17,0,11
"12/14/2021","Y","Y","Dillingham Census Area",70,"Southwest Region",11,1,957,1,958,0,17,0,11
"12/15/2021","Y","Y","Dillingham Census Area",70,"Southwest Region",11,1,958,0,958,0,17,0,11
"12/16/2021","Y","Y","Dillingham Census Area",70,"Southwest Region",11,1,959,1,959,0,17,0,11
"12/17/2021","Y","Y","Dillingham Census Area",70,"Southwest Region",11,0,959,2,961,0,17,0,11
"12/19/2021","Y","Y","Dillingham Census Area",70,"Southwest Region",11,1,960,0,961,0,17,0,11
"12/21/2021","Y","Y","Dillingham Census Area",70,"Southwest Region",11,1,961,1,962,0,17,0,11
"12/22/2021","Y","Y","Dillingham Census Area",70,"Southwest Region",11,2,963,2,964,0,17,0,11
"12/23/2021","Y","Y","Dillingham Census Area",70,"Southwest Region",11,2,965,3,967,0,17,0,11
"12/24/2021","Y","Y","Dillingham Census Area",70,"Southwest Region",11,2,967,0,967,0,17,0,11
"12/27/2021","Y","Y","Dillingham Census Area",70,"Southwest Region",11,0,967,1,968,0,17,0,11
"12/28/2021","Y","Y","Dillingham Census Area",70,"Southwest Region",11,1,968,1,969,0,17,0,11
"12/29/2021","Y","Y","Dillingham Census Area",70,"Southwest Region",11,1,969,4,973,0,17,0,11
"12/30/2021","Y","Y","Dillingham Census Area",70,"Southwest Region",11,5,974,2,975,0,17,0,11
"12/31/2021","Y","Y","Dillingham Census Area",70,"Southwest Region",11,0,974,1,976,0,17,0,11
"01/01/2022","Y","Y","Dillingham Census Area",70,"Southwest Region",11,7,981,13,989,0,17,0,11
"01/02/2022","Y","Y","Dillingham Census Area",70,"Southwest Region",11,0,981,1,990,0,17,0,11
"01/03/2022","Y","Y","Dillingham Census Area",70,"Southwest Region",11,7,988,1,991,0,17,0,11
"01/04/2022","Y","Y","Dillingham Census Area",70,"Southwest Region",11,5,993,6,997,0,17,0,11
"01/05/2022","Y","Y","Dillingham Census Area",70,"Southwest Region",11,2,995,3,1000,0,17,0,11
"01/06/2022","Y","Y","Dillingham Census Area",70,"Southwest Region",11,6,1001,5,1005,0,17,0,11
"01/07/2022","Y","Y","Dillingham Census Area",70,"Southwest Region",11,3,1004,3,1008,0,17,0,11
"01/08/2022","Y","Y","Dillingham Census Area",70,"Southwest Region",11,1,1005,1,1009,0,17,0,11
"01/09/2022","Y","Y","Dillingham Census Area",70,"Southwest Region",11,1,1006,2,1011,0,17,0,11
"01/10/2022","Y","Y","Dillingham Census Area",70,"Southwest Region",11,8,1014,13,1024,0,17,0,11
"01/11/2022","Y","Y","Dillingham Census Area",70,"Southwest Region",11,6,1020,9,1033,0,17,0,11
"01/12/2022","Y","Y","Dillingham Census Area",70,"Southwest Region",11,8,1028,9,1042,0,17,0,11
"01/13/2022","Y","Y","Dillingham Census Area",70,"Southwest Region",11,11,1039,10,1052,0,17,0,11
"01/14/2022","Y","Y","Dillingham Census Area",70,"Southwest Region",11,8,1047,10,1062,0,17,0,11
"01/15/2022","Y","Y","Dillingham Census Area",70,"Southwest Region",11,9,1056,11,1073,0,17,0,11
"01/16/2022","Y","Y","Dillingham Census Area",70,"Southwest Region",11,13,1069,5,1078,0,17,0,11
"01/17/2022","Y","Y","Dillingham Census Area",70,"Southwest Region",11,3,1072,4,1082,0,17,0,11
"01/18/2022","Y","Y","Dillingham Census Area",70,"Southwest Region",11,12,1084,16,1098,0,17,0,11
"01/19/2022","Y","Y","Dillingham Census Area",70,"Southwest Region",11,10,1094,11,1109,0,17,0,11
"01/20/2022","Y","Y","Dillingham Census Area",70,"Southwest Region",11,11,1105,18,1127,0,17,0,11
"01/21/2022","Y","Y","Dillingham Census Area",70,"Southwest Region",11,6,1111,11,1138,0,17,0,11
"01/22/2022","Y","Y","Dillingham Census Area",70,"Southwest Region",11,2,1113,7,1145,0,17,0,11
"01/23/2022","Y","Y","Dillingham Census Area",70,"Southwest Region",11,0,1113,4,1149,0,17,0,11
"01/24/2022","Y","Y","Dillingham Census Area",70,"Southwest Region",11,27,1140,36,1185,0,17,0,11
"01/25/2022","Y","Y","Dillingham Census Area",70,"Southwest Region",11,9,1149,17,1202,0,17,0,11
"01/26/2022","Y","Y","Dillingham Census Area",70,"Southwest Region",11,23,1172,35,1237,0,17,0,11
"01/27/2022","Y","Y","Dillingham Census Area",70,"Southwest Region",11,14,1186,14,1251,0,17,0,11
"01/28/2022","Y","Y","Dillingham Census Area",70,"Southwest Region",11,9,1195,13,1264,0,17,0,11
"01/29/2022","Y","Y","Dillingham Census Area",70,"Southwest Region",11,16,1211,17,1281,0,17,0,11
"01/30/2022","Y","Y","Dillingham Census Area",70,"Southwest Region",11,5,1216,2,1283,0,17,0,11
"01/31/2022","Y","Y","Dillingham Census Area",70,"Southwest Region",11,68,1284,31,1314,0,17,0,11
"02/01/2022","Y","Y","Dillingham Census Area",70,"Southwest Region",11,10,1294,4,1318,0,17,0,11
"02/02/2022","Y","Y","Dillingham Census Area",70,"Southwest Region",11,23,1317,16,1334,0,17,0,11
"02/03/2022","Y","Y","Dillingham Census Area",70,"Southwest Region",11,13,1330,17,1351,0,17,0,11
"02/04/2022","Y","Y","Dillingham Census Area",70,"Southwest Region",11,3,1333,10,1361,0,17,0,11
"02/05/2022","Y","Y","Dillingham Census Area",70,"Southwest Region",11,9,1342,8,1369,0,17,0,11
"02/06/2022","Y","Y","Dillingham Census Area",70,"Southwest Region",11,11,1353,2,1371,0,17,0,11
"02/07/2022","Y","Y","Dillingham Census Area",70,"Southwest Region",11,24,1377,28,1399,0,17,0,11
"02/08/2022","Y","Y","Dillingham Census Area",70,"Southwest Region",11,14,1391,16,1415,0,17,0,11
"02/09/2022","Y","Y","Dillingham Census Area",70,"Southwest Region",11,9,1400,12,1427,0,17,0,11
"02/10/2022","Y","Y","Dillingham Census Area",70,"Southwest Region",11,23,1423,16,1443,0,17,0,11
"02/11/2022","Y","Y","Dillingham Census Area",70,"Southwest Region",11,2,1425,2,1445,0,17,0,11
"02/12/2022","Y","Y","Dillingham Census Area",70,"Southwest Region",11,4,1429,0,1445,0,17,0,11
"02/13/2022","Y","Y","Dillingham Census Area",70,"Southwest Region",11,1,1430,0,1445,0,17,0,11
"02/14/2022","Y","Y","Dillingham Census Area",70,"Southwest Region",11,5,1435,0,1445,0,17,0,11
"02/15/2022","Y","Y","Dillingham Census Area",70,"Southwest Region",11,0,1435,8,1453,0,17,0,11
"02/16/2022","Y","Y","Dillingham Census Area",70,"Southwest Region",11,2,1437,7,1460,0,17,0,11
"02/17/2022","Y","Y","Dillingham Census Area",70,"Southwest Region",11,18,1455,3,1463,0,17,0,11
"02/18/2022","Y","Y","Dillingham Census Area",70,"Southwest Region",11,2,1457,3,1466,0,17,0,11
"02/19/2022","Y","Y","Dillingham Census Area",70,"Southwest Region",11,7,1464,1,1467,0,17,0,11
"02/20/2022","Y","Y","Dillingham Census Area",70,"Southwest Region",11,2,1466,2,1469,0,17,0,11
"02/21/2022","Y","Y","Dillingham Census Area",70,"Southwest Region",11,5,1471,5,1474,0,17,0,11
"02/22/2022","Y","Y","Dillingham Census Area",70,"Southwest Region",11,6,1477,5,1479,0,17,0,11
"02/23/2022","Y","Y","Dillingham Census Area",70,"Southwest Region",11,1,1478,2,1481,0,17,0,11
"02/24/2022","Y","Y","Dillingham Census Area",70,"Southwest Region",11,4,1482,5,1486,0,17,0,11
"02/25/2022","Y","Y","Dillingham Census Area",70,"Southwest Region",11,1,1483,1,1487,0,17,0,11
"02/26/2022","Y","Y","Dillingham Census Area",70,"Southwest Region",11,1,1484,0,1487,0,17,0,11
"02/27/2022","Y","Y","Dillingham Census Area",70,"Southwest Region",11,1,1485,1,1488,0,17,0,11
"02/28/2022","Y","Y","Dillingham Census Area",70,"Southwest Region",11,2,1487,1,1489,0,17,0,11
"03/01/2022","Y","Y","Dillingham Census Area",70,"Southwest Region",11,2,1489,2,1491,0,17,0,11
"03/02/2022","Y","Y","Dillingham Census Area",70,"Southwest Region",11,1,1490,0,1491,0,17,0,11
"03/03/2022","Y","Y","Dillingham Census Area",70,"Southwest Region",11,2,1492,2,1493,0,17,0,11
"03/04/2022","Y","Y","Dillingham Census Area",70,"Southwest Region",11,0,1492,3,1496,0,17,0,11
"03/05/2022","Y","Y","Dillingham Census Area",70,"Southwest Region",11,1,1493,0,1496,0,17,0,11
"03/06/2022","Y","Y","Dillingham Census Area",70,"Southwest Region",11,3,1496,0,1496,0,17,0,11
"03/07/2022","Y","Y","Dillingham Census Area",70,"Southwest Region",11,0,1496,10,1506,0,17,0,11
"03/08/2022","Y","Y","Dillingham Census Area",70,"Southwest Region",11,1,1497,14,1520,0,17,0,11
"03/09/2022","Y","Y","Dillingham Census Area",70,"Southwest Region",11,15,1512,5,1525,0,17,0,11
"03/10/2022","Y","Y","Dillingham Census Area",70,"Southwest Region",11,7,1519,9,1534,0,17,0,11
"03/11/2022","Y","Y","Dillingham Census Area",70,"Southwest Region",11,3,1522,10,1544,0,17,0,11
"03/12/2022","Y","Y","Dillingham Census Area",70,"Southwest Region",11,14,1536,1,1545,0,17,0,11
"03/13/2022","Y","Y","Dillingham Census Area",70,"Southwest Region",11,7,1543,0,1545,0,17,0,11
"03/14/2022","Y","Y","Dillingham Census Area",70,"Southwest Region",11,0,1543,6,1551,0,17,0,11
"03/15/2022","Y","Y","Dillingham Census Area",70,"Southwest Region",11,4,1547,11,1562,0,17,0,11
"03/16/2022","Y","Y","Dillingham Census Area",70,"Southwest Region",11,5,1552,2,1564,0,17,0,11
"03/17/2022","Y","Y","Dillingham Census Area",70,"Southwest Region",11,18,1570,17,1581,0,17,0,11
"03/18/2022","Y","Y","Dillingham Census Area",70,"Southwest Region",11,1,1571,5,1586,0,17,0,11
"03/19/2022","Y","Y","Dillingham Census Area",70,"Southwest Region",11,8,1579,1,1587,0,17,0,11
"03/20/2022","Y","Y","Dillingham Census Area",70,"Southwest Region",11,3,1582,1,1588,0,17,0,11
"03/21/2022","Y","Y","Dillingham Census Area",70,"Southwest Region",11,14,1596,21,1609,0,17,0,11
"03/22/2022","Y","Y","Dillingham Census Area",70,"Southwest Region",11,17,1613,20,1629,0,17,0,11
"03/23/2022","Y","Y","Dillingham Census Area",70,"Southwest Region",11,6,1619,15,1644,0,17,0,11
"03/24/2022","Y","Y","Dillingham Census Area",70,"Southwest Region",11,24,1643,16,1660,0,17,0,11
"03/25/2022","Y","Y","Dillingham Census Area",70,"Southwest Region",11,16,1659,25,1685,0,17,0,11
"03/26/2022","Y","Y","Dillingham Census Area",70,"Southwest Region",11,19,1678,6,1691,0,17,0,11
"03/27/2022","Y","Y","Dillingham Census Area",70,"Southwest Region",11,10,1688,6,1697,0,17,0,11
"03/28/2022","Y","Y","Dillingham Census Area",70,"Southwest Region",11,2,1690,13,1710,0,17,0,11
"03/29/2022","Y","Y","Dillingham Census Area",70,"Southwest Region",11,14,1704,13,1723,0,17,0,11
"03/30/2022","Y","Y","Dillingham Census Area",70,"Southwest Region",11,12,1716,18,1741,0,17,0,11
"03/31/2022","Y","Y","Dillingham Census Area",70,"Southwest Region",11,7,1723,5,1746,0,17,0,11
"04/01/2022","Y","Y","Dillingham Census Area",70,"Southwest Region",11,19,1742,4,1750,0,17,0,11
"04/02/2022","Y","Y","Dillingham Census Area",70,"Southwest Region",11,5,1747,1,1751,0,17,0,11
"04/03/2022","Y","Y","Dillingham Census Area",70,"Southwest Region",11,1,1748,1,1752,0,17,0,11
"04/04/2022","Y","Y","Dillingham Census Area",70,"Southwest Region",11,6,1754,5,1757,0,17,0,11
"04/05/2022","Y","Y","Dillingham Census Area",70,"Southwest Region",11,7,1761,19,1776,0,17,0,11
"04/06/2022","Y","Y","Dillingham Census Area",70,"Southwest Region",11,16,1777,3,1779,0,17,0,11
"04/07/2022","Y","Y","Dillingham Census Area",70,"Southwest Region",11,2,1779,6,1785,0,17,0,11
"04/08/2022","Y","Y","Dillingham Census Area",70,"Southwest Region",11,4,1783,9,1794,0,17,0,11
"04/09/2022","Y","Y","Dillingham Census Area",70,"Southwest Region",11,7,1790,0,1794,0,17,0,11
"04/10/2022","Y","Y","Dillingham Census Area",70,"Southwest Region",11,3,1793,0,1794,0,17,0,11
"04/11/2022","Y","Y","Dillingham Census Area",70,"Southwest Region",11,4,1797,11,1805,0,17,0,11
"04/12/2022","Y","Y","Dillingham Census Area",70,"Southwest Region",11,7,1804,8,1813,0,17,0,11
"04/13/2022","Y","Y","Dillingham Census Area",70,"Southwest Region",11,2,1806,10,1823,0,17,0,11
"04/14/2022","Y","Y","Dillingham Census Area",70,"Southwest Region",11,14,1820,1,1824,0,17,0,11
"04/15/2022","Y","Y","Dillingham Census Area",70,"Southwest Region",11,6,1826,4,1828,0,17,0,11
"04/16/2022","Y","Y","Dillingham Census Area",70,"Southwest Region",11,1,1827,0,1828,0,17,0,11
"04/17/2022","Y","Y","Dillingham Census Area",70,"Southwest Region",11,1,1828,0,1828,0,17,0,11
"04/18/2022","Y","Y","Dillingham Census Area",70,"Southwest Region",11,0,1828,3,1831,0,17,0,11
"04/19/2022","Y","Y","Dillingham Census Area",70,"Southwest Region",11,6,1834,10,1841,0,17,0,11
"04/20/2022","Y","Y","Dillingham Census Area",70,"Southwest Region",11,13,1847,7,1848,0,17,0,11
"04/21/2022","Y","Y","Dillingham Census Area",70,"Southwest Region",11,1,1848,0,1848,0,17,0,11
"04/22/2022","Y","Y","Dillingham Census Area",70,"Southwest Region",11,1,1849,2,1850,0,17,0,11
"04/23/2022","Y","Y","Dillingham Census Area",70,"Southwest Region",11,1,1850,1,1851,0,17,0,11
"04/24/2022","Y","Y","Dillingham Census Area",70,"Southwest Region",11,4,1854,3,1854,0,17,0,11
"04/26/2022","Y","Y","Dillingham Census Area",70,"Southwest Region",11,1,1855,1,1855,0,17,0,11
"03/08/2020","Y","Y","Fairbanks North Star Borough",90,"Fairbanks North Star Borough",2,0,0,1,1,0,0,0,0
"03/10/2020","Y","Y","Fairbanks North Star Borough",90,"Fairbanks North Star Borough",2,0,0,1,2,0,0,0,0
"03/12/2020","Y","Y","Fairbanks North Star Borough",90,"Fairbanks North Star Borough",2,0,0,1,3,0,0,0,0
"03/13/2020","Y","Y","Fairbanks North Star Borough",90,"Fairbanks North Star Borough",2,0,0,2,5,0,0,0,0
"03/14/2020","Y","Y","Fairbanks North Star Borough",90,"Fairbanks North Star Borough",2,0,0,2,7,0,0,0,0
"03/15/2020","Y","Y","Fairbanks North Star Borough",90,"Fairbanks North Star Borough",2,0,0,3,10,0,0,0,0
"03/16/2020","Y","Y","Fairbanks North Star Borough",90,"Fairbanks North Star Borough",2,2,2,5,15,0,0,0,0
"03/17/2020","Y","Y","Fairbanks North Star Borough",90,"Fairbanks North Star Borough",2,1,3,1,16,0,0,0,0
"03/18/2020","Y","Y","Fairbanks North Star Borough",90,"Fairbanks North Star Borough",2,0,3,4,20,0,0,0,0
"03/19/2020","Y","Y","Fairbanks North Star Borough",90,"Fairbanks North Star Borough",2,3,6,4,24,0,0,0,0
"03/20/2020","Y","Y","Fairbanks North Star Borough",90,"Fairbanks North Star Borough",2,0,6,2,26,0,0,0,0
"03/21/2020","Y","Y","Fairbanks North Star Borough",90,"Fairbanks North Star Borough",2,1,7,4,30,0,0,0,0
"03/23/2020","Y","Y","Fairbanks North Star Borough",90,"Fairbanks North Star Borough",2,2,9,5,35,0,0,0,0
"03/24/2020","Y","Y","Fairbanks North Star Borough",90,"Fairbanks North Star Borough",2,0,9,5,40,2,2,0,0
"03/25/2020","Y","Y","Fairbanks North Star Borough",90,"Fairbanks North Star Borough",2,4,13,4,44,1,3,0,0
"03/26/2020","Y","Y","Fairbanks North Star Borough",90,"Fairbanks North Star Borough",2,4,17,2,46,0,3,0,0
"03/27/2020","Y","Y","Fairbanks North Star Borough",90,"Fairbanks North Star Borough",2,5,22,4,50,0,3,0,0
"03/28/2020","Y","Y","Fairbanks North Star Borough",90,"Fairbanks North Star Borough",2,2,24,3,53,0,3,0,0
"03/29/2020","Y","Y","Fairbanks North Star Borough",90,"Fairbanks North Star Borough",2,4,28,2,55,2,5,0,0
"03/30/2020","Y","Y","Fairbanks North Star Borough",90,"Fairbanks North Star Borough",2,7,35,3,58,0,5,0,0
"03/31/2020","Y","Y","Fairbanks North Star Borough",90,"Fairbanks North Star Borough",2,5,40,5,63,1,6,0,0
"04/01/2020","Y","Y","Fairbanks North Star Borough",90,"Fairbanks North Star Borough",2,3,43,3,66,0,6,0,0
"04/02/2020","Y","Y","Fairbanks North Star Borough",90,"Fairbanks North Star Borough",2,0,43,1,67,1,7,0,0
"04/03/2020","Y","Y","Fairbanks North Star Borough",90,"Fairbanks North Star Borough",2,2,45,2,69,1,8,1,1
"04/04/2020","Y","Y","Fairbanks North Star Borough",90,"Fairbanks North Star Borough",2,7,52,2,71,0,8,0,1
"04/05/2020","Y","Y","Fairbanks North Star Borough",90,"Fairbanks North Star Borough",2,1,53,1,72,0,8,0,1
"04/06/2020","Y","Y","Fairbanks North Star Borough",90,"Fairbanks North Star Borough",2,11,64,4,76,1,9,0,1
"04/07/2020","Y","Y","Fairbanks North Star Borough",90,"Fairbanks North Star Borough",2,5,69,1,77,0,9,0,1
"04/08/2020","Y","Y","Fairbanks North Star Borough",90,"Fairbanks North Star Borough",2,2,71,0,77,0,9,0,1
"04/09/2020","Y","Y","Fairbanks North Star Borough",90,"Fairbanks North Star Borough",2,4,75,0,77,0,9,0,1
"04/10/2020","Y","Y","Fairbanks North Star Borough",90,"Fairbanks North Star Borough",2,0,75,1,78,0,9,1,2
"04/11/2020","Y","Y","Fairbanks North Star Borough",90,"Fairbanks North Star Borough",2,3,78,0,78,0,9,0,2
"04/21/2020","Y","Y","Fairbanks North Star Borough",90,"Fairbanks North Star Borough",2,0,78,1,79,0,9,0,2
"04/24/2020","Y","Y","Fairbanks North Star Borough",90,"Fairbanks North Star Borough",2,0,78,1,80,0,9,0,2
"04/25/2020","Y","Y","Fairbanks North Star Borough",90,"Fairbanks North Star Borough",2,1,79,1,81,0,9,0,2
"04/27/2020","Y","Y","Fairbanks North Star Borough",90,"Fairbanks North Star Borough",2,1,80,1,82,0,9,0,2
"04/30/2020","Y","Y","Fairbanks North Star Borough",90,"Fairbanks North Star Borough",2,1,81,0,82,0,9,0,2
"05/01/2020","Y","Y","Fairbanks North Star Borough",90,"Fairbanks North Star Borough",2,1,82,0,82,0,9,0,2
"05/04/2020","Y","Y","Fairbanks North Star Borough",90,"Fairbanks North Star Borough",2,0,82,1,83,0,9,0,2
"05/06/2020","Y","Y","Fairbanks North Star Borough",90,"Fairbanks North Star Borough",2,0,82,1,84,0,9,0,2
"05/09/2020","Y","Y","Fairbanks North Star Borough",90,"Fairbanks North Star Borough",2,1,83,0,84,0,9,0,2
"05/10/2020","Y","Y","Fairbanks North Star Borough",90,"Fairbanks North Star Borough",2,1,84,0,84,0,9,0,2
"05/20/2020","Y","Y","Fairbanks North Star Borough",90,"Fairbanks North Star Borough",2,0,84,1,85,0,9,0,2
"06/02/2020","Y","Y","Fairbanks North Star Borough",90,"Fairbanks North Star Borough",2,0,84,1,86,0,9,0,2
"06/03/2020","Y","Y","Fairbanks North Star Borough",90,"Fairbanks North Star Borough",2,0,84,1,87,0,9,0,2
"06/06/2020","Y","Y","Fairbanks North Star Borough",90,"Fairbanks North Star Borough",2,0,84,1,88,0,9,0,2
"06/08/2020","Y","Y","Fairbanks North Star Borough",90,"Fairbanks North Star Borough",2,0,84,2,90,0,9,0,2
"06/09/2020","Y","Y","Fairbanks North Star Borough",90,"Fairbanks North Star Borough",2,0,84,1,91,0,9,0,2
"06/10/2020","Y","Y","Fairbanks North Star Borough",90,"Fairbanks North Star Borough",2,3,87,2,93,0,9,0,2
"06/11/2020","Y","Y","Fairbanks North Star Borough",90,"Fairbanks North Star Borough",2,1,88,7,100,1,10,0,2
"06/12/2020","Y","Y","Fairbanks North Star Borough",90,"Fairbanks North Star Borough",2,3,91,2,102,0,10,0,2
"06/13/2020","Y","Y","Fairbanks North Star Borough",90,"Fairbanks North Star Borough",2,4,95,1,103,0,10,0,2
"06/14/2020","Y","Y","Fairbanks North Star Borough",90,"Fairbanks North Star Borough",2,0,95,1,104,0,10,0,2
"06/15/2020","Y","Y","Fairbanks North Star Borough",90,"Fairbanks North Star Borough",2,0,95,5,109,0,10,0,2
"06/16/2020","Y","Y","Fairbanks North Star Borough",90,"Fairbanks North Star Borough",2,6,101,3,112,0,10,0,2
"06/17/2020","Y","Y","Fairbanks North Star Borough",90,"Fairbanks North Star Borough",2,3,104,1,113,0,10,0,2
"06/18/2020","Y","Y","Fairbanks North Star Borough",90,"Fairbanks North Star Borough",2,2,106,4,117,0,10,0,2
"06/19/2020","Y","Y","Fairbanks North Star Borough",90,"Fairbanks North Star Borough",2,7,113,2,119,0,10,0,2
"06/20/2020","Y","Y","Fairbanks North Star Borough",90,"Fairbanks North Star Borough",2,3,116,2,121,0,10,0,2
"06/21/2020","Y","Y","Fairbanks North Star Borough",90,"Fairbanks North Star Borough",2,0,116,3,124,0,10,0,2
"06/22/2020","Y","Y","Fairbanks North Star Borough",90,"Fairbanks North Star Borough",2,2,118,4,128,0,10,0,2
"06/23/2020","Y","Y","Fairbanks North Star Borough",90,"Fairbanks North Star Borough",2,3,121,5,133,0,10,0,2
"06/24/2020","Y","Y","Fairbanks North Star Borough",90,"Fairbanks North Star Borough",2,7,128,6,139,0,10,0,2
"06/25/2020","Y","Y","Fairbanks North Star Borough",90,"Fairbanks North Star Borough",2,3,131,6,145,1,11,0,2
"06/26/2020","Y","Y","Fairbanks North Star Borough",90,"Fairbanks North Star Borough",2,1,132,6,151,0,11,0,2
"06/27/2020","Y","Y","Fairbanks North Star Borough",90,"Fairbanks North Star Borough",2,3,135,1,152,0,11,0,2
"06/28/2020","Y","Y","Fairbanks North Star Borough",90,"Fairbanks North Star Borough",2,2,137,4,156,0,11,0,2
"06/29/2020","Y","Y","Fairbanks North Star Borough",90,"Fairbanks North Star Borough",2,5,142,3,159,0,11,0,2
"06/30/2020","Y","Y","Fairbanks North Star Borough",90,"Fairbanks North Star Borough",2,3,145,4,163,0,11,0,2
"07/01/2020","Y","Y","Fairbanks North Star Borough",90,"Fairbanks North Star Borough",2,2,147,4,167,1,12,0,2
"07/02/2020","Y","Y","Fairbanks North Star Borough",90,"Fairbanks North Star Borough",2,11,158,6,173,1,13,0,2
"07/03/2020","Y","Y","Fairbanks North Star Borough",90,"Fairbanks North Star Borough",2,5,163,4,177,0,13,0,2
"07/04/2020","Y","Y","Fairbanks North Star Borough",90,"Fairbanks North Star Borough",2,2,165,2,179,1,14,0,2
"07/05/2020","Y","Y","Fairbanks North Star Borough",90,"Fairbanks North Star Borough",2,5,170,7,186,0,14,0,2
"07/06/2020","Y","Y","Fairbanks North Star Borough",90,"Fairbanks North Star Borough",2,0,170,2,188,0,14,0,2
"07/07/2020","Y","Y","Fairbanks North Star Borough",90,"Fairbanks North Star Borough",2,5,175,15,203,0,14,0,2
"07/08/2020","Y","Y","Fairbanks North Star Borough",90,"Fairbanks North Star Borough",2,8,183,20,223,0,14,0,2
"07/09/2020","Y","Y","Fairbanks North Star Borough",90,"Fairbanks North Star Borough",2,15,198,28,251,0,14,0,2
"07/10/2020","Y","Y","Fairbanks North Star Borough",90,"Fairbanks North Star Borough",2,24,222,23,274,0,14,0,2
"07/11/2020","Y","Y","Fairbanks North Star Borough",90,"Fairbanks North Star Borough",2,22,244,7,281,1,15,0,2
"07/12/2020","Y","Y","Fairbanks North Star Borough",90,"Fairbanks North Star Borough",2,11,255,4,285,1,16,0,2
"07/13/2020","Y","Y","Fairbanks North Star Borough",90,"Fairbanks North Star Borough",2,7,262,15,300,0,16,0,2
"07/14/2020","Y","Y","Fairbanks North Star Borough",90,"Fairbanks North Star Borough",2,5,267,13,313,0,16,0,2
"07/15/2020","Y","Y","Fairbanks North Star Borough",90,"Fairbanks North Star Borough",2,23,290,5,318,0,16,0,2
"07/16/2020","Y","Y","Fairbanks North Star Borough",90,"Fairbanks North Star Borough",2,3,293,9,327,0,16,1,3
"07/17/2020","Y","Y","Fairbanks North Star Borough",90,"Fairbanks North Star Borough",2,9,302,5,332,0,16,0,3
"07/18/2020","Y","Y","Fairbanks North Star Borough",90,"Fairbanks North Star Borough",2,9,311,5,337,0,16,0,3
"07/19/2020","Y","Y","Fairbanks North Star Borough",90,"Fairbanks North Star Borough",2,7,318,6,343,1,17,0,3
"07/20/2020","Y","Y","Fairbanks North Star Borough",90,"Fairbanks North Star Borough",2,4,322,7,350,1,18,0,3
"07/21/2020","Y","Y","Fairbanks North Star Borough",90,"Fairbanks North Star Borough",2,10,332,7,357,0,18,1,4
"07/22/2020","Y","Y","Fairbanks North Star Borough",90,"Fairbanks North Star Borough",2,13,345,12,369,1,19,0,4
"07/23/2020","Y","Y","Fairbanks North Star Borough",90,"Fairbanks North Star Borough",2,5,350,4,373,0,19,0,4
"07/24/2020","Y","Y","Fairbanks North Star Borough",90,"Fairbanks North Star Borough",2,6,356,6,379,0,19,0,4
"07/25/2020","Y","Y","Fairbanks North Star Borough",90,"Fairbanks North Star Borough",2,11,367,9,388,1,20,0,4
"07/26/2020","Y","Y","Fairbanks North Star Borough",90,"Fairbanks North Star Borough",2,3,370,6,394,0,20,1,5
"07/27/2020","Y","Y","Fairbanks North Star Borough",90,"Fairbanks North Star Borough",2,7,377,9,403,0,20,0,5
"07/28/2020","Y","Y","Fairbanks North Star Borough",90,"Fairbanks North Star Borough",2,2,379,4,407,0,20,0,5
"07/29/2020","Y","Y","Fairbanks North Star Borough",90,"Fairbanks North Star Borough",2,5,384,6,413,0,20,0,5
"07/30/2020","Y","Y","Fairbanks North Star Borough",90,"Fairbanks North Star Borough",2,13,397,7,420,0,20,0,5
"07/31/2020","Y","Y","Fairbanks North Star Borough",90,"Fairbanks North Star Borough",2,4,401,3,423,0,20,0,5
"08/01/2020","Y","Y","Fairbanks North Star Borough",90,"Fairbanks North Star Borough",2,3,404,3,426,0,20,0,5
"08/02/2020","Y","Y","Fairbanks North Star Borough",90,"Fairbanks North Star Borough",2,4,408,2,428,0,20,0,5
"08/03/2020","Y","Y","Fairbanks North Star Borough",90,"Fairbanks North Star Borough",2,3,411,7,435,1,21,0,5
"08/04/2020","Y","Y","Fairbanks North Star Borough",90,"Fairbanks North Star Borough",2,2,413,7,442,1,22,0,5
"08/05/2020","Y","Y","Fairbanks North Star Borough",90,"Fairbanks North Star Borough",2,6,419,5,447,1,23,0,5
"08/06/2020","Y","Y","Fairbanks North Star Borough",90,"Fairbanks North Star Borough",2,8,427,7,454,0,23,0,5
"08/07/2020","Y","Y","Fairbanks North Star Borough",90,"Fairbanks North Star Borough",2,4,431,4,458,0,23,0,5
"08/08/2020","Y","Y","Fairbanks North Star Borough",90,"Fairbanks North Star Borough",2,9,440,6,464,0,23,1,6
"08/09/2020","Y","Y","Fairbanks North Star Borough",90,"Fairbanks North Star Borough",2,1,441,3,467,0,23,0,6
"08/10/2020","Y","Y","Fairbanks North Star Borough",90,"Fairbanks North Star Borough",2,2,443,10,477,0,23,0,6
"08/11/2020","Y","Y","Fairbanks North Star Borough",90,"Fairbanks North Star Borough",2,6,449,10,487,0,23,1,7
"08/12/2020","Y","Y","Fairbanks North Star Borough",90,"Fairbanks North Star Borough",2,12,461,11,498,1,24,0,7
"08/13/2020","Y","Y","Fairbanks North Star Borough",90,"Fairbanks North Star Borough",2,2,463,5,503,1,25,1,8
"08/14/2020","Y","Y","Fairbanks North Star Borough",90,"Fairbanks North Star Borough",2,19,482,8,511,1,26,0,8
"08/15/2020","Y","Y","Fairbanks North Star Borough",90,"Fairbanks North Star Borough",2,10,492,7,518,1,27,0,8
"08/16/2020","Y","Y","Fairbanks North Star Borough",90,"Fairbanks North Star Borough",2,4,496,2,520,0,27,0,8
"08/17/2020","Y","Y","Fairbanks North Star Borough",90,"Fairbanks North Star Borough",2,8,504,8,528,0,27,0,8
"08/18/2020","Y","Y","Fairbanks North Star Borough",90,"Fairbanks North Star Borough",2,14,518,10,538,0,27,0,8
"08/19/2020","Y","Y","Fairbanks North Star Borough",90,"Fairbanks North Star Borough",2,11,529,13,551,0,27,0,8
"08/20/2020","Y","Y","Fairbanks North Star Borough",90,"Fairbanks North Star Borough",2,9,538,8,559,0,27,0,8
"08/21/2020","Y","Y","Fairbanks North Star Borough",90,"Fairbanks North Star Borough",2,12,550,19,578,1,28,1,9
"08/22/2020","Y","Y","Fairbanks North Star Borough",90,"Fairbanks North Star Borough",2,12,562,6,584,0,28,0,9
"08/23/2020","Y","Y","Fairbanks North Star Borough",90,"Fairbanks North Star Borough",2,3,565,9,593,0,28,0,9
"08/24/2020","Y","Y","Fairbanks North Star Borough",90,"Fairbanks North Star Borough",2,4,569,5,598,0,28,0,9
"08/25/2020","Y","Y","Fairbanks North Star Borough",90,"Fairbanks North Star Borough",2,10,579,17,615,1,29,0,9
"08/26/2020","Y","Y","Fairbanks North Star Borough",90,"Fairbanks North Star Borough",2,17,596,9,624,0,29,0,9
"08/27/2020","Y","Y","Fairbanks North Star Borough",90,"Fairbanks North Star Borough",2,17,613,15,639,0,29,0,9
"08/28/2020","Y","Y","Fairbanks North Star Borough",90,"Fairbanks North Star Borough",2,13,626,17,656,0,29,0,9
"08/29/2020","Y","Y","Fairbanks North Star Borough",90,"Fairbanks North Star Borough",2,14,640,11,667,0,29,0,9
"08/30/2020","Y","Y","Fairbanks North Star Borough",90,"Fairbanks North Star Borough",2,5,645,7,674,0,29,0,9
"08/31/2020","Y","Y","Fairbanks North Star Borough",90,"Fairbanks North Star Borough",2,4,649,17,691,1,30,0,9
"09/01/2020","Y","Y","Fairbanks North Star Borough",90,"Fairbanks North Star Borough",2,21,670,31,722,0,30,0,9
"09/02/2020","Y","Y","Fairbanks North Star Borough",90,"Fairbanks North Star Borough",2,18,688,15,737,0,30,0,9
"09/03/2020","Y","Y","Fairbanks North Star Borough",90,"Fairbanks North Star Borough",2,21,709,30,767,0,30,0,9
"09/04/2020","Y","Y","Fairbanks North Star Borough",90,"Fairbanks North Star Borough",2,18,727,6,773,0,30,1,10
"09/05/2020","Y","Y","Fairbanks North Star Borough",90,"Fairbanks North Star Borough",2,19,746,5,778,0,30,0,10
"09/06/2020","Y","Y","Fairbanks North Star Borough",90,"Fairbanks North Star Borough",2,8,754,6,784,1,31,0,10
"09/07/2020","Y","Y","Fairbanks North Star Borough",90,"Fairbanks North Star Borough",2,4,758,7,791,1,32,0,10
"09/08/2020","Y","Y","Fairbanks North Star Borough",90,"Fairbanks North Star Borough",2,12,770,27,818,0,32,0,10
"09/09/2020","Y","Y","Fairbanks North Star Borough",90,"Fairbanks North Star Borough",2,31,801,19,837,0,32,0,10
"09/10/2020","Y","Y","Fairbanks North Star Borough",90,"Fairbanks North Star Borough",2,33,834,35,872,0,32,0,10
"09/11/2020","Y","Y","Fairbanks North Star Borough",90,"Fairbanks North Star Borough",2,21,855,17,889,0,32,0,10
"09/12/2020","Y","Y","Fairbanks North Star Borough",90,"Fairbanks North Star Borough",2,15,870,6,895,0,32,0,10
"09/13/2020","Y","Y","Fairbanks North Star Borough",90,"Fairbanks North Star Borough",2,12,882,2,897,0,32,0,10
"09/14/2020","Y","Y","Fairbanks North Star Borough",90,"Fairbanks North Star Borough",2,5,887,22,919,1,33,0,10
"09/15/2020","Y","Y","Fairbanks North Star Borough",90,"Fairbanks North Star Borough",2,18,905,14,933,0,33,0,10
"09/16/2020","Y","Y","Fairbanks North Star Borough",90,"Fairbanks North Star Borough",2,14,919,17,950,0,33,0,10
"09/17/2020","Y","Y","Fairbanks North Star Borough",90,"Fairbanks North Star Borough",2,12,931,16,966,0,33,0,10
"09/18/2020","Y","Y","Fairbanks North Star Borough",90,"Fairbanks North Star Borough",2,11,942,21,987,1,34,0,10
"09/19/2020","Y","Y","Fairbanks North Star Borough",90,"Fairbanks North Star Borough",2,20,962,5,992,0,34,0,10
"09/20/2020","Y","Y","Fairbanks North Star Borough",90,"Fairbanks North Star Borough",2,19,981,12,1004,0,34,0,10
"09/21/2020","Y","Y","Fairbanks North Star Borough",90,"Fairbanks North Star Borough",2,6,987,29,1033,0,34,0,10
"09/22/2020","Y","Y","Fairbanks North Star Borough",90,"Fairbanks North Star Borough",2,14,1001,29,1062,0,34,0,10
"09/23/2020","Y","Y","Fairbanks North Star Borough",90,"Fairbanks North Star Borough",2,11,1012,19,1081,0,34,1,11
"09/24/2020","Y","Y","Fairbanks North Star Borough",90,"Fairbanks North Star Borough",2,31,1043,45,1126,0,34,0,11
"09/25/2020","Y","Y","Fairbanks North Star Borough",90,"Fairbanks North Star Borough",2,22,1065,34,1160,0,34,0,11
"09/26/2020","Y","Y","Fairbanks North Star Borough",90,"Fairbanks North Star Borough",2,28,1093,13,1173,0,34,0,11
"09/27/2020","Y","Y","Fairbanks North Star Borough",90,"Fairbanks North Star Borough",2,15,1108,19,1192,0,34,0,11
"09/28/2020","Y","Y","Fairbanks North Star Borough",90,"Fairbanks North Star Borough",2,17,1125,36,1228,0,34,0,11
"09/29/2020","Y","Y","Fairbanks North Star Borough",90,"Fairbanks North Star Borough",2,15,1140,36,1264,0,34,0,11
"09/30/2020","Y","Y","Fairbanks North Star Borough",90,"Fairbanks North Star Borough",2,33,1173,42,1306,0,34,0,11
"10/01/2020","Y","Y","Fairbanks North Star Borough",90,"Fairbanks North Star Borough",2,39,1212,47,1353,1,35,0,11
"10/02/2020","Y","Y","Fairbanks North Star Borough",90,"Fairbanks North Star Borough",2,37,1249,49,1402,0,35,0,11
"10/03/2020","Y","Y","Fairbanks North Star Borough",90,"Fairbanks North Star Borough",2,42,1291,9,1411,0,35,0,11
"10/04/2020","Y","Y","Fairbanks North Star Borough",90,"Fairbanks North Star Borough",2,54,1345,28,1439,0,35,0,11
"10/05/2020","Y","Y","Fairbanks North Star Borough",90,"Fairbanks North Star Borough",2,28,1373,56,1495,0,35,0,11
"10/06/2020","Y","Y","Fairbanks North Star Borough",90,"Fairbanks North Star Borough",2,37,1410,56,1551,1,36,0,11
"10/07/2020","Y","Y","Fairbanks North Star Borough",90,"Fairbanks North Star Borough",2,27,1437,27,1578,0,36,0,11
"10/08/2020","Y","Y","Fairbanks North Star Borough",90,"Fairbanks North Star Borough",2,43,1480,44,1622,0,36,0,11
"10/09/2020","Y","Y","Fairbanks North Star Borough",90,"Fairbanks North Star Borough",2,33,1513,36,1658,0,36,0,11
"10/10/2020","Y","Y","Fairbanks North Star Borough",90,"Fairbanks North Star Borough",2,36,1549,18,1676,1,37,0,11
"10/11/2020","Y","Y","Fairbanks North Star Borough",90,"Fairbanks North Star Borough",2,46,1595,17,1693,0,37,0,11
"10/12/2020","Y","Y","Fairbanks North Star Borough",90,"Fairbanks North Star Borough",2,30,1625,29,1722,1,38,1,12
"10/13/2020","Y","Y","Fairbanks North Star Borough",90,"Fairbanks North Star Borough",2,17,1642,46,1768,2,40,0,12
"10/14/2020","Y","Y","Fairbanks North Star Borough",90,"Fairbanks North Star Borough",2,27,1669,29,1797,0,40,1,13
"10/15/2020","Y","Y","Fairbanks North Star Borough",90,"Fairbanks North Star Borough",2,30,1699,62,1859,0,40,0,13
"10/16/2020","Y","Y","Fairbanks North Star Borough",90,"Fairbanks North Star Borough",2,24,1723,26,1885,0,40,0,13
"10/17/2020","Y","Y","Fairbanks North Star Borough",90,"Fairbanks North Star Borough",2,33,1756,31,1916,0,40,0,13
"10/18/2020","Y","Y","Fairbanks North Star Borough",90,"Fairbanks North Star Borough",2,56,1812,15,1931,1,41,0,13
"10/19/2020","Y","Y","Fairbanks North Star Borough",90,"Fairbanks North Star Borough",2,27,1839,37,1968,0,41,1,14
"10/20/2020","Y","Y","Fairbanks North Star Borough",90,"Fairbanks North Star Borough",2,5,1844,49,2017,1,42,0,14
"10/21/2020","Y","Y","Fairbanks North Star Borough",90,"Fairbanks North Star Borough",2,4,1848,50,2067,0,42,0,14
"10/22/2020","Y","Y","Fairbanks North Star Borough",90,"Fairbanks North Star Borough",2,23,1871,38,2105,0,42,0,14
"10/23/2020","Y","Y","Fairbanks North Star Borough",90,"Fairbanks North Star Borough",2,26,1897,37,2142,0,42,0,14
"10/24/2020","Y","Y","Fairbanks North Star Borough",90,"Fairbanks North Star Borough",2,77,1974,20,2162,0,42,1,15
"10/25/2020","Y","Y","Fairbanks North Star Borough",90,"Fairbanks North Star Borough",2,44,2018,18,2180,0,42,0,15
"10/26/2020","Y","Y","Fairbanks North Star Borough",90,"Fairbanks North Star Borough",2,62,2080,55,2235,1,43,0,15
"10/27/2020","Y","Y","Fairbanks North Star Borough",90,"Fairbanks North Star Borough",2,34,2114,58,2293,1,44,0,15
"10/28/2020","Y","Y","Fairbanks North Star Borough",90,"Fairbanks North Star Borough",2,15,2129,51,2344,0,44,0,15
"10/29/2020","Y","Y","Fairbanks North Star Borough",90,"Fairbanks North Star Borough",2,21,2150,37,2381,0,44,0,15
"10/30/2020","Y","Y","Fairbanks North Star Borough",90,"Fairbanks North Star Borough",2,39,2189,22,2403,0,44,0,15
"10/31/2020","Y","Y","Fairbanks North Star Borough",90,"Fairbanks North Star Borough",2,37,2226,22,2425,0,44,1,16
"11/01/2020","Y","Y","Fairbanks North Star Borough",90,"Fairbanks North Star Borough",2,47,2273,26,2451,0,44,0,16
"11/02/2020","Y","Y","Fairbanks North Star Borough",90,"Fairbanks North Star Borough",2,38,2311,55,2506,0,44,0,16
"11/03/2020","Y","Y","Fairbanks North Star Borough",90,"Fairbanks North Star Borough",2,55,2366,53,2559,2,46,0,16
"11/04/2020","Y","Y","Fairbanks North Star Borough",90,"Fairbanks North Star Borough",2,26,2392,42,2601,1,47,0,16
"11/05/2020","Y","Y","Fairbanks North Star Borough",90,"Fairbanks North Star Borough",2,5,2397,49,2650,0,47,0,16
"11/06/2020","Y","Y","Fairbanks North Star Borough",90,"Fairbanks North Star Borough",2,28,2425,36,2686,1,48,0,16
"11/07/2020","Y","Y","Fairbanks North Star Borough",90,"Fairbanks North Star Borough",2,27,2452,21,2707,2,50,0,16
"11/08/2020","Y","Y","Fairbanks North Star Borough",90,"Fairbanks North Star Borough",2,46,2498,20,2727,0,50,0,16
"11/09/2020","Y","Y","Fairbanks North Star Borough",90,"Fairbanks North Star Borough",2,40,2538,57,2784,1,51,1,17
"11/10/2020","Y","Y","Fairbanks North Star Borough",90,"Fairbanks North Star Borough",2,12,2550,48,2832,1,52,0,17
"11/11/2020","Y","Y","Fairbanks North Star Borough",90,"Fairbanks North Star Borough",2,39,2589,36,2868,1,53,0,17
"11/12/2020","Y","Y","Fairbanks North Star Borough",90,"Fairbanks North Star Borough",2,63,2652,56,2924,0,53,0,17
"11/13/2020","Y","Y","Fairbanks North Star Borough",90,"Fairbanks North Star Borough",2,80,2732,49,2973,0,53,0,17
"11/14/2020","Y","Y","Fairbanks North Star Borough",90,"Fairbanks North Star Borough",2,69,2801,25,2998,1,54,0,17
"11/15/2020","Y","Y","Fairbanks North Star Borough",90,"Fairbanks North Star Borough",2,18,2819,31,3029,0,54,0,17
"11/16/2020","Y","Y","Fairbanks North Star Borough",90,"Fairbanks North Star Borough",2,22,2841,70,3099,0,54,0,17
"11/17/2020","Y","Y","Fairbanks North Star Borough",90,"Fairbanks North Star Borough",2,42,2883,43,3142,1,55,0,17
"11/18/2020","Y","Y","Fairbanks North Star Borough",90,"Fairbanks North Star Borough",2,50,2933,74,3216,1,56,0,17
"11/19/2020","Y","Y","Fairbanks North Star Borough",90,"Fairbanks North Star Borough",2,32,2965,68,3284,2,58,0,17
"11/20/2020","Y","Y","Fairbanks North Star Borough",90,"Fairbanks North Star Borough",2,93,3058,88,3372,0,58,0,17
"11/21/2020","Y","Y","Fairbanks North Star Borough",90,"Fairbanks North Star Borough",2,46,3104,32,3404,0,58,0,17
"11/22/2020","Y","Y","Fairbanks North Star Borough",90,"Fairbanks North Star Borough",2,39,3143,19,3423,0,58,0,17
"11/23/2020","Y","Y","Fairbanks North Star Borough",90,"Fairbanks North Star Borough",2,21,3164,64,3487,1,59,0,17
"11/24/2020","Y","Y","Fairbanks North Star Borough",90,"Fairbanks North Star Borough",2,26,3190,58,3545,0,59,0,17
"11/25/2020","Y","Y","Fairbanks North Star Borough",90,"Fairbanks North Star Borough",2,21,3211,59,3604,0,59,0,17
"11/26/2020","Y","Y","Fairbanks North Star Borough",90,"Fairbanks North Star Borough",2,45,3256,9,3613,1,60,0,17
"11/27/2020","Y","Y","Fairbanks North Star Borough",90,"Fairbanks North Star Borough",2,44,3300,43,3656,0,60,0,17
"11/28/2020","Y","Y","Fairbanks North Star Borough",90,"Fairbanks North Star Borough",2,77,3377,41,3697,0,60,0,17
"11/29/2020","Y","Y","Fairbanks North Star Borough",90,"Fairbanks North Star Borough",2,15,3392,28,3725,2,62,0,17
"11/30/2020","Y","Y","Fairbanks North Star Borough",90,"Fairbanks North Star Borough",2,13,3405,77,3802,0,62,0,17
"12/01/2020","Y","Y","Fairbanks North Star Borough",90,"Fairbanks North Star Borough",2,15,3420,59,3861,1,63,0,17
"12/02/2020","Y","Y","Fairbanks North Star Borough",90,"Fairbanks North Star Borough",2,30,3450,50,3911,0,63,0,17
"12/03/2020","Y","Y","Fairbanks North Star Borough",90,"Fairbanks North Star Borough",2,36,3486,69,3980,0,63,0,17
"12/04/2020","Y","Y","Fairbanks North Star Borough",90,"Fairbanks North Star Borough",2,135,3621,38,4018,2,65,0,17
"12/05/2020","Y","Y","Fairbanks North Star Borough",90,"Fairbanks North Star Borough",2,34,3655,23,4041,2,67,0,17
"12/06/2020","Y","Y","Fairbanks North Star Borough",90,"Fairbanks North Star Borough",2,43,3698,19,4060,1,68,0,17
"12/07/2020","Y","Y","Fairbanks North Star Borough",90,"Fairbanks North Star Borough",2,78,3776,45,4105,0,68,0,17
"12/08/2020","Y","Y","Fairbanks North Star Borough",90,"Fairbanks North Star Borough",2,75,3851,65,4170,0,68,0,17
"12/09/2020","Y","Y","Fairbanks North Star Borough",90,"Fairbanks North Star Borough",2,125,3976,55,4225,1,69,3,20
"12/10/2020","Y","Y","Fairbanks North Star Borough",90,"Fairbanks North Star Borough",2,84,4060,39,4264,1,70,0,20
"12/11/2020","Y","Y","Fairbanks North Star Borough",90,"Fairbanks North Star Borough",2,68,4128,44,4308,0,70,0,20
"12/12/2020","Y","Y","Fairbanks North Star Borough",90,"Fairbanks North Star Borough",2,45,4173,36,4344,0,70,0,20
"12/13/2020","Y","Y","Fairbanks North Star Borough",90,"Fairbanks North Star Borough",2,83,4256,18,4362,1,71,0,20
"12/14/2020","Y","Y","Fairbanks North Star Borough",90,"Fairbanks North Star Borough",2,27,4283,42,4404,0,71,0,20
"12/15/2020","Y","Y","Fairbanks North Star Borough",90,"Fairbanks North Star Borough",2,48,4331,59,4463,0,71,0,20
"12/16/2020","Y","Y","Fairbanks North Star Borough",90,"Fairbanks North Star Borough",2,32,4363,36,4499,0,71,0,20
"12/17/2020","Y","Y","Fairbanks North Star Borough",90,"Fairbanks North Star Borough",2,90,4453,35,4534,0,71,0,20
"12/18/2020","Y","Y","Fairbanks North Star Borough",90,"Fairbanks North Star Borough",2,26,4479,43,4577,0,71,0,20
"12/19/2020","Y","Y","Fairbanks North Star Borough",90,"Fairbanks North Star Borough",2,7,4486,15,4592,0,71,0,20
"12/20/2020","Y","Y","Fairbanks North Star Borough",90,"Fairbanks North Star Borough",2,13,4499,11,4603,1,72,0,20
"12/21/2020","Y","Y","Fairbanks North Star Borough",90,"Fairbanks North Star Borough",2,20,4519,47,4650,1,73,0,20
"12/22/2020","Y","Y","Fairbanks North Star Borough",90,"Fairbanks North Star Borough",2,42,4561,26,4676,1,74,0,20
"12/23/2020","Y","Y","Fairbanks North Star Borough",90,"Fairbanks North Star Borough",2,32,4593,28,4704,0,74,0,20
"12/24/2020","Y","Y","Fairbanks North Star Borough",90,"Fairbanks North Star Borough",2,17,4610,11,4715,0,74,0,20
"12/25/2020","Y","Y","Fairbanks North Star Borough",90,"Fairbanks North Star Borough",2,40,4650,7,4722,0,74,0,20
"12/26/2020","Y","Y","Fairbanks North Star Borough",90,"Fairbanks North Star Borough",2,56,4706,24,4746,4,78,0,20
"12/27/2020","Y","Y","Fairbanks North Star Borough",90,"Fairbanks North Star Borough",2,6,4712,29,4775,2,80,0,20
"12/28/2020","Y","Y","Fairbanks North Star Borough",90,"Fairbanks North Star Borough",2,29,4741,57,4832,0,80,0,20
"12/29/2020","Y","Y","Fairbanks North Star Borough",90,"Fairbanks North Star Borough",2,29,4770,54,4886,0,80,1,21
"12/30/2020","Y","Y","Fairbanks North Star Borough",90,"Fairbanks North Star Borough",2,36,4806,37,4923,0,80,0,21
"12/31/2020","Y","Y","Fairbanks North Star Borough",90,"Fairbanks North Star Borough",2,53,4859,51,4974,2,82,0,21
"01/01/2021","Y","Y","Fairbanks North Star Borough",90,"Fairbanks North Star Borough",2,52,4911,12,4986,2,84,0,21
"01/02/2021","Y","Y","Fairbanks North Star Borough",90,"Fairbanks North Star Borough",2,11,4922,56,5042,0,84,0,21
"01/03/2021","Y","Y","Fairbanks North Star Borough",90,"Fairbanks North Star Borough",2,18,4940,41,5083,0,84,0,21
"01/04/2021","Y","Y","Fairbanks North Star Borough",90,"Fairbanks North Star Borough",2,42,4982,64,5147,1,85,0,21
"01/05/2021","Y","Y","Fairbanks North Star Borough",90,"Fairbanks North Star Borough",2,67,5049,58,5205,2,87,0,21
"01/06/2021","Y","Y","Fairbanks North Star Borough",90,"Fairbanks North Star Borough",2,39,5088,47,5252,4,91,0,21
"01/07/2021","Y","Y","Fairbanks North Star Borough",90,"Fairbanks North Star Borough",2,43,5131,34,5286,1,92,1,22
"01/08/2021","Y","Y","Fairbanks North Star Borough",90,"Fairbanks North Star Borough",2,72,5203,45,5331,0,92,0,22
"01/09/2021","Y","Y","Fairbanks North Star Borough",90,"Fairbanks North Star Borough",2,32,5235,20,5351,2,94,0,22
"01/10/2021","Y","Y","Fairbanks North Star Borough",90,"Fairbanks North Star Borough",2,31,5266,17,5368,2,96,1,23
"01/11/2021","Y","Y","Fairbanks North Star Borough",90,"Fairbanks North Star Borough",2,24,5290,41,5409,0,96,0,23
"01/12/2021","Y","Y","Fairbanks North Star Borough",90,"Fairbanks North Star Borough",2,48,5338,30,5439,1,97,0,23
"01/13/2021","Y","Y","Fairbanks North Star Borough",90,"Fairbanks North Star Borough",2,51,5389,39,5478,0,97,2,25
"01/14/2021","Y","Y","Fairbanks North Star Borough",90,"Fairbanks North Star Borough",2,45,5434,21,5499,0,97,0,25
"01/15/2021","Y","Y","Fairbanks North Star Borough",90,"Fairbanks North Star Borough",2,17,5451,23,5522,2,99,0,25
"01/16/2021","Y","Y","Fairbanks North Star Borough",90,"Fairbanks North Star Borough",2,36,5487,14,5536,0,99,0,25
"01/17/2021","Y","Y","Fairbanks North Star Borough",90,"Fairbanks North Star Borough",2,12,5499,18,5554,1,100,1,26
"01/18/2021","Y","Y","Fairbanks North Star Borough",90,"Fairbanks North Star Borough",2,5,5504,15,5569,0,100,1,27
"01/19/2021","Y","Y","Fairbanks North Star Borough",90,"Fairbanks North Star Borough",2,26,5530,28,5597,0,100,0,27
"01/20/2021","Y","Y","Fairbanks North Star Borough",90,"Fairbanks North Star Borough",2,27,5557,24,5621,0,100,0,27
"01/21/2021","Y","Y","Fairbanks North Star Borough",90,"Fairbanks North Star Borough",2,34,5591,17,5638,1,101,0,27
"01/22/2021","Y","Y","Fairbanks North Star Borough",90,"Fairbanks North Star Borough",2,27,5618,18,5656,0,101,0,27
"01/23/2021","Y","Y","Fairbanks North Star Borough",90,"Fairbanks North Star Borough",2,18,5636,8,5664,1,102,0,27
"01/24/2021","Y","Y","Fairbanks North Star Borough",90,"Fairbanks North Star Borough",2,5,5641,6,5670,0,102,0,27
"01/25/2021","Y","Y","Fairbanks North Star Borough",90,"Fairbanks North Star Borough",2,8,5649,16,5686,0,102,1,28
"01/26/2021","Y","Y","Fairbanks North Star Borough",90,"Fairbanks North Star Borough",2,5,5654,13,5699,0,102,1,29
"01/27/2021","Y","Y","Fairbanks North Star Borough",90,"Fairbanks North Star Borough",2,24,5678,9,5708,1,103,0,29
"01/28/2021","Y","Y","Fairbanks North Star Borough",90,"Fairbanks North Star Borough",2,13,5691,16,5724,0,103,0,29
"01/29/2021","Y","Y","Fairbanks North Star Borough",90,"Fairbanks North Star Borough",2,6,5697,11,5735,0,103,0,29
"01/30/2021","Y","Y","Fairbanks North Star Borough",90,"Fairbanks North Star Borough",2,14,5711,5,5740,0,103,0,29
"01/31/2021","Y","Y","Fairbanks North Star Borough",90,"Fairbanks North Star Borough",2,4,5715,8,5748,0,103,1,30
"02/01/2021","Y","Y","Fairbanks North Star Borough",90,"Fairbanks North Star Borough",2,12,5727,22,5770,0,103,0,30
"02/02/2021","Y","Y","Fairbanks North Star Borough",90,"Fairbanks North Star Borough",2,17,5744,17,5787,0,103,0,30
"02/03/2021","Y","Y","Fairbanks North Star Borough",90,"Fairbanks North Star Borough",2,20,5764,19,5806,2,105,0,30
"02/04/2021","Y","Y","Fairbanks North Star Borough",90,"Fairbanks North Star Borough",2,14,5778,6,5812,0,105,0,30
"02/05/2021","Y","Y","Fairbanks North Star Borough",90,"Fairbanks North Star Borough",2,15,5793,11,5823,0,105,0,30
"02/06/2021","Y","Y","Fairbanks North Star Borough",90,"Fairbanks North Star Borough",2,17,5810,7,5830,0,105,0,30
"02/07/2021","Y","Y","Fairbanks North Star Borough",90,"Fairbanks North Star Borough",2,2,5812,4,5834,0,105,0,30
"02/08/2021","Y","Y","Fairbanks North Star Borough",90,"Fairbanks North Star Borough",2,3,5815,18,5852,0,105,0,30
"02/09/2021","Y","Y","Fairbanks North Star Borough",90,"Fairbanks North Star Borough",2,21,5836,10,5862,0,105,0,30
"02/10/2021","Y","Y","Fairbanks North Star Borough",90,"Fairbanks North Star Borough",2,12,5848,9,5871,0,105,0,30
"02/11/2021","Y","Y","Fairbanks North Star Borough",90,"Fairbanks North Star Borough",2,8,5856,16,5887,0,105,0,30
"02/12/2021","Y","Y","Fairbanks North Star Borough",90,"Fairbanks North Star Borough",2,19,5875,14,5901,0,105,0,30
"02/13/2021","Y","Y","Fairbanks North Star Borough",90,"Fairbanks North Star Borough",2,5,5880,4,5905,0,105,0,30
"02/14/2021","Y","Y","Fairbanks North Star Borough",90,"Fairbanks North Star Borough",2,4,5884,9,5914,1,106,0,30
"02/15/2021","Y","Y","Fairbanks North Star Borough",90,"Fairbanks North Star Borough",2,10,5894,14,5928,0,106,0,30
"02/16/2021","Y","Y","Fairbanks North Star Borough",90,"Fairbanks North Star Borough",2,4,5898,21,5949,0,106,0,30
"02/17/2021","Y","Y","Fairbanks North Star Borough",90,"Fairbanks North Star Borough",2,24,5922,23,5972,1,107,0,30
"02/18/2021","Y","Y","Fairbanks North Star Borough",90,"Fairbanks North Star Borough",2,19,5941,13,5985,1,108,0,30
"02/19/2021","Y","Y","Fairbanks North Star Borough",90,"Fairbanks North Star Borough",2,23,5964,13,5998,0,108,0,30
"02/20/2021","Y","Y","Fairbanks North Star Borough",90,"Fairbanks North Star Borough",2,15,5979,10,6008,0,108,0,30
"02/21/2021","Y","Y","Fairbanks North Star Borough",90,"Fairbanks North Star Borough",2,5,5984,5,6013,0,108,0,30
"02/22/2021","Y","Y","Fairbanks North Star Borough",90,"Fairbanks North Star Borough",2,5,5989,23,6036,1,109,0,30
"02/23/2021","Y","Y","Fairbanks North Star Borough",90,"Fairbanks North Star Borough",2,25,6014,22,6058,0,109,0,30
"02/24/2021","Y","Y","Fairbanks North Star Borough",90,"Fairbanks North Star Borough",2,25,6039,16,6074,2,111,0,30
"02/25/2021","Y","Y","Fairbanks North Star Borough",90,"Fairbanks North Star Borough",2,10,6049,6,6080,0,111,0,30
"02/26/2021","Y","Y","Fairbanks North Star Borough",90,"Fairbanks North Star Borough",2,14,6063,4,6084,0,111,0,30
"02/27/2021","Y","Y","Fairbanks North Star Borough",90,"Fairbanks North Star Borough",2,15,6078,9,6093,0,111,1,31
"02/28/2021","Y","Y","Fairbanks North Star Borough",90,"Fairbanks North Star Borough",2,3,6081,6,6099,0,111,0,31
"03/01/2021","Y","Y","Fairbanks North Star Borough",90,"Fairbanks North Star Borough",2,12,6093,19,6118,2,113,0,31
"03/02/2021","Y","Y","Fairbanks North Star Borough",90,"Fairbanks North Star Borough",2,20,6113,20,6138,1,114,0,31
"03/03/2021","Y","Y","Fairbanks North Star Borough",90,"Fairbanks North Star Borough",2,17,6130,15,6153,2,116,0,31
"03/04/2021","Y","Y","Fairbanks North Star Borough",90,"Fairbanks North Star Borough",2,13,6143,21,6174,0,116,1,32
"03/05/2021","Y","Y","Fairbanks North Star Borough",90,"Fairbanks North Star Borough",2,12,6155,8,6182,0,116,0,32
"03/06/2021","Y","Y","Fairbanks North Star Borough",90,"Fairbanks North Star Borough",2,13,6168,14,6196,0,116,1,33
"03/07/2021","Y","Y","Fairbanks North Star Borough",90,"Fairbanks North Star Borough",2,15,6183,6,6202,1,117,0,33
"03/08/2021","Y","Y","Fairbanks North Star Borough",90,"Fairbanks North Star Borough",2,5,6188,23,6225,0,117,0,33
"03/09/2021","Y","Y","Fairbanks North Star Borough",90,"Fairbanks North Star Borough",2,17,6205,18,6243,0,117,0,33
"03/10/2021","Y","Y","Fairbanks North Star Borough",90,"Fairbanks North Star Borough",2,24,6229,14,6257,2,119,0,33
"03/11/2021","Y","Y","Fairbanks North Star Borough",90,"Fairbanks North Star Borough",2,5,6234,5,6262,0,119,0,33
"03/12/2021","Y","Y","Fairbanks North Star Borough",90,"Fairbanks North Star Borough",2,19,6253,7,6269,0,119,1,34
"03/13/2021","Y","Y","Fairbanks North Star Borough",90,"Fairbanks North Star Borough",2,5,6258,6,6275,0,119,0,34
"03/14/2021","Y","Y","Fairbanks North Star Borough",90,"Fairbanks North Star Borough",2,8,6266,10,6285,0,119,0,34
"03/15/2021","Y","Y","Fairbanks North Star Borough",90,"Fairbanks North Star Borough",2,14,6280,21,6306,0,119,0,34
"03/16/2021","Y","Y","Fairbanks North Star Borough",90,"Fairbanks North Star Borough",2,16,6296,22,6328,0,119,0,34
"03/17/2021","Y","Y","Fairbanks North Star Borough",90,"Fairbanks North Star Borough",2,19,6315,12,6340,1,120,0,34
"03/18/2021","Y","Y","Fairbanks North Star Borough",90,"Fairbanks North Star Borough",2,3,6318,9,6349,0,120,1,35
"03/19/2021","Y","Y","Fairbanks North Star Borough",90,"Fairbanks North Star Borough",2,25,6343,11,6360,0,120,1,36
"03/20/2021","Y","Y","Fairbanks North Star Borough",90,"Fairbanks North Star Borough",2,6,6349,8,6368,0,120,0,36
"03/21/2021","Y","Y","Fairbanks North Star Borough",90,"Fairbanks North Star Borough",2,2,6351,9,6377,1,121,0,36
"03/22/2021","Y","Y","Fairbanks North Star Borough",90,"Fairbanks North Star Borough",2,13,6364,18,6395,1,122,0,36
"03/23/2021","Y","Y","Fairbanks North Star Borough",90,"Fairbanks North Star Borough",2,8,6372,8,6403,0,122,0,36
"03/24/2021","Y","Y","Fairbanks North Star Borough",90,"Fairbanks North Star Borough",2,14,6386,17,6420,0,122,0,36
"03/25/2021","Y","Y","Fairbanks North Star Borough",90,"Fairbanks North Star Borough",2,6,6392,29,6449,1,123,0,36
"03/26/2021","Y","Y","Fairbanks North Star Borough",90,"Fairbanks North Star Borough",2,14,6406,29,6478,0,123,0,36
"03/27/2021","Y","Y","Fairbanks North Star Borough",90,"Fairbanks North Star Borough",2,30,6436,12,6490,2,125,0,36
"03/28/2021","Y","Y","Fairbanks North Star Borough",90,"Fairbanks North Star Borough",2,19,6455,7,6497,0,125,0,36
"03/29/2021","Y","Y","Fairbanks North Star Borough",90,"Fairbanks North Star Borough",2,7,6462,33,6530,0,125,0,36
"03/30/2021","Y","Y","Fairbanks North Star Borough",90,"Fairbanks North Star Borough",2,24,6486,20,6550,0,125,0,36
"03/31/2021","Y","Y","Fairbanks North Star Borough",90,"Fairbanks North Star Borough",2,14,6500,15,6565,1,126,0,36
"04/01/2021","Y","Y","Fairbanks North Star Borough",90,"Fairbanks North Star Borough",2,28,6528,20,6585,0,126,0,36
"04/02/2021","Y","Y","Fairbanks North Star Borough",90,"Fairbanks North Star Borough",2,18,6546,10,6595,0,126,0,36
"04/03/2021","Y","Y","Fairbanks North Star Borough",90,"Fairbanks North Star Borough",2,16,6562,19,6614,0,126,0,36
"04/04/2021","Y","Y","Fairbanks North Star Borough",90,"Fairbanks North Star Borough",2,9,6571,6,6620,0,126,0,36
"04/05/2021","Y","Y","Fairbanks North Star Borough",90,"Fairbanks North Star Borough",2,5,6576,26,6646,0,126,0,36
"04/06/2021","Y","Y","Fairbanks North Star Borough",90,"Fairbanks North Star Borough",2,11,6587,24,6670,1,127,0,36
"04/07/2021","Y","Y","Fairbanks North Star Borough",90,"Fairbanks North Star Borough",2,35,6622,26,6696,1,128,0,36
"04/08/2021","Y","Y","Fairbanks North Star Borough",90,"Fairbanks North Star Borough",2,32,6654,15,6711,0,128,0,36
"04/09/2021","Y","Y","Fairbanks North Star Borough",90,"Fairbanks North Star Borough",2,14,6668,13,6724,0,128,0,36
"04/10/2021","Y","Y","Fairbanks North Star Borough",90,"Fairbanks North Star Borough",2,9,6677,9,6733,1,129,0,36
"04/11/2021","Y","Y","Fairbanks North Star Borough",90,"Fairbanks North Star Borough",2,11,6688,15,6748,1,130,0,36
"04/12/2021","Y","Y","Fairbanks North Star Borough",90,"Fairbanks North Star Borough",2,12,6700,21,6769,1,131,0,36
"04/13/2021","Y","Y","Fairbanks North Star Borough",90,"Fairbanks North Star Borough",2,23,6723,26,6795,0,131,0,36
"04/14/2021","Y","Y","Fairbanks North Star Borough",90,"Fairbanks North Star Borough",2,17,6740,32,6827,2,133,0,36
"04/15/2021","Y","Y","Fairbanks North Star Borough",90,"Fairbanks North Star Borough",2,33,6773,25,6852,0,133,0,36
"04/16/2021","Y","Y","Fairbanks North Star Borough",90,"Fairbanks North Star Borough",2,17,6790,38,6890,0,133,0,36
"04/17/2021","Y","Y","Fairbanks North Star Borough",90,"Fairbanks North Star Borough",2,18,6808,33,6923,0,133,0,36
"04/18/2021","Y","Y","Fairbanks North Star Borough",90,"Fairbanks North Star Borough",2,16,6824,25,6948,1,134,0,36
"04/19/2021","Y","Y","Fairbanks North Star Borough",90,"Fairbanks North Star Borough",2,28,6852,67,7015,3,137,0,36
"04/20/2021","Y","Y","Fairbanks North Star Borough",90,"Fairbanks North Star Borough",2,42,6894,72,7087,1,138,0,36
"04/21/2021","Y","Y","Fairbanks North Star Borough",90,"Fairbanks North Star Borough",2,108,7002,62,7149,0,138,0,36
"04/22/2021","Y","Y","Fairbanks North Star Borough",90,"Fairbanks North Star Borough",2,34,7036,59,7208,0,138,1,37
"04/23/2021","Y","Y","Fairbanks North Star Borough",90,"Fairbanks North Star Borough",2,46,7082,52,7260,1,139,0,37
"04/24/2021","Y","Y","Fairbanks North Star Borough",90,"Fairbanks North Star Borough",2,101,7183,25,7285,2,141,0,37
"04/25/2021","Y","Y","Fairbanks North Star Borough",90,"Fairbanks North Star Borough",2,14,7197,18,7303,1,142,1,38
"04/26/2021","Y","Y","Fairbanks North Star Borough",90,"Fairbanks North Star Borough",2,74,7271,71,7374,2,144,0,38
"04/27/2021","Y","Y","Fairbanks North Star Borough",90,"Fairbanks North Star Borough",2,58,7329,44,7418,3,147,0,38
"04/28/2021","Y","Y","Fairbanks North Star Borough",90,"Fairbanks North Star Borough",2,53,7382,42,7460,1,148,0,38
"04/29/2021","Y","Y","Fairbanks North Star Borough",90,"Fairbanks North Star Borough",2,40,7422,28,7488,2,150,0,38
"04/30/2021","Y","Y","Fairbanks North Star Borough",90,"Fairbanks North Star Borough",2,22,7444,38,7526,1,151,0,38
"05/01/2021","Y","Y","Fairbanks North Star Borough",90,"Fairbanks North Star Borough",2,43,7487,23,7549,1,152,0,38
"05/02/2021","Y","Y","Fairbanks North Star Borough",90,"Fairbanks North Star Borough",2,19,7506,12,7561,0,152,0,38
"05/03/2021","Y","Y","Fairbanks North Star Borough",90,"Fairbanks North Star Borough",2,29,7535,27,7588,3,155,1,39
"05/04/2021","Y","Y","Fairbanks North Star Borough",90,"Fairbanks North Star Borough",2,32,7567,27,7615,0,155,0,39
"05/05/2021","Y","Y","Fairbanks North Star Borough",90,"Fairbanks North Star Borough",2,23,7590,20,7635,0,155,0,39
"05/06/2021","Y","Y","Fairbanks North Star Borough",90,"Fairbanks North Star Borough",2,19,7609,10,7645,0,155,1,40
"05/07/2021","Y","Y","Fairbanks North Star Borough",90,"Fairbanks North Star Borough",2,14,7623,10,7655,1,156,1,41
"05/08/2021","Y","Y","Fairbanks North Star Borough",90,"Fairbanks North Star Borough",2,13,7636,6,7661,0,156,1,42
"05/09/2021","Y","Y","Fairbanks North Star Borough",90,"Fairbanks North Star Borough",2,15,7651,4,7665,0,156,2,44
"05/10/2021","Y","Y","Fairbanks North Star Borough",90,"Fairbanks North Star Borough",2,3,7654,20,7685,0,156,1,45
"05/11/2021","Y","Y","Fairbanks North Star Borough",90,"Fairbanks North Star Borough",2,20,7674,13,7698,0,156,0,45
"05/12/2021","Y","Y","Fairbanks North Star Borough",90,"Fairbanks North Star Borough",2,14,7688,13,7711,0,156,0,45
"05/13/2021","Y","Y","Fairbanks North Star Borough",90,"Fairbanks North Star Borough",2,9,7697,6,7717,0,156,1,46
"05/14/2021","Y","Y","Fairbanks North Star Borough",90,"Fairbanks North Star Borough",2,7,7704,14,7731,0,156,0,46
"05/15/2021","Y","Y","Fairbanks North Star Borough",90,"Fairbanks North Star Borough",2,9,7713,4,7735,0,156,0,46
"05/16/2021","Y","Y","Fairbanks North Star Borough",90,"Fairbanks North Star Borough",2,6,7719,4,7739,0,156,0,46
"05/17/2021","Y","Y","Fairbanks North Star Borough",90,"Fairbanks North Star Borough",2,3,7722,10,7749,0,156,0,46
"05/18/2021","Y","Y","Fairbanks North Star Borough",90,"Fairbanks North Star Borough",2,13,7735,11,7760,1,157,0,46
"05/19/2021","Y","Y","Fairbanks North Star Borough",90,"Fairbanks North Star Borough",2,14,7749,6,7766,0,157,0,46
"05/20/2021","Y","Y","Fairbanks North Star Borough",90,"Fairbanks North Star Borough",2,7,7756,3,7769,2,159,0,46
"05/21/2021","Y","Y","Fairbanks North Star Borough",90,"Fairbanks North Star Borough",2,7,7763,3,7772,0,159,0,46
"05/22/2021","Y","Y","Fairbanks North Star Borough",90,"Fairbanks North Star Borough",2,0,7763,4,7776,0,159,0,46
"05/23/2021","Y","Y","Fairbanks North Star Borough",90,"Fairbanks North Star Borough",2,2,7765,1,7777,0,159,0,46
"05/24/2021","Y","Y","Fairbanks North Star Borough",90,"Fairbanks North Star Borough",2,10,7775,9,7786,1,160,0,46
"05/25/2021","Y","Y","Fairbanks North Star Borough",90,"Fairbanks North Star Borough",2,6,7781,6,7792,0,160,0,46
"05/26/2021","Y","Y","Fairbanks North Star Borough",90,"Fairbanks North Star Borough",2,5,7786,4,7796,0,160,0,46
"05/27/2021","Y","Y","Fairbanks North Star Borough",90,"Fairbanks North Star Borough",2,3,7789,7,7803,0,160,1,47
"05/28/2021","Y","Y","Fairbanks North Star Borough",90,"Fairbanks North Star Borough",2,6,7795,5,7808,0,160,0,47
"05/29/2021","Y","Y","Fairbanks North Star Borough",90,"Fairbanks North Star Borough",2,1,7796,3,7811,1,161,0,47
"05/30/2021","Y","Y","Fairbanks North Star Borough",90,"Fairbanks North Star Borough",2,7,7803,1,7812,0,161,0,47
"05/31/2021","Y","Y","Fairbanks North Star Borough",90,"Fairbanks North Star Borough",2,0,7803,2,7814,0,161,0,47
"06/01/2021","Y","Y","Fairbanks North Star Borough",90,"Fairbanks North Star Borough",2,6,7809,5,7819,0,161,0,47
"06/02/2021","Y","Y","Fairbanks North Star Borough",90,"Fairbanks North Star Borough",2,6,7815,1,7820,0,161,0,47
"06/03/2021","Y","Y","Fairbanks North Star Borough",90,"Fairbanks North Star Borough",2,2,7817,3,7823,0,161,0,47
"06/04/2021","Y","Y","Fairbanks North Star Borough",90,"Fairbanks North Star Borough",2,1,7818,0,7823,1,162,0,47
"06/07/2021","Y","Y","Fairbanks North Star Borough",90,"Fairbanks North Star Borough",2,3,7821,3,7826,0,162,0,47
"06/08/2021","Y","Y","Fairbanks North Star Borough",90,"Fairbanks North Star Borough",2,1,7822,0,7826,0,162,0,47
"06/09/2021","Y","Y","Fairbanks North Star Borough",90,"Fairbanks North Star Borough",2,0,7822,1,7827,0,162,0,47
"06/10/2021","Y","Y","Fairbanks North Star Borough",90,"Fairbanks North Star Borough",2,1,7823,0,7827,0,162,0,47
"06/11/2021","Y","Y","Fairbanks North Star Borough",90,"Fairbanks North Star Borough",2,1,7824,1,7828,0,162,0,47
"06/12/2021","Y","Y","Fairbanks North Star Borough",90,"Fairbanks North Star Borough",2,1,7825,2,7830,0,162,0,47
"06/14/2021","Y","Y","Fairbanks North Star Borough",90,"Fairbanks North Star Borough",2,2,7827,2,7832,0,162,0,47
"06/15/2021","Y","Y","Fairbanks North Star Borough",90,"Fairbanks North Star Borough",2,0,7827,1,7833,0,162,0,47
"06/16/2021","Y","Y","Fairbanks North Star Borough",90,"Fairbanks North Star Borough",2,2,7829,1,7834,0,162,0,47
"06/17/2021","Y","Y","Fairbanks North Star Borough",90,"Fairbanks North Star Borough",2,2,7831,3,7837,0,162,0,47
"06/18/2021","Y","Y","Fairbanks North Star Borough",90,"Fairbanks North Star Borough",2,2,7833,1,7838,0,162,0,47
"06/19/2021","Y","Y","Fairbanks North Star Borough",90,"Fairbanks North Star Borough",2,1,7834,0,7838,0,162,0,47
"06/20/2021","Y","Y","Fairbanks North Star Borough",90,"Fairbanks North Star Borough",2,1,7835,0,7838,0,162,0,47
"06/21/2021","Y","Y","Fairbanks North Star Borough",90,"Fairbanks North Star Borough",2,1,7836,1,7839,0,162,0,47
"06/22/2021","Y","Y","Fairbanks North Star Borough",90,"Fairbanks North Star Borough",2,1,7837,0,7839,0,162,0,47
"06/25/2021","Y","Y","Fairbanks North Star Borough",90,"Fairbanks North Star Borough",2,0,7837,1,7840,0,162,0,47
"06/28/2021","Y","Y","Fairbanks North Star Borough",90,"Fairbanks North Star Borough",2,0,7837,3,7843,0,162,0,47
"06/30/2021","Y","Y","Fairbanks North Star Borough",90,"Fairbanks North Star Borough",2,2,7839,1,7844,0,162,0,47
"07/01/2021","Y","Y","Fairbanks North Star Borough",90,"Fairbanks North Star Borough",2,1,7840,2,7846,0,162,0,47
"07/02/2021","Y","Y","Fairbanks North Star Borough",90,"Fairbanks North Star Borough",2,4,7844,1,7847,0,162,0,47
"07/04/2021","Y","Y","Fairbanks North Star Borough",90,"Fairbanks North Star Borough",2,1,7845,0,7847,0,162,0,47
"07/06/2021","Y","Y","Fairbanks North Star Borough",90,"Fairbanks North Star Borough",2,0,7845,3,7850,0,162,0,47
"07/07/2021","Y","Y","Fairbanks North Star Borough",90,"Fairbanks North Star Borough",2,2,7847,1,7851,0,162,0,47
"07/08/2021","Y","Y","Fairbanks North Star Borough",90,"Fairbanks North Star Borough",2,1,7848,1,7852,0,162,0,47
"07/09/2021","Y","Y","Fairbanks North Star Borough",90,"Fairbanks North Star Borough",2,2,7850,2,7854,1,163,0,47
"07/10/2021","Y","Y","Fairbanks North Star Borough",90,"Fairbanks North Star Borough",2,2,7852,1,7855,0,163,0,47
"07/11/2021","Y","Y","Fairbanks North Star Borough",90,"Fairbanks North Star Borough",2,1,7853,0,7855,0,163,0,47
"07/12/2021","Y","Y","Fairbanks North Star Borough",90,"Fairbanks North Star Borough",2,0,7853,5,7860,0,163,0,47
"07/13/2021","Y","Y","Fairbanks North Star Borough",90,"Fairbanks North Star Borough",2,2,7855,4,7864,0,163,0,47
"07/14/2021","Y","Y","Fairbanks North Star Borough",90,"Fairbanks North Star Borough",2,4,7859,5,7869,0,163,0,47
"07/15/2021","Y","Y","Fairbanks North Star Borough",90,"Fairbanks North Star Borough",2,8,7867,7,7876,1,164,0,47
"07/16/2021","Y","Y","Fairbanks North Star Borough",90,"Fairbanks North Star Borough",2,5,7872,9,7885,0,164,0,47
"07/17/2021","Y","Y","Fairbanks North Star Borough",90,"Fairbanks North Star Borough",2,3,7875,5,7890,0,164,0,47
"07/18/2021","Y","Y","Fairbanks North Star Borough",90,"Fairbanks North Star Borough",2,2,7877,6,7896,0,164,0,47
"07/19/2021","Y","Y","Fairbanks North Star Borough",90,"Fairbanks North Star Borough",2,12,7889,9,7905,0,164,0,47
"07/20/2021","Y","Y","Fairbanks North Star Borough",90,"Fairbanks North Star Borough",2,3,7892,12,7917,0,164,0,47
"07/21/2021","Y","Y","Fairbanks North Star Borough",90,"Fairbanks North Star Borough",2,15,7907,11,7928,1,165,0,47
"07/22/2021","Y","Y","Fairbanks North Star Borough",90,"Fairbanks North Star Borough",2,10,7917,15,7943,0,165,0,47
"07/23/2021","Y","Y","Fairbanks North Star Borough",90,"Fairbanks North Star Borough",2,9,7926,16,7959,0,165,0,47
"07/24/2021","Y","Y","Fairbanks North Star Borough",90,"Fairbanks North Star Borough",2,5,7931,8,7967,1,166,0,47
"07/25/2021","Y","Y","Fairbanks North Star Borough",90,"Fairbanks North Star Borough",2,9,7940,9,7976,0,166,0,47
"07/26/2021","Y","Y","Fairbanks North Star Borough",90,"Fairbanks North Star Borough",2,10,7950,19,7995,0,166,0,47
"07/27/2021","Y","Y","Fairbanks North Star Borough",90,"Fairbanks North Star Borough",2,14,7964,20,8015,2,168,1,48
"07/28/2021","Y","Y","Fairbanks North Star Borough",90,"Fairbanks North Star Borough",2,26,7990,18,8033,1,169,0,48
"07/29/2021","Y","Y","Fairbanks North Star Borough",90,"Fairbanks North Star Borough",2,13,8003,7,8040,0,169,0,48
"07/30/2021","Y","Y","Fairbanks North Star Borough",90,"Fairbanks North Star Borough",2,9,8012,20,8060,1,170,0,48
"07/31/2021","Y","Y","Fairbanks North Star Borough",90,"Fairbanks North Star Borough",2,12,8024,9,8069,0,170,1,49
"08/01/2021","Y","Y","Fairbanks North Star Borough",90,"Fairbanks North Star Borough",2,15,8039,12,8081,0,170,0,49
"08/02/2021","Y","Y","Fairbanks North Star Borough",90,"Fairbanks North Star Borough",2,18,8057,29,8110,1,171,0,49
"08/03/2021","Y","Y","Fairbanks North Star Borough",90,"Fairbanks North Star Borough",2,19,8076,23,8133,2,173,0,49
"08/04/2021","Y","Y","Fairbanks North Star Borough",90,"Fairbanks North Star Borough",2,25,8101,34,8167,0,173,1,50
"08/05/2021","Y","Y","Fairbanks North Star Borough",90,"Fairbanks North Star Borough",2,9,8110,19,8186,0,173,1,51
"08/06/2021","Y","Y","Fairbanks North Star Borough",90,"Fairbanks North Star Borough",2,23,8133,18,8204,1,174,0,51
"08/07/2021","Y","Y","Fairbanks North Star Borough",90,"Fairbanks North Star Borough",2,9,8142,14,8218,2,176,0,51
"08/08/2021","Y","Y","Fairbanks North Star Borough",90,"Fairbanks North Star Borough",2,1,8143,9,8227,0,176,0,51
"08/09/2021","Y","Y","Fairbanks North Star Borough",90,"Fairbanks North Star Borough",2,22,8165,32,8259,1,177,1,52
"08/10/2021","Y","Y","Fairbanks North Star Borough",90,"Fairbanks North Star Borough",2,15,8180,19,8278,1,178,0,52
"08/11/2021","Y","Y","Fairbanks North Star Borough",90,"Fairbanks North Star Borough",2,24,8204,17,8295,2,180,0,52
"08/12/2021","Y","Y","Fairbanks North Star Borough",90,"Fairbanks North Star Borough",2,18,8222,20,8315,0,180,0,52
"08/13/2021","Y","Y","Fairbanks North Star Borough",90,"Fairbanks North Star Borough",2,21,8243,23,8338,1,181,0,52
"08/14/2021","Y","Y","Fairbanks North Star Borough",90,"Fairbanks North Star Borough",2,7,8250,20,8358,0,181,0,52
"08/15/2021","Y","Y","Fairbanks North Star Borough",90,"Fairbanks North Star Borough",2,12,8262,16,8374,0,181,0,52
"08/16/2021","Y","Y","Fairbanks North Star Borough",90,"Fairbanks North Star Borough",2,33,8295,69,8443,1,182,0,52
"08/17/2021","Y","Y","Fairbanks North Star Borough",90,"Fairbanks North Star Borough",2,32,8327,37,8480,1,183,0,52
"08/18/2021","Y","Y","Fairbanks North Star Borough",90,"Fairbanks North Star Borough",2,41,8368,34,8514,3,186,0,52
"08/19/2021","Y","Y","Fairbanks North Star Borough",90,"Fairbanks North Star Borough",2,35,8403,60,8574,1,187,1,53
"08/20/2021","Y","Y","Fairbanks North Star Borough",90,"Fairbanks North Star Borough",2,39,8442,41,8615,1,188,0,53
"08/21/2021","Y","Y","Fairbanks North Star Borough",90,"Fairbanks North Star Borough",2,17,8459,23,8638,1,189,0,53
"08/22/2021","Y","Y","Fairbanks North Star Borough",90,"Fairbanks North Star Borough",2,0,8459,22,8660,0,189,0,53
"08/23/2021","Y","Y","Fairbanks North Star Borough",90,"Fairbanks North Star Borough",2,60,8519,62,8722,0,189,0,53
"08/24/2021","Y","Y","Fairbanks North Star Borough",90,"Fairbanks North Star Borough",2,61,8580,81,8803,1,190,0,53
"08/25/2021","Y","Y","Fairbanks North Star Borough",90,"Fairbanks North Star Borough",2,66,8646,83,8886,2,192,0,53
"08/26/2021","Y","Y","Fairbanks North Star Borough",90,"Fairbanks North Star Borough",2,33,8679,83,8969,1,193,0,53
"08/27/2021","Y","Y","Fairbanks North Star Borough",90,"Fairbanks North Star Borough",2,50,8729,92,9061,2,195,1,54
"08/28/2021","Y","Y","Fairbanks North Star Borough",90,"Fairbanks North Star Borough",2,58,8787,48,9109,4,199,0,54
"08/29/2021","Y","Y","Fairbanks North Star Borough",90,"Fairbanks North Star Borough",2,6,8793,70,9179,2,201,0,54
"08/30/2021","Y","Y","Fairbanks North Star Borough",90,"Fairbanks North Star Borough",2,23,8816,169,9348,1,202,1,55
"08/31/2021","Y","Y","Fairbanks North Star Borough",90,"Fairbanks North Star Borough",2,102,8918,150,9498,3,205,0,55
"09/01/2021","Y","Y","Fairbanks North Star Borough",90,"Fairbanks North Star Borough",2,118,9036,153,9651,1,206,0,55
"09/02/2021","Y","Y","Fairbanks North Star Borough",90,"Fairbanks North Star Borough",2,10,9046,120,9771,2,208,1,56
"09/03/2021","Y","Y","Fairbanks North Star Borough",90,"Fairbanks North Star Borough",2,168,9214,143,9914,0,208,0,56
"09/04/2021","Y","Y","Fairbanks North Star Borough",90,"Fairbanks North Star Borough",2,76,9290,69,9983,3,211,1,57
"09/05/2021","Y","Y","Fairbanks North Star Borough",90,"Fairbanks North Star Borough",2,35,9325,89,10072,2,213,0,57
"09/06/2021","Y","Y","Fairbanks North Star Borough",90,"Fairbanks North Star Borough",2,27,9352,107,10179,5,218,0,57
"09/07/2021","Y","Y","Fairbanks North Star Borough",90,"Fairbanks North Star Borough",2,139,9491,203,10382,5,223,1,58
"09/08/2021","Y","Y","Fairbanks North Star Borough",90,"Fairbanks North Star Borough",2,86,9577,129,10511,3,226,0,58
"09/09/2021","Y","Y","Fairbanks North Star Borough",90,"Fairbanks North Star Borough",2,115,9692,121,10632,1,227,0,58
"09/10/2021","Y","Y","Fairbanks North Star Borough",90,"Fairbanks North Star Borough",2,181,9873,111,10743,1,228,1,59
"09/11/2021","Y","Y","Fairbanks North Star Borough",90,"Fairbanks North Star Borough",2,41,9914,57,10800,2,230,0,59
"09/12/2021","Y","Y","Fairbanks North Star Borough",90,"Fairbanks North Star Borough",2,36,9950,45,10845,3,233,2,61
"09/13/2021","Y","Y","Fairbanks North Star Borough",90,"Fairbanks North Star Borough",2,121,10071,170,11015,3,236,1,62
"09/14/2021","Y","Y","Fairbanks North Star Borough",90,"Fairbanks North Star Borough",2,171,10242,162,11177,3,239,2,64
"09/15/2021","Y","Y","Fairbanks North Star Borough",90,"Fairbanks North Star Borough",2,133,10375,142,11319,1,240,0,64
"09/16/2021","Y","Y","Fairbanks North Star Borough",90,"Fairbanks North Star Borough",2,149,10524,137,11456,1,241,0,64
"09/17/2021","Y","Y","Fairbanks North Star Borough",90,"Fairbanks North Star Borough",2,93,10617,132,11588,3,244,0,64
"09/18/2021","Y","Y","Fairbanks North Star Borough",90,"Fairbanks North Star Borough",2,43,10660,81,11669,2,246,0,64
"09/19/2021","Y","Y","Fairbanks North Star Borough",90,"Fairbanks North Star Borough",2,31,10691,71,11740,2,248,0,64
"09/20/2021","Y","Y","Fairbanks North Star Borough",90,"Fairbanks North Star Borough",2,69,10760,171,11911,0,248,2,66
"09/21/2021","Y","Y","Fairbanks North Star Borough",90,"Fairbanks North Star Borough",2,167,10927,109,12020,2,250,2,68
"09/22/2021","Y","Y","Fairbanks North Star Borough",90,"Fairbanks North Star Borough",2,237,11164,138,12158,3,253,3,71
"09/23/2021","Y","Y","Fairbanks North Star Borough",90,"Fairbanks North Star Borough",2,305,11469,128,12286,4,257,0,71
"09/24/2021","Y","Y","Fairbanks North Star Borough",90,"Fairbanks North Star Borough",2,133,11602,128,12414,2,259,0,71
"09/25/2021","Y","Y","Fairbanks North Star Borough",90,"Fairbanks North Star Borough",2,227,11829,70,12484,1,260,0,71
"09/26/2021","Y","Y","Fairbanks North Star Borough",90,"Fairbanks North Star Borough",2,281,12110,62,12546,4,264,0,71
"09/27/2021","Y","Y","Fairbanks North Star Borough",90,"Fairbanks North Star Borough",2,113,12223,174,12720,4,268,0,71
"09/28/2021","Y","Y","Fairbanks North Star Borough",90,"Fairbanks North Star Borough",2,153,12376,100,12820,4,272,4,75
"09/29/2021","Y","Y","Fairbanks North Star Borough",90,"Fairbanks North Star Borough",2,125,12501,147,12967,3,275,1,76
"09/30/2021","Y","Y","Fairbanks North Star Borough",90,"Fairbanks North Star Borough",2,160,12661,106,13073,5,280,0,76
"10/01/2021","Y","Y","Fairbanks North Star Borough",90,"Fairbanks North Star Borough",2,200,12861,112,13185,0,280,0,76
"10/02/2021","Y","Y","Fairbanks North Star Borough",90,"Fairbanks North Star Borough",2,96,12957,52,13237,4,284,2,78
"10/03/2021","Y","Y","Fairbanks North Star Borough",90,"Fairbanks North Star Borough",2,22,12979,55,13292,2,286,0,78
"10/04/2021","Y","Y","Fairbanks North Star Borough",90,"Fairbanks North Star Borough",2,139,13118,160,13452,5,291,0,78
"10/05/2021","Y","Y","Fairbanks North Star Borough",90,"Fairbanks North Star Borough",2,114,13232,116,13568,3,294,1,79
"10/06/2021","Y","Y","Fairbanks North Star Borough",90,"Fairbanks North Star Borough",2,71,13303,124,13692,1,295,2,81
"10/07/2021","Y","Y","Fairbanks North Star Borough",90,"Fairbanks North Star Borough",2,75,13378,104,13796,1,296,0,81
"10/08/2021","Y","Y","Fairbanks North Star Borough",90,"Fairbanks North Star Borough",2,83,13461,96,13892,1,297,4,85
"10/09/2021","Y","Y","Fairbanks North Star Borough",90,"Fairbanks North Star Borough",2,125,13586,45,13937,2,299,0,85
"10/10/2021","Y","Y","Fairbanks North Star Borough",90,"Fairbanks North Star Borough",2,89,13675,61,13998,2,301,0,85
"10/11/2021","Y","Y","Fairbanks North Star Borough",90,"Fairbanks North Star Borough",2,28,13703,147,14145,2,303,0,85
"10/12/2021","Y","Y","Fairbanks North Star Borough",90,"Fairbanks North Star Borough",2,217,13920,122,14267,4,307,0,85
"10/13/2021","Y","Y","Fairbanks North Star Borough",90,"Fairbanks North Star Borough",2,96,14016,97,14364,6,313,1,86
"10/14/2021","Y","Y","Fairbanks North Star Borough",90,"Fairbanks North Star Borough",2,127,14143,90,14454,1,314,2,88
"10/15/2021","Y","Y","Fairbanks North Star Borough",90,"Fairbanks North Star Borough",2,44,14187,88,14542,1,315,2,90
"10/16/2021","Y","Y","Fairbanks North Star Borough",90,"Fairbanks North Star Borough",2,138,14325,42,14584,2,317,3,93
"10/17/2021","Y","Y","Fairbanks North Star Borough",90,"Fairbanks North Star Borough",2,51,14376,34,14618,1,318,1,94
"10/18/2021","Y","Y","Fairbanks North Star Borough",90,"Fairbanks North Star Borough",2,69,14445,127,14745,2,320,1,95
"10/19/2021","Y","Y","Fairbanks North Star Borough",90,"Fairbanks North Star Borough",2,105,14550,83,14828,6,326,1,96
"10/20/2021","Y","Y","Fairbanks North Star Borough",90,"Fairbanks North Star Borough",2,62,14612,84,14912,1,327,1,97
"10/21/2021","Y","Y","Fairbanks North Star Borough",90,"Fairbanks North Star Borough",2,106,14718,77,14989,3,330,3,100
"10/22/2021","Y","Y","Fairbanks North Star Borough",90,"Fairbanks North Star Borough",2,39,14757,60,15049,1,331,1,101
"10/23/2021","Y","Y","Fairbanks North Star Borough",90,"Fairbanks North Star Borough",2,78,14835,27,15076,3,334,1,102
"10/24/2021","Y","Y","Fairbanks North Star Borough",90,"Fairbanks North Star Borough",2,16,14851,30,15106,1,335,1,103
"10/25/2021","Y","Y","Fairbanks North Star Borough",90,"Fairbanks North Star Borough",2,104,14955,85,15191,2,337,0,103
"10/26/2021","Y","Y","Fairbanks North Star Borough",90,"Fairbanks North Star Borough",2,48,15003,55,15246,0,337,1,104
"10/27/2021","Y","Y","Fairbanks North Star Borough",90,"Fairbanks North Star Borough",2,61,15064,67,15313,1,338,1,105
"10/28/2021","Y","Y","Fairbanks North Star Borough",90,"Fairbanks North Star Borough",2,76,15140,58,15371,2,340,0,105
"10/29/2021","Y","Y","Fairbanks North Star Borough",90,"Fairbanks North Star Borough",2,58,15198,58,15429,1,341,2,107
"10/30/2021","Y","Y","Fairbanks North Star Borough",90,"Fairbanks North Star Borough",2,67,15265,47,15476,0,341,1,108
"10/31/2021","Y","Y","Fairbanks North Star Borough",90,"Fairbanks North Star Borough",2,8,15273,23,15499,2,343,0,108
"11/01/2021","Y","Y","Fairbanks North Star Borough",90,"Fairbanks North Star Borough",2,68,15341,112,15611,1,344,0,108
"11/02/2021","Y","Y","Fairbanks North Star Borough",90,"Fairbanks North Star Borough",2,164,15505,54,15665,0,344,0,108
"11/03/2021","Y","Y","Fairbanks North Star Borough",90,"Fairbanks North Star Borough",2,37,15542,64,15729,1,345,0,108
"11/04/2021","Y","Y","Fairbanks North Star Borough",90,"Fairbanks North Star Borough",2,96,15638,54,15783,1,346,0,108
"11/05/2021","Y","Y","Fairbanks North Star Borough",90,"Fairbanks North Star Borough",2,48,15686,55,15838,0,346,1,109
"11/06/2021","Y","Y","Fairbanks North Star Borough",90,"Fairbanks North Star Borough",2,60,15746,25,15863,2,348,0,109
"11/07/2021","Y","Y","Fairbanks North Star Borough",90,"Fairbanks North Star Borough",2,35,15781,24,15887,0,348,0,109
"11/08/2021","Y","Y","Fairbanks North Star Borough",90,"Fairbanks North Star Borough",2,43,15824,89,15976,1,349,1,110
"11/09/2021","Y","Y","Fairbanks North Star Borough",90,"Fairbanks North Star Borough",2,45,15869,45,16021,2,351,0,110
"11/10/2021","Y","Y","Fairbanks North Star Borough",90,"Fairbanks North Star Borough",2,46,15915,58,16079,2,353,0,110
"11/11/2021","Y","Y","Fairbanks North Star Borough",90,"Fairbanks North Star Borough",2,64,15979,38,16117,1,354,0,110
"11/12/2021","Y","Y","Fairbanks North Star Borough",90,"Fairbanks North Star Borough",2,31,16010,47,16164,3,357,1,111
"11/13/2021","Y","Y","Fairbanks North Star Borough",90,"Fairbanks North Star Borough",2,43,16053,21,16185,2,359,1,112
"11/14/2021","Y","Y","Fairbanks North Star Borough",90,"Fairbanks North Star Borough",2,27,16080,21,16206,2,361,0,112
"11/15/2021","Y","Y","Fairbanks North Star Borough",90,"Fairbanks North Star Borough",2,33,16113,72,16278,4,365,0,112
"11/16/2021","Y","Y","Fairbanks North Star Borough",90,"Fairbanks North Star Borough",2,70,16183,62,16340,3,368,0,112
"11/17/2021","Y","Y","Fairbanks North Star Borough",90,"Fairbanks North Star Borough",2,38,16221,60,16400,1,369,0,112
"11/18/2021","Y","Y","Fairbanks North Star Borough",90,"Fairbanks North Star Borough",2,50,16271,44,16444,1,370,0,112
"11/19/2021","Y","Y","Fairbanks North Star Borough",90,"Fairbanks North Star Borough",2,56,16327,26,16470,0,370,1,113
"11/20/2021","Y","Y","Fairbanks North Star Borough",90,"Fairbanks North Star Borough",2,34,16361,15,16485,0,370,1,114
"11/21/2021","Y","Y","Fairbanks North Star Borough",90,"Fairbanks North Star Borough",2,7,16368,16,16501,0,370,1,115
"11/22/2021","Y","Y","Fairbanks North Star Borough",90,"Fairbanks North Star Borough",2,24,16392,32,16533,1,371,0,115
"11/23/2021","Y","Y","Fairbanks North Star Borough",90,"Fairbanks North Star Borough",2,59,16451,28,16561,0,371,0,115
"11/24/2021","Y","Y","Fairbanks North Star Borough",90,"Fairbanks North Star Borough",2,77,16528,24,16585,0,371,0,115
"11/25/2021","Y","Y","Fairbanks North Star Borough",90,"Fairbanks North Star Borough",2,6,16534,2,16587,0,371,0,115
"11/26/2021","Y","Y","Fairbanks North Star Borough",90,"Fairbanks North Star Borough",2,27,16561,20,16607,1,372,1,116
"11/27/2021","Y","Y","Fairbanks North Star Borough",90,"Fairbanks North Star Borough",2,12,16573,10,16617,1,373,0,116
"11/28/2021","Y","Y","Fairbanks North Star Borough",90,"Fairbanks North Star Borough",2,6,16579,7,16624,1,374,0,116
"11/29/2021","Y","Y","Fairbanks North Star Borough",90,"Fairbanks North Star Borough",2,23,16602,33,16657,1,375,0,116
"11/30/2021","Y","Y","Fairbanks North Star Borough",90,"Fairbanks North Star Borough",2,29,16631,22,16679,0,375,0,116
"12/01/2021","Y","Y","Fairbanks North Star Borough",90,"Fairbanks North Star Borough",2,25,16656,21,16700,1,376,0,116
"12/02/2021","Y","Y","Fairbanks North Star Borough",90,"Fairbanks North Star Borough",2,24,16680,19,16719,1,377,0,116
"12/03/2021","Y","Y","Fairbanks North Star Borough",90,"Fairbanks North Star Borough",2,20,16700,19,16738,0,377,0,116
"12/04/2021","Y","Y","Fairbanks North Star Borough",90,"Fairbanks North Star Borough",2,4,16704,6,16744,1,378,0,116
"12/05/2021","Y","Y","Fairbanks North Star Borough",90,"Fairbanks North Star Borough",2,17,16721,10,16754,1,379,0,116
"12/06/2021","Y","Y","Fairbanks North Star Borough",90,"Fairbanks North Star Borough",2,23,16744,23,16777,1,380,0,116
"12/07/2021","Y","Y","Fairbanks North Star Borough",90,"Fairbanks North Star Borough",2,15,16759,14,16791,0,380,1,117
"12/08/2021","Y","Y","Fairbanks North Star Borough",90,"Fairbanks North Star Borough",2,19,16778,17,16808,0,380,0,117
"12/09/2021","Y","Y","Fairbanks North Star Borough",90,"Fairbanks North Star Borough",2,11,16789,10,16818,1,381,1,118
"12/10/2021","Y","Y","Fairbanks North Star Borough",90,"Fairbanks North Star Borough",2,9,16798,14,16832,0,381,0,118
"12/11/2021","Y","Y","Fairbanks North Star Borough",90,"Fairbanks North Star Borough",2,8,16806,8,16840,0,381,0,118
"12/12/2021","Y","Y","Fairbanks North Star Borough",90,"Fairbanks North Star Borough",2,4,16810,8,16848,1,382,0,118
"12/13/2021","Y","Y","Fairbanks North Star Borough",90,"Fairbanks North Star Borough",2,14,16824,10,16858,0,382,0,118
"12/14/2021","Y","Y","Fairbanks North Star Borough",90,"Fairbanks North Star Borough",2,29,16853,24,16882,2,384,0,118
"12/15/2021","Y","Y","Fairbanks North Star Borough",90,"Fairbanks North Star Borough",2,25,16878,9,16891,0,384,0,118
"12/16/2021","Y","Y","Fairbanks North Star Borough",90,"Fairbanks North Star Borough",2,13,16891,18,16909,0,384,0,118
"12/17/2021","Y","Y","Fairbanks North Star Borough",90,"Fairbanks North Star Borough",2,9,16900,13,16922,0,384,0,118
"12/18/2021","Y","Y","Fairbanks North Star Borough",90,"Fairbanks North Star Borough",2,5,16905,8,16930,1,385,0,118
"12/19/2021","Y","Y","Fairbanks North Star Borough",90,"Fairbanks North Star Borough",2,29,16934,27,16957,1,386,0,118
"12/20/2021","Y","Y","Fairbanks North Star Borough",90,"Fairbanks North Star Borough",2,15,16949,12,16969,0,386,1,119
"12/21/2021","Y","Y","Fairbanks North Star Borough",90,"Fairbanks North Star Borough",2,4,16953,36,17005,1,387,0,119
"12/22/2021","Y","Y","Fairbanks North Star Borough",90,"Fairbanks North Star Borough",2,24,16977,26,17031,0,387,0,119
"12/23/2021","Y","Y","Fairbanks North Star Borough",90,"Fairbanks North Star Borough",2,54,17031,40,17071,0,387,0,119
"12/24/2021","Y","Y","Fairbanks North Star Borough",90,"Fairbanks North Star Borough",2,15,17046,24,17095,0,387,0,119
"12/25/2021","Y","Y","Fairbanks North Star Borough",90,"Fairbanks North Star Borough",2,5,17051,10,17105,1,388,0,119
"12/26/2021","Y","Y","Fairbanks North Star Borough",90,"Fairbanks North Star Borough",2,8,17059,7,17112,0,388,0,119
"12/27/2021","Y","Y","Fairbanks North Star Borough",90,"Fairbanks North Star Borough",2,61,17120,31,17143,2,390,0,119
"12/28/2021","Y","Y","Fairbanks North Star Borough",90,"Fairbanks North Star Borough",2,11,17131,26,17169,0,390,0,119
"12/29/2021","Y","Y","Fairbanks North Star Borough",90,"Fairbanks North Star Borough",2,29,17160,29,17198,0,390,0,119
"12/30/2021","Y","Y","Fairbanks North Star Borough",90,"Fairbanks North Star Borough",2,29,17189,52,17250,0,390,0,119
"12/31/2021","Y","Y","Fairbanks North Star Borough",90,"Fairbanks North Star Borough",2,19,17208,53,17303,0,390,0,119
"01/01/2022","Y","Y","Fairbanks North Star Borough",90,"Fairbanks North Star Borough",2,65,17273,18,17321,0,390,0,119
"01/02/2022","Y","Y","Fairbanks North Star Borough",90,"Fairbanks North Star Borough",2,7,17280,51,17372,0,390,0,119
"01/03/2022","Y","Y","Fairbanks North Star Borough",90,"Fairbanks North Star Borough",2,97,17377,97,17469,1,391,1,120
"01/04/2022","Y","Y","Fairbanks North Star Borough",90,"Fairbanks North Star Borough",2,117,17494,164,17633,1,392,0,120
"01/05/2022","Y","Y","Fairbanks North Star Borough",90,"Fairbanks North Star Borough",2,150,17644,143,17776,2,394,0,120
"01/06/2022","Y","Y","Fairbanks North Star Borough",90,"Fairbanks North Star Borough",2,142,17786,140,17916,0,394,1,121
"01/07/2022","Y","Y","Fairbanks North Star Borough",90,"Fairbanks North Star Borough",2,183,17969,227,18143,2,396,0,121
"01/08/2022","Y","Y","Fairbanks North Star Borough",90,"Fairbanks North Star Borough",2,18,17987,64,18207,0,396,0,121
"01/09/2022","Y","Y","Fairbanks North Star Borough",90,"Fairbanks North Star Borough",2,42,18029,55,18262,0,396,0,121
"01/10/2022","Y","Y","Fairbanks North Star Borough",90,"Fairbanks North Star Borough",2,171,18200,256,18518,0,396,0,121
"01/11/2022","Y","Y","Fairbanks North Star Borough",90,"Fairbanks North Star Borough",2,381,18581,422,18940,1,397,0,121
"01/12/2022","Y","Y","Fairbanks North Star Borough",90,"Fairbanks North Star Borough",2,326,18907,334,19274,1,398,0,121
"01/13/2022","Y","Y","Fairbanks North Star Borough",90,"Fairbanks North Star Borough",2,211,19118,218,19492,0,398,0,121
"01/14/2022","Y","Y","Fairbanks North Star Borough",90,"Fairbanks North Star Borough",2,242,19360,273,19765,0,398,1,122
"01/15/2022","Y","Y","Fairbanks North Star Borough",90,"Fairbanks North Star Borough",2,104,19464,129,19894,1,399,0,122
"01/16/2022","Y","Y","Fairbanks North Star Borough",90,"Fairbanks North Star Borough",2,153,19617,140,20034,1,400,0,122
"01/17/2022","Y","Y","Fairbanks North Star Borough",90,"Fairbanks North Star Borough",2,94,19711,180,20214,3,403,1,123
"01/18/2022","Y","Y","Fairbanks North Star Borough",90,"Fairbanks North Star Borough",2,422,20133,416,20630,0,403,0,123
"01/19/2022","Y","Y","Fairbanks North Star Borough",90,"Fairbanks North Star Borough",2,204,20337,271,20901,2,405,0,123
"01/20/2022","Y","Y","Fairbanks North Star Borough",90,"Fairbanks North Star Borough",2,431,20768,404,21305,2,407,0,123
"01/21/2022","Y","Y","Fairbanks North Star Borough",90,"Fairbanks North Star Borough",2,672,21440,647,21952,0,407,0,123
"01/22/2022","Y","Y","Fairbanks North Star Borough",90,"Fairbanks North Star Borough",2,165,21605,152,22104,0,407,1,124
"01/23/2022","Y","Y","Fairbanks North Star Borough",90,"Fairbanks North Star Borough",2,179,21784,151,22255,2,409,0,124
"01/24/2022","Y","Y","Fairbanks North Star Borough",90,"Fairbanks North Star Borough",2,556,22340,668,22923,3,412,1,125
"01/25/2022","Y","Y","Fairbanks North Star Borough",90,"Fairbanks North Star Borough",2,221,22561,222,23145,1,413,0,125
"01/26/2022","Y","Y","Fairbanks North Star Borough",90,"Fairbanks North Star Borough",2,442,23003,370,23515,1,414,0,125
"01/27/2022","Y","Y","Fairbanks North Star Borough",90,"Fairbanks North Star Borough",2,312,23315,287,23802,2,416,0,125
"01/28/2022","Y","Y","Fairbanks North Star Borough",90,"Fairbanks North Star Borough",2,285,23600,180,23982,0,416,0,125
"01/29/2022","Y","Y","Fairbanks North Star Borough",90,"Fairbanks North Star Borough",2,116,23716,113,24095,0,416,0,125
"01/30/2022","Y","Y","Fairbanks North Star Borough",90,"Fairbanks North Star Borough",2,6,23722,6,24101,1,417,0,125
"01/31/2022","Y","Y","Fairbanks North Star Borough",90,"Fairbanks North Star Borough",2,334,24056,342,24443,2,419,0,125
"02/01/2022","Y","Y","Fairbanks North Star Borough",90,"Fairbanks North Star Borough",2,301,24357,207,24650,1,420,0,125
"02/02/2022","Y","Y","Fairbanks North Star Borough",90,"Fairbanks North Star Borough",2,321,24678,160,24810,2,422,0,125
"02/03/2022","Y","Y","Fairbanks North Star Borough",90,"Fairbanks North Star Borough",2,186,24864,163,24973,3,425,0,125
"02/04/2022","Y","Y","Fairbanks North Star Borough",90,"Fairbanks North Star Borough",2,202,25066,189,25162,1,426,1,126
"02/05/2022","Y","Y","Fairbanks North Star Borough",90,"Fairbanks North Star Borough",2,54,25120,51,25213,0,426,0,126
"02/06/2022","Y","Y","Fairbanks North Star Borough",90,"Fairbanks North Star Borough",2,8,25128,8,25221,2,428,0,126
"02/07/2022","Y","Y","Fairbanks North Star Borough",90,"Fairbanks North Star Borough",2,137,25265,137,25358,1,429,0,126
"02/08/2022","Y","Y","Fairbanks North Star Borough",90,"Fairbanks North Star Borough",2,122,25387,109,25467,2,431,1,127
"02/09/2022","Y","Y","Fairbanks North Star Borough",90,"Fairbanks North Star Borough",2,115,25502,114,25581,1,432,1,128
"02/10/2022","Y","Y","Fairbanks North Star Borough",90,"Fairbanks North Star Borough",2,52,25554,56,25637,0,432,0,128
"02/11/2022","Y","Y","Fairbanks North Star Borough",90,"Fairbanks North Star Borough",2,59,25613,64,25701,0,432,0,128
"02/12/2022","Y","Y","Fairbanks North Star Borough",90,"Fairbanks North Star Borough",2,35,25648,28,25729,0,432,0,128
"02/13/2022","Y","Y","Fairbanks North Star Borough",90,"Fairbanks North Star Borough",2,5,25653,4,25733,0,432,0,128
"02/14/2022","Y","Y","Fairbanks North Star Borough",90,"Fairbanks North Star Borough",2,48,25701,49,25782,0,432,0,128
"02/15/2022","Y","Y","Fairbanks North Star Borough",90,"Fairbanks North Star Borough",2,37,25738,40,25822,2,434,0,128
"02/16/2022","Y","Y","Fairbanks North Star Borough",90,"Fairbanks North Star Borough",2,46,25784,47,25869,0,434,0,128
"02/17/2022","Y","Y","Fairbanks North Star Borough",90,"Fairbanks North Star Borough",2,68,25852,65,25934,0,434,1,129
"02/18/2022","Y","Y","Fairbanks North Star Borough",90,"Fairbanks North Star Borough",2,43,25895,41,25975,0,434,0,129
"02/19/2022","Y","Y","Fairbanks North Star Borough",90,"Fairbanks North Star Borough",2,6,25901,8,25983,0,434,0,129
"02/20/2022","Y","Y","Fairbanks North Star Borough",90,"Fairbanks North Star Borough",2,11,25912,7,25990,0,434,0,129
"02/21/2022","Y","Y","Fairbanks North Star Borough",90,"Fairbanks North Star Borough",2,38,25950,37,26027,1,435,0,129
"02/22/2022","Y","Y","Fairbanks North Star Borough",90,"Fairbanks North Star Borough",2,5,25955,13,26040,1,436,1,130
"02/23/2022","Y","Y","Fairbanks North Star Borough",90,"Fairbanks North Star Borough",2,52,26007,32,26072,0,436,0,130
"02/24/2022","Y","Y","Fairbanks North Star Borough",90,"Fairbanks North Star Borough",2,24,26031,28,26100,0,436,0,130
"02/25/2022","Y","Y","Fairbanks North Star Borough",90,"Fairbanks North Star Borough",2,38,26069,21,26121,0,436,0,130
"02/26/2022","Y","Y","Fairbanks North Star Borough",90,"Fairbanks North Star Borough",2,15,26084,16,26137,0,436,0,130
"02/27/2022","Y","Y","Fairbanks North Star Borough",90,"Fairbanks North Star Borough",2,2,26086,2,26139,0,436,0,130
"02/28/2022","Y","Y","Fairbanks North Star Borough",90,"Fairbanks North Star Borough",2,12,26098,17,26156,0,436,1,131
"03/01/2022","Y","Y","Fairbanks North Star Borough",90,"Fairbanks North Star Borough",2,34,26132,25,26181,0,436,0,131
"03/02/2022","Y","Y","Fairbanks North Star Borough",90,"Fairbanks North Star Borough",2,31,26163,8,26189,0,436,0,131
"03/03/2022","Y","Y","Fairbanks North Star Borough",90,"Fairbanks North Star Borough",2,35,26198,16,26205,0,436,0,131
"03/04/2022","Y","Y","Fairbanks North Star Borough",90,"Fairbanks North Star Borough",2,11,26209,10,26215,0,436,0,131
"03/05/2022","Y","Y","Fairbanks North Star Borough",90,"Fairbanks North Star Borough",2,4,26213,4,26219,0,436,0,131
"03/06/2022","Y","Y","Fairbanks North Star Borough",90,"Fairbanks North Star Borough",2,0,26213,1,26220,0,436,0,131
"03/07/2022","Y","Y","Fairbanks North Star Borough",90,"Fairbanks North Star Borough",2,13,26226,12,26232,0,436,0,131
"03/08/2022","Y","Y","Fairbanks North Star Borough",90,"Fairbanks North Star Borough",2,24,26250,28,26260,1,437,0,131
"03/09/2022","Y","Y","Fairbanks North Star Borough",90,"Fairbanks North Star Borough",2,13,26263,13,26273,0,437,1,132
"03/10/2022","Y","Y","Fairbanks North Star Borough",90,"Fairbanks North Star Borough",2,10,26273,11,26284,0,437,0,132
"03/11/2022","Y","Y","Fairbanks North Star Borough",90,"Fairbanks North Star Borough",2,11,26284,11,26295,2,439,0,132
"03/12/2022","Y","Y","Fairbanks North Star Borough",90,"Fairbanks North Star Borough",2,4,26288,5,26300,0,439,0,132
"03/13/2022","Y","Y","Fairbanks North Star Borough",90,"Fairbanks North Star Borough",2,1,26289,1,26301,0,439,0,132
"03/14/2022","Y","Y","Fairbanks North Star Borough",90,"Fairbanks North Star Borough",2,14,26303,13,26314,0,439,0,132
"03/15/2022","Y","Y","Fairbanks North Star Borough",90,"Fairbanks North Star Borough",2,8,26311,5,26319,0,439,0,132
"03/16/2022","Y","Y","Fairbanks North Star Borough",90,"Fairbanks North Star Borough",2,10,26321,10,26329,0,439,0,132
"03/17/2022","Y","Y","Fairbanks North Star Borough",90,"Fairbanks North Star Borough",2,12,26333,11,26340,1,440,0,132
"03/18/2022","Y","Y","Fairbanks North Star Borough",90,"Fairbanks North Star Borough",2,11,26344,10,26350,0,440,0,132
"03/19/2022","Y","Y","Fairbanks North Star Borough",90,"Fairbanks North Star Borough",2,2,26346,4,26354,0,440,0,132
"03/20/2022","Y","Y","Fairbanks North Star Borough",90,"Fairbanks North Star Borough",2,3,26349,2,26356,1,441,0,132
"03/21/2022","Y","Y","Fairbanks North Star Borough",90,"Fairbanks North Star Borough",2,10,26359,11,26367,0,441,0,132
"03/22/2022","Y","Y","Fairbanks North Star Borough",90,"Fairbanks North Star Borough",2,16,26375,17,26384,0,441,0,132
"03/23/2022","Y","Y","Fairbanks North Star Borough",90,"Fairbanks North Star Borough",2,12,26387,11,26395,0,441,0,132
"03/24/2022","Y","Y","Fairbanks North Star Borough",90,"Fairbanks North Star Borough",2,12,26399,9,26404,0,441,0,132
"03/25/2022","Y","Y","Fairbanks North Star Borough",90,"Fairbanks North Star Borough",2,8,26407,8,26412,0,441,0,132
"03/26/2022","Y","Y","Fairbanks North Star Borough",90,"Fairbanks North Star Borough",2,5,26412,8,26420,0,441,0,132
"03/27/2022","Y","Y","Fairbanks North Star Borough",90,"Fairbanks North Star Borough",2,6,26418,3,26423,0,441,0,132
"03/28/2022","Y","Y","Fairbanks North Star Borough",90,"Fairbanks North Star Borough",2,3,26421,5,26428,0,441,0,132
"03/29/2022","Y","Y","Fairbanks North Star Borough",90,"Fairbanks North Star Borough",2,17,26438,19,26447,0,441,0,132
"03/30/2022","Y","Y","Fairbanks North Star Borough",90,"Fairbanks North Star Borough",2,25,26463,25,26472,0,441,0,132
"03/31/2022","Y","Y","Fairbanks North Star Borough",90,"Fairbanks North Star Borough",2,7,26470,7,26479,0,441,0,132
"04/01/2022","Y","Y","Fairbanks North Star Borough",90,"Fairbanks North Star Borough",2,13,26483,12,26491,0,441,0,132
"04/02/2022","Y","Y","Fairbanks North Star Borough",90,"Fairbanks North Star Borough",2,6,26489,6,26497,0,441,0,132
"04/03/2022","Y","Y","Fairbanks North Star Borough",90,"Fairbanks North Star Borough",2,1,26490,0,26497,0,441,0,132
"04/04/2022","Y","Y","Fairbanks North Star Borough",90,"Fairbanks North Star Borough",2,7,26497,9,26506,0,441,0,132
"04/05/2022","Y","Y","Fairbanks North Star Borough",90,"Fairbanks North Star Borough",2,20,26517,23,26529,1,442,0,132
"04/06/2022","Y","Y","Fairbanks North Star Borough",90,"Fairbanks North Star Borough",2,13,26530,8,26537,0,442,1,133
"04/07/2022","Y","Y","Fairbanks North Star Borough",90,"Fairbanks North Star Borough",2,7,26537,11,26548,0,442,0,133
"04/08/2022","Y","Y","Fairbanks North Star Borough",90,"Fairbanks North Star Borough",2,20,26557,24,26572,0,442,0,133
"04/09/2022","Y","Y","Fairbanks North Star Borough",90,"Fairbanks North Star Borough",2,4,26561,1,26573,0,442,0,133
"04/10/2022","Y","Y","Fairbanks North Star Borough",90,"Fairbanks North Star Borough",2,3,26564,3,26576,0,442,0,133
"04/11/2022","Y","Y","Fairbanks North Star Borough",90,"Fairbanks North Star Borough",2,9,26573,15,26591,0,442,0,133
"04/12/2022","Y","Y","Fairbanks North Star Borough",90,"Fairbanks North Star Borough",2,20,26593,24,26615,0,442,0,133
"04/13/2022","Y","Y","Fairbanks North Star Borough",90,"Fairbanks North Star Borough",2,15,26608,8,26623,0,442,0,133
"04/14/2022","Y","Y","Fairbanks North Star Borough",90,"Fairbanks North Star Borough",2,10,26618,14,26637,0,442,0,133
"04/15/2022","Y","Y","Fairbanks North Star Borough",90,"Fairbanks North Star Borough",2,15,26633,9,26646,0,442,0,133
"04/16/2022","Y","Y","Fairbanks North Star Borough",90,"Fairbanks North Star Borough",2,16,26649,10,26656,0,442,0,133
"04/17/2022","Y","Y","Fairbanks North Star Borough",90,"Fairbanks North Star Borough",2,5,26654,2,26658,0,442,0,133
"04/18/2022","Y","Y","Fairbanks North Star Borough",90,"Fairbanks North Star Borough",2,11,26665,15,26673,0,442,0,133
"04/19/2022","Y","Y","Fairbanks North Star Borough",90,"Fairbanks North Star Borough",2,21,26686,32,26705,0,442,0,133
"04/20/2022","Y","Y","Fairbanks North Star Borough",90,"Fairbanks North Star Borough",2,19,26705,2,26707,0,442,0,133
"04/21/2022","Y","Y","Fairbanks North Star Borough",90,"Fairbanks North Star Borough",2,12,26717,10,26717,0,442,0,133
"04/22/2022","Y","Y","Fairbanks North Star Borough",90,"Fairbanks North Star Borough",2,13,26730,14,26731,0,442,0,133
"04/23/2022","Y","Y","Fairbanks North Star Borough",90,"Fairbanks North Star Borough",2,5,26735,5,26736,0,442,0,133
"04/24/2022","Y","Y","Fairbanks North Star Borough",90,"Fairbanks North Star Borough",2,6,26741,7,26743,0,442,0,133
"04/25/2022","Y","Y","Fairbanks North Star Borough",90,"Fairbanks North Star Borough",2,11,26752,9,26752,0,442,0,133
"04/26/2022","Y","Y","Fairbanks North Star Borough",90,"Fairbanks North Star Borough",2,7,26759,7,26759,0,442,0,133
"05/29/2020","Y","Y","Haines Borough",100,"Other Southeast Region - Northern",8,0,0,1,1,0,0,0,0
"06/08/2020","Y","Y","Haines Borough",100,"Other Southeast Region - Northern",8,1,1,0,1,0,0,0,0
"06/17/2020","Y","Y","Haines Borough",100,"Other Southeast Region - Northern",8,0,1,1,2,0,0,0,0
"06/18/2020","Y","Y","Haines Borough",100,"Other Southeast Region - Northern",8,1,2,0,2,0,0,0,0
"07/22/2020","Y","Y","Haines Borough",100,"Other Southeast Region - Northern",8,0,2,1,3,0,0,0,0
"07/24/2020","Y","Y","Haines Borough",100,"Other Southeast Region - Northern",8,1,3,0,3,0,0,0,0
"09/12/2020","Y","Y","Haines Borough",100,"Other Southeast Region - Northern",8,0,3,1,4,0,0,0,0
"09/16/2020","Y","Y","Haines Borough",100,"Other Southeast Region - Northern",8,1,4,0,4,0,0,0,0
"10/08/2020","Y","Y","Haines Borough",100,"Other Southeast Region - Northern",8,0,4,1,5,0,0,0,0
"10/12/2020","Y","Y","Haines Borough",100,"Other Southeast Region - Northern",8,1,5,0,5,0,0,0,0
"10/18/2020","Y","Y","Haines Borough",100,"Other Southeast Region - Northern",8,0,5,1,6,0,0,0,0
"10/22/2020","Y","Y","Haines Borough",100,"Other Southeast Region - Northern",8,0,5,1,7,0,0,0,0
"10/23/2020","Y","Y","Haines Borough",100,"Other Southeast Region - Northern",8,2,7,0,7,0,0,0,0
"10/25/2020","Y","Y","Haines Borough",100,"Other Southeast Region - Northern",8,0,7,1,8,0,0,0,0
"10/29/2020","Y","Y","Haines Borough",100,"Other Southeast Region - Northern",8,1,8,0,8,0,0,0,0
"11/01/2020","Y","Y","Haines Borough",100,"Other Southeast Region - Northern",8,0,8,1,9,0,0,0,0
"11/05/2020","Y","Y","Haines Borough",100,"Other Southeast Region - Northern",8,1,9,0,9,0,0,0,0
"11/07/2020","Y","Y","Haines Borough",100,"Other Southeast Region - Northern",8,0,9,1,10,0,0,0,0
"11/11/2020","Y","Y","Haines Borough",100,"Other Southeast Region - Northern",8,1,10,0,10,0,0,0,0
"11/20/2020","Y","Y","Haines Borough",100,"Other Southeast Region - Northern",8,0,10,1,11,0,0,0,0
"11/30/2020","Y","Y","Haines Borough",100,"Other Southeast Region - Northern",8,1,11,0,11,0,0,0,0
"12/09/2020","Y","Y","Haines Borough",100,"Other Southeast Region - Northern",8,0,11,1,12,0,0,0,0
"12/16/2020","Y","Y","Haines Borough",100,"Other Southeast Region - Northern",8,0,11,1,13,0,0,0,0
"12/17/2020","Y","Y","Haines Borough",100,"Other Southeast Region - Northern",8,2,13,0,13,0,0,0,0
"12/29/2020","Y","Y","Haines Borough",100,"Other Southeast Region - Northern",8,0,13,1,14,0,0,0,0
"01/03/2021","Y","Y","Haines Borough",100,"Other Southeast Region - Northern",8,1,14,0,14,0,0,0,0
"01/10/2021","Y","Y","Haines Borough",100,"Other Southeast Region - Northern",8,0,14,1,15,0,0,0,0
"01/15/2021","Y","Y","Haines Borough",100,"Other Southeast Region - Northern",8,1,15,0,15,0,0,0,0
"01/16/2021","Y","Y","Haines Borough",100,"Other Southeast Region - Northern",8,0,15,1,16,0,0,0,0
"01/20/2021","Y","Y","Haines Borough",100,"Other Southeast Region - Northern",8,0,15,0,16,1,1,0,0
"01/21/2021","Y","Y","Haines Borough",100,"Other Southeast Region - Northern",8,0,15,1,17,0,1,0,0
"01/25/2021","Y","Y","Haines Borough",100,"Other Southeast Region - Northern",8,1,16,0,17,0,1,0,0
"02/10/2021","Y","Y","Haines Borough",100,"Other Southeast Region - Northern",8,1,17,0,17,0,1,0,0
"02/22/2021","Y","Y","Haines Borough",100,"Other Southeast Region - Northern",8,0,17,1,18,0,1,0,0
"02/26/2021","Y","Y","Haines Borough",100,"Other Southeast Region - Northern",8,1,18,0,18,0,1,0,0
"03/19/2021","Y","Y","Haines Borough",100,"Other Southeast Region - Northern",8,0,18,1,19,0,1,0,0
"03/22/2021","Y","Y","Haines Borough",100,"Other Southeast Region - Northern",8,1,19,0,19,0,1,0,0
"04/20/2021","Y","Y","Haines Borough",100,"Other Southeast Region - Northern",8,0,19,1,20,0,1,0,0
"04/21/2021","Y","Y","Haines Borough",100,"Other Southeast Region - Northern",8,0,19,1,21,0,1,0,0
"04/25/2021","Y","Y","Haines Borough",100,"Other Southeast Region - Northern",8,1,20,0,21,0,1,0,0
"04/29/2021","Y","Y","Haines Borough",100,"Other Southeast Region - Northern",8,1,21,0,21,0,1,0,0
"07/22/2021","Y","Y","Haines Borough",100,"Other Southeast Region - Northern",8,0,21,1,22,0,1,0,0
"08/04/2021","Y","Y","Haines Borough",100,"Other Southeast Region - Northern",8,0,21,2,24,0,1,0,0
"08/05/2021","Y","Y","Haines Borough",100,"Other Southeast Region - Northern",8,0,21,3,27,0,1,0,0
"08/06/2021","Y","Y","Haines Borough",100,"Other Southeast Region - Northern",8,0,21,5,32,0,1,0,0
"08/08/2021","Y","Y","Haines Borough",100,"Other Southeast Region - Northern",8,0,21,4,36,0,1,0,0
"08/09/2021","Y","Y","Haines Borough",100,"Other Southeast Region - Northern",8,6,27,14,50,0,1,0,0
"08/10/2021","Y","Y","Haines Borough",100,"Other Southeast Region - Northern",8,0,27,14,64,0,1,0,0
"08/11/2021","Y","Y","Haines Borough",100,"Other Southeast Region - Northern",8,19,46,11,75,0,1,0,0
"08/12/2021","Y","Y","Haines Borough",100,"Other Southeast Region - Northern",8,0,46,9,84,0,1,0,0
"08/13/2021","Y","Y","Haines Borough",100,"Other Southeast Region - Northern",8,0,46,3,87,0,1,0,0
"08/14/2021","Y","Y","Haines Borough",100,"Other Southeast Region - Northern",8,14,60,2,89,0,1,0,0
"08/15/2021","Y","Y","Haines Borough",100,"Other Southeast Region - Northern",8,5,65,3,92,0,1,0,0
"08/16/2021","Y","Y","Haines Borough",100,"Other Southeast Region - Northern",8,10,75,7,99,0,1,0,0
"08/17/2021","Y","Y","Haines Borough",100,"Other Southeast Region - Northern",8,21,96,6,105,0,1,0,0
"08/18/2021","Y","Y","Haines Borough",100,"Other Southeast Region - Northern",8,1,97,3,108,0,1,0,0
"08/19/2021","Y","Y","Haines Borough",100,"Other Southeast Region - Northern",8,1,98,6,114,0,1,0,0
"08/20/2021","Y","Y","Haines Borough",100,"Other Southeast Region - Northern",8,3,101,2,116,0,1,0,0
"08/21/2021","Y","Y","Haines Borough",100,"Other Southeast Region - Northern",8,2,103,0,116,0,1,0,0
"08/22/2021","Y","Y","Haines Borough",100,"Other Southeast Region - Northern",8,1,104,0,116,0,1,0,0
"08/23/2021","Y","Y","Haines Borough",100,"Other Southeast Region - Northern",8,5,109,2,118,0,1,0,0
"08/24/2021","Y","Y","Haines Borough",100,"Other Southeast Region - Northern",8,0,109,3,121,0,1,0,0
"08/25/2021","Y","Y","Haines Borough",100,"Other Southeast Region - Northern",8,1,110,2,123,0,1,0,0
"08/26/2021","Y","Y","Haines Borough",100,"Other Southeast Region - Northern",8,6,116,3,126,0,1,0,0
"08/27/2021","Y","Y","Haines Borough",100,"Other Southeast Region - Northern",8,3,119,0,126,0,1,0,0
"08/29/2021","Y","Y","Haines Borough",100,"Other Southeast Region - Northern",8,5,124,1,127,0,1,0,0
"08/30/2021","Y","Y","Haines Borough",100,"Other Southeast Region - Northern",8,0,124,2,129,0,1,0,0
"08/31/2021","Y","Y","Haines Borough",100,"Other Southeast Region - Northern",8,0,124,1,130,0,1,0,0
"09/01/2021","Y","Y","Haines Borough",100,"Other Southeast Region - Northern",8,0,124,1,131,0,1,0,0
"09/02/2021","Y","Y","Haines Borough",100,"Other Southeast Region - Northern",8,0,124,3,134,0,1,0,0
"09/03/2021","Y","Y","Haines Borough",100,"Other Southeast Region - Northern",8,2,126,1,135,0,1,0,0
"09/04/2021","Y","Y","Haines Borough",100,"Other Southeast Region - Northern",8,0,126,1,136,0,1,0,0
"09/05/2021","Y","Y","Haines Borough",100,"Other Southeast Region - Northern",8,4,130,1,137,0,1,0,0
"09/06/2021","Y","Y","Haines Borough",100,"Other Southeast Region - Northern",8,3,133,0,137,0,1,0,0
"09/07/2021","Y","Y","Haines Borough",100,"Other Southeast Region - Northern",8,0,133,7,144,0,1,0,0
"09/08/2021","Y","Y","Haines Borough",100,"Other Southeast Region - Northern",8,1,134,8,152,0,1,0,0
"09/10/2021","Y","Y","Haines Borough",100,"Other Southeast Region - Northern",8,2,136,6,158,0,1,0,0
"09/11/2021","Y","Y","Haines Borough",100,"Other Southeast Region - Northern",8,0,136,2,160,0,1,0,0
"09/12/2021","Y","Y","Haines Borough",100,"Other Southeast Region - Northern",8,0,136,1,161,0,1,0,0
"09/13/2021","Y","Y","Haines Borough",100,"Other Southeast Region - Northern",8,0,136,6,167,0,1,0,0
"09/14/2021","Y","Y","Haines Borough",100,"Other Southeast Region - Northern",8,0,136,9,176,0,1,0,0
"09/15/2021","Y","Y","Haines Borough",100,"Other Southeast Region - Northern",8,9,145,8,184,0,1,0,0
"09/16/2021","Y","Y","Haines Borough",100,"Other Southeast Region - Northern",8,7,152,1,185,0,1,0,0
"09/17/2021","Y","Y","Haines Borough",100,"Other Southeast Region - Northern",8,0,152,1,186,0,1,0,0
"09/18/2021","Y","Y","Haines Borough",100,"Other Southeast Region - Northern",8,0,152,3,189,0,1,0,0
"09/20/2021","Y","Y","Haines Borough",100,"Other Southeast Region - Northern",8,5,157,5,194,0,1,0,0
"09/21/2021","Y","Y","Haines Borough",100,"Other Southeast Region - Northern",8,8,165,3,197,1,2,0,0
"09/22/2021","Y","Y","Haines Borough",100,"Other Southeast Region - Northern",8,10,175,1,198,0,2,0,0
"09/23/2021","Y","Y","Haines Borough",100,"Other Southeast Region - Northern",8,13,188,1,199,0,2,0,0
"09/25/2021","Y","Y","Haines Borough",100,"Other Southeast Region - Northern",8,3,191,0,199,0,2,0,0
"09/26/2021","Y","Y","Haines Borough",100,"Other Southeast Region - Northern",8,1,192,0,199,0,2,0,0
"09/27/2021","Y","Y","Haines Borough",100,"Other Southeast Region - Northern",8,0,192,3,202,0,2,0,0
"09/28/2021","Y","Y","Haines Borough",100,"Other Southeast Region - Northern",8,10,202,0,202,0,2,0,0
"10/01/2021","Y","Y","Haines Borough",100,"Other Southeast Region - Northern",8,0,202,1,203,0,2,0,0
"10/02/2021","Y","Y","Haines Borough",100,"Other Southeast Region - Northern",8,0,202,1,204,0,2,0,0
"10/03/2021","Y","Y","Haines Borough",100,"Other Southeast Region - Northern",8,0,202,1,205,0,2,0,0
"10/04/2021","Y","Y","Haines Borough",100,"Other Southeast Region - Northern",8,2,204,1,206,0,2,0,0
"10/05/2021","Y","Y","Haines Borough",100,"Other Southeast Region - Northern",8,1,205,1,207,0,2,0,0
"10/07/2021","Y","Y","Haines Borough",100,"Other Southeast Region - Northern",8,0,205,1,208,0,2,0,0
"10/08/2021","Y","Y","Haines Borough",100,"Other Southeast Region - Northern",8,1,206,0,208,0,2,0,0
"10/09/2021","Y","Y","Haines Borough",100,"Other Southeast Region - Northern",8,2,208,2,210,0,2,0,0
"10/10/2021","Y","Y","Haines Borough",100,"Other Southeast Region - Northern",8,2,210,2,212,1,3,0,0
"10/11/2021","Y","Y","Haines Borough",100,"Other Southeast Region - Northern",8,2,212,1,213,0,3,0,0
"10/12/2021","Y","Y","Haines Borough",100,"Other Southeast Region - Northern",8,1,213,0,213,0,3,0,0
"10/15/2021","Y","Y","Haines Borough",100,"Other Southeast Region - Northern",8,0,213,1,214,0,3,0,0
"10/20/2021","Y","Y","Haines Borough",100,"Other Southeast Region - Northern",8,0,213,1,215,0,3,0,0
"10/21/2021","Y","Y","Haines Borough",100,"Other Southeast Region - Northern",8,1,214,0,215,0,3,0,0
"10/22/2021","Y","Y","Haines Borough",100,"Other Southeast Region - Northern",8,0,214,0,215,0,3,1,1
"10/23/2021","Y","Y","Haines Borough",100,"Other Southeast Region - Northern",8,1,215,0,215,0,3,0,1
"10/26/2021","Y","Y","Haines Borough",100,"Other Southeast Region - Northern",8,0,215,2,217,0,3,0,1
"10/27/2021","Y","Y","Haines Borough",100,"Other Southeast Region - Northern",8,0,215,2,219,0,3,0,1
"10/28/2021","Y","Y","Haines Borough",100,"Other Southeast Region - Northern",8,2,217,0,219,0,3,0,1
"10/29/2021","Y","Y","Haines Borough",100,"Other Southeast Region - Northern",8,0,217,1,220,0,3,0,1
"11/01/2021","Y","Y","Haines Borough",100,"Other Southeast Region - Northern",8,1,218,0,220,0,3,0,1
"11/04/2021","Y","Y","Haines Borough",100,"Other Southeast Region - Northern",8,0,218,1,221,0,3,0,1
"11/05/2021","Y","Y","Haines Borough",100,"Other Southeast Region - Northern",8,2,220,0,221,0,3,0,1
"11/07/2021","Y","Y","Haines Borough",100,"Other Southeast Region - Northern",8,1,221,0,221,0,3,0,1
"11/09/2021","Y","Y","Haines Borough",100,"Other Southeast Region - Northern",8,0,221,1,222,0,3,0,1
"11/10/2021","Y","Y","Haines Borough",100,"Other Southeast Region - Northern",8,1,222,0,222,0,3,0,1
"11/12/2021","Y","Y","Haines Borough",100,"Other Southeast Region - Northern",8,0,222,2,224,0,3,0,1
"11/13/2021","Y","Y","Haines Borough",100,"Other Southeast Region - Northern",8,1,223,0,224,0,3,0,1
"11/15/2021","Y","Y","Haines Borough",100,"Other Southeast Region - Northern",8,1,224,0,224,0,3,0,1
"11/26/2021","Y","Y","Haines Borough",100,"Other Southeast Region - Northern",8,0,224,1,225,0,3,0,1
"11/28/2021","Y","Y","Haines Borough",100,"Other Southeast Region - Northern",8,1,225,0,225,0,3,0,1
"12/02/2021","Y","Y","Haines Borough",100,"Other Southeast Region - Northern",8,1,226,1,226,0,3,0,1
"12/03/2021","Y","Y","Haines Borough",100,"Other Southeast Region - Northern",8,0,226,2,228,0,3,0,1
"12/04/2021","Y","Y","Haines Borough",100,"Other Southeast Region - Northern",8,2,228,0,228,0,3,0,1
"12/12/2021","Y","Y","Haines Borough",100,"Other Southeast Region - Northern",8,0,228,1,229,0,3,0,1
"12/13/2021","Y","Y","Haines Borough",100,"Other Southeast Region - Northern",8,0,228,1,230,0,3,0,1
"12/14/2021","Y","Y","Haines Borough",100,"Other Southeast Region - Northern",8,1,229,1,231,0,3,0,1
"12/15/2021","Y","Y","Haines Borough",100,"Other Southeast Region - Northern",8,2,231,0,231,0,3,0,1
"12/18/2021","Y","Y","Haines Borough",100,"Other Southeast Region - Northern",8,1,232,1,232,0,3,0,1
"12/27/2021","Y","Y","Haines Borough",100,"Other Southeast Region - Northern",8,0,232,10,242,0,3,0,1
"12/28/2021","Y","Y","Haines Borough",100,"Other Southeast Region - Northern",8,12,244,17,259,0,3,0,1
"12/29/2021","Y","Y","Haines Borough",100,"Other Southeast Region - Northern",8,15,259,3,262,0,3,0,1
"12/30/2021","Y","Y","Haines Borough",100,"Other Southeast Region - Northern",8,3,262,5,267,0,3,0,1
"12/31/2021","Y","Y","Haines Borough",100,"Other Southeast Region - Northern",8,2,264,0,267,0,3,0,1
"01/02/2022","Y","Y","Haines Borough",100,"Other Southeast Region - Northern",8,0,264,2,269,0,3,0,1
"01/03/2022","Y","Y","Haines Borough",100,"Other Southeast Region - Northern",8,3,267,1,270,0,3,0,1
"01/04/2022","Y","Y","Haines Borough",100,"Other Southeast Region - Northern",8,1,268,5,275,0,3,0,1
"01/05/2022","Y","Y","Haines Borough",100,"Other Southeast Region - Northern",8,5,273,12,287,0,3,0,1
"01/06/2022","Y","Y","Haines Borough",100,"Other Southeast Region - Northern",8,4,277,14,301,0,3,0,1
"01/07/2022","Y","Y","Haines Borough",100,"Other Southeast Region - Northern",8,20,297,3,304,0,3,0,1
"01/08/2022","Y","Y","Haines Borough",100,"Other Southeast Region - Northern",8,1,298,2,306,0,3,0,1
"01/10/2022","Y","Y","Haines Borough",100,"Other Southeast Region - Northern",8,4,302,1,307,0,3,0,1
"01/11/2022","Y","Y","Haines Borough",100,"Other Southeast Region - Northern",8,4,306,10,317,0,3,0,1
"01/12/2022","Y","Y","Haines Borough",100,"Other Southeast Region - Northern",8,2,308,10,327,0,3,0,1
"01/13/2022","Y","Y","Haines Borough",100,"Other Southeast Region - Northern",8,0,308,6,333,0,3,0,1
"01/14/2022","Y","Y","Haines Borough",100,"Other Southeast Region - Northern",8,19,327,8,341,0,3,0,1
"01/15/2022","Y","Y","Haines Borough",100,"Other Southeast Region - Northern",8,6,333,1,342,0,3,0,1
"01/16/2022","Y","Y","Haines Borough",100,"Other Southeast Region - Northern",8,2,335,0,342,0,3,0,1
"01/17/2022","Y","Y","Haines Borough",100,"Other Southeast Region - Northern",8,6,341,0,342,0,3,0,1
"01/18/2022","Y","Y","Haines Borough",100,"Other Southeast Region - Northern",8,0,341,12,354,0,3,0,1
"01/19/2022","Y","Y","Haines Borough",100,"Other Southeast Region - Northern",8,0,341,2,356,0,3,0,1
"01/20/2022","Y","Y","Haines Borough",100,"Other Southeast Region - Northern",8,9,350,10,366,0,3,0,1
"01/21/2022","Y","Y","Haines Borough",100,"Other Southeast Region - Northern",8,2,352,8,374,0,3,0,1
"01/22/2022","Y","Y","Haines Borough",100,"Other Southeast Region - Northern",8,0,352,1,375,0,3,0,1
"01/24/2022","Y","Y","Haines Borough",100,"Other Southeast Region - Northern",8,3,355,12,387,0,3,0,1
"01/25/2022","Y","Y","Haines Borough",100,"Other Southeast Region - Northern",8,2,357,3,390,0,3,0,1
"01/26/2022","Y","Y","Haines Borough",100,"Other Southeast Region - Northern",8,24,381,8,398,0,3,0,1
"01/27/2022","Y","Y","Haines Borough",100,"Other Southeast Region - Northern",8,1,382,8,406,0,3,0,1
"01/28/2022","Y","Y","Haines Borough",100,"Other Southeast Region - Northern",8,2,384,17,423,0,3,0,1
"01/29/2022","Y","Y","Haines Borough",100,"Other Southeast Region - Northern",8,2,386,0,423,0,3,0,1
"01/31/2022","Y","Y","Haines Borough",100,"Other Southeast Region - Northern",8,30,416,5,428,0,3,0,1
"02/01/2022","Y","Y","Haines Borough",100,"Other Southeast Region - Northern",8,7,423,5,433,0,3,0,1
"02/02/2022","Y","Y","Haines Borough",100,"Other Southeast Region - Northern",8,9,432,2,435,0,3,0,1
"02/03/2022","Y","Y","Haines Borough",100,"Other Southeast Region - Northern",8,3,435,3,438,0,3,0,1
"02/04/2022","Y","Y","Haines Borough",100,"Other Southeast Region - Northern",8,0,435,2,440,0,3,0,1
"02/05/2022","Y","Y","Haines Borough",100,"Other Southeast Region - Northern",8,5,440,0,440,0,3,0,1
"02/07/2022","Y","Y","Haines Borough",100,"Other Southeast Region - Northern",8,0,440,7,447,0,3,0,1
"02/08/2022","Y","Y","Haines Borough",100,"Other Southeast Region - Northern",8,2,442,6,453,0,3,0,1
"02/09/2022","Y","Y","Haines Borough",100,"Other Southeast Region - Northern",8,12,454,11,464,0,3,0,1
"02/10/2022","Y","Y","Haines Borough",100,"Other Southeast Region - Northern",8,18,472,10,474,0,3,0,1
"02/11/2022","Y","Y","Haines Borough",100,"Other Southeast Region - Northern",8,4,476,4,478,0,3,0,1
"02/12/2022","Y","Y","Haines Borough",100,"Other Southeast Region - Northern",8,0,476,1,479,0,3,0,1
"02/13/2022","Y","Y","Haines Borough",100,"Other Southeast Region - Northern",8,4,480,3,482,0,3,0,1
"02/14/2022","Y","Y","Haines Borough",100,"Other Southeast Region - Northern",8,3,483,9,491,0,3,0,1
"02/15/2022","Y","Y","Haines Borough",100,"Other Southeast Region - Northern",8,8,491,4,495,0,3,0,1
"02/16/2022","Y","Y","Haines Borough",100,"Other Southeast Region - Northern",8,8,499,8,503,0,3,0,1
"02/17/2022","Y","Y","Haines Borough",100,"Other Southeast Region - Northern",8,17,516,19,522,0,3,0,1
"02/18/2022","Y","Y","Haines Borough",100,"Other Southeast Region - Northern",8,5,521,1,523,0,3,0,1
"02/19/2022","Y","Y","Haines Borough",100,"Other Southeast Region - Northern",8,7,528,6,529,0,3,0,1
"02/20/2022","Y","Y","Haines Borough",100,"Other Southeast Region - Northern",8,9,537,9,538,0,3,0,1
"02/21/2022","Y","Y","Haines Borough",100,"Other Southeast Region - Northern",8,0,537,2,540,0,3,0,1
"02/22/2022","Y","Y","Haines Borough",100,"Other Southeast Region - Northern",8,2,539,2,542,0,3,0,1
"02/23/2022","Y","Y","Haines Borough",100,"Other Southeast Region - Northern",8,11,550,11,553,0,3,0,1
"02/24/2022","Y","Y","Haines Borough",100,"Other Southeast Region - Northern",8,7,557,8,561,0,3,0,1
"02/25/2022","Y","Y","Haines Borough",100,"Other Southeast Region - Northern",8,4,561,4,565,0,3,0,1
"02/26/2022","Y","Y","Haines Borough",100,"Other Southeast Region - Northern",8,6,567,2,567,0,3,0,1
"02/28/2022","Y","Y","Haines Borough",100,"Other Southeast Region - Northern",8,0,567,2,569,0,3,0,1
"03/01/2022","Y","Y","Haines Borough",100,"Other Southeast Region - Northern",8,2,569,0,569,0,3,0,1
"03/02/2022","Y","Y","Haines Borough",100,"Other Southeast Region - Northern",8,2,571,2,571,0,3,0,1
"03/03/2022","Y","Y","Haines Borough",100,"Other Southeast Region - Northern",8,0,571,2,573,0,3,0,1
"03/04/2022","Y","Y","Haines Borough",100,"Other Southeast Region - Northern",8,6,577,4,577,0,3,0,1
"03/05/2022","Y","Y","Haines Borough",100,"Other Southeast Region - Northern",8,1,578,1,578,0,3,0,1
"03/09/2022","Y","Y","Haines Borough",100,"Other Southeast Region - Northern",8,1,579,2,580,0,3,0,1
"03/10/2022","Y","Y","Haines Borough",100,"Other Southeast Region - Northern",8,5,584,4,584,0,3,0,1
"03/16/2022","Y","Y","Haines Borough",100,"Other Southeast Region - Northern",8,1,585,2,586,0,3,0,1
"03/17/2022","Y","Y","Haines Borough",100,"Other Southeast Region - Northern",8,1,586,0,586,0,3,0,1
"03/18/2022","Y","Y","Haines Borough",100,"Other Southeast Region - Northern",8,2,588,2,588,0,3,0,1
"03/21/2022","Y","Y","Haines Borough",100,"Other Southeast Region - Northern",8,0,588,1,589,0,3,0,1
"03/22/2022","Y","Y","Haines Borough",100,"Other Southeast Region - Northern",8,1,589,1,590,0,3,0,1
"03/23/2022","Y","Y","Haines Borough",100,"Other Southeast Region - Northern",8,1,590,0,590,0,3,0,1
"03/28/2022","Y","Y","Haines Borough",100,"Other Southeast Region - Northern",8,0,590,2,592,0,3,0,1
"03/29/2022","Y","Y","Haines Borough",100,"Other Southeast Region - Northern",8,2,592,0,592,0,3,0,1
"03/30/2022","Y","Y","Haines Borough",100,"Other Southeast Region - Northern",8,1,593,1,593,0,3,0,1
"03/31/2022","Y","Y","Haines Borough",100,"Other Southeast Region - Northern",8,0,593,1,594,0,3,0,1
"04/01/2022","Y","Y","Haines Borough",100,"Other Southeast Region - Northern",8,1,594,0,594,0,3,0,1
"04/06/2022","Y","Y","Haines Borough",100,"Other Southeast Region - Northern",8,1,595,1,595,0,3,0,1
"04/10/2022","Y","Y","Haines Borough",100,"Other Southeast Region - Northern",8,2,597,2,597,0,3,0,1
"04/14/2022","Y","Y","Haines Borough",100,"Other Southeast Region - Northern",8,0,597,3,600,0,3,0,1
"04/15/2022","Y","Y","Haines Borough",100,"Other Southeast Region - Northern",8,1,598,1,601,0,3,0,1
"04/17/2022","Y","Y","Haines Borough",100,"Other Southeast Region - Northern",8,3,601,0,601,0,3,0,1
"04/19/2022","Y","Y","Haines Borough",100,"Other Southeast Region - Northern",8,2,603,2,603,0,3,0,1
"04/23/2022","Y","Y","Haines Borough",100,"Other Southeast Region - Northern",8,1,604,1,604,0,3,0,1
"04/24/2022","Y","Y","Haines Borough",100,"Other Southeast Region - Northern",8,2,606,2,606,0,3,0,1
"04/26/2022","Y","Y","Haines Borough",100,"Other Southeast Region - Northern",8,4,610,4,610,0,3,0,1
"03/10/2020","Y","Y","Juneau City and Borough",110,"Juneau City and Borough",3,0,0,1,1,0,0,0,0
"03/17/2020","Y","Y","Juneau City and Borough",110,"Juneau City and Borough",3,0,0,2,3,0,0,0,0
"03/18/2020","Y","Y","Juneau City and Borough",110,"Juneau City and Borough",3,0,0,1,4,0,0,0,0
"03/19/2020","Y","Y","Juneau City and Borough",110,"Juneau City and Borough",3,0,0,2,6,0,0,0,0
"03/20/2020","Y","Y","Juneau City and Borough",110,"Juneau City and Borough",3,0,0,2,8,0,0,0,0
"03/21/2020","Y","Y","Juneau City and Borough",110,"Juneau City and Borough",3,1,1,3,11,1,1,0,0
"03/22/2020","Y","Y","Juneau City and Borough",110,"Juneau City and Borough",3,1,2,1,12,0,1,0,0
"03/23/2020","Y","Y","Juneau City and Borough",110,"Juneau City and Borough",3,0,2,2,14,0,1,0,0
"03/25/2020","Y","Y","Juneau City and Borough",110,"Juneau City and Borough",3,0,2,0,14,1,2,0,0
"03/26/2020","Y","Y","Juneau City and Borough",110,"Juneau City and Borough",3,1,3,0,14,0,2,0,0
"03/27/2020","Y","Y","Juneau City and Borough",110,"Juneau City and Borough",3,1,4,0,14,0,2,0,0
"03/29/2020","Y","Y","Juneau City and Borough",110,"Juneau City and Borough",3,1,5,1,15,1,3,0,0
"03/30/2020","Y","Y","Juneau City and Borough",110,"Juneau City and Borough",3,0,5,0,15,1,4,0,0
"03/31/2020","Y","Y","Juneau City and Borough",110,"Juneau City and Borough",3,4,9,0,15,0,4,0,0
"04/01/2020","Y","Y","Juneau City and Borough",110,"Juneau City and Borough",3,1,10,2,17,0,4,0,0
"04/02/2020","Y","Y","Juneau City and Borough",110,"Juneau City and Borough",3,1,11,1,18,1,5,0,0
"04/03/2020","Y","Y","Juneau City and Borough",110,"Juneau City and Borough",3,1,12,1,19,0,5,0,0
"04/04/2020","Y","Y","Juneau City and Borough",110,"Juneau City and Borough",3,2,14,0,19,0,5,0,0
"04/07/2020","Y","Y","Juneau City and Borough",110,"Juneau City and Borough",3,0,14,1,20,0,5,0,0
"04/09/2020","Y","Y","Juneau City and Borough",110,"Juneau City and Borough",3,1,15,1,21,0,5,0,0
"04/10/2020","Y","Y","Juneau City and Borough",110,"Juneau City and Borough",3,0,15,1,22,0,5,0,0
"04/11/2020","Y","Y","Juneau City and Borough",110,"Juneau City and Borough",3,1,16,3,25,0,5,0,0
"04/12/2020","Y","Y","Juneau City and Borough",110,"Juneau City and Borough",3,1,17,1,26,0,5,0,0
"04/13/2020","Y","Y","Juneau City and Borough",110,"Juneau City and Borough",3,1,18,0,26,0,5,0,0
"04/14/2020","Y","Y","Juneau City and Borough",110,"Juneau City and Borough",3,3,21,1,27,1,6,0,0
"04/15/2020","Y","Y","Juneau City and Borough",110,"Juneau City and Borough",3,2,23,0,27,0,6,0,0
"04/16/2020","Y","Y","Juneau City and Borough",110,"Juneau City and Borough",3,1,24,0,27,0,6,0,0
"04/20/2020","Y","Y","Juneau City and Borough",110,"Juneau City and Borough",3,2,26,0,27,0,6,0,0
"04/21/2020","Y","Y","Juneau City and Borough",110,"Juneau City and Borough",3,1,27,0,27,0,6,0,0
"04/28/2020","Y","Y","Juneau City and Borough",110,"Juneau City and Borough",3,0,27,1,28,0,6,0,0
"04/30/2020","Y","Y","Juneau City and Borough",110,"Juneau City and Borough",3,0,27,1,29,0,6,0,0
"05/11/2020","Y","Y","Juneau City and Borough",110,"Juneau City and Borough",3,2,29,0,29,0,6,0,0
"05/16/2020","Y","Y","Juneau City and Borough",110,"Juneau City and Borough",3,1,30,1,30,0,6,0,0
"05/17/2020","Y","Y","Juneau City and Borough",110,"Juneau City and Borough",3,0,30,1,31,0,6,0,0
"05/20/2020","Y","Y","Juneau City and Borough",110,"Juneau City and Borough",3,0,30,1,32,0,6,0,0
"05/21/2020","Y","Y","Juneau City and Borough",110,"Juneau City and Borough",3,1,31,0,32,0,6,0,0
"05/26/2020","Y","Y","Juneau City and Borough",110,"Juneau City and Borough",3,0,31,1,33,0,6,0,0
"05/27/2020","Y","Y","Juneau City and Borough",110,"Juneau City and Borough",3,1,32,1,34,0,6,0,0
"05/28/2020","Y","Y","Juneau City and Borough",110,"Juneau City and Borough",3,1,33,0,34,0,6,0,0
"06/03/2020","Y","Y","Juneau City and Borough",110,"Juneau City and Borough",3,0,33,1,35,0,6,0,0
"06/04/2020","Y","Y","Juneau City and Borough",110,"Juneau City and Borough",3,0,33,1,36,0,6,0,0
"06/06/2020","Y","Y","Juneau City and Borough",110,"Juneau City and Borough",3,1,34,0,36,0,6,0,0
"06/07/2020","Y","Y","Juneau City and Borough",110,"Juneau City and Borough",3,1,35,0,36,0,6,0,0
"06/08/2020","Y","Y","Juneau City and Borough",110,"Juneau City and Borough",3,0,35,1,37,0,6,0,0
"06/09/2020","Y","Y","Juneau City and Borough",110,"Juneau City and Borough",3,0,35,1,38,0,6,0,0
"06/10/2020","Y","Y","Juneau City and Borough",110,"Juneau City and Borough",3,2,37,0,38,0,6,0,0
"06/13/2020","Y","Y","Juneau City and Borough",110,"Juneau City and Borough",3,0,37,2,40,0,6,0,0
"06/16/2020","Y","Y","Juneau City and Borough",110,"Juneau City and Borough",3,1,38,0,40,0,6,0,0
"06/17/2020","Y","Y","Juneau City and Borough",110,"Juneau City and Borough",3,1,39,1,41,0,6,0,0
"06/25/2020","Y","Y","Juneau City and Borough",110,"Juneau City and Borough",3,1,40,1,42,0,6,0,0
"06/26/2020","Y","Y","Juneau City and Borough",110,"Juneau City and Borough",3,0,40,1,43,0,6,0,0
"06/27/2020","Y","Y","Juneau City and Borough",110,"Juneau City and Borough",3,1,41,1,44,0,6,0,0
"06/29/2020","Y","Y","Juneau City and Borough",110,"Juneau City and Borough",3,1,42,1,45,0,6,0,0
"07/01/2020","Y","Y","Juneau City and Borough",110,"Juneau City and Borough",3,0,42,1,46,0,6,0,0
"07/02/2020","Y","Y","Juneau City and Borough",110,"Juneau City and Borough",3,1,43,1,47,0,6,0,0
"07/03/2020","Y","Y","Juneau City and Borough",110,"Juneau City and Borough",3,1,44,1,48,0,6,0,0
"07/06/2020","Y","Y","Juneau City and Borough",110,"Juneau City and Borough",3,0,44,1,49,0,6,0,0
"07/07/2020","Y","Y","Juneau City and Borough",110,"Juneau City and Borough",3,0,44,2,51,0,6,0,0
"07/08/2020","Y","Y","Juneau City and Borough",110,"Juneau City and Borough",3,0,44,2,53,0,6,0,0
"07/09/2020","Y","Y","Juneau City and Borough",110,"Juneau City and Borough",3,0,44,1,54,0,6,0,0
"07/10/2020","Y","Y","Juneau City and Borough",110,"Juneau City and Borough",3,1,45,1,55,0,6,0,0
"07/11/2020","Y","Y","Juneau City and Borough",110,"Juneau City and Borough",3,3,48,0,55,0,6,0,0
"07/12/2020","Y","Y","Juneau City and Borough",110,"Juneau City and Borough",3,0,48,4,59,0,6,0,0
"07/13/2020","Y","Y","Juneau City and Borough",110,"Juneau City and Borough",3,1,49,1,60,0,6,0,0
"07/14/2020","Y","Y","Juneau City and Borough",110,"Juneau City and Borough",3,1,50,2,62,0,6,0,0
"07/15/2020","Y","Y","Juneau City and Borough",110,"Juneau City and Borough",3,0,50,1,63,0,6,0,0
"07/16/2020","Y","Y","Juneau City and Borough",110,"Juneau City and Borough",3,3,53,3,66,1,7,0,0
"07/17/2020","Y","Y","Juneau City and Borough",110,"Juneau City and Borough",3,2,55,1,67,0,7,0,0
"07/18/2020","Y","Y","Juneau City and Borough",110,"Juneau City and Borough",3,4,59,0,67,0,7,0,0
"07/19/2020","Y","Y","Juneau City and Borough",110,"Juneau City and Borough",3,1,60,0,67,1,8,0,0
"07/20/2020","Y","Y","Juneau City and Borough",110,"Juneau City and Borough",3,1,61,3,70,0,8,0,0
"07/21/2020","Y","Y","Juneau City and Borough",110,"Juneau City and Borough",3,6,67,4,74,0,8,0,0
"07/22/2020","Y","Y","Juneau City and Borough",110,"Juneau City and Borough",3,0,67,4,78,0,8,0,0
"07/23/2020","Y","Y","Juneau City and Borough",110,"Juneau City and Borough",3,1,68,4,82,0,8,0,0
"07/24/2020","Y","Y","Juneau City and Borough",110,"Juneau City and Borough",3,1,69,1,83,0,8,0,0
"07/25/2020","Y","Y","Juneau City and Borough",110,"Juneau City and Borough",3,2,71,0,83,0,8,0,0
"07/26/2020","Y","Y","Juneau City and Borough",110,"Juneau City and Borough",3,3,74,1,84,0,8,0,0
"07/27/2020","Y","Y","Juneau City and Borough",110,"Juneau City and Borough",3,5,79,0,84,0,8,0,0
"07/28/2020","Y","Y","Juneau City and Borough",110,"Juneau City and Borough",3,1,80,2,86,0,8,0,0
"07/29/2020","Y","Y","Juneau City and Borough",110,"Juneau City and Borough",3,2,82,1,87,0,8,0,0
"07/30/2020","Y","Y","Juneau City and Borough",110,"Juneau City and Borough",3,1,83,0,87,0,8,0,0
"07/31/2020","Y","Y","Juneau City and Borough",110,"Juneau City and Borough",3,0,83,3,90,0,8,0,0
"08/01/2020","Y","Y","Juneau City and Borough",110,"Juneau City and Borough",3,1,84,0,90,0,8,0,0
"08/02/2020","Y","Y","Juneau City and Borough",110,"Juneau City and Borough",3,3,87,0,90,0,8,0,0
"08/03/2020","Y","Y","Juneau City and Borough",110,"Juneau City and Borough",3,1,88,4,94,0,8,0,0
"08/04/2020","Y","Y","Juneau City and Borough",110,"Juneau City and Borough",3,1,89,8,102,0,8,0,0
"08/05/2020","Y","Y","Juneau City and Borough",110,"Juneau City and Borough",3,2,91,4,106,0,8,0,0
"08/06/2020","Y","Y","Juneau City and Borough",110,"Juneau City and Borough",3,3,94,5,111,1,9,0,0
"08/07/2020","Y","Y","Juneau City and Borough",110,"Juneau City and Borough",3,3,97,2,113,0,9,0,0
"08/08/2020","Y","Y","Juneau City and Borough",110,"Juneau City and Borough",3,4,101,2,115,0,9,0,0
"08/09/2020","Y","Y","Juneau City and Borough",110,"Juneau City and Borough",3,3,104,4,119,0,9,0,0
"08/10/2020","Y","Y","Juneau City and Borough",110,"Juneau City and Borough",3,3,107,6,125,0,9,0,0
"08/11/2020","Y","Y","Juneau City and Borough",110,"Juneau City and Borough",3,2,109,4,129,0,9,0,0
"08/12/2020","Y","Y","Juneau City and Borough",110,"Juneau City and Borough",3,9,118,7,136,0,9,0,0
"08/13/2020","Y","Y","Juneau City and Borough",110,"Juneau City and Borough",3,11,129,5,141,0,9,0,0
"08/14/2020","Y","Y","Juneau City and Borough",110,"Juneau City and Borough",3,6,135,3,144,0,9,0,0
"08/15/2020","Y","Y","Juneau City and Borough",110,"Juneau City and Borough",3,5,140,2,146,0,9,0,0
"08/16/2020","Y","Y","Juneau City and Borough",110,"Juneau City and Borough",3,1,141,1,147,0,9,0,0
"08/17/2020","Y","Y","Juneau City and Borough",110,"Juneau City and Borough",3,2,143,3,150,0,9,0,0
"08/18/2020","Y","Y","Juneau City and Borough",110,"Juneau City and Borough",3,0,143,1,151,1,10,0,0
"08/19/2020","Y","Y","Juneau City and Borough",110,"Juneau City and Borough",3,4,147,0,151,0,10,0,0
"08/20/2020","Y","Y","Juneau City and Borough",110,"Juneau City and Borough",3,1,148,4,155,1,11,0,0
"08/21/2020","Y","Y","Juneau City and Borough",110,"Juneau City and Borough",3,2,150,1,156,0,11,0,0
"08/22/2020","Y","Y","Juneau City and Borough",110,"Juneau City and Borough",3,5,155,2,158,0,11,0,0
"08/23/2020","Y","Y","Juneau City and Borough",110,"Juneau City and Borough",3,0,155,3,161,0,11,0,0
"08/24/2020","Y","Y","Juneau City and Borough",110,"Juneau City and Borough",3,0,155,1,162,0,11,0,0
"08/26/2020","Y","Y","Juneau City and Borough",110,"Juneau City and Borough",3,4,159,1,163,0,11,0,0
"08/27/2020","Y","Y","Juneau City and Borough",110,"Juneau City and Borough",3,2,161,0,163,0,11,0,0
"08/28/2020","Y","Y","Juneau City and Borough",110,"Juneau City and Borough",3,0,161,5,168,0,11,0,0
"08/29/2020","Y","Y","Juneau City and Borough",110,"Juneau City and Borough",3,3,164,3,171,0,11,0,0
"08/30/2020","Y","Y","Juneau City and Borough",110,"Juneau City and Borough",3,1,165,1,172,0,11,0,0
"08/31/2020","Y","Y","Juneau City and Borough",110,"Juneau City and Borough",3,2,167,6,178,1,12,0,0
"09/01/2020","Y","Y","Juneau City and Borough",110,"Juneau City and Borough",3,1,168,2,180,0,12,0,0
"09/02/2020","Y","Y","Juneau City and Borough",110,"Juneau City and Borough",3,2,170,9,189,0,12,0,0
"09/03/2020","Y","Y","Juneau City and Borough",110,"Juneau City and Borough",3,3,173,9,198,0,12,0,0
"09/04/2020","Y","Y","Juneau City and Borough",110,"Juneau City and Borough",3,2,175,9,207,0,12,0,0
"09/05/2020","Y","Y","Juneau City and Borough",110,"Juneau City and Borough",3,8,183,1,208,0,12,1,1
"09/06/2020","Y","Y","Juneau City and Borough",110,"Juneau City and Borough",3,1,184,0,208,0,12,0,1
"09/07/2020","Y","Y","Juneau City and Borough",110,"Juneau City and Borough",3,3,187,3,211,0,12,0,1
"09/08/2020","Y","Y","Juneau City and Borough",110,"Juneau City and Borough",3,13,200,10,221,0,12,0,1
"09/09/2020","Y","Y","Juneau City and Borough",110,"Juneau City and Borough",3,8,208,7,228,0,12,0,1
"09/10/2020","Y","Y","Juneau City and Borough",110,"Juneau City and Borough",3,5,213,9,237,1,13,0,1
"09/11/2020","Y","Y","Juneau City and Borough",110,"Juneau City and Borough",3,6,219,8,245,0,13,0,1
"09/12/2020","Y","Y","Juneau City and Borough",110,"Juneau City and Borough",3,5,224,2,247,0,13,0,1
"09/13/2020","Y","Y","Juneau City and Borough",110,"Juneau City and Borough",3,5,229,3,250,0,13,0,1
"09/14/2020","Y","Y","Juneau City and Borough",110,"Juneau City and Borough",3,1,230,5,255,0,13,0,1
"09/15/2020","Y","Y","Juneau City and Borough",110,"Juneau City and Borough",3,1,231,0,255,1,14,0,1
"09/16/2020","Y","Y","Juneau City and Borough",110,"Juneau City and Borough",3,16,247,4,259,0,14,0,1
"09/17/2020","Y","Y","Juneau City and Borough",110,"Juneau City and Borough",3,0,247,1,260,0,14,0,1
"09/18/2020","Y","Y","Juneau City and Borough",110,"Juneau City and Borough",3,4,251,4,264,0,14,0,1
"09/19/2020","Y","Y","Juneau City and Borough",110,"Juneau City and Borough",3,5,256,5,269,0,14,0,1
"09/20/2020","Y","Y","Juneau City and Borough",110,"Juneau City and Borough",3,4,260,0,269,0,14,0,1
"09/21/2020","Y","Y","Juneau City and Borough",110,"Juneau City and Borough",3,0,260,6,275,0,14,0,1
"09/22/2020","Y","Y","Juneau City and Borough",110,"Juneau City and Borough",3,2,262,2,277,0,14,0,1
"09/23/2020","Y","Y","Juneau City and Borough",110,"Juneau City and Borough",3,7,269,5,282,0,14,0,1
"09/24/2020","Y","Y","Juneau City and Borough",110,"Juneau City and Borough",3,6,275,1,283,0,14,0,1
"09/25/2020","Y","Y","Juneau City and Borough",110,"Juneau City and Borough",3,3,278,2,285,0,14,0,1
"09/26/2020","Y","Y","Juneau City and Borough",110,"Juneau City and Borough",3,1,279,3,288,1,15,0,1
"09/27/2020","Y","Y","Juneau City and Borough",110,"Juneau City and Borough",3,2,281,1,289,0,15,0,1
"09/28/2020","Y","Y","Juneau City and Borough",110,"Juneau City and Borough",3,1,282,1,290,0,15,0,1
"09/29/2020","Y","Y","Juneau City and Borough",110,"Juneau City and Borough",3,3,285,2,292,1,16,0,1
"09/30/2020","Y","Y","Juneau City and Borough",110,"Juneau City and Borough",3,1,286,4,296,0,16,0,1
"10/01/2020","Y","Y","Juneau City and Borough",110,"Juneau City and Borough",3,2,288,1,297,1,17,0,1
"10/02/2020","Y","Y","Juneau City and Borough",110,"Juneau City and Borough",3,3,291,3,300,0,17,0,1
"10/03/2020","Y","Y","Juneau City and Borough",110,"Juneau City and Borough",3,1,292,3,303,0,17,0,1
"10/04/2020","Y","Y","Juneau City and Borough",110,"Juneau City and Borough",3,2,294,3,306,0,17,0,1
"10/05/2020","Y","Y","Juneau City and Borough",110,"Juneau City and Borough",3,2,296,2,308,0,17,0,1
"10/06/2020","Y","Y","Juneau City and Borough",110,"Juneau City and Borough",3,2,298,2,310,0,17,0,1
"10/07/2020","Y","Y","Juneau City and Borough",110,"Juneau City and Borough",3,1,299,6,316,1,18,0,1
"10/08/2020","Y","Y","Juneau City and Borough",110,"Juneau City and Borough",3,2,301,5,321,0,18,0,1
"10/09/2020","Y","Y","Juneau City and Borough",110,"Juneau City and Borough",3,4,305,14,335,3,21,0,1
"10/10/2020","Y","Y","Juneau City and Borough",110,"Juneau City and Borough",3,11,316,5,340,1,22,0,1
"10/11/2020","Y","Y","Juneau City and Borough",110,"Juneau City and Borough",3,3,319,7,347,0,22,0,1
"10/12/2020","Y","Y","Juneau City and Borough",110,"Juneau City and Borough",3,5,324,5,352,1,23,0,1
"10/13/2020","Y","Y","Juneau City and Borough",110,"Juneau City and Borough",3,4,328,4,356,1,24,1,2
"10/14/2020","Y","Y","Juneau City and Borough",110,"Juneau City and Borough",3,3,331,5,361,0,24,0,2
"10/15/2020","Y","Y","Juneau City and Borough",110,"Juneau City and Borough",3,6,337,10,371,0,24,0,2
"10/16/2020","Y","Y","Juneau City and Borough",110,"Juneau City and Borough",3,13,350,24,395,1,25,0,2
"10/17/2020","Y","Y","Juneau City and Borough",110,"Juneau City and Borough",3,5,355,7,402,0,25,0,2
"10/18/2020","Y","Y","Juneau City and Borough",110,"Juneau City and Borough",3,3,358,4,406,1,26,0,2
"10/19/2020","Y","Y","Juneau City and Borough",110,"Juneau City and Borough",3,6,364,8,414,0,26,0,2
"10/20/2020","Y","Y","Juneau City and Borough",110,"Juneau City and Borough",3,3,367,9,423,1,27,0,2
"10/21/2020","Y","Y","Juneau City and Borough",110,"Juneau City and Borough",3,3,370,8,431,0,27,0,2
"10/22/2020","Y","Y","Juneau City and Borough",110,"Juneau City and Borough",3,6,376,16,447,0,27,0,2
"10/23/2020","Y","Y","Juneau City and Borough",110,"Juneau City and Borough",3,6,382,19,466,0,27,0,2
"10/24/2020","Y","Y","Juneau City and Borough",110,"Juneau City and Borough",3,38,420,11,477,0,27,0,2
"10/25/2020","Y","Y","Juneau City and Borough",110,"Juneau City and Borough",3,9,429,7,484,1,28,0,2
"10/26/2020","Y","Y","Juneau City and Borough",110,"Juneau City and Borough",3,9,438,15,499,0,28,0,2
"10/27/2020","Y","Y","Juneau City and Borough",110,"Juneau City and Borough",3,8,446,16,515,0,28,0,2
"10/28/2020","Y","Y","Juneau City and Borough",110,"Juneau City and Borough",3,6,452,11,526,1,29,0,2
"10/29/2020","Y","Y","Juneau City and Borough",110,"Juneau City and Borough",3,18,470,12,538,1,30,0,2
"10/30/2020","Y","Y","Juneau City and Borough",110,"Juneau City and Borough",3,12,482,14,552,1,31,0,2
"10/31/2020","Y","Y","Juneau City and Borough",110,"Juneau City and Borough",3,10,492,9,561,1,32,0,2
"11/01/2020","Y","Y","Juneau City and Borough",110,"Juneau City and Borough",3,4,496,6,567,0,32,0,2
"11/02/2020","Y","Y","Juneau City and Borough",110,"Juneau City and Borough",3,21,517,18,585,0,32,0,2
"11/03/2020","Y","Y","Juneau City and Borough",110,"Juneau City and Borough",3,14,531,7,592,0,32,0,2
"11/04/2020","Y","Y","Juneau City and Borough",110,"Juneau City and Borough",3,3,534,8,600,0,32,0,2
"11/05/2020","Y","Y","Juneau City and Borough",110,"Juneau City and Borough",3,10,544,9,609,2,34,0,2
"11/06/2020","Y","Y","Juneau City and Borough",110,"Juneau City and Borough",3,10,554,10,619,0,34,0,2
"11/07/2020","Y","Y","Juneau City and Borough",110,"Juneau City and Borough",3,3,557,5,624,0,34,0,2
"11/08/2020","Y","Y","Juneau City and Borough",110,"Juneau City and Borough",3,12,569,3,627,0,34,0,2
"11/09/2020","Y","Y","Juneau City and Borough",110,"Juneau City and Borough",3,4,573,10,637,1,35,0,2
"11/10/2020","Y","Y","Juneau City and Borough",110,"Juneau City and Borough",3,12,585,10,647,0,35,0,2
"11/11/2020","Y","Y","Juneau City and Borough",110,"Juneau City and Borough",3,8,593,7,654,0,35,0,2
"11/12/2020","Y","Y","Juneau City and Borough",110,"Juneau City and Borough",3,23,616,8,662,0,35,0,2
"11/13/2020","Y","Y","Juneau City and Borough",110,"Juneau City and Borough",3,15,631,7,669,0,35,0,2
"11/14/2020","Y","Y","Juneau City and Borough",110,"Juneau City and Borough",3,16,647,6,675,0,35,0,2
"11/15/2020","Y","Y","Juneau City and Borough",110,"Juneau City and Borough",3,8,655,4,679,0,35,1,3
"11/16/2020","Y","Y","Juneau City and Borough",110,"Juneau City and Borough",3,5,660,20,699,0,35,0,3
"11/17/2020","Y","Y","Juneau City and Borough",110,"Juneau City and Borough",3,6,666,13,712,0,35,0,3
"11/18/2020","Y","Y","Juneau City and Borough",110,"Juneau City and Borough",3,6,672,10,722,0,35,0,3
"11/19/2020","Y","Y","Juneau City and Borough",110,"Juneau City and Borough",3,2,674,4,726,0,35,0,3
"11/20/2020","Y","Y","Juneau City and Borough",110,"Juneau City and Borough",3,9,683,5,731,0,35,0,3
"11/21/2020","Y","Y","Juneau City and Borough",110,"Juneau City and Borough",3,13,696,7,738,0,35,0,3
"11/22/2020","Y","Y","Juneau City and Borough",110,"Juneau City and Borough",3,6,702,1,739,0,35,0,3
"11/23/2020","Y","Y","Juneau City and Borough",110,"Juneau City and Borough",3,6,708,12,751,2,37,0,3
"11/24/2020","Y","Y","Juneau City and Borough",110,"Juneau City and Borough",3,9,717,8,759,0,37,0,3
"11/25/2020","Y","Y","Juneau City and Borough",110,"Juneau City and Borough",3,11,728,11,770,0,37,0,3
"11/26/2020","Y","Y","Juneau City and Borough",110,"Juneau City and Borough",3,2,730,1,771,0,37,0,3
"11/27/2020","Y","Y","Juneau City and Borough",110,"Juneau City and Borough",3,7,737,12,783,0,37,0,3
"11/28/2020","Y","Y","Juneau City and Borough",110,"Juneau City and Borough",3,10,747,0,783,0,37,0,3
"11/29/2020","Y","Y","Juneau City and Borough",110,"Juneau City and Borough",3,7,754,13,796,0,37,0,3
"11/30/2020","Y","Y","Juneau City and Borough",110,"Juneau City and Borough",3,2,756,15,811,0,37,0,3
"12/01/2020","Y","Y","Juneau City and Borough",110,"Juneau City and Borough",3,5,761,11,822,0,37,0,3
"12/02/2020","Y","Y","Juneau City and Borough",110,"Juneau City and Borough",3,4,765,3,825,0,37,0,3
"12/03/2020","Y","Y","Juneau City and Borough",110,"Juneau City and Borough",3,30,795,5,830,0,37,0,3
"12/04/2020","Y","Y","Juneau City and Borough",110,"Juneau City and Borough",3,4,799,3,833,0,37,0,3
"12/05/2020","Y","Y","Juneau City and Borough",110,"Juneau City and Borough",3,3,802,5,838,0,37,0,3
"12/06/2020","Y","Y","Juneau City and Borough",110,"Juneau City and Borough",3,3,805,4,842,0,37,0,3
"12/07/2020","Y","Y","Juneau City and Borough",110,"Juneau City and Borough",3,8,813,2,844,0,37,0,3
"12/08/2020","Y","Y","Juneau City and Borough",110,"Juneau City and Borough",3,3,816,4,848,0,37,0,3
"12/09/2020","Y","Y","Juneau City and Borough",110,"Juneau City and Borough",3,20,836,6,854,1,38,0,3
"12/10/2020","Y","Y","Juneau City and Borough",110,"Juneau City and Borough",3,9,845,10,864,0,38,0,3
"12/11/2020","Y","Y","Juneau City and Borough",110,"Juneau City and Borough",3,4,849,1,865,0,38,0,3
"12/12/2020","Y","Y","Juneau City and Borough",110,"Juneau City and Borough",3,8,857,4,869,1,39,0,3
"12/13/2020","Y","Y","Juneau City and Borough",110,"Juneau City and Borough",3,2,859,9,878,0,39,0,3
"12/14/2020","Y","Y","Juneau City and Borough",110,"Juneau City and Borough",3,8,867,0,878,0,39,0,3
"12/15/2020","Y","Y","Juneau City and Borough",110,"Juneau City and Borough",3,0,867,4,882,0,39,0,3
"12/16/2020","Y","Y","Juneau City and Borough",110,"Juneau City and Borough",3,1,868,7,889,0,39,0,3
"12/17/2020","Y","Y","Juneau City and Borough",110,"Juneau City and Borough",3,9,877,10,899,0,39,0,3
"12/18/2020","Y","Y","Juneau City and Borough",110,"Juneau City and Borough",3,4,881,2,901,0,39,0,3
"12/19/2020","Y","Y","Juneau City and Borough",110,"Juneau City and Borough",3,2,883,6,907,0,39,0,3
"12/20/2020","Y","Y","Juneau City and Borough",110,"Juneau City and Borough",3,1,884,6,913,0,39,0,3
"12/21/2020","Y","Y","Juneau City and Borough",110,"Juneau City and Borough",3,17,901,8,921,0,39,0,3
"12/22/2020","Y","Y","Juneau City and Borough",110,"Juneau City and Borough",3,2,903,6,927,0,39,0,3
"12/23/2020","Y","Y","Juneau City and Borough",110,"Juneau City and Borough",3,11,914,6,933,0,39,0,3
"12/24/2020","Y","Y","Juneau City and Borough",110,"Juneau City and Borough",3,4,918,3,936,0,39,0,3
"12/25/2020","Y","Y","Juneau City and Borough",110,"Juneau City and Borough",3,4,922,0,936,0,39,0,3
"12/26/2020","Y","Y","Juneau City and Borough",110,"Juneau City and Borough",3,2,924,5,941,0,39,0,3
"12/27/2020","Y","Y","Juneau City and Borough",110,"Juneau City and Borough",3,1,925,2,943,0,39,0,3
"12/28/2020","Y","Y","Juneau City and Borough",110,"Juneau City and Borough",3,0,925,3,946,0,39,0,3
"12/29/2020","Y","Y","Juneau City and Borough",110,"Juneau City and Borough",3,5,930,3,949,0,39,0,3
"12/30/2020","Y","Y","Juneau City and Borough",110,"Juneau City and Borough",3,8,938,2,951,0,39,0,3
"12/31/2020","Y","Y","Juneau City and Borough",110,"Juneau City and Borough",3,0,938,1,952,0,39,0,3
"01/01/2021","Y","Y","Juneau City and Borough",110,"Juneau City and Borough",3,8,946,0,952,0,39,0,3
"01/02/2021","Y","Y","Juneau City and Borough",110,"Juneau City and Borough",3,0,946,2,954,0,39,0,3
"01/03/2021","Y","Y","Juneau City and Borough",110,"Juneau City and Borough",3,0,946,0,954,1,40,0,3
"01/04/2021","Y","Y","Juneau City and Borough",110,"Juneau City and Borough",3,0,946,3,957,0,40,0,3
"01/05/2021","Y","Y","Juneau City and Borough",110,"Juneau City and Borough",3,6,952,5,962,0,40,0,3
"01/06/2021","Y","Y","Juneau City and Borough",110,"Juneau City and Borough",3,0,952,1,963,0,40,0,3
"01/07/2021","Y","Y","Juneau City and Borough",110,"Juneau City and Borough",3,5,957,3,966,0,40,0,3
"01/08/2021","Y","Y","Juneau City and Borough",110,"Juneau City and Borough",3,0,957,2,968,0,40,0,3
"01/09/2021","Y","Y","Juneau City and Borough",110,"Juneau City and Borough",3,0,957,1,969,0,40,0,3
"01/10/2021","Y","Y","Juneau City and Borough",110,"Juneau City and Borough",3,1,958,0,969,0,40,0,3
"01/11/2021","Y","Y","Juneau City and Borough",110,"Juneau City and Borough",3,8,966,3,972,0,40,0,3
"01/12/2021","Y","Y","Juneau City and Borough",110,"Juneau City and Borough",3,1,967,7,979,0,40,0,3
"01/13/2021","Y","Y","Juneau City and Borough",110,"Juneau City and Borough",3,6,973,7,986,0,40,0,3
"01/14/2021","Y","Y","Juneau City and Borough",110,"Juneau City and Borough",3,4,977,4,990,0,40,0,3
"01/15/2021","Y","Y","Juneau City and Borough",110,"Juneau City and Borough",3,1,978,3,993,0,40,0,3
"01/16/2021","Y","Y","Juneau City and Borough",110,"Juneau City and Borough",3,2,980,3,996,1,41,0,3
"01/17/2021","Y","Y","Juneau City and Borough",110,"Juneau City and Borough",3,2,982,2,998,0,41,0,3
"01/18/2021","Y","Y","Juneau City and Borough",110,"Juneau City and Borough",3,0,982,3,1001,0,41,0,3
"01/19/2021","Y","Y","Juneau City and Borough",110,"Juneau City and Borough",3,1,983,6,1007,0,41,0,3
"01/20/2021","Y","Y","Juneau City and Borough",110,"Juneau City and Borough",3,17,1000,0,1007,0,41,0,3
"01/21/2021","Y","Y","Juneau City and Borough",110,"Juneau City and Borough",3,2,1002,6,1013,1,42,0,3
"01/22/2021","Y","Y","Juneau City and Borough",110,"Juneau City and Borough",3,6,1008,9,1022,0,42,0,3
"01/23/2021","Y","Y","Juneau City and Borough",110,"Juneau City and Borough",3,1,1009,3,1025,1,43,0,3
"01/24/2021","Y","Y","Juneau City and Borough",110,"Juneau City and Borough",3,0,1009,1,1026,0,43,0,3
"01/25/2021","Y","Y","Juneau City and Borough",110,"Juneau City and Borough",3,4,1013,8,1034,0,43,0,3
"01/26/2021","Y","Y","Juneau City and Borough",110,"Juneau City and Borough",3,2,1015,6,1040,0,43,0,3
"01/27/2021","Y","Y","Juneau City and Borough",110,"Juneau City and Borough",3,2,1017,2,1042,0,43,0,3
"01/28/2021","Y","Y","Juneau City and Borough",110,"Juneau City and Borough",3,18,1035,5,1047,0,43,0,3
"01/29/2021","Y","Y","Juneau City and Borough",110,"Juneau City and Borough",3,3,1038,6,1053,0,43,0,3
"01/30/2021","Y","Y","Juneau City and Borough",110,"Juneau City and Borough",3,5,1043,0,1053,0,43,0,3
"01/31/2021","Y","Y","Juneau City and Borough",110,"Juneau City and Borough",3,0,1043,2,1055,0,43,0,3
"02/01/2021","Y","Y","Juneau City and Borough",110,"Juneau City and Borough",3,2,1045,7,1062,0,43,0,3
"02/02/2021","Y","Y","Juneau City and Borough",110,"Juneau City and Borough",3,6,1051,2,1064,0,43,0,3
"02/03/2021","Y","Y","Juneau City and Borough",110,"Juneau City and Borough",3,4,1055,1,1065,0,43,0,3
"02/04/2021","Y","Y","Juneau City and Borough",110,"Juneau City and Borough",3,6,1061,2,1067,0,43,0,3
"02/05/2021","Y","Y","Juneau City and Borough",110,"Juneau City and Borough",3,0,1061,1,1068,0,43,0,3
"02/06/2021","Y","Y","Juneau City and Borough",110,"Juneau City and Borough",3,6,1067,1,1069,0,43,0,3
"02/08/2021","Y","Y","Juneau City and Borough",110,"Juneau City and Borough",3,1,1068,1,1070,0,43,0,3
"02/09/2021","Y","Y","Juneau City and Borough",110,"Juneau City and Borough",3,0,1068,2,1072,0,43,0,3
"02/10/2021","Y","Y","Juneau City and Borough",110,"Juneau City and Borough",3,2,1070,2,1074,0,43,0,3
"02/11/2021","Y","Y","Juneau City and Borough",110,"Juneau City and Borough",3,3,1073,3,1077,0,43,0,3
"02/12/2021","Y","Y","Juneau City and Borough",110,"Juneau City and Borough",3,1,1074,5,1082,0,43,0,3
"02/13/2021","Y","Y","Juneau City and Borough",110,"Juneau City and Borough",3,0,1074,1,1083,0,43,0,3
"02/14/2021","Y","Y","Juneau City and Borough",110,"Juneau City and Borough",3,0,1074,1,1084,0,43,0,3
"02/15/2021","Y","Y","Juneau City and Borough",110,"Juneau City and Borough",3,2,1076,1,1085,0,43,0,3
"02/16/2021","Y","Y","Juneau City and Borough",110,"Juneau City and Borough",3,0,1076,7,1092,0,43,0,3
"02/17/2021","Y","Y","Juneau City and Borough",110,"Juneau City and Borough",3,0,1076,3,1095,0,43,0,3
"02/18/2021","Y","Y","Juneau City and Borough",110,"Juneau City and Borough",3,6,1082,5,1100,0,43,0,3
"02/19/2021","Y","Y","Juneau City and Borough",110,"Juneau City and Borough",3,7,1089,4,1104,0,43,0,3
"02/20/2021","Y","Y","Juneau City and Borough",110,"Juneau City and Borough",3,3,1092,0,1104,0,43,0,3
"02/21/2021","Y","Y","Juneau City and Borough",110,"Juneau City and Borough",3,7,1099,0,1104,0,43,0,3
"02/22/2021","Y","Y","Juneau City and Borough",110,"Juneau City and Borough",3,1,1100,1,1105,0,43,0,3
"02/23/2021","Y","Y","Juneau City and Borough",110,"Juneau City and Borough",3,3,1103,3,1108,0,43,0,3
"02/24/2021","Y","Y","Juneau City and Borough",110,"Juneau City and Borough",3,1,1104,1,1109,0,43,0,3
"02/25/2021","Y","Y","Juneau City and Borough",110,"Juneau City and Borough",3,1,1105,0,1109,0,43,0,3
"02/26/2021","Y","Y","Juneau City and Borough",110,"Juneau City and Borough",3,1,1106,4,1113,0,43,0,3
"02/27/2021","Y","Y","Juneau City and Borough",110,"Juneau City and Borough",3,6,1112,1,1114,0,43,0,3
"03/01/2021","Y","Y","Juneau City and Borough",110,"Juneau City and Borough",3,1,1113,3,1117,0,43,0,3
"03/02/2021","Y","Y","Juneau City and Borough",110,"Juneau City and Borough",3,5,1118,6,1123,0,43,0,3
"03/03/2021","Y","Y","Juneau City and Borough",110,"Juneau City and Borough",3,1,1119,1,1124,0,43,0,3
"03/04/2021","Y","Y","Juneau City and Borough",110,"Juneau City and Borough",3,4,1123,1,1125,0,43,0,3
"03/05/2021","Y","Y","Juneau City and Borough",110,"Juneau City and Borough",3,1,1124,1,1126,0,43,0,3
"03/06/2021","Y","Y","Juneau City and Borough",110,"Juneau City and Borough",3,1,1125,2,1128,0,43,0,3
"03/07/2021","Y","Y","Juneau City and Borough",110,"Juneau City and Borough",3,0,1125,1,1129,0,43,0,3
"03/08/2021","Y","Y","Juneau City and Borough",110,"Juneau City and Borough",3,1,1126,1,1130,1,44,0,3
"03/09/2021","Y","Y","Juneau City and Borough",110,"Juneau City and Borough",3,3,1129,0,1130,0,44,0,3
"03/10/2021","Y","Y","Juneau City and Borough",110,"Juneau City and Borough",3,1,1130,1,1131,0,44,0,3
"03/11/2021","Y","Y","Juneau City and Borough",110,"Juneau City and Borough",3,0,1130,1,1132,0,44,0,3
"03/12/2021","Y","Y","Juneau City and Borough",110,"Juneau City and Borough",3,1,1131,2,1134,0,44,0,3
"03/13/2021","Y","Y","Juneau City and Borough",110,"Juneau City and Borough",3,3,1134,4,1138,0,44,0,3
"03/14/2021","Y","Y","Juneau City and Borough",110,"Juneau City and Borough",3,3,1137,1,1139,1,45,0,3
"03/15/2021","Y","Y","Juneau City and Borough",110,"Juneau City and Borough",3,1,1138,2,1141,0,45,0,3
"03/16/2021","Y","Y","Juneau City and Borough",110,"Juneau City and Borough",3,2,1140,0,1141,0,45,0,3
"03/17/2021","Y","Y","Juneau City and Borough",110,"Juneau City and Borough",3,1,1141,1,1142,0,45,0,3
"03/19/2021","Y","Y","Juneau City and Borough",110,"Juneau City and Borough",3,0,1141,1,1143,0,45,0,3
"03/20/2021","Y","Y","Juneau City and Borough",110,"Juneau City and Borough",3,1,1142,2,1145,0,45,0,3
"03/23/2021","Y","Y","Juneau City and Borough",110,"Juneau City and Borough",3,2,1144,0,1145,0,45,0,3
"03/24/2021","Y","Y","Juneau City and Borough",110,"Juneau City and Borough",3,0,1144,1,1146,0,45,0,3
"03/25/2021","Y","Y","Juneau City and Borough",110,"Juneau City and Borough",3,1,1145,5,1151,0,45,0,3
"03/26/2021","Y","Y","Juneau City and Borough",110,"Juneau City and Borough",3,2,1147,2,1153,0,45,0,3
"03/27/2021","Y","Y","Juneau City and Borough",110,"Juneau City and Borough",3,3,1150,1,1154,0,45,0,3
"03/28/2021","Y","Y","Juneau City and Borough",110,"Juneau City and Borough",3,2,1152,2,1156,0,45,0,3
"03/29/2021","Y","Y","Juneau City and Borough",110,"Juneau City and Borough",3,0,1152,2,1158,0,45,0,3
"03/30/2021","Y","Y","Juneau City and Borough",110,"Juneau City and Borough",3,4,1156,2,1160,0,45,0,3
"03/31/2021","Y","Y","Juneau City and Borough",110,"Juneau City and Borough",3,1,1157,0,1160,0,45,0,3
"04/01/2021","Y","Y","Juneau City and Borough",110,"Juneau City and Borough",3,1,1158,3,1163,0,45,0,3
"04/02/2021","Y","Y","Juneau City and Borough",110,"Juneau City and Borough",3,3,1161,5,1168,0,45,0,3
"04/03/2021","Y","Y","Juneau City and Borough",110,"Juneau City and Borough",3,1,1162,4,1172,0,45,0,3
"04/04/2021","Y","Y","Juneau City and Borough",110,"Juneau City and Borough",3,3,1165,3,1175,0,45,0,3
"04/05/2021","Y","Y","Juneau City and Borough",110,"Juneau City and Borough",3,2,1167,0,1175,0,45,0,3
"04/06/2021","Y","Y","Juneau City and Borough",110,"Juneau City and Borough",3,5,1172,6,1181,0,45,0,3
"04/07/2021","Y","Y","Juneau City and Borough",110,"Juneau City and Borough",3,5,1177,4,1185,0,45,0,3
"04/08/2021","Y","Y","Juneau City and Borough",110,"Juneau City and Borough",3,5,1182,2,1187,0,45,0,3
"04/09/2021","Y","Y","Juneau City and Borough",110,"Juneau City and Borough",3,1,1183,3,1190,0,45,0,3
"04/10/2021","Y","Y","Juneau City and Borough",110,"Juneau City and Borough",3,3,1186,2,1192,0,45,0,3
"04/11/2021","Y","Y","Juneau City and Borough",110,"Juneau City and Borough",3,2,1188,1,1193,0,45,0,3
"04/12/2021","Y","Y","Juneau City and Borough",110,"Juneau City and Borough",3,1,1189,4,1197,0,45,0,3
"04/13/2021","Y","Y","Juneau City and Borough",110,"Juneau City and Borough",3,4,1193,0,1197,0,45,0,3
"04/14/2021","Y","Y","Juneau City and Borough",110,"Juneau City and Borough",3,0,1193,2,1199,0,45,0,3
"04/15/2021","Y","Y","Juneau City and Borough",110,"Juneau City and Borough",3,1,1194,4,1203,0,45,0,3
"04/16/2021","Y","Y","Juneau City and Borough",110,"Juneau City and Borough",3,5,1199,3,1206,0,45,0,3
"04/17/2021","Y","Y","Juneau City and Borough",110,"Juneau City and Borough",3,3,1202,5,1211,0,45,0,3
"04/18/2021","Y","Y","Juneau City and Borough",110,"Juneau City and Borough",3,5,1207,1,1212,0,45,0,3
"04/19/2021","Y","Y","Juneau City and Borough",110,"Juneau City and Borough",3,0,1207,4,1216,0,45,0,3
"04/20/2021","Y","Y","Juneau City and Borough",110,"Juneau City and Borough",3,5,1212,3,1219,0,45,0,3
"04/21/2021","Y","Y","Juneau City and Borough",110,"Juneau City and Borough",3,4,1216,2,1221,0,45,0,3
"04/22/2021","Y","Y","Juneau City and Borough",110,"Juneau City and Borough",3,2,1218,1,1222,0,45,0,3
"04/23/2021","Y","Y","Juneau City and Borough",110,"Juneau City and Borough",3,1,1219,1,1223,0,45,0,3
"04/24/2021","Y","Y","Juneau City and Borough",110,"Juneau City and Borough",3,1,1220,1,1224,0,45,0,3
"04/25/2021","Y","Y","Juneau City and Borough",110,"Juneau City and Borough",3,1,1221,1,1225,0,45,0,3
"04/26/2021","Y","Y","Juneau City and Borough",110,"Juneau City and Borough",3,1,1222,1,1226,1,46,0,3
"04/27/2021","Y","Y","Juneau City and Borough",110,"Juneau City and Borough",3,1,1223,3,1229,0,46,0,3
"04/28/2021","Y","Y","Juneau City and Borough",110,"Juneau City and Borough",3,1,1224,2,1231,0,46,0,3
"04/29/2021","Y","Y","Juneau City and Borough",110,"Juneau City and Borough",3,2,1226,3,1234,0,46,0,3
"04/30/2021","Y","Y","Juneau City and Borough",110,"Juneau City and Borough",3,4,1230,4,1238,0,46,0,3
"05/01/2021","Y","Y","Juneau City and Borough",110,"Juneau City and Borough",3,4,1234,3,1241,0,46,0,3
"05/02/2021","Y","Y","Juneau City and Borough",110,"Juneau City and Borough",3,2,1236,1,1242,0,46,0,3
"05/03/2021","Y","Y","Juneau City and Borough",110,"Juneau City and Borough",3,2,1238,3,1245,0,46,0,3
"05/04/2021","Y","Y","Juneau City and Borough",110,"Juneau City and Borough",3,2,1240,1,1246,0,46,0,3
"05/05/2021","Y","Y","Juneau City and Borough",110,"Juneau City and Borough",3,2,1242,5,1251,0,46,0,3
"05/06/2021","Y","Y","Juneau City and Borough",110,"Juneau City and Borough",3,5,1247,2,1253,0,46,0,3
"05/07/2021","Y","Y","Juneau City and Borough",110,"Juneau City and Borough",3,3,1250,6,1259,0,46,0,3
"05/08/2021","Y","Y","Juneau City and Borough",110,"Juneau City and Borough",3,5,1255,2,1261,0,46,0,3
"05/09/2021","Y","Y","Juneau City and Borough",110,"Juneau City and Borough",3,2,1257,1,1262,0,46,0,3
"05/10/2021","Y","Y","Juneau City and Borough",110,"Juneau City and Borough",3,1,1258,4,1266,0,46,0,3
"05/11/2021","Y","Y","Juneau City and Borough",110,"Juneau City and Borough",3,5,1263,1,1267,0,46,0,3
"05/12/2021","Y","Y","Juneau City and Borough",110,"Juneau City and Borough",3,1,1264,3,1270,0,46,0,3
"05/13/2021","Y","Y","Juneau City and Borough",110,"Juneau City and Borough",3,3,1267,2,1272,0,46,0,3
"05/14/2021","Y","Y","Juneau City and Borough",110,"Juneau City and Borough",3,1,1268,2,1274,0,46,0,3
"05/15/2021","Y","Y","Juneau City and Borough",110,"Juneau City and Borough",3,1,1269,0,1274,1,47,0,3
"05/16/2021","Y","Y","Juneau City and Borough",110,"Juneau City and Borough",3,0,1269,1,1275,0,47,0,3
"05/17/2021","Y","Y","Juneau City and Borough",110,"Juneau City and Borough",3,3,1272,1,1276,0,47,0,3
"05/18/2021","Y","Y","Juneau City and Borough",110,"Juneau City and Borough",3,1,1273,0,1276,0,47,0,3
"05/19/2021","Y","Y","Juneau City and Borough",110,"Juneau City and Borough",3,0,1273,2,1278,0,47,0,3
"05/20/2021","Y","Y","Juneau City and Borough",110,"Juneau City and Borough",3,2,1275,1,1279,0,47,0,3
"05/21/2021","Y","Y","Juneau City and Borough",110,"Juneau City and Borough",3,3,1278,2,1281,0,47,0,3
"05/22/2021","Y","Y","Juneau City and Borough",110,"Juneau City and Borough",3,1,1279,1,1282,0,47,0,3
"05/23/2021","Y","Y","Juneau City and Borough",110,"Juneau City and Borough",3,0,1279,2,1284,0,47,0,3
"05/24/2021","Y","Y","Juneau City and Borough",110,"Juneau City and Borough",3,2,1281,3,1287,0,47,0,3
"05/25/2021","Y","Y","Juneau City and Borough",110,"Juneau City and Borough",3,1,1282,0,1287,0,47,0,3
"05/26/2021","Y","Y","Juneau City and Borough",110,"Juneau City and Borough",3,0,1282,1,1288,0,47,0,3
"05/27/2021","Y","Y","Juneau City and Borough",110,"Juneau City and Borough",3,3,1285,1,1289,0,47,0,3
"05/28/2021","Y","Y","Juneau City and Borough",110,"Juneau City and Borough",3,3,1288,2,1291,0,47,0,3
"05/29/2021","Y","Y","Juneau City and Borough",110,"Juneau City and Borough",3,0,1288,2,1293,0,47,0,3
"05/30/2021","Y","Y","Juneau City and Borough",110,"Juneau City and Borough",3,0,1288,2,1295,0,47,0,3
"05/31/2021","Y","Y","Juneau City and Borough",110,"Juneau City and Borough",3,3,1291,4,1299,0,47,0,3
"06/01/2021","Y","Y","Juneau City and Borough",110,"Juneau City and Borough",3,4,1295,6,1305,0,47,0,3
"06/02/2021","Y","Y","Juneau City and Borough",110,"Juneau City and Borough",3,7,1302,2,1307,0,47,0,3
"06/03/2021","Y","Y","Juneau City and Borough",110,"Juneau City and Borough",3,4,1306,1,1308,0,47,0,3
"06/04/2021","Y","Y","Juneau City and Borough",110,"Juneau City and Borough",3,1,1307,0,1308,1,48,0,3
"06/05/2021","Y","Y","Juneau City and Borough",110,"Juneau City and Borough",3,0,1307,2,1310,0,48,0,3
"06/06/2021","Y","Y","Juneau City and Borough",110,"Juneau City and Borough",3,1,1308,0,1310,0,48,0,3
"06/07/2021","Y","Y","Juneau City and Borough",110,"Juneau City and Borough",3,2,1310,4,1314,0,48,0,3
"06/08/2021","Y","Y","Juneau City and Borough",110,"Juneau City and Borough",3,3,1313,2,1316,0,48,0,3
"06/09/2021","Y","Y","Juneau City and Borough",110,"Juneau City and Borough",3,2,1315,3,1319,0,48,0,3
"06/10/2021","Y","Y","Juneau City and Borough",110,"Juneau City and Borough",3,1,1316,0,1319,1,49,0,3
"06/11/2021","Y","Y","Juneau City and Borough",110,"Juneau City and Borough",3,0,1316,1,1320,0,49,0,3
"06/12/2021","Y","Y","Juneau City and Borough",110,"Juneau City and Borough",3,0,1316,2,1322,0,49,0,3
"06/13/2021","Y","Y","Juneau City and Borough",110,"Juneau City and Borough",3,3,1319,0,1322,0,49,0,3
"06/15/2021","Y","Y","Juneau City and Borough",110,"Juneau City and Borough",3,1,1320,1,1323,0,49,0,3
"06/16/2021","Y","Y","Juneau City and Borough",110,"Juneau City and Borough",3,1,1321,0,1323,0,49,0,3
"06/17/2021","Y","Y","Juneau City and Borough",110,"Juneau City and Borough",3,0,1321,1,1324,0,49,0,3
"06/18/2021","Y","Y","Juneau City and Borough",110,"Juneau City and Borough",3,2,1323,0,1324,0,49,0,3
"06/20/2021","Y","Y","Juneau City and Borough",110,"Juneau City and Borough",3,0,1323,2,1326,0,49,0,3
"06/22/2021","Y","Y","Juneau City and Borough",110,"Juneau City and Borough",3,1,1324,0,1326,0,49,0,3
"06/24/2021","Y","Y","Juneau City and Borough",110,"Juneau City and Borough",3,0,1324,1,1327,0,49,0,3
"06/25/2021","Y","Y","Juneau City and Borough",110,"Juneau City and Borough",3,0,1324,1,1328,0,49,0,3
"06/26/2021","Y","Y","Juneau City and Borough",110,"Juneau City and Borough",3,2,1326,0,1328,0,49,0,3
"06/28/2021","Y","Y","Juneau City and Borough",110,"Juneau City and Borough",3,1,1327,0,1328,0,49,0,3
"06/29/2021","Y","Y","Juneau City and Borough",110,"Juneau City and Borough",3,1,1328,1,1329,0,49,0,3
"06/30/2021","Y","Y","Juneau City and Borough",110,"Juneau City and Borough",3,0,1328,2,1331,0,49,0,3
"07/01/2021","Y","Y","Juneau City and Borough",110,"Juneau City and Borough",3,1,1329,2,1333,0,49,0,3
"07/02/2021","Y","Y","Juneau City and Borough",110,"Juneau City and Borough",3,2,1331,5,1338,0,49,0,3
"07/03/2021","Y","Y","Juneau City and Borough",110,"Juneau City and Borough",3,2,1333,0,1338,0,49,0,3
"07/04/2021","Y","Y","Juneau City and Borough",110,"Juneau City and Borough",3,1,1334,1,1339,0,49,0,3
"07/05/2021","Y","Y","Juneau City and Borough",110,"Juneau City and Borough",3,1,1335,1,1340,0,49,0,3
"07/06/2021","Y","Y","Juneau City and Borough",110,"Juneau City and Borough",3,3,1338,0,1340,0,49,0,3
"07/07/2021","Y","Y","Juneau City and Borough",110,"Juneau City and Borough",3,0,1338,1,1341,0,49,0,3
"07/08/2021","Y","Y","Juneau City and Borough",110,"Juneau City and Borough",3,0,1338,1,1342,0,49,0,3
"07/09/2021","Y","Y","Juneau City and Borough",110,"Juneau City and Borough",3,3,1341,1,1343,0,49,0,3
"07/10/2021","Y","Y","Juneau City and Borough",110,"Juneau City and Borough",3,1,1342,0,1343,0,49,0,3
"07/12/2021","Y","Y","Juneau City and Borough",110,"Juneau City and Borough",3,0,1342,1,1344,0,49,0,3
"07/13/2021","Y","Y","Juneau City and Borough",110,"Juneau City and Borough",3,1,1343,4,1348,1,50,0,3
"07/14/2021","Y","Y","Juneau City and Borough",110,"Juneau City and Borough",3,4,1347,3,1351,0,50,0,3
"07/15/2021","Y","Y","Juneau City and Borough",110,"Juneau City and Borough",3,1,1348,5,1356,0,50,0,3
"07/16/2021","Y","Y","Juneau City and Borough",110,"Juneau City and Borough",3,0,1348,8,1364,0,50,0,3
"07/17/2021","Y","Y","Juneau City and Borough",110,"Juneau City and Borough",3,12,1360,9,1373,1,51,0,3
"07/18/2021","Y","Y","Juneau City and Borough",110,"Juneau City and Borough",3,5,1365,13,1386,0,51,0,3
"07/19/2021","Y","Y","Juneau City and Borough",110,"Juneau City and Borough",3,16,1381,13,1399,0,51,0,3
"07/20/2021","Y","Y","Juneau City and Borough",110,"Juneau City and Borough",3,12,1393,16,1415,0,51,0,3
"07/21/2021","Y","Y","Juneau City and Borough",110,"Juneau City and Borough",3,13,1406,13,1428,0,51,0,3
"07/22/2021","Y","Y","Juneau City and Borough",110,"Juneau City and Borough",3,10,1416,20,1448,1,52,0,3
"07/23/2021","Y","Y","Juneau City and Borough",110,"Juneau City and Borough",3,23,1439,16,1464,0,52,0,3
"07/24/2021","Y","Y","Juneau City and Borough",110,"Juneau City and Borough",3,4,1443,8,1472,0,52,0,3
"07/25/2021","Y","Y","Juneau City and Borough",110,"Juneau City and Borough",3,6,1449,7,1479,1,53,0,3
"07/26/2021","Y","Y","Juneau City and Borough",110,"Juneau City and Borough",3,18,1467,10,1489,0,53,0,3
"07/27/2021","Y","Y","Juneau City and Borough",110,"Juneau City and Borough",3,12,1479,14,1503,0,53,0,3
"07/28/2021","Y","Y","Juneau City and Borough",110,"Juneau City and Borough",3,11,1490,8,1511,1,54,0,3
"07/29/2021","Y","Y","Juneau City and Borough",110,"Juneau City and Borough",3,11,1501,9,1520,0,54,0,3
"07/30/2021","Y","Y","Juneau City and Borough",110,"Juneau City and Borough",3,8,1509,6,1526,0,54,0,3
"07/31/2021","Y","Y","Juneau City and Borough",110,"Juneau City and Borough",3,13,1522,5,1531,0,54,0,3
"08/01/2021","Y","Y","Juneau City and Borough",110,"Juneau City and Borough",3,1,1523,7,1538,0,54,0,3
"08/02/2021","Y","Y","Juneau City and Borough",110,"Juneau City and Borough",3,2,1525,7,1545,0,54,0,3
"08/03/2021","Y","Y","Juneau City and Borough",110,"Juneau City and Borough",3,11,1536,23,1568,1,55,0,3
"08/04/2021","Y","Y","Juneau City and Borough",110,"Juneau City and Borough",3,7,1543,11,1579,2,57,0,3
"08/05/2021","Y","Y","Juneau City and Borough",110,"Juneau City and Borough",3,5,1548,15,1594,0,57,0,3
"08/06/2021","Y","Y","Juneau City and Borough",110,"Juneau City and Borough",3,16,1564,9,1603,0,57,1,4
"08/07/2021","Y","Y","Juneau City and Borough",110,"Juneau City and Borough",3,12,1576,1,1604,0,57,0,4
"08/08/2021","Y","Y","Juneau City and Borough",110,"Juneau City and Borough",3,4,1580,13,1617,0,57,0,4
"08/09/2021","Y","Y","Juneau City and Borough",110,"Juneau City and Borough",3,10,1590,28,1645,0,57,0,4
"08/10/2021","Y","Y","Juneau City and Borough",110,"Juneau City and Borough",3,19,1609,18,1663,0,57,0,4
"08/11/2021","Y","Y","Juneau City and Borough",110,"Juneau City and Borough",3,17,1626,31,1694,2,59,0,4
"08/12/2021","Y","Y","Juneau City and Borough",110,"Juneau City and Borough",3,16,1642,21,1715,0,59,0,4
"08/13/2021","Y","Y","Juneau City and Borough",110,"Juneau City and Borough",3,18,1660,31,1746,0,59,0,4
"08/14/2021","Y","Y","Juneau City and Borough",110,"Juneau City and Borough",3,9,1669,14,1760,1,60,0,4
"08/15/2021","Y","Y","Juneau City and Borough",110,"Juneau City and Borough",3,33,1702,18,1778,0,60,1,5
"08/16/2021","Y","Y","Juneau City and Borough",110,"Juneau City and Borough",3,18,1720,30,1808,0,60,0,5
"08/17/2021","Y","Y","Juneau City and Borough",110,"Juneau City and Borough",3,21,1741,34,1842,0,60,0,5
"08/18/2021","Y","Y","Juneau City and Borough",110,"Juneau City and Borough",3,33,1774,25,1867,0,60,1,6
"08/19/2021","Y","Y","Juneau City and Borough",110,"Juneau City and Borough",3,25,1799,13,1880,0,60,0,6
"08/20/2021","Y","Y","Juneau City and Borough",110,"Juneau City and Borough",3,35,1834,37,1917,2,62,0,6
"08/21/2021","Y","Y","Juneau City and Borough",110,"Juneau City and Borough",3,19,1853,18,1935,1,63,0,6
"08/22/2021","Y","Y","Juneau City and Borough",110,"Juneau City and Borough",3,3,1856,14,1949,0,63,0,6
"08/23/2021","Y","Y","Juneau City and Borough",110,"Juneau City and Borough",3,18,1874,31,1980,0,63,0,6
"08/24/2021","Y","Y","Juneau City and Borough",110,"Juneau City and Borough",3,33,1907,33,2013,1,64,0,6
"08/25/2021","Y","Y","Juneau City and Borough",110,"Juneau City and Borough",3,12,1919,30,2043,0,64,0,6
"08/26/2021","Y","Y","Juneau City and Borough",110,"Juneau City and Borough",3,32,1951,41,2084,1,65,0,6
"08/27/2021","Y","Y","Juneau City and Borough",110,"Juneau City and Borough",3,36,1987,40,2124,1,66,0,6
"08/28/2021","Y","Y","Juneau City and Borough",110,"Juneau City and Borough",3,10,1997,19,2143,1,67,0,6
"08/29/2021","Y","Y","Juneau City and Borough",110,"Juneau City and Borough",3,1,1998,27,2170,1,68,0,6
"08/30/2021","Y","Y","Juneau City and Borough",110,"Juneau City and Borough",3,63,2061,28,2198,0,68,0,6
"08/31/2021","Y","Y","Juneau City and Borough",110,"Juneau City and Borough",3,28,2089,25,2223,0,68,0,6
"09/01/2021","Y","Y","Juneau City and Borough",110,"Juneau City and Borough",3,31,2120,11,2234,1,69,0,6
"09/02/2021","Y","Y","Juneau City and Borough",110,"Juneau City and Borough",3,20,2140,20,2254,0,69,0,6
"09/03/2021","Y","Y","Juneau City and Borough",110,"Juneau City and Borough",3,22,2162,28,2282,0,69,0,6
"09/04/2021","Y","Y","Juneau City and Borough",110,"Juneau City and Borough",3,30,2192,11,2293,0,69,0,6
"09/05/2021","Y","Y","Juneau City and Borough",110,"Juneau City and Borough",3,14,2206,21,2314,0,69,0,6
"09/06/2021","Y","Y","Juneau City and Borough",110,"Juneau City and Borough",3,10,2216,24,2338,2,71,0,6
"09/07/2021","Y","Y","Juneau City and Borough",110,"Juneau City and Borough",3,14,2230,31,2369,1,72,0,6
"09/08/2021","Y","Y","Juneau City and Borough",110,"Juneau City and Borough",3,27,2257,25,2394,0,72,0,6
"09/09/2021","Y","Y","Juneau City and Borough",110,"Juneau City and Borough",3,10,2267,27,2421,0,72,0,6
"09/10/2021","Y","Y","Juneau City and Borough",110,"Juneau City and Borough",3,31,2298,39,2460,0,72,0,6
"09/11/2021","Y","Y","Juneau City and Borough",110,"Juneau City and Borough",3,6,2304,20,2480,1,73,0,6
"09/12/2021","Y","Y","Juneau City and Borough",110,"Juneau City and Borough",3,1,2305,30,2510,0,73,0,6
"09/13/2021","Y","Y","Juneau City and Borough",110,"Juneau City and Borough",3,12,2317,45,2555,0,73,0,6
"09/14/2021","Y","Y","Juneau City and Borough",110,"Juneau City and Borough",3,58,2375,38,2593,3,76,0,6
"09/15/2021","Y","Y","Juneau City and Borough",110,"Juneau City and Borough",3,58,2433,33,2626,0,76,0,6
"09/16/2021","Y","Y","Juneau City and Borough",110,"Juneau City and Borough",3,26,2459,28,2654,1,77,0,6
"09/17/2021","Y","Y","Juneau City and Borough",110,"Juneau City and Borough",3,39,2498,33,2687,1,78,0,6
"09/18/2021","Y","Y","Juneau City and Borough",110,"Juneau City and Borough",3,40,2538,32,2719,0,78,0,6
"09/19/2021","Y","Y","Juneau City and Borough",110,"Juneau City and Borough",3,16,2554,19,2738,0,78,0,6
"09/20/2021","Y","Y","Juneau City and Borough",110,"Juneau City and Borough",3,45,2599,33,2771,0,78,0,6
"09/21/2021","Y","Y","Juneau City and Borough",110,"Juneau City and Borough",3,40,2639,18,2789,2,80,0,6
"09/22/2021","Y","Y","Juneau City and Borough",110,"Juneau City and Borough",3,52,2691,28,2817,2,82,0,6
"09/23/2021","Y","Y","Juneau City and Borough",110,"Juneau City and Borough",3,33,2724,32,2849,0,82,0,6
"09/24/2021","Y","Y","Juneau City and Borough",110,"Juneau City and Borough",3,35,2759,29,2878,1,83,0,6
"09/25/2021","Y","Y","Juneau City and Borough",110,"Juneau City and Borough",3,41,2800,17,2895,0,83,0,6
"09/26/2021","Y","Y","Juneau City and Borough",110,"Juneau City and Borough",3,30,2830,16,2911,1,84,0,6
"09/27/2021","Y","Y","Juneau City and Borough",110,"Juneau City and Borough",3,23,2853,32,2943,1,85,1,7
"09/28/2021","Y","Y","Juneau City and Borough",110,"Juneau City and Borough",3,30,2883,26,2969,0,85,0,7
"09/29/2021","Y","Y","Juneau City and Borough",110,"Juneau City and Borough",3,45,2928,18,2987,1,86,0,7
"09/30/2021","Y","Y","Juneau City and Borough",110,"Juneau City and Borough",3,38,2966,22,3009,3,89,0,7
"10/01/2021","Y","Y","Juneau City and Borough",110,"Juneau City and Borough",3,22,2988,12,3021,0,89,1,8
"10/02/2021","Y","Y","Juneau City and Borough",110,"Juneau City and Borough",3,11,2999,14,3035,1,90,0,8
"10/03/2021","Y","Y","Juneau City and Borough",110,"Juneau City and Borough",3,12,3011,13,3048,0,90,0,8
"10/04/2021","Y","Y","Juneau City and Borough",110,"Juneau City and Borough",3,15,3026,18,3066,1,91,0,8
"10/05/2021","Y","Y","Juneau City and Borough",110,"Juneau City and Borough",3,15,3041,14,3080,0,91,0,8
"10/06/2021","Y","Y","Juneau City and Borough",110,"Juneau City and Borough",3,12,3053,18,3098,0,91,0,8
"10/07/2021","Y","Y","Juneau City and Borough",110,"Juneau City and Borough",3,25,3078,35,3133,0,91,0,8
"10/08/2021","Y","Y","Juneau City and Borough",110,"Juneau City and Borough",3,27,3105,23,3156,1,92,0,8
"10/09/2021","Y","Y","Juneau City and Borough",110,"Juneau City and Borough",3,29,3134,30,3186,0,92,0,8
"10/10/2021","Y","Y","Juneau City and Borough",110,"Juneau City and Borough",3,26,3160,19,3205,0,92,0,8
"10/11/2021","Y","Y","Juneau City and Borough",110,"Juneau City and Borough",3,31,3191,39,3244,1,93,0,8
"10/12/2021","Y","Y","Juneau City and Borough",110,"Juneau City and Borough",3,39,3230,27,3271,1,94,0,8
"10/13/2021","Y","Y","Juneau City and Borough",110,"Juneau City and Borough",3,23,3253,34,3305,0,94,0,8
"10/14/2021","Y","Y","Juneau City and Borough",110,"Juneau City and Borough",3,27,3280,26,3331,1,95,0,8
"10/15/2021","Y","Y","Juneau City and Borough",110,"Juneau City and Borough",3,24,3304,15,3346,3,98,1,9
"10/16/2021","Y","Y","Juneau City and Borough",110,"Juneau City and Borough",3,20,3324,17,3363,0,98,0,9
"10/17/2021","Y","Y","Juneau City and Borough",110,"Juneau City and Borough",3,16,3340,24,3387,0,98,0,9
"10/18/2021","Y","Y","Juneau City and Borough",110,"Juneau City and Borough",3,27,3367,17,3404,0,98,0,9
"10/19/2021","Y","Y","Juneau City and Borough",110,"Juneau City and Borough",3,20,3387,27,3431,1,99,0,9
"10/20/2021","Y","Y","Juneau City and Borough",110,"Juneau City and Borough",3,29,3416,16,3447,0,99,0,9
"10/21/2021","Y","Y","Juneau City and Borough",110,"Juneau City and Borough",3,25,3441,19,3466,1,100,0,9
"10/22/2021","Y","Y","Juneau City and Borough",110,"Juneau City and Borough",3,12,3453,16,3482,1,101,0,9
"10/23/2021","Y","Y","Juneau City and Borough",110,"Juneau City and Borough",3,22,3475,10,3492,0,101,1,10
"10/24/2021","Y","Y","Juneau City and Borough",110,"Juneau City and Borough",3,9,3484,15,3507,0,101,0,10
"10/25/2021","Y","Y","Juneau City and Borough",110,"Juneau City and Borough",3,14,3498,18,3525,0,101,0,10
"10/26/2021","Y","Y","Juneau City and Borough",110,"Juneau City and Borough",3,15,3513,25,3550,1,102,0,10
"10/27/2021","Y","Y","Juneau City and Borough",110,"Juneau City and Borough",3,30,3543,35,3585,0,102,0,10
"10/28/2021","Y","Y","Juneau City and Borough",110,"Juneau City and Borough",3,31,3574,17,3602,0,102,0,10
"10/29/2021","Y","Y","Juneau City and Borough",110,"Juneau City and Borough",3,20,3594,7,3609,0,102,2,12
"10/30/2021","Y","Y","Juneau City and Borough",110,"Juneau City and Borough",3,7,3601,4,3613,0,102,0,12
"10/31/2021","Y","Y","Juneau City and Borough",110,"Juneau City and Borough",3,5,3606,14,3627,0,102,0,12
"11/01/2021","Y","Y","Juneau City and Borough",110,"Juneau City and Borough",3,10,3616,12,3639,0,102,0,12
"11/02/2021","Y","Y","Juneau City and Borough",110,"Juneau City and Borough",3,12,3628,16,3655,1,103,0,12
"11/03/2021","Y","Y","Juneau City and Borough",110,"Juneau City and Borough",3,14,3642,10,3665,0,103,0,12
"11/04/2021","Y","Y","Juneau City and Borough",110,"Juneau City and Borough",3,16,3658,7,3672,0,103,0,12
"11/05/2021","Y","Y","Juneau City and Borough",110,"Juneau City and Borough",3,10,3668,3,3675,1,104,0,12
"11/06/2021","Y","Y","Juneau City and Borough",110,"Juneau City and Borough",3,5,3673,9,3684,0,104,0,12
"11/07/2021","Y","Y","Juneau City and Borough",110,"Juneau City and Borough",3,7,3680,6,3690,1,105,0,12
"11/08/2021","Y","Y","Juneau City and Borough",110,"Juneau City and Borough",3,7,3687,9,3699,0,105,0,12
"11/09/2021","Y","Y","Juneau City and Borough",110,"Juneau City and Borough",3,8,3695,6,3705,1,106,1,13
"11/10/2021","Y","Y","Juneau City and Borough",110,"Juneau City and Borough",3,1,3696,7,3712,0,106,0,13
"11/11/2021","Y","Y","Juneau City and Borough",110,"Juneau City and Borough",3,3,3699,7,3719,0,106,0,13
"11/12/2021","Y","Y","Juneau City and Borough",110,"Juneau City and Borough",3,5,3704,9,3728,0,106,0,13
"11/13/2021","Y","Y","Juneau City and Borough",110,"Juneau City and Borough",3,7,3711,1,3729,0,106,0,13
"11/14/2021","Y","Y","Juneau City and Borough",110,"Juneau City and Borough",3,0,3711,8,3737,0,106,0,13
"11/15/2021","Y","Y","Juneau City and Borough",110,"Juneau City and Borough",3,2,3713,6,3743,0,106,0,13
"11/16/2021","Y","Y","Juneau City and Borough",110,"Juneau City and Borough",3,0,3713,3,3746,0,106,0,13
"11/17/2021","Y","Y","Juneau City and Borough",110,"Juneau City and Borough",3,2,3715,5,3751,0,106,0,13
"11/18/2021","Y","Y","Juneau City and Borough",110,"Juneau City and Borough",3,34,3749,7,3758,0,106,1,14
"11/19/2021","Y","Y","Juneau City and Borough",110,"Juneau City and Borough",3,3,3752,4,3762,0,106,0,14
"11/20/2021","Y","Y","Juneau City and Borough",110,"Juneau City and Borough",3,5,3757,5,3767,0,106,0,14
"11/21/2021","Y","Y","Juneau City and Borough",110,"Juneau City and Borough",3,3,3760,10,3777,0,106,0,14
"11/22/2021","Y","Y","Juneau City and Borough",110,"Juneau City and Borough",3,6,3766,16,3793,0,106,0,14
"11/23/2021","Y","Y","Juneau City and Borough",110,"Juneau City and Borough",3,19,3785,7,3800,0,106,0,14
"11/24/2021","Y","Y","Juneau City and Borough",110,"Juneau City and Borough",3,11,3796,6,3806,0,106,0,14
"11/25/2021","Y","Y","Juneau City and Borough",110,"Juneau City and Borough",3,4,3800,0,3806,0,106,0,14
"11/26/2021","Y","Y","Juneau City and Borough",110,"Juneau City and Borough",3,4,3804,5,3811,0,106,0,14
"11/27/2021","Y","Y","Juneau City and Borough",110,"Juneau City and Borough",3,5,3809,10,3821,0,106,0,14
"11/28/2021","Y","Y","Juneau City and Borough",110,"Juneau City and Borough",3,10,3819,5,3826,0,106,0,14
"11/29/2021","Y","Y","Juneau City and Borough",110,"Juneau City and Borough",3,4,3823,7,3833,0,106,0,14
"11/30/2021","Y","Y","Juneau City and Borough",110,"Juneau City and Borough",3,6,3829,15,3848,0,106,0,14
"12/01/2021","Y","Y","Juneau City and Borough",110,"Juneau City and Borough",3,13,3842,3,3851,0,106,0,14
"12/02/2021","Y","Y","Juneau City and Borough",110,"Juneau City and Borough",3,11,3853,19,3870,0,106,1,15
"12/03/2021","Y","Y","Juneau City and Borough",110,"Juneau City and Borough",3,13,3866,12,3882,0,106,0,15
"12/04/2021","Y","Y","Juneau City and Borough",110,"Juneau City and Borough",3,7,3873,2,3884,0,106,0,15
"12/05/2021","Y","Y","Juneau City and Borough",110,"Juneau City and Borough",3,2,3875,1,3885,0,106,0,15
"12/06/2021","Y","Y","Juneau City and Borough",110,"Juneau City and Borough",3,8,3883,4,3889,0,106,0,15
"12/07/2021","Y","Y","Juneau City and Borough",110,"Juneau City and Borough",3,7,3890,6,3895,0,106,0,15
"12/08/2021","Y","Y","Juneau City and Borough",110,"Juneau City and Borough",3,20,3910,21,3916,1,107,0,15
"12/09/2021","Y","Y","Juneau City and Borough",110,"Juneau City and Borough",3,5,3915,9,3925,0,107,0,15
"12/10/2021","Y","Y","Juneau City and Borough",110,"Juneau City and Borough",3,8,3923,8,3933,0,107,0,15
"12/11/2021","Y","Y","Juneau City and Borough",110,"Juneau City and Borough",3,11,3934,11,3944,0,107,0,15
"12/12/2021","Y","Y","Juneau City and Borough",110,"Juneau City and Borough",3,4,3938,2,3946,1,108,0,15
"12/13/2021","Y","Y","Juneau City and Borough",110,"Juneau City and Borough",3,7,3945,4,3950,0,108,0,15
"12/14/2021","Y","Y","Juneau City and Borough",110,"Juneau City and Borough",3,13,3958,12,3962,0,108,0,15
"12/15/2021","Y","Y","Juneau City and Borough",110,"Juneau City and Borough",3,8,3966,9,3971,0,108,0,15
"12/16/2021","Y","Y","Juneau City and Borough",110,"Juneau City and Borough",3,7,3973,9,3980,0,108,0,15
"12/17/2021","Y","Y","Juneau City and Borough",110,"Juneau City and Borough",3,7,3980,4,3984,0,108,0,15
"12/18/2021","Y","Y","Juneau City and Borough",110,"Juneau City and Borough",3,6,3986,7,3991,0,108,0,15
"12/19/2021","Y","Y","Juneau City and Borough",110,"Juneau City and Borough",3,6,3992,6,3997,0,108,0,15
"12/20/2021","Y","Y","Juneau City and Borough",110,"Juneau City and Borough",3,1,3993,2,3999,0,108,0,15
"12/21/2021","Y","Y","Juneau City and Borough",110,"Juneau City and Borough",3,8,4001,8,4007,0,108,0,15
"12/22/2021","Y","Y","Juneau City and Borough",110,"Juneau City and Borough",3,15,4016,20,4027,0,108,0,15
"12/23/2021","Y","Y","Juneau City and Borough",110,"Juneau City and Borough",3,16,4032,18,4045,0,108,0,15
"12/24/2021","Y","Y","Juneau City and Borough",110,"Juneau City and Borough",3,11,4043,11,4056,0,108,0,15
"12/25/2021","Y","Y","Juneau City and Borough",110,"Juneau City and Borough",3,16,4059,16,4072,0,108,0,15
"12/26/2021","Y","Y","Juneau City and Borough",110,"Juneau City and Borough",3,6,4065,5,4077,0,108,0,15
"12/27/2021","Y","Y","Juneau City and Borough",110,"Juneau City and Borough",3,37,4102,43,4120,0,108,0,15
"12/28/2021","Y","Y","Juneau City and Borough",110,"Juneau City and Borough",3,38,4140,39,4159,0,108,0,15
"12/29/2021","Y","Y","Juneau City and Borough",110,"Juneau City and Borough",3,43,4183,44,4203,0,108,0,15
"12/30/2021","Y","Y","Juneau City and Borough",110,"Juneau City and Borough",3,60,4243,57,4260,0,108,0,15
"12/31/2021","Y","Y","Juneau City and Borough",110,"Juneau City and Borough",3,31,4274,34,4294,0,108,0,15
"01/01/2022","Y","Y","Juneau City and Borough",110,"Juneau City and Borough",3,30,4304,23,4317,0,108,0,15
"01/02/2022","Y","Y","Juneau City and Borough",110,"Juneau City and Borough",3,17,4321,33,4350,0,108,0,15
"01/03/2022","Y","Y","Juneau City and Borough",110,"Juneau City and Borough",3,42,4363,61,4411,1,109,0,15
"01/04/2022","Y","Y","Juneau City and Borough",110,"Juneau City and Borough",3,82,4445,126,4537,0,109,0,15
"01/05/2022","Y","Y","Juneau City and Borough",110,"Juneau City and Borough",3,108,4553,64,4601,0,109,0,15
"01/06/2022","Y","Y","Juneau City and Borough",110,"Juneau City and Borough",3,88,4641,81,4682,1,110,0,15
"01/07/2022","Y","Y","Juneau City and Borough",110,"Juneau City and Borough",3,78,4719,85,4767,1,111,0,15
"01/08/2022","Y","Y","Juneau City and Borough",110,"Juneau City and Borough",3,83,4802,83,4850,1,112,0,15
"01/09/2022","Y","Y","Juneau City and Borough",110,"Juneau City and Borough",3,50,4852,60,4910,0,112,0,15
"01/10/2022","Y","Y","Juneau City and Borough",110,"Juneau City and Borough",3,87,4939,93,5003,0,112,0,15
"01/11/2022","Y","Y","Juneau City and Borough",110,"Juneau City and Borough",3,84,5023,89,5092,0,112,0,15
"01/12/2022","Y","Y","Juneau City and Borough",110,"Juneau City and Borough",3,108,5131,112,5204,0,112,0,15
"01/13/2022","Y","Y","Juneau City and Borough",110,"Juneau City and Borough",3,132,5263,136,5340,1,113,0,15
"01/14/2022","Y","Y","Juneau City and Borough",110,"Juneau City and Borough",3,119,5382,114,5454,0,113,0,15
"01/15/2022","Y","Y","Juneau City and Borough",110,"Juneau City and Borough",3,100,5482,93,5547,1,114,0,15
"01/16/2022","Y","Y","Juneau City and Borough",110,"Juneau City and Borough",3,99,5581,99,5646,1,115,0,15
"01/17/2022","Y","Y","Juneau City and Borough",110,"Juneau City and Borough",3,86,5667,86,5732,1,116,0,15
"01/18/2022","Y","Y","Juneau City and Borough",110,"Juneau City and Borough",3,93,5760,85,5817,0,116,0,15
"01/19/2022","Y","Y","Juneau City and Borough",110,"Juneau City and Borough",3,140,5900,129,5946,0,116,0,15
"01/20/2022","Y","Y","Juneau City and Borough",110,"Juneau City and Borough",3,58,5958,68,6014,2,118,0,15
"01/21/2022","Y","Y","Juneau City and Borough",110,"Juneau City and Borough",3,102,6060,94,6108,1,119,0,15
"01/22/2022","Y","Y","Juneau City and Borough",110,"Juneau City and Borough",3,79,6139,81,6189,0,119,0,15
"01/23/2022","Y","Y","Juneau City and Borough",110,"Juneau City and Borough",3,48,6187,45,6234,0,119,0,15
"01/24/2022","Y","Y","Juneau City and Borough",110,"Juneau City and Borough",3,76,6263,101,6335,0,119,0,15
"01/25/2022","Y","Y","Juneau City and Borough",110,"Juneau City and Borough",3,82,6345,69,6404,0,119,0,15
"01/26/2022","Y","Y","Juneau City and Borough",110,"Juneau City and Borough",3,102,6447,100,6504,1,120,0,15
"01/27/2022","Y","Y","Juneau City and Borough",110,"Juneau City and Borough",3,59,6506,43,6547,1,121,0,15
"01/28/2022","Y","Y","Juneau City and Borough",110,"Juneau City and Borough",3,69,6575,67,6614,0,121,0,15
"01/29/2022","Y","Y","Juneau City and Borough",110,"Juneau City and Borough",3,44,6619,44,6658,0,121,1,16
"01/30/2022","Y","Y","Juneau City and Borough",110,"Juneau City and Borough",3,46,6665,47,6705,0,121,0,16
"01/31/2022","Y","Y","Juneau City and Borough",110,"Juneau City and Borough",3,47,6712,44,6749,1,122,0,16
"02/01/2022","Y","Y","Juneau City and Borough",110,"Juneau City and Borough",3,77,6789,70,6819,0,122,0,16
"02/02/2022","Y","Y","Juneau City and Borough",110,"Juneau City and Borough",3,58,6847,55,6874,0,122,0,16
"02/03/2022","Y","Y","Juneau City and Borough",110,"Juneau City and Borough",3,52,6899,47,6921,0,122,0,16
"02/04/2022","Y","Y","Juneau City and Borough",110,"Juneau City and Borough",3,39,6938,36,6957,0,122,0,16
"02/05/2022","Y","Y","Juneau City and Borough",110,"Juneau City and Borough",3,31,6969,29,6986,1,123,0,16
"02/06/2022","Y","Y","Juneau City and Borough",110,"Juneau City and Borough",3,30,6999,24,7010,0,123,0,16
"02/07/2022","Y","Y","Juneau City and Borough",110,"Juneau City and Borough",3,18,7017,17,7027,1,124,0,16
"02/08/2022","Y","Y","Juneau City and Borough",110,"Juneau City and Borough",3,47,7064,45,7072,1,125,1,17
"02/09/2022","Y","Y","Juneau City and Borough",110,"Juneau City and Borough",3,44,7108,43,7115,0,125,0,17
"02/10/2022","Y","Y","Juneau City and Borough",110,"Juneau City and Borough",3,26,7134,24,7139,0,125,0,17
"02/11/2022","Y","Y","Juneau City and Borough",110,"Juneau City and Borough",3,26,7160,26,7165,0,125,0,17
"02/12/2022","Y","Y","Juneau City and Borough",110,"Juneau City and Borough",3,12,7172,11,7176,0,125,0,17
"02/13/2022","Y","Y","Juneau City and Borough",110,"Juneau City and Borough",3,22,7194,20,7196,0,125,1,18
"02/14/2022","Y","Y","Juneau City and Borough",110,"Juneau City and Borough",3,13,7207,14,7210,1,126,0,18
"02/15/2022","Y","Y","Juneau City and Borough",110,"Juneau City and Borough",3,8,7215,7,7217,0,126,0,18
"02/16/2022","Y","Y","Juneau City and Borough",110,"Juneau City and Borough",3,24,7239,26,7243,0,126,0,18
"02/17/2022","Y","Y","Juneau City and Borough",110,"Juneau City and Borough",3,17,7256,17,7260,0,126,0,18
"02/18/2022","Y","Y","Juneau City and Borough",110,"Juneau City and Borough",3,17,7273,18,7278,0,126,0,18
"02/19/2022","Y","Y","Juneau City and Borough",110,"Juneau City and Borough",3,16,7289,14,7292,0,126,0,18
"02/20/2022","Y","Y","Juneau City and Borough",110,"Juneau City and Borough",3,9,7298,11,7303,0,126,0,18
"02/21/2022","Y","Y","Juneau City and Borough",110,"Juneau City and Borough",3,13,7311,15,7318,0,126,0,18
"02/22/2022","Y","Y","Juneau City and Borough",110,"Juneau City and Borough",3,15,7326,16,7334,0,126,0,18
"02/23/2022","Y","Y","Juneau City and Borough",110,"Juneau City and Borough",3,32,7358,31,7365,0,126,0,18
"02/24/2022","Y","Y","Juneau City and Borough",110,"Juneau City and Borough",3,18,7376,16,7381,0,126,0,18
"02/25/2022","Y","Y","Juneau City and Borough",110,"Juneau City and Borough",3,9,7385,7,7388,0,126,0,18
"02/26/2022","Y","Y","Juneau City and Borough",110,"Juneau City and Borough",3,8,7393,8,7396,0,126,0,18
"02/27/2022","Y","Y","Juneau City and Borough",110,"Juneau City and Borough",3,17,7410,17,7413,0,126,0,18
"02/28/2022","Y","Y","Juneau City and Borough",110,"Juneau City and Borough",3,11,7421,13,7426,0,126,0,18
"03/01/2022","Y","Y","Juneau City and Borough",110,"Juneau City and Borough",3,27,7448,25,7451,0,126,0,18
"03/02/2022","Y","Y","Juneau City and Borough",110,"Juneau City and Borough",3,17,7465,16,7467,0,126,0,18
"03/03/2022","Y","Y","Juneau City and Borough",110,"Juneau City and Borough",3,13,7478,13,7480,0,126,0,18
"03/04/2022","Y","Y","Juneau City and Borough",110,"Juneau City and Borough",3,15,7493,15,7495,0,126,0,18
"03/05/2022","Y","Y","Juneau City and Borough",110,"Juneau City and Borough",3,12,7505,12,7507,0,126,0,18
"03/06/2022","Y","Y","Juneau City and Borough",110,"Juneau City and Borough",3,8,7513,8,7515,0,126,0,18
"03/07/2022","Y","Y","Juneau City and Borough",110,"Juneau City and Borough",3,4,7517,3,7518,0,126,0,18
"03/08/2022","Y","Y","Juneau City and Borough",110,"Juneau City and Borough",3,25,7542,26,7544,0,126,0,18
"03/09/2022","Y","Y","Juneau City and Borough",110,"Juneau City and Borough",3,9,7551,10,7554,0,126,0,18
"03/10/2022","Y","Y","Juneau City and Borough",110,"Juneau City and Borough",3,9,7560,7,7561,0,126,0,18
"03/11/2022","Y","Y","Juneau City and Borough",110,"Juneau City and Borough",3,11,7571,12,7573,0,126,0,18
"03/12/2022","Y","Y","Juneau City and Borough",110,"Juneau City and Borough",3,18,7589,24,7597,0,126,0,18
"03/13/2022","Y","Y","Juneau City and Borough",110,"Juneau City and Borough",3,7,7596,0,7597,0,126,0,18
"03/14/2022","Y","Y","Juneau City and Borough",110,"Juneau City and Borough",3,3,7599,3,7600,0,126,0,18
"03/15/2022","Y","Y","Juneau City and Borough",110,"Juneau City and Borough",3,17,7616,17,7617,1,127,0,18
"03/16/2022","Y","Y","Juneau City and Borough",110,"Juneau City and Borough",3,15,7631,15,7632,0,127,0,18
"03/17/2022","Y","Y","Juneau City and Borough",110,"Juneau City and Borough",3,11,7642,12,7644,1,128,0,18
"03/18/2022","Y","Y","Juneau City and Borough",110,"Juneau City and Borough",3,8,7650,7,7651,0,128,0,18
"03/19/2022","Y","Y","Juneau City and Borough",110,"Juneau City and Borough",3,10,7660,11,7662,1,129,0,18
"03/20/2022","Y","Y","Juneau City and Borough",110,"Juneau City and Borough",3,4,7664,3,7665,0,129,0,18
"03/21/2022","Y","Y","Juneau City and Borough",110,"Juneau City and Borough",3,13,7677,17,7682,0,129,0,18
"03/22/2022","Y","Y","Juneau City and Borough",110,"Juneau City and Borough",3,13,7690,12,7694,0,129,0,18
"03/23/2022","Y","Y","Juneau City and Borough",110,"Juneau City and Borough",3,17,7707,15,7709,0,129,0,18
"03/24/2022","Y","Y","Juneau City and Borough",110,"Juneau City and Borough",3,12,7719,10,7719,0,129,0,18
"03/25/2022","Y","Y","Juneau City and Borough",110,"Juneau City and Borough",3,14,7733,15,7734,0,129,0,18
"03/26/2022","Y","Y","Juneau City and Borough",110,"Juneau City and Borough",3,5,7738,5,7739,0,129,0,18
"03/27/2022","Y","Y","Juneau City and Borough",110,"Juneau City and Borough",3,8,7746,10,7749,0,129,0,18
"03/28/2022","Y","Y","Juneau City and Borough",110,"Juneau City and Borough",3,7,7753,8,7757,1,130,0,18
"03/29/2022","Y","Y","Juneau City and Borough",110,"Juneau City and Borough",3,20,7773,24,7781,0,130,0,18
"03/30/2022","Y","Y","Juneau City and Borough",110,"Juneau City and Borough",3,38,7811,35,7816,0,130,0,18
"03/31/2022","Y","Y","Juneau City and Borough",110,"Juneau City and Borough",3,11,7822,15,7831,0,130,0,18
"04/01/2022","Y","Y","Juneau City and Borough",110,"Juneau City and Borough",3,22,7844,18,7849,0,130,0,18
"04/02/2022","Y","Y","Juneau City and Borough",110,"Juneau City and Borough",3,6,7850,5,7854,0,130,0,18
"04/03/2022","Y","Y","Juneau City and Borough",110,"Juneau City and Borough",3,3,7853,4,7858,0,130,0,18
"04/04/2022","Y","Y","Juneau City and Borough",110,"Juneau City and Borough",3,3,7856,2,7860,0,130,0,18
"04/05/2022","Y","Y","Juneau City and Borough",110,"Juneau City and Borough",3,11,7867,9,7869,0,130,0,18
"04/06/2022","Y","Y","Juneau City and Borough",110,"Juneau City and Borough",3,10,7877,11,7880,0,130,0,18
"04/07/2022","Y","Y","Juneau City and Borough",110,"Juneau City and Borough",3,3,7880,5,7885,0,130,0,18
"04/08/2022","Y","Y","Juneau City and Borough",110,"Juneau City and Borough",3,20,7900,20,7905,0,130,0,18
"04/09/2022","Y","Y","Juneau City and Borough",110,"Juneau City and Borough",3,11,7911,7,7912,0,130,0,18
"04/10/2022","Y","Y","Juneau City and Borough",110,"Juneau City and Borough",3,4,7915,4,7916,1,131,0,18
"04/11/2022","Y","Y","Juneau City and Borough",110,"Juneau City and Borough",3,2,7917,2,7918,0,131,0,18
"04/12/2022","Y","Y","Juneau City and Borough",110,"Juneau City and Borough",3,11,7928,23,7941,1,132,0,18
"04/13/2022","Y","Y","Juneau City and Borough",110,"Juneau City and Borough",3,17,7945,6,7947,0,132,0,18
"04/14/2022","Y","Y","Juneau City and Borough",110,"Juneau City and Borough",3,11,7956,12,7959,0,132,0,18
"04/15/2022","Y","Y","Juneau City and Borough",110,"Juneau City and Borough",3,13,7969,13,7972,0,132,0,18
"04/16/2022","Y","Y","Juneau City and Borough",110,"Juneau City and Borough",3,8,7977,11,7983,0,132,0,18
"04/17/2022","Y","Y","Juneau City and Borough",110,"Juneau City and Borough",3,6,7983,0,7983,0,132,0,18
"04/18/2022","Y","Y","Juneau City and Borough",110,"Juneau City and Borough",3,6,7989,12,7995,0,132,0,18
"04/19/2022","Y","Y","Juneau City and Borough",110,"Juneau City and Borough",3,24,8013,35,8030,0,132,0,18
"04/20/2022","Y","Y","Juneau City and Borough",110,"Juneau City and Borough",3,20,8033,9,8039,0,132,0,18
"04/21/2022","Y","Y","Juneau City and Borough",110,"Juneau City and Borough",3,5,8038,3,8042,0,132,0,18
"04/22/2022","Y","Y","Juneau City and Borough",110,"Juneau City and Borough",3,16,8054,16,8058,0,132,0,18
"04/23/2022","Y","Y","Juneau City and Borough",110,"Juneau City and Borough",3,17,8071,14,8072,0,132,0,18
"04/24/2022","Y","Y","Juneau City and Borough",110,"Juneau City and Borough",3,7,8078,7,8079,0,132,0,18
"04/25/2022","Y","Y","Juneau City and Borough",110,"Juneau City and Borough",3,6,8084,6,8085,0,132,0,18
"04/26/2022","Y","Y","Juneau City and Borough",110,"Juneau City and Borough",3,21,8105,20,8105,0,132,0,18
"03/10/2020","Y","Y","Kenai Peninsula Borough",122,"Kenai Peninsula Borough",4,0,0,1,1,0,0,0,0
"03/13/2020","Y","Y","Kenai Peninsula Borough",122,"Kenai Peninsula Borough",4,0,0,1,2,0,0,0,0
"03/15/2020","Y","Y","Kenai Peninsula Borough",122,"Kenai Peninsula Borough",4,0,0,2,4,0,0,0,0
"03/18/2020","Y","Y","Kenai Peninsula Borough",122,"Kenai Peninsula Borough",4,1,1,1,5,0,0,0,0
"03/19/2020","Y","Y","Kenai Peninsula Borough",122,"Kenai Peninsula Borough",4,0,1,2,7,0,0,0,0
"03/20/2020","Y","Y","Kenai Peninsula Borough",122,"Kenai Peninsula Borough",4,0,1,1,8,0,0,0,0
"03/21/2020","Y","Y","Kenai Peninsula Borough",122,"Kenai Peninsula Borough",4,2,3,2,10,0,0,0,0
"03/23/2020","Y","Y","Kenai Peninsula Borough",122,"Kenai Peninsula Borough",4,1,4,0,10,0,0,0,0
"03/25/2020","Y","Y","Kenai Peninsula Borough",122,"Kenai Peninsula Borough",4,1,5,0,10,0,0,0,0
"03/27/2020","Y","Y","Kenai Peninsula Borough",122,"Kenai Peninsula Borough",4,0,5,2,12,0,0,0,0
"03/28/2020","Y","Y","Kenai Peninsula Borough",122,"Kenai Peninsula Borough",4,2,7,0,12,1,1,0,0
"03/30/2020","Y","Y","Kenai Peninsula Borough",122,"Kenai Peninsula Borough",4,0,7,2,14,0,1,0,0
"03/31/2020","Y","Y","Kenai Peninsula Borough",122,"Kenai Peninsula Borough",4,1,8,0,14,0,1,0,0
"04/02/2020","Y","Y","Kenai Peninsula Borough",122,"Kenai Peninsula Borough",4,2,10,0,14,0,1,0,0
"04/04/2020","Y","Y","Kenai Peninsula Borough",122,"Kenai Peninsula Borough",4,1,11,1,15,0,1,0,0
"04/05/2020","Y","Y","Kenai Peninsula Borough",122,"Kenai Peninsula Borough",4,1,12,0,15,0,1,0,0
"04/08/2020","Y","Y","Kenai Peninsula Borough",122,"Kenai Peninsula Borough",4,1,13,0,15,0,1,0,0
"04/09/2020","Y","Y","Kenai Peninsula Borough",122,"Kenai Peninsula Borough",4,1,14,0,15,0,1,0,0
"04/11/2020","Y","Y","Kenai Peninsula Borough",122,"Kenai Peninsula Borough",4,0,14,1,16,0,1,0,0
"04/12/2020","Y","Y","Kenai Peninsula Borough",122,"Kenai Peninsula Borough",4,0,14,1,17,0,1,0,0
"04/14/2020","Y","Y","Kenai Peninsula Borough",122,"Kenai Peninsula Borough",4,1,15,1,18,0,1,0,0
"04/16/2020","Y","Y","Kenai Peninsula Borough",122,"Kenai Peninsula Borough",4,1,16,0,18,0,1,0,0
"04/17/2020","Y","Y","Kenai Peninsula Borough",122,"Kenai Peninsula Borough",4,2,18,0,18,0,1,0,0
"04/21/2020","Y","Y","Kenai Peninsula Borough",122,"Kenai Peninsula Borough",4,0,18,1,19,0,1,0,0
"04/28/2020","Y","Y","Kenai Peninsula Borough",122,"Kenai Peninsula Borough",4,0,18,1,20,1,2,0,0
"04/29/2020","Y","Y","Kenai Peninsula Borough",122,"Kenai Peninsula Borough",4,0,18,1,21,0,2,0,0
"04/30/2020","Y","Y","Kenai Peninsula Borough",122,"Kenai Peninsula Borough",4,2,20,0,21,0,2,0,0
"05/02/2020","Y","Y","Kenai Peninsula Borough",122,"Kenai Peninsula Borough",4,1,21,0,21,1,3,0,0
"05/03/2020","Y","Y","Kenai Peninsula Borough",122,"Kenai Peninsula Borough",4,0,21,1,22,0,3,0,0
"05/04/2020","Y","Y","Kenai Peninsula Borough",122,"Kenai Peninsula Borough",4,0,21,1,23,0,3,0,0
"05/05/2020","Y","Y","Kenai Peninsula Borough",122,"Kenai Peninsula Borough",4,0,21,0,23,0,3,1,1
"05/06/2020","Y","Y","Kenai Peninsula Borough",122,"Kenai Peninsula Borough",4,1,22,0,23,0,3,0,1
"05/08/2020","Y","Y","Kenai Peninsula Borough",122,"Kenai Peninsula Borough",4,1,23,0,23,0,3,0,1
"05/09/2020","Y","Y","Kenai Peninsula Borough",122,"Kenai Peninsula Borough",4,0,23,1,24,0,3,0,1
"05/10/2020","Y","Y","Kenai Peninsula Borough",122,"Kenai Peninsula Borough",4,1,24,0,24,0,3,0,1
"05/11/2020","Y","Y","Kenai Peninsula Borough",122,"Kenai Peninsula Borough",4,0,24,1,25,0,3,0,1
"05/14/2020","Y","Y","Kenai Peninsula Borough",122,"Kenai Peninsula Borough",4,0,24,1,26,0,3,0,1
"05/15/2020","Y","Y","Kenai Peninsula Borough",122,"Kenai Peninsula Borough",4,1,25,0,26,0,3,0,1
"05/16/2020","Y","Y","Kenai Peninsula Borough",122,"Kenai Peninsula Borough",4,1,26,1,27,0,3,0,1
"05/18/2020","Y","Y","Kenai Peninsula Borough",122,"Kenai Peninsula Borough",4,0,26,1,28,0,3,0,1
"05/19/2020","Y","Y","Kenai Peninsula Borough",122,"Kenai Peninsula Borough",4,0,26,1,29,1,4,0,1
"05/20/2020","Y","Y","Kenai Peninsula Borough",122,"Kenai Peninsula Borough",4,0,26,1,30,0,4,0,1
"05/21/2020","Y","Y","Kenai Peninsula Borough",122,"Kenai Peninsula Borough",4,0,26,1,31,0,4,0,1
"05/22/2020","Y","Y","Kenai Peninsula Borough",122,"Kenai Peninsula Borough",4,0,26,1,32,0,4,0,1
"05/23/2020","Y","Y","Kenai Peninsula Borough",122,"Kenai Peninsula Borough",4,0,26,3,35,0,4,0,1
"05/24/2020","Y","Y","Kenai Peninsula Borough",122,"Kenai Peninsula Borough",4,1,27,2,37,0,4,0,1
"05/25/2020","Y","Y","Kenai Peninsula Borough",122,"Kenai Peninsula Borough",4,0,27,4,41,0,4,0,1
"05/26/2020","Y","Y","Kenai Peninsula Borough",122,"Kenai Peninsula Borough",4,0,27,2,43,1,5,0,1
"05/27/2020","Y","Y","Kenai Peninsula Borough",122,"Kenai Peninsula Borough",4,7,34,6,49,0,5,0,1
"05/28/2020","Y","Y","Kenai Peninsula Borough",122,"Kenai Peninsula Borough",4,2,36,5,54,0,5,0,1
"05/29/2020","Y","Y","Kenai Peninsula Borough",122,"Kenai Peninsula Borough",4,1,37,4,58,0,5,0,1
"05/30/2020","Y","Y","Kenai Peninsula Borough",122,"Kenai Peninsula Borough",4,8,45,3,61,0,5,0,1
"05/31/2020","Y","Y","Kenai Peninsula Borough",122,"Kenai Peninsula Borough",4,4,49,6,67,0,5,0,1
"06/01/2020","Y","Y","Kenai Peninsula Borough",122,"Kenai Peninsula Borough",4,5,54,6,73,0,5,0,1
"06/02/2020","Y","Y","Kenai Peninsula Borough",122,"Kenai Peninsula Borough",4,6,60,3,76,0,5,0,1
"06/03/2020","Y","Y","Kenai Peninsula Borough",122,"Kenai Peninsula Borough",4,3,63,4,80,0,5,0,1
"06/04/2020","Y","Y","Kenai Peninsula Borough",122,"Kenai Peninsula Borough",4,5,68,6,86,0,5,0,1
"06/05/2020","Y","Y","Kenai Peninsula Borough",122,"Kenai Peninsula Borough",4,10,78,9,95,0,5,0,1
"06/06/2020","Y","Y","Kenai Peninsula Borough",122,"Kenai Peninsula Borough",4,1,79,6,101,0,5,0,1
"06/07/2020","Y","Y","Kenai Peninsula Borough",122,"Kenai Peninsula Borough",4,4,83,2,103,0,5,0,1
"06/08/2020","Y","Y","Kenai Peninsula Borough",122,"Kenai Peninsula Borough",4,2,85,3,106,0,5,0,1
"06/09/2020","Y","Y","Kenai Peninsula Borough",122,"Kenai Peninsula Borough",4,9,94,2,108,0,5,0,1
"06/10/2020","Y","Y","Kenai Peninsula Borough",122,"Kenai Peninsula Borough",4,3,97,6,114,0,5,0,1
"06/11/2020","Y","Y","Kenai Peninsula Borough",122,"Kenai Peninsula Borough",4,5,102,1,115,0,5,0,1
"06/12/2020","Y","Y","Kenai Peninsula Borough",122,"Kenai Peninsula Borough",4,6,108,2,117,2,7,0,1
"06/13/2020","Y","Y","Kenai Peninsula Borough",122,"Kenai Peninsula Borough",4,1,109,1,118,0,7,0,1
"06/14/2020","Y","Y","Kenai Peninsula Borough",122,"Kenai Peninsula Borough",4,1,110,0,118,0,7,0,1
"06/15/2020","Y","Y","Kenai Peninsula Borough",122,"Kenai Peninsula Borough",4,4,114,1,119,0,7,0,1
"06/16/2020","Y","Y","Kenai Peninsula Borough",122,"Kenai Peninsula Borough",4,2,116,0,119,0,7,0,1
"06/17/2020","Y","Y","Kenai Peninsula Borough",122,"Kenai Peninsula Borough",4,1,117,1,120,1,8,0,1
"06/18/2020","Y","Y","Kenai Peninsula Borough",122,"Kenai Peninsula Borough",4,1,118,1,121,0,8,0,1
"06/19/2020","Y","Y","Kenai Peninsula Borough",122,"Kenai Peninsula Borough",4,2,120,2,123,0,8,0,1
"06/20/2020","Y","Y","Kenai Peninsula Borough",122,"Kenai Peninsula Borough",4,1,121,0,123,1,9,0,1
"06/21/2020","Y","Y","Kenai Peninsula Borough",122,"Kenai Peninsula Borough",4,0,121,1,124,0,9,0,1
"06/22/2020","Y","Y","Kenai Peninsula Borough",122,"Kenai Peninsula Borough",4,1,122,6,130,0,9,0,1
"06/23/2020","Y","Y","Kenai Peninsula Borough",122,"Kenai Peninsula Borough",4,0,122,3,133,0,9,0,1
"06/24/2020","Y","Y","Kenai Peninsula Borough",122,"Kenai Peninsula Borough",4,5,127,1,134,0,9,0,1
"06/25/2020","Y","Y","Kenai Peninsula Borough",122,"Kenai Peninsula Borough",4,2,129,4,138,0,9,0,1
"06/26/2020","Y","Y","Kenai Peninsula Borough",122,"Kenai Peninsula Borough",4,2,131,9,147,0,9,0,1
"06/27/2020","Y","Y","Kenai Peninsula Borough",122,"Kenai Peninsula Borough",4,3,134,6,153,0,9,0,1
"06/28/2020","Y","Y","Kenai Peninsula Borough",122,"Kenai Peninsula Borough",4,8,142,3,156,0,9,0,1
"06/29/2020","Y","Y","Kenai Peninsula Borough",122,"Kenai Peninsula Borough",4,5,147,6,162,0,9,0,1
"06/30/2020","Y","Y","Kenai Peninsula Borough",122,"Kenai Peninsula Borough",4,5,152,2,164,0,9,0,1
"07/01/2020","Y","Y","Kenai Peninsula Borough",122,"Kenai Peninsula Borough",4,4,156,2,166,0,9,0,1
"07/02/2020","Y","Y","Kenai Peninsula Borough",122,"Kenai Peninsula Borough",4,3,159,2,168,0,9,0,1
"07/03/2020","Y","Y","Kenai Peninsula Borough",122,"Kenai Peninsula Borough",4,0,159,2,170,0,9,0,1
"07/04/2020","Y","Y","Kenai Peninsula Borough",122,"Kenai Peninsula Borough",4,2,161,4,174,0,9,0,1
"07/05/2020","Y","Y","Kenai Peninsula Borough",122,"Kenai Peninsula Borough",4,2,163,4,178,0,9,0,1
"07/06/2020","Y","Y","Kenai Peninsula Borough",122,"Kenai Peninsula Borough",4,1,164,7,185,0,9,0,1
"07/07/2020","Y","Y","Kenai Peninsula Borough",122,"Kenai Peninsula Borough",4,9,173,9,194,0,9,0,1
"07/08/2020","Y","Y","Kenai Peninsula Borough",122,"Kenai Peninsula Borough",4,7,180,6,200,0,9,0,1
"07/09/2020","Y","Y","Kenai Peninsula Borough",122,"Kenai Peninsula Borough",4,6,186,5,205,0,9,0,1
"07/10/2020","Y","Y","Kenai Peninsula Borough",122,"Kenai Peninsula Borough",4,3,189,7,212,0,9,0,1
"07/11/2020","Y","Y","Kenai Peninsula Borough",122,"Kenai Peninsula Borough",4,8,197,2,214,0,9,0,1
"07/12/2020","Y","Y","Kenai Peninsula Borough",122,"Kenai Peninsula Borough",4,3,200,2,216,0,9,0,1
"07/13/2020","Y","Y","Kenai Peninsula Borough",122,"Kenai Peninsula Borough",4,6,206,9,225,0,9,0,1
"07/14/2020","Y","Y","Kenai Peninsula Borough",122,"Kenai Peninsula Borough",4,0,206,7,232,0,9,0,1
"07/15/2020","Y","Y","Kenai Peninsula Borough",122,"Kenai Peninsula Borough",4,11,217,7,239,0,9,0,1
"07/16/2020","Y","Y","Kenai Peninsula Borough",122,"Kenai Peninsula Borough",4,5,222,3,242,1,10,0,1
"07/17/2020","Y","Y","Kenai Peninsula Borough",122,"Kenai Peninsula Borough",4,8,230,10,252,0,10,0,1
"07/18/2020","Y","Y","Kenai Peninsula Borough",122,"Kenai Peninsula Borough",4,5,235,2,254,0,10,0,1
"07/19/2020","Y","Y","Kenai Peninsula Borough",122,"Kenai Peninsula Borough",4,6,241,3,257,0,10,0,1
"07/20/2020","Y","Y","Kenai Peninsula Borough",122,"Kenai Peninsula Borough",4,7,248,10,267,0,10,0,1
"07/21/2020","Y","Y","Kenai Peninsula Borough",122,"Kenai Peninsula Borough",4,6,254,12,279,0,10,0,1
"07/22/2020","Y","Y","Kenai Peninsula Borough",122,"Kenai Peninsula Borough",4,1,255,1,280,0,10,0,1
"07/23/2020","Y","Y","Kenai Peninsula Borough",122,"Kenai Peninsula Borough",4,7,262,6,286,0,10,0,1
"07/24/2020","Y","Y","Kenai Peninsula Borough",122,"Kenai Peninsula Borough",4,11,273,2,288,0,10,0,1
"07/25/2020","Y","Y","Kenai Peninsula Borough",122,"Kenai Peninsula Borough",4,1,274,0,288,0,10,0,1
"07/26/2020","Y","Y","Kenai Peninsula Borough",122,"Kenai Peninsula Borough",4,4,278,4,292,0,10,0,1
"07/27/2020","Y","Y","Kenai Peninsula Borough",122,"Kenai Peninsula Borough",4,6,284,9,301,0,10,0,1
"07/28/2020","Y","Y","Kenai Peninsula Borough",122,"Kenai Peninsula Borough",4,5,289,2,303,0,10,0,1
"07/29/2020","Y","Y","Kenai Peninsula Borough",122,"Kenai Peninsula Borough",4,5,294,5,308,0,10,0,1
"07/30/2020","Y","Y","Kenai Peninsula Borough",122,"Kenai Peninsula Borough",4,1,295,3,311,0,10,0,1
"07/31/2020","Y","Y","Kenai Peninsula Borough",122,"Kenai Peninsula Borough",4,8,303,1,312,0,10,0,1
"08/01/2020","Y","Y","Kenai Peninsula Borough",122,"Kenai Peninsula Borough",4,3,306,4,316,0,10,0,1
"08/03/2020","Y","Y","Kenai Peninsula Borough",122,"Kenai Peninsula Borough",4,1,307,6,322,0,10,0,1
"08/04/2020","Y","Y","Kenai Peninsula Borough",122,"Kenai Peninsula Borough",4,3,310,5,327,0,10,0,1
"08/05/2020","Y","Y","Kenai Peninsula Borough",122,"Kenai Peninsula Borough",4,2,312,7,334,0,10,0,1
"08/06/2020","Y","Y","Kenai Peninsula Borough",122,"Kenai Peninsula Borough",4,5,317,2,336,0,10,0,1
"08/07/2020","Y","Y","Kenai Peninsula Borough",122,"Kenai Peninsula Borough",4,4,321,5,341,0,10,0,1
"08/08/2020","Y","Y","Kenai Peninsula Borough",122,"Kenai Peninsula Borough",4,6,327,4,345,0,10,0,1
"08/09/2020","Y","Y","Kenai Peninsula Borough",122,"Kenai Peninsula Borough",4,6,333,1,346,0,10,0,1
"08/10/2020","Y","Y","Kenai Peninsula Borough",122,"Kenai Peninsula Borough",4,8,341,6,352,2,12,0,1
"08/11/2020","Y","Y","Kenai Peninsula Borough",122,"Kenai Peninsula Borough",4,3,344,5,357,0,12,0,1
"08/12/2020","Y","Y","Kenai Peninsula Borough",122,"Kenai Peninsula Borough",4,3,347,9,366,0,12,0,1
"08/13/2020","Y","Y","Kenai Peninsula Borough",122,"Kenai Peninsula Borough",4,2,349,2,368,0,12,0,1
"08/14/2020","Y","Y","Kenai Peninsula Borough",122,"Kenai Peninsula Borough",4,3,352,1,369,0,12,0,1
"08/15/2020","Y","Y","Kenai Peninsula Borough",122,"Kenai Peninsula Borough",4,12,364,10,379,0,12,0,1
"08/16/2020","Y","Y","Kenai Peninsula Borough",122,"Kenai Peninsula Borough",4,1,365,1,380,0,12,0,1
"08/17/2020","Y","Y","Kenai Peninsula Borough",122,"Kenai Peninsula Borough",4,15,380,5,385,1,13,0,1
"08/18/2020","Y","Y","Kenai Peninsula Borough",122,"Kenai Peninsula Borough",4,2,382,3,388,0,13,0,1
"08/19/2020","Y","Y","Kenai Peninsula Borough",122,"Kenai Peninsula Borough",4,2,384,4,392,0,13,0,1
"08/20/2020","Y","Y","Kenai Peninsula Borough",122,"Kenai Peninsula Borough",4,4,388,3,395,0,13,0,1
"08/21/2020","Y","Y","Kenai Peninsula Borough",122,"Kenai Peninsula Borough",4,9,397,8,403,0,13,0,1
"08/22/2020","Y","Y","Kenai Peninsula Borough",122,"Kenai Peninsula Borough",4,3,400,1,404,0,13,0,1
"08/23/2020","Y","Y","Kenai Peninsula Borough",122,"Kenai Peninsula Borough",4,2,402,0,404,0,13,0,1
"08/24/2020","Y","Y","Kenai Peninsula Borough",122,"Kenai Peninsula Borough",4,1,403,6,410,0,13,0,1
"08/25/2020","Y","Y","Kenai Peninsula Borough",122,"Kenai Peninsula Borough",4,3,406,1,411,0,13,0,1
"08/26/2020","Y","Y","Kenai Peninsula Borough",122,"Kenai Peninsula Borough",4,1,407,1,412,0,13,0,1
"08/27/2020","Y","Y","Kenai Peninsula Borough",122,"Kenai Peninsula Borough",4,0,407,2,414,0,13,0,1
"08/28/2020","Y","Y","Kenai Peninsula Borough",122,"Kenai Peninsula Borough",4,1,408,2,416,0,13,0,1
"08/29/2020","Y","Y","Kenai Peninsula Borough",122,"Kenai Peninsula Borough",4,3,411,1,417,0,13,0,1
"08/30/2020","Y","Y","Kenai Peninsula Borough",122,"Kenai Peninsula Borough",4,0,411,1,418,0,13,0,1
"08/31/2020","Y","Y","Kenai Peninsula Borough",122,"Kenai Peninsula Borough",4,1,412,4,422,0,13,0,1
"09/01/2020","Y","Y","Kenai Peninsula Borough",122,"Kenai Peninsula Borough",4,3,415,3,425,0,13,0,1
"09/02/2020","Y","Y","Kenai Peninsula Borough",122,"Kenai Peninsula Borough",4,2,417,1,426,0,13,0,1
"09/03/2020","Y","Y","Kenai Peninsula Borough",122,"Kenai Peninsula Borough",4,1,418,0,426,0,13,0,1
"09/04/2020","Y","Y","Kenai Peninsula Borough",122,"Kenai Peninsula Borough",4,1,419,2,428,0,13,0,1
"09/05/2020","Y","Y","Kenai Peninsula Borough",122,"Kenai Peninsula Borough",4,3,422,0,428,0,13,0,1
"09/06/2020","Y","Y","Kenai Peninsula Borough",122,"Kenai Peninsula Borough",4,1,423,2,430,0,13,0,1
"09/07/2020","Y","Y","Kenai Peninsula Borough",122,"Kenai Peninsula Borough",4,1,424,0,430,0,13,0,1
"09/08/2020","Y","Y","Kenai Peninsula Borough",122,"Kenai Peninsula Borough",4,3,427,0,430,0,13,0,1
"09/10/2020","Y","Y","Kenai Peninsula Borough",122,"Kenai Peninsula Borough",4,1,428,1,431,0,13,0,1
"09/11/2020","Y","Y","Kenai Peninsula Borough",122,"Kenai Peninsula Borough",4,0,428,1,432,0,13,0,1
"09/12/2020","Y","Y","Kenai Peninsula Borough",122,"Kenai Peninsula Borough",4,0,428,1,433,0,13,0,1
"09/13/2020","Y","Y","Kenai Peninsula Borough",122,"Kenai Peninsula Borough",4,0,428,2,435,0,13,0,1
"09/15/2020","Y","Y","Kenai Peninsula Borough",122,"Kenai Peninsula Borough",4,3,431,3,438,0,13,0,1
"09/16/2020","Y","Y","Kenai Peninsula Borough",122,"Kenai Peninsula Borough",4,3,434,1,439,0,13,0,1
"09/17/2020","Y","Y","Kenai Peninsula Borough",122,"Kenai Peninsula Borough",4,2,436,1,440,0,13,0,1
"09/18/2020","Y","Y","Kenai Peninsula Borough",122,"Kenai Peninsula Borough",4,0,436,2,442,0,13,0,1
"09/20/2020","Y","Y","Kenai Peninsula Borough",122,"Kenai Peninsula Borough",4,1,437,0,442,0,13,0,1
"09/21/2020","Y","Y","Kenai Peninsula Borough",122,"Kenai Peninsula Borough",4,0,437,1,443,0,13,0,1
"09/22/2020","Y","Y","Kenai Peninsula Borough",122,"Kenai Peninsula Borough",4,5,442,5,448,0,13,0,1
"09/23/2020","Y","Y","Kenai Peninsula Borough",122,"Kenai Peninsula Borough",4,2,444,3,451,1,14,0,1
"09/24/2020","Y","Y","Kenai Peninsula Borough",122,"Kenai Peninsula Borough",4,0,444,1,452,0,14,0,1
"09/25/2020","Y","Y","Kenai Peninsula Borough",122,"Kenai Peninsula Borough",4,4,448,4,456,0,14,0,1
"09/26/2020","Y","Y","Kenai Peninsula Borough",122,"Kenai Peninsula Borough",4,3,451,1,457,0,14,0,1
"09/28/2020","Y","Y","Kenai Peninsula Borough",122,"Kenai Peninsula Borough",4,3,454,6,463,0,14,0,1
"09/29/2020","Y","Y","Kenai Peninsula Borough",122,"Kenai Peninsula Borough",4,1,455,5,468,0,14,0,1
"09/30/2020","Y","Y","Kenai Peninsula Borough",122,"Kenai Peninsula Borough",4,1,456,3,471,0,14,0,1
"10/01/2020","Y","Y","Kenai Peninsula Borough",122,"Kenai Peninsula Borough",4,6,462,4,475,0,14,0,1
"10/02/2020","Y","Y","Kenai Peninsula Borough",122,"Kenai Peninsula Borough",4,2,464,8,483,0,14,0,1
"10/03/2020","Y","Y","Kenai Peninsula Borough",122,"Kenai Peninsula Borough",4,3,467,2,485,0,14,0,1
"10/04/2020","Y","Y","Kenai Peninsula Borough",122,"Kenai Peninsula Borough",4,2,469,3,488,0,14,0,1
"10/05/2020","Y","Y","Kenai Peninsula Borough",122,"Kenai Peninsula Borough",4,4,473,12,500,0,14,0,1
"10/06/2020","Y","Y","Kenai Peninsula Borough",122,"Kenai Peninsula Borough",4,3,476,8,508,0,14,0,1
"10/07/2020","Y","Y","Kenai Peninsula Borough",122,"Kenai Peninsula Borough",4,7,483,8,516,0,14,0,1
"10/08/2020","Y","Y","Kenai Peninsula Borough",122,"Kenai Peninsula Borough",4,6,489,8,524,0,14,0,1
"10/09/2020","Y","Y","Kenai Peninsula Borough",122,"Kenai Peninsula Borough",4,12,501,8,532,0,14,0,1
"10/10/2020","Y","Y","Kenai Peninsula Borough",122,"Kenai Peninsula Borough",4,13,514,4,536,0,14,0,1
"10/11/2020","Y","Y","Kenai Peninsula Borough",122,"Kenai Peninsula Borough",4,1,515,2,538,0,14,0,1
"10/12/2020","Y","Y","Kenai Peninsula Borough",122,"Kenai Peninsula Borough",4,16,531,18,556,0,14,1,2
"10/13/2020","Y","Y","Kenai Peninsula Borough",122,"Kenai Peninsula Borough",4,4,535,9,565,0,14,0,2
"10/14/2020","Y","Y","Kenai Peninsula Borough",122,"Kenai Peninsula Borough",4,4,539,14,579,0,14,0,2
"10/15/2020","Y","Y","Kenai Peninsula Borough",122,"Kenai Peninsula Borough",4,2,541,21,600,0,14,0,2
"10/16/2020","Y","Y","Kenai Peninsula Borough",122,"Kenai Peninsula Borough",4,9,550,18,618,1,15,0,2
"10/17/2020","Y","Y","Kenai Peninsula Borough",122,"Kenai Peninsula Borough",4,16,566,12,630,0,15,0,2
"10/18/2020","Y","Y","Kenai Peninsula Borough",122,"Kenai Peninsula Borough",4,10,576,7,637,1,16,0,2
"10/19/2020","Y","Y","Kenai Peninsula Borough",122,"Kenai Peninsula Borough",4,16,592,45,682,0,16,0,2
"10/20/2020","Y","Y","Kenai Peninsula Borough",122,"Kenai Peninsula Borough",4,15,607,25,707,0,16,0,2
"10/21/2020","Y","Y","Kenai Peninsula Borough",122,"Kenai Peninsula Borough",4,13,620,30,737,0,16,0,2
"10/22/2020","Y","Y","Kenai Peninsula Borough",122,"Kenai Peninsula Borough",4,11,631,33,770,0,16,0,2
"10/23/2020","Y","Y","Kenai Peninsula Borough",122,"Kenai Peninsula Borough",4,19,650,37,807,0,16,0,2
"10/24/2020","Y","Y","Kenai Peninsula Borough",122,"Kenai Peninsula Borough",4,38,688,12,819,0,16,0,2
"10/25/2020","Y","Y","Kenai Peninsula Borough",122,"Kenai Peninsula Borough",4,34,722,9,828,1,17,0,2
"10/26/2020","Y","Y","Kenai Peninsula Borough",122,"Kenai Peninsula Borough",4,26,748,53,881,0,17,0,2
"10/27/2020","Y","Y","Kenai Peninsula Borough",122,"Kenai Peninsula Borough",4,32,780,35,916,1,18,0,2
"10/28/2020","Y","Y","Kenai Peninsula Borough",122,"Kenai Peninsula Borough",4,37,817,32,948,1,19,0,2
"10/29/2020","Y","Y","Kenai Peninsula Borough",122,"Kenai Peninsula Borough",4,37,854,44,992,0,19,0,2
"10/30/2020","Y","Y","Kenai Peninsula Borough",122,"Kenai Peninsula Borough",4,41,895,37,1029,2,21,0,2
"10/31/2020","Y","Y","Kenai Peninsula Borough",122,"Kenai Peninsula Borough",4,29,924,10,1039,1,22,0,2
"11/01/2020","Y","Y","Kenai Peninsula Borough",122,"Kenai Peninsula Borough",4,13,937,11,1050,1,23,0,2
"11/02/2020","Y","Y","Kenai Peninsula Borough",122,"Kenai Peninsula Borough",4,23,960,52,1102,0,23,0,2
"11/03/2020","Y","Y","Kenai Peninsula Borough",122,"Kenai Peninsula Borough",4,45,1005,33,1135,1,24,0,2
"11/04/2020","Y","Y","Kenai Peninsula Borough",122,"Kenai Peninsula Borough",4,16,1021,46,1181,1,25,0,2
"11/05/2020","Y","Y","Kenai Peninsula Borough",122,"Kenai Peninsula Borough",4,37,1058,40,1221,0,25,0,2
"11/06/2020","Y","Y","Kenai Peninsula Borough",122,"Kenai Peninsula Borough",4,49,1107,66,1287,0,25,0,2
"11/07/2020","Y","Y","Kenai Peninsula Borough",122,"Kenai Peninsula Borough",4,59,1166,24,1311,0,25,0,2
"11/08/2020","Y","Y","Kenai Peninsula Borough",122,"Kenai Peninsula Borough",4,26,1192,18,1329,2,27,0,2
"11/09/2020","Y","Y","Kenai Peninsula Borough",122,"Kenai Peninsula Borough",4,60,1252,81,1410,1,28,0,2
"11/10/2020","Y","Y","Kenai Peninsula Borough",122,"Kenai Peninsula Borough",4,62,1314,77,1487,1,29,0,2
"11/11/2020","Y","Y","Kenai Peninsula Borough",122,"Kenai Peninsula Borough",4,42,1356,59,1546,1,30,0,2
"11/12/2020","Y","Y","Kenai Peninsula Borough",122,"Kenai Peninsula Borough",4,85,1441,80,1626,1,31,1,3
"11/13/2020","Y","Y","Kenai Peninsula Borough",122,"Kenai Peninsula Borough",4,45,1486,57,1683,5,36,0,3
"11/14/2020","Y","Y","Kenai Peninsula Borough",122,"Kenai Peninsula Borough",4,57,1543,28,1711,2,38,0,3
"11/15/2020","Y","Y","Kenai Peninsula Borough",122,"Kenai Peninsula Borough",4,31,1574,28,1739,2,40,0,3
"11/16/2020","Y","Y","Kenai Peninsula Borough",122,"Kenai Peninsula Borough",4,42,1616,111,1850,1,41,0,3
"11/17/2020","Y","Y","Kenai Peninsula Borough",122,"Kenai Peninsula Borough",4,65,1681,87,1937,2,43,0,3
"11/18/2020","Y","Y","Kenai Peninsula Borough",122,"Kenai Peninsula Borough",4,74,1755,88,2025,1,44,0,3
"11/19/2020","Y","Y","Kenai Peninsula Borough",122,"Kenai Peninsula Borough",4,36,1791,83,2108,0,44,0,3
"11/20/2020","Y","Y","Kenai Peninsula Borough",122,"Kenai Peninsula Borough",4,84,1875,98,2206,2,46,1,4
"11/21/2020","Y","Y","Kenai Peninsula Borough",122,"Kenai Peninsula Borough",4,52,1927,36,2242,1,47,1,5
"11/22/2020","Y","Y","Kenai Peninsula Borough",122,"Kenai Peninsula Borough",4,19,1946,21,2263,0,47,1,6
"11/23/2020","Y","Y","Kenai Peninsula Borough",122,"Kenai Peninsula Borough",4,51,1997,109,2372,1,48,0,6
"11/24/2020","Y","Y","Kenai Peninsula Borough",122,"Kenai Peninsula Borough",4,60,2057,87,2459,2,50,0,6
"11/25/2020","Y","Y","Kenai Peninsula Borough",122,"Kenai Peninsula Borough",4,143,2200,48,2507,3,53,0,6
"11/26/2020","Y","Y","Kenai Peninsula Borough",122,"Kenai Peninsula Borough",4,96,2296,7,2514,1,54,0,6
"11/27/2020","Y","Y","Kenai Peninsula Borough",122,"Kenai Peninsula Borough",4,42,2338,37,2551,1,55,0,6
"11/28/2020","Y","Y","Kenai Peninsula Borough",122,"Kenai Peninsula Borough",4,29,2367,25,2576,1,56,0,6
"11/29/2020","Y","Y","Kenai Peninsula Borough",122,"Kenai Peninsula Borough",4,29,2396,23,2599,0,56,0,6
"11/30/2020","Y","Y","Kenai Peninsula Borough",122,"Kenai Peninsula Borough",4,57,2453,78,2677,1,57,0,6
"12/01/2020","Y","Y","Kenai Peninsula Borough",122,"Kenai Peninsula Borough",4,78,2531,46,2723,2,59,1,7
"12/02/2020","Y","Y","Kenai Peninsula Borough",122,"Kenai Peninsula Borough",4,68,2599,57,2780,1,60,0,7
"12/03/2020","Y","Y","Kenai Peninsula Borough",122,"Kenai Peninsula Borough",4,54,2653,34,2814,4,64,0,7
"12/04/2020","Y","Y","Kenai Peninsula Borough",122,"Kenai Peninsula Borough",4,72,2725,42,2856,0,64,1,8
"12/05/2020","Y","Y","Kenai Peninsula Borough",122,"Kenai Peninsula Borough",4,43,2768,16,2872,1,65,0,8
"12/06/2020","Y","Y","Kenai Peninsula Borough",122,"Kenai Peninsula Borough",4,26,2794,19,2891,1,66,0,8
"12/07/2020","Y","Y","Kenai Peninsula Borough",122,"Kenai Peninsula Borough",4,33,2827,53,2944,0,66,0,8
"12/08/2020","Y","Y","Kenai Peninsula Borough",122,"Kenai Peninsula Borough",4,47,2874,47,2991,0,66,2,10
"12/09/2020","Y","Y","Kenai Peninsula Borough",122,"Kenai Peninsula Borough",4,43,2917,45,3036,0,66,1,11
"12/10/2020","Y","Y","Kenai Peninsula Borough",122,"Kenai Peninsula Borough",4,46,2963,26,3062,0,66,0,11
"12/11/2020","Y","Y","Kenai Peninsula Borough",122,"Kenai Peninsula Borough",4,34,2997,32,3094,0,66,1,12
"12/12/2020","Y","Y","Kenai Peninsula Borough",122,"Kenai Peninsula Borough",4,47,3044,18,3112,0,66,0,12
"12/13/2020","Y","Y","Kenai Peninsula Borough",122,"Kenai Peninsula Borough",4,13,3057,14,3126,1,67,0,12
"12/14/2020","Y","Y","Kenai Peninsula Borough",122,"Kenai Peninsula Borough",4,10,3067,45,3171,0,67,0,12
"12/15/2020","Y","Y","Kenai Peninsula Borough",122,"Kenai Peninsula Borough",4,61,3128,34,3205,0,67,0,12
"12/16/2020","Y","Y","Kenai Peninsula Borough",122,"Kenai Peninsula Borough",4,23,3151,24,3229,0,67,0,12
"12/17/2020","Y","Y","Kenai Peninsula Borough",122,"Kenai Peninsula Borough",4,58,3209,38,3267,0,67,0,12
"12/18/2020","Y","Y","Kenai Peninsula Borough",122,"Kenai Peninsula Borough",4,26,3235,27,3294,1,68,0,12
"12/19/2020","Y","Y","Kenai Peninsula Borough",122,"Kenai Peninsula Borough",4,24,3259,10,3304,0,68,0,12
"12/20/2020","Y","Y","Kenai Peninsula Borough",122,"Kenai Peninsula Borough",4,9,3268,9,3313,1,69,0,12
"12/21/2020","Y","Y","Kenai Peninsula Borough",122,"Kenai Peninsula Borough",4,23,3291,36,3349,0,69,0,12
"12/22/2020","Y","Y","Kenai Peninsula Borough",122,"Kenai Peninsula Borough",4,16,3307,23,3372,1,70,1,13
"12/23/2020","Y","Y","Kenai Peninsula Borough",122,"Kenai Peninsula Borough",4,22,3329,10,3382,2,72,2,15
"12/24/2020","Y","Y","Kenai Peninsula Borough",122,"Kenai Peninsula Borough",4,17,3346,6,3388,0,72,0,15
"12/25/2020","Y","Y","Kenai Peninsula Borough",122,"Kenai Peninsula Borough",4,12,3358,1,3389,1,73,0,15
"12/26/2020","Y","Y","Kenai Peninsula Borough",122,"Kenai Peninsula Borough",4,20,3378,5,3394,1,74,1,16
"12/27/2020","Y","Y","Kenai Peninsula Borough",122,"Kenai Peninsula Borough",4,3,3381,4,3398,0,74,0,16
"12/28/2020","Y","Y","Kenai Peninsula Borough",122,"Kenai Peninsula Borough",4,7,3388,17,3415,1,75,0,16
"12/29/2020","Y","Y","Kenai Peninsula Borough",122,"Kenai Peninsula Borough",4,6,3394,6,3421,0,75,1,17
"12/30/2020","Y","Y","Kenai Peninsula Borough",122,"Kenai Peninsula Borough",4,9,3403,16,3437,0,75,1,18
"12/31/2020","Y","Y","Kenai Peninsula Borough",122,"Kenai Peninsula Borough",4,11,3414,12,3449,0,75,0,18
"01/01/2021","Y","Y","Kenai Peninsula Borough",122,"Kenai Peninsula Borough",4,19,3433,5,3454,0,75,0,18
"01/02/2021","Y","Y","Kenai Peninsula Borough",122,"Kenai Peninsula Borough",4,2,3435,7,3461,0,75,0,18
"01/03/2021","Y","Y","Kenai Peninsula Borough",122,"Kenai Peninsula Borough",4,14,3449,9,3470,0,75,0,18
"01/04/2021","Y","Y","Kenai Peninsula Borough",122,"Kenai Peninsula Borough",4,10,3459,22,3492,0,75,0,18
"01/05/2021","Y","Y","Kenai Peninsula Borough",122,"Kenai Peninsula Borough",4,15,3474,19,3511,0,75,0,18
"01/06/2021","Y","Y","Kenai Peninsula Borough",122,"Kenai Peninsula Borough",4,9,3483,21,3532,0,75,0,18
"01/07/2021","Y","Y","Kenai Peninsula Borough",122,"Kenai Peninsula Borough",4,13,3496,10,3542,1,76,0,18
"01/08/2021","Y","Y","Kenai Peninsula Borough",122,"Kenai Peninsula Borough",4,28,3524,16,3558,1,77,0,18
"01/09/2021","Y","Y","Kenai Peninsula Borough",122,"Kenai Peninsula Borough",4,11,3535,8,3566,1,78,0,18
"01/10/2021","Y","Y","Kenai Peninsula Borough",122,"Kenai Peninsula Borough",4,7,3542,4,3570,0,78,0,18
"01/11/2021","Y","Y","Kenai Peninsula Borough",122,"Kenai Peninsula Borough",4,9,3551,9,3579,0,78,0,18
"01/12/2021","Y","Y","Kenai Peninsula Borough",122,"Kenai Peninsula Borough",4,13,3564,11,3590,0,78,0,18
"01/13/2021","Y","Y","Kenai Peninsula Borough",122,"Kenai Peninsula Borough",4,13,3577,13,3603,0,78,0,18
"01/14/2021","Y","Y","Kenai Peninsula Borough",122,"Kenai Peninsula Borough",4,8,3585,3,3606,0,78,0,18
"01/15/2021","Y","Y","Kenai Peninsula Borough",122,"Kenai Peninsula Borough",4,7,3592,6,3612,0,78,0,18
"01/16/2021","Y","Y","Kenai Peninsula Borough",122,"Kenai Peninsula Borough",4,3,3595,2,3614,0,78,0,18
"01/17/2021","Y","Y","Kenai Peninsula Borough",122,"Kenai Peninsula Borough",4,13,3608,8,3622,0,78,0,18
"01/18/2021","Y","Y","Kenai Peninsula Borough",122,"Kenai Peninsula Borough",4,4,3612,6,3628,0,78,0,18
"01/19/2021","Y","Y","Kenai Peninsula Borough",122,"Kenai Peninsula Borough",4,9,3621,8,3636,0,78,0,18
"01/20/2021","Y","Y","Kenai Peninsula Borough",122,"Kenai Peninsula Borough",4,12,3633,4,3640,0,78,0,18
"01/21/2021","Y","Y","Kenai Peninsula Borough",122,"Kenai Peninsula Borough",4,5,3638,1,3641,0,78,0,18
"01/22/2021","Y","Y","Kenai Peninsula Borough",122,"Kenai Peninsula Borough",4,2,3640,4,3645,0,78,0,18
"01/23/2021","Y","Y","Kenai Peninsula Borough",122,"Kenai Peninsula Borough",4,3,3643,3,3648,0,78,0,18
"01/24/2021","Y","Y","Kenai Peninsula Borough",122,"Kenai Peninsula Borough",4,1,3644,3,3651,0,78,0,18
"01/25/2021","Y","Y","Kenai Peninsula Borough",122,"Kenai Peninsula Borough",4,3,3647,8,3659,1,79,0,18
"01/26/2021","Y","Y","Kenai Peninsula Borough",122,"Kenai Peninsula Borough",4,3,3650,4,3663,0,79,0,18
"01/27/2021","Y","Y","Kenai Peninsula Borough",122,"Kenai Peninsula Borough",4,7,3657,5,3668,0,79,0,18
"01/28/2021","Y","Y","Kenai Peninsula Borough",122,"Kenai Peninsula Borough",4,4,3661,5,3673,0,79,0,18
"01/29/2021","Y","Y","Kenai Peninsula Borough",122,"Kenai Peninsula Borough",4,3,3664,3,3676,0,79,0,18
"01/30/2021","Y","Y","Kenai Peninsula Borough",122,"Kenai Peninsula Borough",4,4,3668,3,3679,0,79,0,18
"01/31/2021","Y","Y","Kenai Peninsula Borough",122,"Kenai Peninsula Borough",4,1,3669,3,3682,0,79,0,18
"02/01/2021","Y","Y","Kenai Peninsula Borough",122,"Kenai Peninsula Borough",4,5,3674,5,3687,0,79,0,18
"02/02/2021","Y","Y","Kenai Peninsula Borough",122,"Kenai Peninsula Borough",4,6,3680,2,3689,0,79,0,18
"02/03/2021","Y","Y","Kenai Peninsula Borough",122,"Kenai Peninsula Borough",4,1,3681,5,3694,0,79,0,18
"02/04/2021","Y","Y","Kenai Peninsula Borough",122,"Kenai Peninsula Borough",4,3,3684,5,3699,0,79,0,18
"02/05/2021","Y","Y","Kenai Peninsula Borough",122,"Kenai Peninsula Borough",4,6,3690,3,3702,0,79,0,18
"02/06/2021","Y","Y","Kenai Peninsula Borough",122,"Kenai Peninsula Borough",4,6,3696,2,3704,0,79,0,18
"02/07/2021","Y","Y","Kenai Peninsula Borough",122,"Kenai Peninsula Borough",4,2,3698,2,3706,0,79,0,18
"02/08/2021","Y","Y","Kenai Peninsula Borough",122,"Kenai Peninsula Borough",4,3,3701,8,3714,0,79,0,18
"02/09/2021","Y","Y","Kenai Peninsula Borough",122,"Kenai Peninsula Borough",4,8,3709,3,3717,0,79,0,18
"02/10/2021","Y","Y","Kenai Peninsula Borough",122,"Kenai Peninsula Borough",4,1,3710,7,3724,0,79,0,18
"02/11/2021","Y","Y","Kenai Peninsula Borough",122,"Kenai Peninsula Borough",4,9,3719,1,3725,0,79,0,18
"02/12/2021","Y","Y","Kenai Peninsula Borough",122,"Kenai Peninsula Borough",4,3,3722,0,3725,0,79,0,18
"02/13/2021","Y","Y","Kenai Peninsula Borough",122,"Kenai Peninsula Borough",4,1,3723,1,3726,0,79,0,18
"02/14/2021","Y","Y","Kenai Peninsula Borough",122,"Kenai Peninsula Borough",4,0,3723,2,3728,0,79,0,18
"02/15/2021","Y","Y","Kenai Peninsula Borough",122,"Kenai Peninsula Borough",4,1,3724,7,3735,0,79,0,18
"02/16/2021","Y","Y","Kenai Peninsula Borough",122,"Kenai Peninsula Borough",4,1,3725,3,3738,0,79,0,18
"02/17/2021","Y","Y","Kenai Peninsula Borough",122,"Kenai Peninsula Borough",4,8,3733,2,3740,0,79,0,18
"02/18/2021","Y","Y","Kenai Peninsula Borough",122,"Kenai Peninsula Borough",4,3,3736,4,3744,0,79,0,18
"02/19/2021","Y","Y","Kenai Peninsula Borough",122,"Kenai Peninsula Borough",4,4,3740,2,3746,0,79,0,18
"02/20/2021","Y","Y","Kenai Peninsula Borough",122,"Kenai Peninsula Borough",4,1,3741,5,3751,0,79,0,18
"02/21/2021","Y","Y","Kenai Peninsula Borough",122,"Kenai Peninsula Borough",4,2,3743,2,3753,0,79,0,18
"02/22/2021","Y","Y","Kenai Peninsula Borough",122,"Kenai Peninsula Borough",4,5,3748,5,3758,0,79,0,18
"02/23/2021","Y","Y","Kenai Peninsula Borough",122,"Kenai Peninsula Borough",4,3,3751,7,3765,0,79,0,18
"02/24/2021","Y","Y","Kenai Peninsula Borough",122,"Kenai Peninsula Borough",4,1,3752,5,3770,1,80,0,18
"02/25/2021","Y","Y","Kenai Peninsula Borough",122,"Kenai Peninsula Borough",4,3,3755,3,3773,1,81,0,18
"02/26/2021","Y","Y","Kenai Peninsula Borough",122,"Kenai Peninsula Borough",4,3,3758,0,3773,0,81,0,18
"02/27/2021","Y","Y","Kenai Peninsula Borough",122,"Kenai Peninsula Borough",4,4,3762,3,3776,0,81,0,18
"02/28/2021","Y","Y","Kenai Peninsula Borough",122,"Kenai Peninsula Borough",4,3,3765,1,3777,0,81,0,18
"03/01/2021","Y","Y","Kenai Peninsula Borough",122,"Kenai Peninsula Borough",4,3,3768,4,3781,0,81,0,18
"03/02/2021","Y","Y","Kenai Peninsula Borough",122,"Kenai Peninsula Borough",4,7,3775,9,3790,0,81,0,18
"03/03/2021","Y","Y","Kenai Peninsula Borough",122,"Kenai Peninsula Borough",4,5,3780,3,3793,0,81,0,18
"03/04/2021","Y","Y","Kenai Peninsula Borough",122,"Kenai Peninsula Borough",4,7,3787,5,3798,0,81,0,18
"03/05/2021","Y","Y","Kenai Peninsula Borough",122,"Kenai Peninsula Borough",4,5,3792,5,3803,1,82,0,18
"03/06/2021","Y","Y","Kenai Peninsula Borough",122,"Kenai Peninsula Borough",4,2,3794,1,3804,0,82,0,18
"03/07/2021","Y","Y","Kenai Peninsula Borough",122,"Kenai Peninsula Borough",4,1,3795,2,3806,1,83,0,18
"03/08/2021","Y","Y","Kenai Peninsula Borough",122,"Kenai Peninsula Borough",4,3,3798,0,3806,0,83,0,18
"03/09/2021","Y","Y","Kenai Peninsula Borough",122,"Kenai Peninsula Borough",4,2,3800,3,3809,0,83,0,18
"03/10/2021","Y","Y","Kenai Peninsula Borough",122,"Kenai Peninsula Borough",4,3,3803,5,3814,0,83,0,18
"03/11/2021","Y","Y","Kenai Peninsula Borough",122,"Kenai Peninsula Borough",4,4,3807,8,3822,0,83,0,18
"03/12/2021","Y","Y","Kenai Peninsula Borough",122,"Kenai Peninsula Borough",4,10,3817,5,3827,0,83,0,18
"03/13/2021","Y","Y","Kenai Peninsula Borough",122,"Kenai Peninsula Borough",4,4,3821,2,3829,0,83,0,18
"03/14/2021","Y","Y","Kenai Peninsula Borough",122,"Kenai Peninsula Borough",4,4,3825,3,3832,0,83,0,18
"03/15/2021","Y","Y","Kenai Peninsula Borough",122,"Kenai Peninsula Borough",4,4,3829,9,3841,1,84,0,18
"03/16/2021","Y","Y","Kenai Peninsula Borough",122,"Kenai Peninsula Borough",4,4,3833,1,3842,0,84,0,18
"03/17/2021","Y","Y","Kenai Peninsula Borough",122,"Kenai Peninsula Borough",4,3,3836,2,3844,0,84,0,18
"03/18/2021","Y","Y","Kenai Peninsula Borough",122,"Kenai Peninsula Borough",4,1,3837,2,3846,0,84,0,18
"03/19/2021","Y","Y","Kenai Peninsula Borough",122,"Kenai Peninsula Borough",4,3,3840,3,3849,0,84,0,18
"03/20/2021","Y","Y","Kenai Peninsula Borough",122,"Kenai Peninsula Borough",4,3,3843,0,3849,0,84,0,18
"03/21/2021","Y","Y","Kenai Peninsula Borough",122,"Kenai Peninsula Borough",4,0,3843,1,3850,0,84,0,18
"03/22/2021","Y","Y","Kenai Peninsula Borough",122,"Kenai Peninsula Borough",4,3,3846,8,3858,0,84,0,18
"03/23/2021","Y","Y","Kenai Peninsula Borough",122,"Kenai Peninsula Borough",4,4,3850,9,3867,0,84,0,18
"03/24/2021","Y","Y","Kenai Peninsula Borough",122,"Kenai Peninsula Borough",4,7,3857,4,3871,0,84,0,18
"03/25/2021","Y","Y","Kenai Peninsula Borough",122,"Kenai Peninsula Borough",4,2,3859,8,3879,0,84,0,18
"03/26/2021","Y","Y","Kenai Peninsula Borough",122,"Kenai Peninsula Borough",4,12,3871,7,3886,0,84,0,18
"03/27/2021","Y","Y","Kenai Peninsula Borough",122,"Kenai Peninsula Borough",4,5,3876,3,3889,0,84,0,18
"03/28/2021","Y","Y","Kenai Peninsula Borough",122,"Kenai Peninsula Borough",4,3,3879,0,3889,0,84,0,18
"03/29/2021","Y","Y","Kenai Peninsula Borough",122,"Kenai Peninsula Borough",4,1,3880,15,3904,0,84,0,18
"03/30/2021","Y","Y","Kenai Peninsula Borough",122,"Kenai Peninsula Borough",4,7,3887,6,3910,0,84,0,18
"03/31/2021","Y","Y","Kenai Peninsula Borough",122,"Kenai Peninsula Borough",4,11,3898,10,3920,0,84,0,18
"04/01/2021","Y","Y","Kenai Peninsula Borough",122,"Kenai Peninsula Borough",4,12,3910,15,3935,0,84,0,18
"04/02/2021","Y","Y","Kenai Peninsula Borough",122,"Kenai Peninsula Borough",4,11,3921,11,3946,0,84,0,18
"04/03/2021","Y","Y","Kenai Peninsula Borough",122,"Kenai Peninsula Borough",4,13,3934,5,3951,0,84,0,18
"04/04/2021","Y","Y","Kenai Peninsula Borough",122,"Kenai Peninsula Borough",4,3,3937,7,3958,0,84,0,18
"04/05/2021","Y","Y","Kenai Peninsula Borough",122,"Kenai Peninsula Borough",4,5,3942,22,3980,0,84,0,18
"04/06/2021","Y","Y","Kenai Peninsula Borough",122,"Kenai Peninsula Borough",4,16,3958,5,3985,1,85,0,18
"04/07/2021","Y","Y","Kenai Peninsula Borough",122,"Kenai Peninsula Borough",4,14,3972,10,3995,1,86,0,18
"04/08/2021","Y","Y","Kenai Peninsula Borough",122,"Kenai Peninsula Borough",4,13,3985,13,4008,0,86,0,18
"04/09/2021","Y","Y","Kenai Peninsula Borough",122,"Kenai Peninsula Borough",4,15,4000,14,4022,1,87,0,18
"04/10/2021","Y","Y","Kenai Peninsula Borough",122,"Kenai Peninsula Borough",4,2,4002,6,4028,0,87,0,18
"04/11/2021","Y","Y","Kenai Peninsula Borough",122,"Kenai Peninsula Borough",4,2,4004,2,4030,2,89,0,18
"04/12/2021","Y","Y","Kenai Peninsula Borough",122,"Kenai Peninsula Borough",4,6,4010,22,4052,1,90,0,18
"04/13/2021","Y","Y","Kenai Peninsula Borough",122,"Kenai Peninsula Borough",4,13,4023,18,4070,1,91,0,18
"04/14/2021","Y","Y","Kenai Peninsula Borough",122,"Kenai Peninsula Borough",4,14,4037,15,4085,2,93,0,18
"04/15/2021","Y","Y","Kenai Peninsula Borough",122,"Kenai Peninsula Borough",4,21,4058,12,4097,0,93,0,18
"04/16/2021","Y","Y","Kenai Peninsula Borough",122,"Kenai Peninsula Borough",4,22,4080,14,4111,0,93,0,18
"04/17/2021","Y","Y","Kenai Peninsula Borough",122,"Kenai Peninsula Borough",4,13,4093,9,4120,0,93,0,18
"04/18/2021","Y","Y","Kenai Peninsula Borough",122,"Kenai Peninsula Borough",4,12,4105,3,4123,1,94,0,18
"04/19/2021","Y","Y","Kenai Peninsula Borough",122,"Kenai Peninsula Borough",4,7,4112,14,4137,0,94,0,18
"04/20/2021","Y","Y","Kenai Peninsula Borough",122,"Kenai Peninsula Borough",4,14,4126,13,4150,1,95,0,18
"04/21/2021","Y","Y","Kenai Peninsula Borough",122,"Kenai Peninsula Borough",4,13,4139,9,4159,0,95,0,18
"04/22/2021","Y","Y","Kenai Peninsula Borough",122,"Kenai Peninsula Borough",4,8,4147,7,4166,2,97,0,18
"04/23/2021","Y","Y","Kenai Peninsula Borough",122,"Kenai Peninsula Borough",4,8,4155,6,4172,0,97,0,18
"04/24/2021","Y","Y","Kenai Peninsula Borough",122,"Kenai Peninsula Borough",4,3,4158,5,4177,1,98,0,18
"04/25/2021","Y","Y","Kenai Peninsula Borough",122,"Kenai Peninsula Borough",4,2,4160,3,4180,0,98,0,18
"04/26/2021","Y","Y","Kenai Peninsula Borough",122,"Kenai Peninsula Borough",4,3,4163,11,4191,0,98,0,18
"04/27/2021","Y","Y","Kenai Peninsula Borough",122,"Kenai Peninsula Borough",4,16,4179,4,4195,0,98,0,18
"04/28/2021","Y","Y","Kenai Peninsula Borough",122,"Kenai Peninsula Borough",4,9,4188,6,4201,0,98,0,18
"04/29/2021","Y","Y","Kenai Peninsula Borough",122,"Kenai Peninsula Borough",4,4,4192,8,4209,0,98,0,18
"04/30/2021","Y","Y","Kenai Peninsula Borough",122,"Kenai Peninsula Borough",4,6,4198,3,4212,0,98,0,18
"05/01/2021","Y","Y","Kenai Peninsula Borough",122,"Kenai Peninsula Borough",4,3,4201,3,4215,0,98,0,18
"05/02/2021","Y","Y","Kenai Peninsula Borough",122,"Kenai Peninsula Borough",4,2,4203,2,4217,0,98,0,18
"05/03/2021","Y","Y","Kenai Peninsula Borough",122,"Kenai Peninsula Borough",4,5,4208,4,4221,0,98,0,18
"05/04/2021","Y","Y","Kenai Peninsula Borough",122,"Kenai Peninsula Borough",4,6,4214,9,4230,0,98,0,18
"05/05/2021","Y","Y","Kenai Peninsula Borough",122,"Kenai Peninsula Borough",4,4,4218,6,4236,0,98,0,18
"05/06/2021","Y","Y","Kenai Peninsula Borough",122,"Kenai Peninsula Borough",4,7,4225,2,4238,0,98,0,18
"05/07/2021","Y","Y","Kenai Peninsula Borough",122,"Kenai Peninsula Borough",4,3,4228,3,4241,0,98,0,18
"05/08/2021","Y","Y","Kenai Peninsula Borough",122,"Kenai Peninsula Borough",4,2,4230,2,4243,0,98,0,18
"05/09/2021","Y","Y","Kenai Peninsula Borough",122,"Kenai Peninsula Borough",4,2,4232,2,4245,0,98,0,18
"05/10/2021","Y","Y","Kenai Peninsula Borough",122,"Kenai Peninsula Borough",4,6,4238,9,4254,0,98,0,18
"05/11/2021","Y","Y","Kenai Peninsula Borough",122,"Kenai Peninsula Borough",4,8,4246,9,4263,0,98,0,18
"05/12/2021","Y","Y","Kenai Peninsula Borough",122,"Kenai Peninsula Borough",4,8,4254,4,4267,0,98,0,18
"05/13/2021","Y","Y","Kenai Peninsula Borough",122,"Kenai Peninsula Borough",4,8,4262,3,4270,0,98,0,18
"05/14/2021","Y","Y","Kenai Peninsula Borough",122,"Kenai Peninsula Borough",4,1,4263,3,4273,0,98,0,18
"05/15/2021","Y","Y","Kenai Peninsula Borough",122,"Kenai Peninsula Borough",4,0,4263,2,4275,0,98,1,19
"05/16/2021","Y","Y","Kenai Peninsula Borough",122,"Kenai Peninsula Borough",4,4,4267,0,4275,0,98,0,19
"05/17/2021","Y","Y","Kenai Peninsula Borough",122,"Kenai Peninsula Borough",4,3,4270,5,4280,0,98,0,19
"05/18/2021","Y","Y","Kenai Peninsula Borough",122,"Kenai Peninsula Borough",4,3,4273,1,4281,1,99,0,19
"05/19/2021","Y","Y","Kenai Peninsula Borough",122,"Kenai Peninsula Borough",4,6,4279,3,4284,0,99,0,19
"05/20/2021","Y","Y","Kenai Peninsula Borough",122,"Kenai Peninsula Borough",4,1,4280,4,4288,0,99,0,19
"05/21/2021","Y","Y","Kenai Peninsula Borough",122,"Kenai Peninsula Borough",4,4,4284,3,4291,0,99,0,19
"05/22/2021","Y","Y","Kenai Peninsula Borough",122,"Kenai Peninsula Borough",4,3,4287,2,4293,0,99,0,19
"05/24/2021","Y","Y","Kenai Peninsula Borough",122,"Kenai Peninsula Borough",4,3,4290,3,4296,0,99,0,19
"05/25/2021","Y","Y","Kenai Peninsula Borough",122,"Kenai Peninsula Borough",4,1,4291,2,4298,0,99,0,19
"05/26/2021","Y","Y","Kenai Peninsula Borough",122,"Kenai Peninsula Borough",4,3,4294,1,4299,0,99,1,20
"05/27/2021","Y","Y","Kenai Peninsula Borough",122,"Kenai Peninsula Borough",4,2,4296,4,4303,0,99,0,20
"05/28/2021","Y","Y","Kenai Peninsula Borough",122,"Kenai Peninsula Borough",4,2,4298,2,4305,0,99,0,20
"05/29/2021","Y","Y","Kenai Peninsula Borough",122,"Kenai Peninsula Borough",4,0,4298,1,4306,0,99,0,20
"05/30/2021","Y","Y","Kenai Peninsula Borough",122,"Kenai Peninsula Borough",4,1,4299,2,4308,1,100,0,20
"05/31/2021","Y","Y","Kenai Peninsula Borough",122,"Kenai Peninsula Borough",4,3,4302,4,4312,0,100,0,20
"06/01/2021","Y","Y","Kenai Peninsula Borough",122,"Kenai Peninsula Borough",4,3,4305,0,4312,0,100,0,20
"06/02/2021","Y","Y","Kenai Peninsula Borough",122,"Kenai Peninsula Borough",4,3,4308,6,4318,0,100,0,20
"06/03/2021","Y","Y","Kenai Peninsula Borough",122,"Kenai Peninsula Borough",4,3,4311,2,4320,0,100,0,20
"06/04/2021","Y","Y","Kenai Peninsula Borough",122,"Kenai Peninsula Borough",4,3,4314,0,4320,0,100,0,20
"06/05/2021","Y","Y","Kenai Peninsula Borough",122,"Kenai Peninsula Borough",4,1,4315,0,4320,0,100,0,20
"06/07/2021","Y","Y","Kenai Peninsula Borough",122,"Kenai Peninsula Borough",4,2,4317,2,4322,0,100,0,20
"06/08/2021","Y","Y","Kenai Peninsula Borough",122,"Kenai Peninsula Borough",4,0,4317,1,4323,0,100,0,20
"06/09/2021","Y","Y","Kenai Peninsula Borough",122,"Kenai Peninsula Borough",4,2,4319,4,4327,0,100,0,20
"06/10/2021","Y","Y","Kenai Peninsula Borough",122,"Kenai Peninsula Borough",4,4,4323,1,4328,0,100,0,20
"06/11/2021","Y","Y","Kenai Peninsula Borough",122,"Kenai Peninsula Borough",4,0,4323,2,4330,0,100,0,20
"06/12/2021","Y","Y","Kenai Peninsula Borough",122,"Kenai Peninsula Borough",4,0,4323,1,4331,0,100,0,20
"06/13/2021","Y","Y","Kenai Peninsula Borough",122,"Kenai Peninsula Borough",4,1,4324,0,4331,0,100,0,20
"06/14/2021","Y","Y","Kenai Peninsula Borough",122,"Kenai Peninsula Borough",4,0,4324,1,4332,0,100,0,20
"06/15/2021","Y","Y","Kenai Peninsula Borough",122,"Kenai Peninsula Borough",4,1,4325,0,4332,0,100,0,20
"06/16/2021","Y","Y","Kenai Peninsula Borough",122,"Kenai Peninsula Borough",4,2,4327,1,4333,0,100,0,20
"06/17/2021","Y","Y","Kenai Peninsula Borough",122,"Kenai Peninsula Borough",4,1,4328,1,4334,0,100,0,20
"06/18/2021","Y","Y","Kenai Peninsula Borough",122,"Kenai Peninsula Borough",4,1,4329,1,4335,0,100,0,20
"06/19/2021","Y","Y","Kenai Peninsula Borough",122,"Kenai Peninsula Borough",4,1,4330,1,4336,0,100,0,20
"06/20/2021","Y","Y","Kenai Peninsula Borough",122,"Kenai Peninsula Borough",4,1,4331,0,4336,0,100,0,20
"06/21/2021","Y","Y","Kenai Peninsula Borough",122,"Kenai Peninsula Borough",4,2,4333,4,4340,0,100,0,20
"06/22/2021","Y","Y","Kenai Peninsula Borough",122,"Kenai Peninsula Borough",4,3,4336,0,4340,0,100,0,20
"06/25/2021","Y","Y","Kenai Peninsula Borough",122,"Kenai Peninsula Borough",4,0,4336,1,4341,0,100,0,20
"06/26/2021","Y","Y","Kenai Peninsula Borough",122,"Kenai Peninsula Borough",4,2,4338,2,4343,0,100,0,20
"06/27/2021","Y","Y","Kenai Peninsula Borough",122,"Kenai Peninsula Borough",4,0,4338,1,4344,0,100,0,20
"06/28/2021","Y","Y","Kenai Peninsula Borough",122,"Kenai Peninsula Borough",4,1,4339,2,4346,1,101,0,20
"06/29/2021","Y","Y","Kenai Peninsula Borough",122,"Kenai Peninsula Borough",4,0,4339,2,4348,1,102,0,20
"06/30/2021","Y","Y","Kenai Peninsula Borough",122,"Kenai Peninsula Borough",4,4,4343,2,4350,0,102,0,20
"07/01/2021","Y","Y","Kenai Peninsula Borough",122,"Kenai Peninsula Borough",4,3,4346,1,4351,0,102,0,20
"07/02/2021","Y","Y","Kenai Peninsula Borough",122,"Kenai Peninsula Borough",4,1,4347,4,4355,0,102,0,20
"07/03/2021","Y","Y","Kenai Peninsula Borough",122,"Kenai Peninsula Borough",4,2,4349,4,4359,0,102,0,20
"07/04/2021","Y","Y","Kenai Peninsula Borough",122,"Kenai Peninsula Borough",4,4,4353,3,4362,0,102,0,20
"07/05/2021","Y","Y","Kenai Peninsula Borough",122,"Kenai Peninsula Borough",4,9,4362,8,4370,0,102,0,20
"07/06/2021","Y","Y","Kenai Peninsula Borough",122,"Kenai Peninsula Borough",4,1,4363,9,4379,0,102,0,20
"07/07/2021","Y","Y","Kenai Peninsula Borough",122,"Kenai Peninsula Borough",4,5,4368,8,4387,1,103,0,20
"07/08/2021","Y","Y","Kenai Peninsula Borough",122,"Kenai Peninsula Borough",4,1,4369,7,4394,0,103,0,20
"07/09/2021","Y","Y","Kenai Peninsula Borough",122,"Kenai Peninsula Borough",4,9,4378,6,4400,2,105,0,20
"07/10/2021","Y","Y","Kenai Peninsula Borough",122,"Kenai Peninsula Borough",4,15,4393,6,4406,1,106,0,20
"07/11/2021","Y","Y","Kenai Peninsula Borough",122,"Kenai Peninsula Borough",4,3,4396,0,4406,0,106,0,20
"07/12/2021","Y","Y","Kenai Peninsula Borough",122,"Kenai Peninsula Borough",4,7,4403,15,4421,0,106,0,20
"07/13/2021","Y","Y","Kenai Peninsula Borough",122,"Kenai Peninsula Borough",4,14,4417,17,4438,1,107,0,20
"07/14/2021","Y","Y","Kenai Peninsula Borough",122,"Kenai Peninsula Borough",4,18,4435,25,4463,0,107,0,20
"07/15/2021","Y","Y","Kenai Peninsula Borough",122,"Kenai Peninsula Borough",4,20,4455,27,4490,1,108,0,20
"07/16/2021","Y","Y","Kenai Peninsula Borough",122,"Kenai Peninsula Borough",4,22,4477,29,4519,0,108,0,20
"07/17/2021","Y","Y","Kenai Peninsula Borough",122,"Kenai Peninsula Borough",4,18,4495,13,4532,0,108,0,20
"07/18/2021","Y","Y","Kenai Peninsula Borough",122,"Kenai Peninsula Borough",4,13,4508,18,4550,0,108,0,20
"07/19/2021","Y","Y","Kenai Peninsula Borough",122,"Kenai Peninsula Borough",4,28,4536,54,4604,1,109,0,20
"07/20/2021","Y","Y","Kenai Peninsula Borough",122,"Kenai Peninsula Borough",4,39,4575,24,4628,0,109,0,20
"07/21/2021","Y","Y","Kenai Peninsula Borough",122,"Kenai Peninsula Borough",4,17,4592,50,4678,1,110,0,20
"07/22/2021","Y","Y","Kenai Peninsula Borough",122,"Kenai Peninsula Borough",4,23,4615,46,4724,2,112,0,20
"07/23/2021","Y","Y","Kenai Peninsula Borough",122,"Kenai Peninsula Borough",4,27,4642,30,4754,5,117,0,20
"07/24/2021","Y","Y","Kenai Peninsula Borough",122,"Kenai Peninsula Borough",4,32,4674,19,4773,1,118,0,20
"07/25/2021","Y","Y","Kenai Peninsula Borough",122,"Kenai Peninsula Borough",4,13,4687,19,4792,1,119,0,20
"07/26/2021","Y","Y","Kenai Peninsula Borough",122,"Kenai Peninsula Borough",4,13,4700,45,4837,1,120,2,22
"07/27/2021","Y","Y","Kenai Peninsula Borough",122,"Kenai Peninsula Borough",4,20,4720,44,4881,2,122,0,22
"07/28/2021","Y","Y","Kenai Peninsula Borough",122,"Kenai Peninsula Borough",4,48,4768,58,4939,3,125,1,23
"07/29/2021","Y","Y","Kenai Peninsula Borough",122,"Kenai Peninsula Borough",4,34,4802,49,4988,0,125,0,23
"07/30/2021","Y","Y","Kenai Peninsula Borough",122,"Kenai Peninsula Borough",4,19,4821,42,5030,2,127,0,23
"07/31/2021","Y","Y","Kenai Peninsula Borough",122,"Kenai Peninsula Borough",4,44,4865,14,5044,0,127,0,23
"08/01/2021","Y","Y","Kenai Peninsula Borough",122,"Kenai Peninsula Borough",4,30,4895,15,5059,1,128,0,23
"08/02/2021","Y","Y","Kenai Peninsula Borough",122,"Kenai Peninsula Borough",4,38,4933,55,5114,3,131,0,23
"08/03/2021","Y","Y","Kenai Peninsula Borough",122,"Kenai Peninsula Borough",4,43,4976,63,5177,1,132,2,25
"08/04/2021","Y","Y","Kenai Peninsula Borough",122,"Kenai Peninsula Borough",4,134,5110,33,5210,1,133,2,27
"08/05/2021","Y","Y","Kenai Peninsula Borough",122,"Kenai Peninsula Borough",4,33,5143,47,5257,3,136,1,28
"08/06/2021","Y","Y","Kenai Peninsula Borough",122,"Kenai Peninsula Borough",4,42,5185,33,5290,3,139,0,28
"08/07/2021","Y","Y","Kenai Peninsula Borough",122,"Kenai Peninsula Borough",4,40,5225,26,5316,2,141,1,29
"08/08/2021","Y","Y","Kenai Peninsula Borough",122,"Kenai Peninsula Borough",4,5,5230,33,5349,2,143,0,29
"08/09/2021","Y","Y","Kenai Peninsula Borough",122,"Kenai Peninsula Borough",4,35,5265,86,5435,1,144,0,29
"08/10/2021","Y","Y","Kenai Peninsula Borough",122,"Kenai Peninsula Borough",4,29,5294,68,5503,1,145,0,29
"08/11/2021","Y","Y","Kenai Peninsula Borough",122,"Kenai Peninsula Borough",4,36,5330,70,5573,1,146,0,29
"08/12/2021","Y","Y","Kenai Peninsula Borough",122,"Kenai Peninsula Borough",4,64,5394,70,5643,1,147,0,29
"08/13/2021","Y","Y","Kenai Peninsula Borough",122,"Kenai Peninsula Borough",4,58,5452,59,5702,2,149,2,31
"08/14/2021","Y","Y","Kenai Peninsula Borough",122,"Kenai Peninsula Borough",4,58,5510,15,5717,2,151,0,31
"08/15/2021","Y","Y","Kenai Peninsula Borough",122,"Kenai Peninsula Borough",4,36,5546,40,5757,1,152,0,31
"08/16/2021","Y","Y","Kenai Peninsula Borough",122,"Kenai Peninsula Borough",4,74,5620,119,5876,2,154,0,31
"08/17/2021","Y","Y","Kenai Peninsula Borough",122,"Kenai Peninsula Borough",4,84,5704,69,5945,2,156,0,31
"08/18/2021","Y","Y","Kenai Peninsula Borough",122,"Kenai Peninsula Borough",4,76,5780,39,5984,1,157,0,31
"08/19/2021","Y","Y","Kenai Peninsula Borough",122,"Kenai Peninsula Borough",4,36,5816,65,6049,4,161,1,32
"08/20/2021","Y","Y","Kenai Peninsula Borough",122,"Kenai Peninsula Borough",4,79,5895,74,6123,2,163,0,32
"08/21/2021","Y","Y","Kenai Peninsula Borough",122,"Kenai Peninsula Borough",4,36,5931,31,6154,0,163,0,32
"08/22/2021","Y","Y","Kenai Peninsula Borough",122,"Kenai Peninsula Borough",4,11,5942,26,6180,0,163,0,32
"08/23/2021","Y","Y","Kenai Peninsula Borough",122,"Kenai Peninsula Borough",4,97,6039,95,6275,3,166,0,32
"08/24/2021","Y","Y","Kenai Peninsula Borough",122,"Kenai Peninsula Borough",4,57,6096,81,6356,1,167,1,33
"08/25/2021","Y","Y","Kenai Peninsula Borough",122,"Kenai Peninsula Borough",4,89,6185,74,6430,3,170,0,33
"08/26/2021","Y","Y","Kenai Peninsula Borough",122,"Kenai Peninsula Borough",4,54,6239,78,6508,3,173,0,33
"08/27/2021","Y","Y","Kenai Peninsula Borough",122,"Kenai Peninsula Borough",4,66,6305,69,6577,2,175,0,33
"08/28/2021","Y","Y","Kenai Peninsula Borough",122,"Kenai Peninsula Borough",4,25,6330,38,6615,0,175,1,34
"08/29/2021","Y","Y","Kenai Peninsula Borough",122,"Kenai Peninsula Borough",4,22,6352,19,6634,1,176,0,34
"08/30/2021","Y","Y","Kenai Peninsula Borough",122,"Kenai Peninsula Borough",4,73,6425,106,6740,1,177,0,34
"08/31/2021","Y","Y","Kenai Peninsula Borough",122,"Kenai Peninsula Borough",4,95,6520,73,6813,1,178,0,34
"09/01/2021","Y","Y","Kenai Peninsula Borough",122,"Kenai Peninsula Borough",4,50,6570,92,6905,0,178,0,34
"09/02/2021","Y","Y","Kenai Peninsula Borough",122,"Kenai Peninsula Borough",4,80,6650,103,7008,0,178,0,34
"09/03/2021","Y","Y","Kenai Peninsula Borough",122,"Kenai Peninsula Borough",4,84,6734,51,7059,2,180,1,35
"09/04/2021","Y","Y","Kenai Peninsula Borough",122,"Kenai Peninsula Borough",4,70,6804,26,7085,1,181,1,36
"09/05/2021","Y","Y","Kenai Peninsula Borough",122,"Kenai Peninsula Borough",4,41,6845,22,7107,4,185,2,38
"09/06/2021","Y","Y","Kenai Peninsula Borough",122,"Kenai Peninsula Borough",4,54,6899,30,7137,2,187,0,38
"09/07/2021","Y","Y","Kenai Peninsula Borough",122,"Kenai Peninsula Borough",4,46,6945,118,7255,1,188,0,38
"09/08/2021","Y","Y","Kenai Peninsula Borough",122,"Kenai Peninsula Borough",4,47,6992,75,7330,0,188,0,38
"09/09/2021","Y","Y","Kenai Peninsula Borough",122,"Kenai Peninsula Borough",4,54,7046,69,7399,2,190,0,38
"09/10/2021","Y","Y","Kenai Peninsula Borough",122,"Kenai Peninsula Borough",4,45,7091,88,7487,2,192,2,40
"09/11/2021","Y","Y","Kenai Peninsula Borough",122,"Kenai Peninsula Borough",4,17,7108,29,7516,1,193,0,40
"09/12/2021","Y","Y","Kenai Peninsula Borough",122,"Kenai Peninsula Borough",4,9,7117,24,7540,0,193,0,40
"09/13/2021","Y","Y","Kenai Peninsula Borough",122,"Kenai Peninsula Borough",4,33,7150,110,7650,0,193,0,40
"09/14/2021","Y","Y","Kenai Peninsula Borough",122,"Kenai Peninsula Borough",4,79,7229,91,7741,2,195,0,40
"09/15/2021","Y","Y","Kenai Peninsula Borough",122,"Kenai Peninsula Borough",4,71,7300,77,7818,0,195,1,41
"09/16/2021","Y","Y","Kenai Peninsula Borough",122,"Kenai Peninsula Borough",4,93,7393,59,7877,2,197,1,42
"09/17/2021","Y","Y","Kenai Peninsula Borough",122,"Kenai Peninsula Borough",4,43,7436,74,7951,2,199,0,42
"09/18/2021","Y","Y","Kenai Peninsula Borough",122,"Kenai Peninsula Borough",4,29,7465,19,7970,2,201,1,43
"09/19/2021","Y","Y","Kenai Peninsula Borough",122,"Kenai Peninsula Borough",4,21,7486,17,7987,4,205,1,44
"09/20/2021","Y","Y","Kenai Peninsula Borough",122,"Kenai Peninsula Borough",4,54,7540,91,8078,2,207,0,44
"09/21/2021","Y","Y","Kenai Peninsula Borough",122,"Kenai Peninsula Borough",4,50,7590,82,8160,6,213,1,45
"09/22/2021","Y","Y","Kenai Peninsula Borough",122,"Kenai Peninsula Borough",4,142,7732,52,8212,0,213,0,45
"09/23/2021","Y","Y","Kenai Peninsula Borough",122,"Kenai Peninsula Borough",4,192,7924,58,8270,2,215,0,45
"09/24/2021","Y","Y","Kenai Peninsula Borough",122,"Kenai Peninsula Borough",4,99,8023,54,8324,3,218,0,45
"09/25/2021","Y","Y","Kenai Peninsula Borough",122,"Kenai Peninsula Borough",4,76,8099,18,8342,3,221,0,45
"09/26/2021","Y","Y","Kenai Peninsula Borough",122,"Kenai Peninsula Borough",4,88,8187,22,8364,1,222,1,46
"09/27/2021","Y","Y","Kenai Peninsula Borough",122,"Kenai Peninsula Borough",4,43,8230,112,8476,0,222,1,47
"09/28/2021","Y","Y","Kenai Peninsula Borough",122,"Kenai Peninsula Borough",4,70,8300,67,8543,1,223,1,48
"09/29/2021","Y","Y","Kenai Peninsula Borough",122,"Kenai Peninsula Borough",4,126,8426,58,8601,0,223,1,49
"09/30/2021","Y","Y","Kenai Peninsula Borough",122,"Kenai Peninsula Borough",4,53,8479,65,8666,3,226,0,49
"10/01/2021","Y","Y","Kenai Peninsula Borough",122,"Kenai Peninsula Borough",4,81,8560,67,8733,2,228,3,52
"10/02/2021","Y","Y","Kenai Peninsula Borough",122,"Kenai Peninsula Borough",4,74,8634,38,8771,1,229,0,52
"10/03/2021","Y","Y","Kenai Peninsula Borough",122,"Kenai Peninsula Borough",4,30,8664,40,8811,0,229,0,52
"10/04/2021","Y","Y","Kenai Peninsula Borough",122,"Kenai Peninsula Borough",4,53,8717,141,8952,1,230,0,52
"10/05/2021","Y","Y","Kenai Peninsula Borough",122,"Kenai Peninsula Borough",4,107,8824,87,9039,2,232,2,54
"10/06/2021","Y","Y","Kenai Peninsula Borough",122,"Kenai Peninsula Borough",4,101,8925,198,9237,1,233,0,54
"10/07/2021","Y","Y","Kenai Peninsula Borough",122,"Kenai Peninsula Borough",4,57,8982,58,9295,1,234,0,54
"10/08/2021","Y","Y","Kenai Peninsula Borough",122,"Kenai Peninsula Borough",4,162,9144,60,9355,0,234,1,55
"10/09/2021","Y","Y","Kenai Peninsula Borough",122,"Kenai Peninsula Borough",4,93,9237,57,9412,4,238,0,55
"10/10/2021","Y","Y","Kenai Peninsula Borough",122,"Kenai Peninsula Borough",4,87,9324,25,9437,4,242,1,56
"10/11/2021","Y","Y","Kenai Peninsula Borough",122,"Kenai Peninsula Borough",4,34,9358,133,9570,2,244,0,56
"10/12/2021","Y","Y","Kenai Peninsula Borough",122,"Kenai Peninsula Borough",4,90,9448,86,9656,1,245,1,57
"10/13/2021","Y","Y","Kenai Peninsula Borough",122,"Kenai Peninsula Borough",4,79,9527,66,9722,1,246,0,57
"10/14/2021","Y","Y","Kenai Peninsula Borough",122,"Kenai Peninsula Borough",4,61,9588,57,9779,0,246,0,57
"10/15/2021","Y","Y","Kenai Peninsula Borough",122,"Kenai Peninsula Borough",4,60,9648,65,9844,2,248,1,58
"10/16/2021","Y","Y","Kenai Peninsula Borough",122,"Kenai Peninsula Borough",4,77,9725,37,9881,1,249,2,60
"10/17/2021","Y","Y","Kenai Peninsula Borough",122,"Kenai Peninsula Borough",4,69,9794,40,9921,2,251,1,61
"10/18/2021","Y","Y","Kenai Peninsula Borough",122,"Kenai Peninsula Borough",4,42,9836,116,10037,0,251,0,61
"10/19/2021","Y","Y","Kenai Peninsula Borough",122,"Kenai Peninsula Borough",4,95,9931,93,10130,1,252,0,61
"10/20/2021","Y","Y","Kenai Peninsula Borough",122,"Kenai Peninsula Borough",4,82,10013,74,10204,1,253,1,62
"10/21/2021","Y","Y","Kenai Peninsula Borough",122,"Kenai Peninsula Borough",4,79,10092,68,10272,4,257,0,62
"10/22/2021","Y","Y","Kenai Peninsula Borough",122,"Kenai Peninsula Borough",4,43,10135,71,10343,4,261,0,62
"10/23/2021","Y","Y","Kenai Peninsula Borough",122,"Kenai Peninsula Borough",4,101,10236,41,10384,5,266,0,62
"10/24/2021","Y","Y","Kenai Peninsula Borough",122,"Kenai Peninsula Borough",4,36,10272,29,10413,3,269,1,63
"10/25/2021","Y","Y","Kenai Peninsula Borough",122,"Kenai Peninsula Borough",4,61,10333,95,10508,1,270,1,64
"10/26/2021","Y","Y","Kenai Peninsula Borough",122,"Kenai Peninsula Borough",4,36,10369,72,10580,1,271,1,65
"10/27/2021","Y","Y","Kenai Peninsula Borough",122,"Kenai Peninsula Borough",4,94,10463,40,10620,2,273,1,66
"10/28/2021","Y","Y","Kenai Peninsula Borough",122,"Kenai Peninsula Borough",4,83,10546,61,10681,3,276,2,68
"10/29/2021","Y","Y","Kenai Peninsula Borough",122,"Kenai Peninsula Borough",4,55,10601,46,10727,2,278,0,68
"10/30/2021","Y","Y","Kenai Peninsula Borough",122,"Kenai Peninsula Borough",4,42,10643,26,10753,2,280,2,70
"10/31/2021","Y","Y","Kenai Peninsula Borough",122,"Kenai Peninsula Borough",4,48,10691,30,10783,0,280,1,71
"11/01/2021","Y","Y","Kenai Peninsula Borough",122,"Kenai Peninsula Borough",4,45,10736,66,10849,1,281,1,72
"11/02/2021","Y","Y","Kenai Peninsula Borough",122,"Kenai Peninsula Borough",4,40,10776,50,10899,1,282,0,72
"11/03/2021","Y","Y","Kenai Peninsula Borough",122,"Kenai Peninsula Borough",4,43,10819,37,10936,1,283,1,73
"11/04/2021","Y","Y","Kenai Peninsula Borough",122,"Kenai Peninsula Borough",4,46,10865,34,10970,2,285,2,75
"11/05/2021","Y","Y","Kenai Peninsula Borough",122,"Kenai Peninsula Borough",4,55,10920,33,11003,0,285,0,75
"11/06/2021","Y","Y","Kenai Peninsula Borough",122,"Kenai Peninsula Borough",4,36,10956,8,11011,0,285,0,75
"11/07/2021","Y","Y","Kenai Peninsula Borough",122,"Kenai Peninsula Borough",4,12,10968,8,11019,2,287,1,76
"11/08/2021","Y","Y","Kenai Peninsula Borough",122,"Kenai Peninsula Borough",4,14,10982,42,11061,1,288,0,76
"11/09/2021","Y","Y","Kenai Peninsula Borough",122,"Kenai Peninsula Borough",4,30,11012,27,11088,1,289,0,76
"11/10/2021","Y","Y","Kenai Peninsula Borough",122,"Kenai Peninsula Borough",4,14,11026,25,11113,1,290,0,76
"11/11/2021","Y","Y","Kenai Peninsula Borough",122,"Kenai Peninsula Borough",4,30,11056,22,11135,0,290,0,76
"11/12/2021","Y","Y","Kenai Peninsula Borough",122,"Kenai Peninsula Borough",4,22,11078,33,11168,0,290,0,76
"11/13/2021","Y","Y","Kenai Peninsula Borough",122,"Kenai Peninsula Borough",4,31,11109,18,11186,0,290,0,76
"11/14/2021","Y","Y","Kenai Peninsula Borough",122,"Kenai Peninsula Borough",4,15,11124,3,11189,0,290,0,76
"11/15/2021","Y","Y","Kenai Peninsula Borough",122,"Kenai Peninsula Borough",4,39,11163,36,11225,1,291,0,76
"11/16/2021","Y","Y","Kenai Peninsula Borough",122,"Kenai Peninsula Borough",4,30,11193,34,11259,0,291,0,76
"11/17/2021","Y","Y","Kenai Peninsula Borough",122,"Kenai Peninsula Borough",4,17,11210,18,11277,0,291,0,76
"11/18/2021","Y","Y","Kenai Peninsula Borough",122,"Kenai Peninsula Borough",4,34,11244,19,11296,1,292,0,76
"11/19/2021","Y","Y","Kenai Peninsula Borough",122,"Kenai Peninsula Borough",4,21,11265,18,11314,0,292,0,76
"11/20/2021","Y","Y","Kenai Peninsula Borough",122,"Kenai Peninsula Borough",4,12,11277,6,11320,0,292,0,76
"11/21/2021","Y","Y","Kenai Peninsula Borough",122,"Kenai Peninsula Borough",4,6,11283,4,11324,0,292,0,76
"11/22/2021","Y","Y","Kenai Peninsula Borough",122,"Kenai Peninsula Borough",4,7,11290,25,11349,0,292,1,77
"11/23/2021","Y","Y","Kenai Peninsula Borough",122,"Kenai Peninsula Borough",4,39,11329,10,11359,1,293,2,79
"11/24/2021","Y","Y","Kenai Peninsula Borough",122,"Kenai Peninsula Borough",4,12,11341,23,11382,0,293,1,80
"11/25/2021","Y","Y","Kenai Peninsula Borough",122,"Kenai Peninsula Borough",4,5,11346,3,11385,0,293,0,80
"11/26/2021","Y","Y","Kenai Peninsula Borough",122,"Kenai Peninsula Borough",4,17,11363,4,11389,1,294,0,80
"11/27/2021","Y","Y","Kenai Peninsula Borough",122,"Kenai Peninsula Borough",4,14,11377,5,11394,1,295,0,80
"11/28/2021","Y","Y","Kenai Peninsula Borough",122,"Kenai Peninsula Borough",4,6,11383,6,11400,0,295,0,80
"11/29/2021","Y","Y","Kenai Peninsula Borough",122,"Kenai Peninsula Borough",4,9,11392,31,11431,0,295,0,80
"11/30/2021","Y","Y","Kenai Peninsula Borough",122,"Kenai Peninsula Borough",4,22,11414,15,11446,0,295,0,80
"12/01/2021","Y","Y","Kenai Peninsula Borough",122,"Kenai Peninsula Borough",4,15,11429,20,11466,0,295,0,80
"12/02/2021","Y","Y","Kenai Peninsula Borough",122,"Kenai Peninsula Borough",4,18,11447,14,11480,1,296,0,80
"12/03/2021","Y","Y","Kenai Peninsula Borough",122,"Kenai Peninsula Borough",4,25,11472,16,11496,0,296,0,80
"12/04/2021","Y","Y","Kenai Peninsula Borough",122,"Kenai Peninsula Borough",4,6,11478,7,11503,0,296,2,82
"12/05/2021","Y","Y","Kenai Peninsula Borough",122,"Kenai Peninsula Borough",4,17,11495,6,11509,0,296,0,82
"12/06/2021","Y","Y","Kenai Peninsula Borough",122,"Kenai Peninsula Borough",4,4,11499,4,11513,0,296,0,82
"12/07/2021","Y","Y","Kenai Peninsula Borough",122,"Kenai Peninsula Borough",4,6,11505,9,11522,0,296,0,82
"12/08/2021","Y","Y","Kenai Peninsula Borough",122,"Kenai Peninsula Borough",4,13,11518,14,11536,0,296,0,82
"12/09/2021","Y","Y","Kenai Peninsula Borough",122,"Kenai Peninsula Borough",4,18,11536,15,11551,0,296,0,82
"12/10/2021","Y","Y","Kenai Peninsula Borough",122,"Kenai Peninsula Borough",4,13,11549,11,11562,0,296,0,82
"12/11/2021","Y","Y","Kenai Peninsula Borough",122,"Kenai Peninsula Borough",4,9,11558,9,11571,0,296,0,82
"12/12/2021","Y","Y","Kenai Peninsula Borough",122,"Kenai Peninsula Borough",4,7,11565,4,11575,0,296,0,82
"12/13/2021","Y","Y","Kenai Peninsula Borough",122,"Kenai Peninsula Borough",4,4,11569,4,11579,0,296,0,82
"12/14/2021","Y","Y","Kenai Peninsula Borough",122,"Kenai Peninsula Borough",4,13,11582,18,11597,1,297,0,82
"12/15/2021","Y","Y","Kenai Peninsula Borough",122,"Kenai Peninsula Borough",4,14,11596,10,11607,0,297,1,83
"12/16/2021","Y","Y","Kenai Peninsula Borough",122,"Kenai Peninsula Borough",4,9,11605,13,11620,2,299,0,83
"12/17/2021","Y","Y","Kenai Peninsula Borough",122,"Kenai Peninsula Borough",4,18,11623,15,11635,0,299,0,83
"12/18/2021","Y","Y","Kenai Peninsula Borough",122,"Kenai Peninsula Borough",4,6,11629,5,11640,0,299,0,83
"12/19/2021","Y","Y","Kenai Peninsula Borough",122,"Kenai Peninsula Borough",4,7,11636,8,11648,0,299,0,83
"12/20/2021","Y","Y","Kenai Peninsula Borough",122,"Kenai Peninsula Borough",4,10,11646,12,11660,0,299,1,84
"12/21/2021","Y","Y","Kenai Peninsula Borough",122,"Kenai Peninsula Borough",4,15,11661,16,11676,0,299,0,84
"12/22/2021","Y","Y","Kenai Peninsula Borough",122,"Kenai Peninsula Borough",4,17,11678,19,11695,1,300,0,84
"12/23/2021","Y","Y","Kenai Peninsula Borough",122,"Kenai Peninsula Borough",4,15,11693,13,11708,1,301,0,84
"12/24/2021","Y","Y","Kenai Peninsula Borough",122,"Kenai Peninsula Borough",4,5,11698,6,11714,1,302,0,84
"12/25/2021","Y","Y","Kenai Peninsula Borough",122,"Kenai Peninsula Borough",4,6,11704,7,11721,0,302,1,85
"12/26/2021","Y","Y","Kenai Peninsula Borough",122,"Kenai Peninsula Borough",4,6,11710,6,11727,0,302,0,85
"12/27/2021","Y","Y","Kenai Peninsula Borough",122,"Kenai Peninsula Borough",4,10,11720,20,11747,0,302,0,85
"12/28/2021","Y","Y","Kenai Peninsula Borough",122,"Kenai Peninsula Borough",4,19,11739,26,11773,0,302,0,85
"12/29/2021","Y","Y","Kenai Peninsula Borough",122,"Kenai Peninsula Borough",4,18,11757,14,11787,0,302,0,85
"12/30/2021","Y","Y","Kenai Peninsula Borough",122,"Kenai Peninsula Borough",4,25,11782,20,11807,0,302,0,85
"12/31/2021","Y","Y","Kenai Peninsula Borough",122,"Kenai Peninsula Borough",4,8,11790,11,11818,0,302,0,85
"01/01/2022","Y","Y","Kenai Peninsula Borough",122,"Kenai Peninsula Borough",4,6,11796,2,11820,0,302,0,85
"01/02/2022","Y","Y","Kenai Peninsula Borough",122,"Kenai Peninsula Borough",4,14,11810,13,11833,0,302,0,85
"01/03/2022","Y","Y","Kenai Peninsula Borough",122,"Kenai Peninsula Borough",4,15,11825,39,11872,0,302,0,85
"01/04/2022","Y","Y","Kenai Peninsula Borough",122,"Kenai Peninsula Borough",4,43,11868,48,11920,0,302,0,85
"01/05/2022","Y","Y","Kenai Peninsula Borough",122,"Kenai Peninsula Borough",4,45,11913,58,11978,0,302,0,85
"01/06/2022","Y","Y","Kenai Peninsula Borough",122,"Kenai Peninsula Borough",4,47,11960,56,12034,0,302,0,85
"01/07/2022","Y","Y","Kenai Peninsula Borough",122,"Kenai Peninsula Borough",4,61,12021,61,12095,0,302,0,85
"01/08/2022","Y","Y","Kenai Peninsula Borough",122,"Kenai Peninsula Borough",4,35,12056,30,12125,0,302,0,85
"01/09/2022","Y","Y","Kenai Peninsula Borough",122,"Kenai Peninsula Borough",4,22,12078,24,12149,1,303,0,85
"01/10/2022","Y","Y","Kenai Peninsula Borough",122,"Kenai Peninsula Borough",4,49,12127,98,12247,0,303,0,85
"01/11/2022","Y","Y","Kenai Peninsula Borough",122,"Kenai Peninsula Borough",4,98,12225,124,12371,0,303,0,85
"01/12/2022","Y","Y","Kenai Peninsula Borough",122,"Kenai Peninsula Borough",4,79,12304,90,12461,0,303,0,85
"01/13/2022","Y","Y","Kenai Peninsula Borough",122,"Kenai Peninsula Borough",4,100,12404,109,12570,0,303,0,85
"01/14/2022","Y","Y","Kenai Peninsula Borough",122,"Kenai Peninsula Borough",4,115,12519,116,12686,0,303,0,85
"01/15/2022","Y","Y","Kenai Peninsula Borough",122,"Kenai Peninsula Borough",4,122,12641,83,12769,0,303,0,85
"01/16/2022","Y","Y","Kenai Peninsula Borough",122,"Kenai Peninsula Borough",4,62,12703,66,12835,0,303,0,85
"01/17/2022","Y","Y","Kenai Peninsula Borough",122,"Kenai Peninsula Borough",4,54,12757,95,12930,2,305,0,85
"01/18/2022","Y","Y","Kenai Peninsula Borough",122,"Kenai Peninsula Borough",4,197,12954,178,13108,0,305,0,85
"01/19/2022","Y","Y","Kenai Peninsula Borough",122,"Kenai Peninsula Borough",4,172,13126,176,13284,0,305,0,85
"01/20/2022","Y","Y","Kenai Peninsula Borough",122,"Kenai Peninsula Borough",4,148,13274,192,13476,0,305,0,85
"01/21/2022","Y","Y","Kenai Peninsula Borough",122,"Kenai Peninsula Borough",4,135,13409,142,13618,1,306,0,85
"01/22/2022","Y","Y","Kenai Peninsula Borough",122,"Kenai Peninsula Borough",4,50,13459,53,13671,0,306,0,85
"01/23/2022","Y","Y","Kenai Peninsula Borough",122,"Kenai Peninsula Borough",4,55,13514,77,13748,0,306,0,85
"01/24/2022","Y","Y","Kenai Peninsula Borough",122,"Kenai Peninsula Borough",4,143,13657,203,13951,0,306,0,85
"01/25/2022","Y","Y","Kenai Peninsula Borough",122,"Kenai Peninsula Borough",4,231,13888,142,14093,0,306,0,85
"01/26/2022","Y","Y","Kenai Peninsula Borough",122,"Kenai Peninsula Borough",4,212,14100,186,14279,2,308,0,85
"01/27/2022","Y","Y","Kenai Peninsula Borough",122,"Kenai Peninsula Borough",4,155,14255,166,14445,0,308,0,85
"01/28/2022","Y","Y","Kenai Peninsula Borough",122,"Kenai Peninsula Borough",4,204,14459,167,14612,1,309,1,86
"01/29/2022","Y","Y","Kenai Peninsula Borough",122,"Kenai Peninsula Borough",4,88,14547,82,14694,0,309,0,86
"01/30/2022","Y","Y","Kenai Peninsula Borough",122,"Kenai Peninsula Borough",4,56,14603,52,14746,1,310,0,86
"01/31/2022","Y","Y","Kenai Peninsula Borough",122,"Kenai Peninsula Borough",4,145,14748,146,14892,1,311,0,86
"02/01/2022","Y","Y","Kenai Peninsula Borough",122,"Kenai Peninsula Borough",4,131,14879,124,15016,0,311,0,86
"02/02/2022","Y","Y","Kenai Peninsula Borough",122,"Kenai Peninsula Borough",4,185,15064,153,15169,0,311,0,86
"02/03/2022","Y","Y","Kenai Peninsula Borough",122,"Kenai Peninsula Borough",4,90,15154,77,15246,0,311,0,86
"02/04/2022","Y","Y","Kenai Peninsula Borough",122,"Kenai Peninsula Borough",4,122,15276,96,15342,1,312,0,86
"02/05/2022","Y","Y","Kenai Peninsula Borough",122,"Kenai Peninsula Borough",4,53,15329,50,15392,1,313,1,87
"02/06/2022","Y","Y","Kenai Peninsula Borough",122,"Kenai Peninsula Borough",4,58,15387,38,15430,1,314,0,87
"02/07/2022","Y","Y","Kenai Peninsula Borough",122,"Kenai Peninsula Borough",4,66,15453,86,15516,3,317,0,87
"02/08/2022","Y","Y","Kenai Peninsula Borough",122,"Kenai Peninsula Borough",4,108,15561,109,15625,0,317,1,88
"02/09/2022","Y","Y","Kenai Peninsula Borough",122,"Kenai Peninsula Borough",4,84,15645,79,15704,0,317,0,88
"02/10/2022","Y","Y","Kenai Peninsula Borough",122,"Kenai Peninsula Borough",4,47,15692,51,15755,0,317,0,88
"02/11/2022","Y","Y","Kenai Peninsula Borough",122,"Kenai Peninsula Borough",4,87,15779,85,15840,1,318,0,88
"02/12/2022","Y","Y","Kenai Peninsula Borough",122,"Kenai Peninsula Borough",4,46,15825,36,15876,0,318,0,88
"02/13/2022","Y","Y","Kenai Peninsula Borough",122,"Kenai Peninsula Borough",4,17,15842,17,15893,0,318,0,88
"02/14/2022","Y","Y","Kenai Peninsula Borough",122,"Kenai Peninsula Borough",4,62,15904,70,15963,1,319,0,88
"02/15/2022","Y","Y","Kenai Peninsula Borough",122,"Kenai Peninsula Borough",4,29,15933,23,15986,1,320,0,88
"02/16/2022","Y","Y","Kenai Peninsula Borough",122,"Kenai Peninsula Borough",4,43,15976,44,16030,2,322,0,88
"02/17/2022","Y","Y","Kenai Peninsula Borough",122,"Kenai Peninsula Borough",4,53,16029,58,16088,3,325,1,89
"02/18/2022","Y","Y","Kenai Peninsula Borough",122,"Kenai Peninsula Borough",4,53,16082,54,16142,1,326,0,89
"02/19/2022","Y","Y","Kenai Peninsula Borough",122,"Kenai Peninsula Borough",4,22,16104,17,16159,1,327,1,90
"02/20/2022","Y","Y","Kenai Peninsula Borough",122,"Kenai Peninsula Borough",4,16,16120,16,16175,1,328,0,90
"02/21/2022","Y","Y","Kenai Peninsula Borough",122,"Kenai Peninsula Borough",4,38,16158,48,16223,2,330,1,91
"02/22/2022","Y","Y","Kenai Peninsula Borough",122,"Kenai Peninsula Borough",4,38,16196,47,16270,0,330,0,91
"02/23/2022","Y","Y","Kenai Peninsula Borough",122,"Kenai Peninsula Borough",4,68,16264,58,16328,0,330,1,92
"02/24/2022","Y","Y","Kenai Peninsula Borough",122,"Kenai Peninsula Borough",4,77,16341,64,16392,0,330,0,92
"02/25/2022","Y","Y","Kenai Peninsula Borough",122,"Kenai Peninsula Borough",4,54,16395,25,16417,1,331,1,93
"02/26/2022","Y","Y","Kenai Peninsula Borough",122,"Kenai Peninsula Borough",4,13,16408,9,16426,0,331,0,93
"02/27/2022","Y","Y","Kenai Peninsula Borough",122,"Kenai Peninsula Borough",4,12,16420,14,16440,1,332,0,93
"02/28/2022","Y","Y","Kenai Peninsula Borough",122,"Kenai Peninsula Borough",4,34,16454,31,16471,1,333,0,93
"03/01/2022","Y","Y","Kenai Peninsula Borough",122,"Kenai Peninsula Borough",4,31,16485,27,16498,0,333,0,93
"03/02/2022","Y","Y","Kenai Peninsula Borough",122,"Kenai Peninsula Borough",4,31,16516,25,16523,2,335,0,93
"03/03/2022","Y","Y","Kenai Peninsula Borough",122,"Kenai Peninsula Borough",4,10,16526,13,16536,1,336,0,93
"03/04/2022","Y","Y","Kenai Peninsula Borough",122,"Kenai Peninsula Borough",4,30,16556,36,16572,0,336,0,93
"03/05/2022","Y","Y","Kenai Peninsula Borough",122,"Kenai Peninsula Borough",4,9,16565,7,16579,0,336,2,95
"03/06/2022","Y","Y","Kenai Peninsula Borough",122,"Kenai Peninsula Borough",4,10,16575,10,16589,0,336,0,95
"03/07/2022","Y","Y","Kenai Peninsula Borough",122,"Kenai Peninsula Borough",4,10,16585,15,16604,0,336,0,95
"03/08/2022","Y","Y","Kenai Peninsula Borough",122,"Kenai Peninsula Borough",4,14,16599,19,16623,0,336,0,95
"03/09/2022","Y","Y","Kenai Peninsula Borough",122,"Kenai Peninsula Borough",4,31,16630,34,16657,0,336,0,95
"03/10/2022","Y","Y","Kenai Peninsula Borough",122,"Kenai Peninsula Borough",4,15,16645,17,16674,0,336,0,95
"03/11/2022","Y","Y","Kenai Peninsula Borough",122,"Kenai Peninsula Borough",4,26,16671,30,16704,0,336,0,95
"03/12/2022","Y","Y","Kenai Peninsula Borough",122,"Kenai Peninsula Borough",4,19,16690,11,16715,0,336,0,95
"03/13/2022","Y","Y","Kenai Peninsula Borough",122,"Kenai Peninsula Borough",4,8,16698,9,16724,0,336,0,95
"03/14/2022","Y","Y","Kenai Peninsula Borough",122,"Kenai Peninsula Borough",4,39,16737,26,16750,1,337,0,95
"03/15/2022","Y","Y","Kenai Peninsula Borough",122,"Kenai Peninsula Borough",4,19,16756,34,16784,1,338,0,95
"03/16/2022","Y","Y","Kenai Peninsula Borough",122,"Kenai Peninsula Borough",4,26,16782,16,16800,0,338,0,95
"03/17/2022","Y","Y","Kenai Peninsula Borough",122,"Kenai Peninsula Borough",4,31,16813,27,16827,1,339,0,95
"03/18/2022","Y","Y","Kenai Peninsula Borough",122,"Kenai Peninsula Borough",4,12,16825,14,16841,2,341,0,95
"03/19/2022","Y","Y","Kenai Peninsula Borough",122,"Kenai Peninsula Borough",4,4,16829,4,16845,1,342,0,95
"03/20/2022","Y","Y","Kenai Peninsula Borough",122,"Kenai Peninsula Borough",4,6,16835,7,16852,0,342,0,95
"03/21/2022","Y","Y","Kenai Peninsula Borough",122,"Kenai Peninsula Borough",4,22,16857,28,16880,0,342,1,96
"03/22/2022","Y","Y","Kenai Peninsula Borough",122,"Kenai Peninsula Borough",4,18,16875,35,16915,0,342,0,96
"03/23/2022","Y","Y","Kenai Peninsula Borough",122,"Kenai Peninsula Borough",4,38,16913,25,16940,0,342,0,96
"03/24/2022","Y","Y","Kenai Peninsula Borough",122,"Kenai Peninsula Borough",4,34,16947,32,16972,2,344,0,96
"03/25/2022","Y","Y","Kenai Peninsula Borough",122,"Kenai Peninsula Borough",4,23,16970,22,16994,0,344,0,96
"03/26/2022","Y","Y","Kenai Peninsula Borough",122,"Kenai Peninsula Borough",4,7,16977,15,17009,0,344,0,96
"03/27/2022","Y","Y","Kenai Peninsula Borough",122,"Kenai Peninsula Borough",4,3,16980,11,17020,1,345,0,96
"03/28/2022","Y","Y","Kenai Peninsula Borough",122,"Kenai Peninsula Borough",4,5,16985,17,17037,0,345,0,96
"03/29/2022","Y","Y","Kenai Peninsula Borough",122,"Kenai Peninsula Borough",4,7,16992,16,17053,0,345,0,96
"03/30/2022","Y","Y","Kenai Peninsula Borough",122,"Kenai Peninsula Borough",4,23,17015,19,17072,0,345,0,96
"03/31/2022","Y","Y","Kenai Peninsula Borough",122,"Kenai Peninsula Borough",4,6,17021,17,17089,1,346,0,96
"04/01/2022","Y","Y","Kenai Peninsula Borough",122,"Kenai Peninsula Borough",4,17,17038,17,17106,0,346,0,96
"04/02/2022","Y","Y","Kenai Peninsula Borough",122,"Kenai Peninsula Borough",4,9,17047,6,17112,0,346,0,96
"04/03/2022","Y","Y","Kenai Peninsula Borough",122,"Kenai Peninsula Borough",4,2,17049,5,17117,0,346,0,96
"04/04/2022","Y","Y","Kenai Peninsula Borough",122,"Kenai Peninsula Borough",4,9,17058,21,17138,0,346,0,96
"04/05/2022","Y","Y","Kenai Peninsula Borough",122,"Kenai Peninsula Borough",4,10,17068,15,17153,0,346,0,96
"04/06/2022","Y","Y","Kenai Peninsula Borough",122,"Kenai Peninsula Borough",4,9,17077,11,17164,0,346,0,96
"04/07/2022","Y","Y","Kenai Peninsula Borough",122,"Kenai Peninsula Borough",4,10,17087,10,17174,0,346,0,96
"04/08/2022","Y","Y","Kenai Peninsula Borough",122,"Kenai Peninsula Borough",4,12,17099,12,17186,0,346,0,96
"04/09/2022","Y","Y","Kenai Peninsula Borough",122,"Kenai Peninsula Borough",4,5,17104,7,17193,0,346,0,96
"04/10/2022","Y","Y","Kenai Peninsula Borough",122,"Kenai Peninsula Borough",4,2,17106,5,17198,0,346,0,96
"04/11/2022","Y","Y","Kenai Peninsula Borough",122,"Kenai Peninsula Borough",4,12,17118,13,17211,0,346,0,96
"04/12/2022","Y","Y","Kenai Peninsula Borough",122,"Kenai Peninsula Borough",4,10,17128,17,17228,0,346,0,96
"04/13/2022","Y","Y","Kenai Peninsula Borough",122,"Kenai Peninsula Borough",4,10,17138,7,17235,0,346,0,96
"04/14/2022","Y","Y","Kenai Peninsula Borough",122,"Kenai Peninsula Borough",4,67,17205,43,17278,0,346,0,96
"04/15/2022","Y","Y","Kenai Peninsula Borough",122,"Kenai Peninsula Borough",4,70,17275,13,17291,0,346,0,96
"04/16/2022","Y","Y","Kenai Peninsula Borough",122,"Kenai Peninsula Borough",4,15,17290,7,17298,0,346,0,96
"04/17/2022","Y","Y","Kenai Peninsula Borough",122,"Kenai Peninsula Borough",4,3,17293,4,17302,0,346,0,96
"04/18/2022","Y","Y","Kenai Peninsula Borough",122,"Kenai Peninsula Borough",4,16,17309,19,17321,0,346,0,96
"04/19/2022","Y","Y","Kenai Peninsula Borough",122,"Kenai Peninsula Borough",4,23,17332,22,17343,0,346,0,96
"04/20/2022","Y","Y","Kenai Peninsula Borough",122,"Kenai Peninsula Borough",4,11,17343,7,17350,0,346,0,96
"04/21/2022","Y","Y","Kenai Peninsula Borough",122,"Kenai Peninsula Borough",4,9,17352,6,17356,0,346,0,96
"04/22/2022","Y","Y","Kenai Peninsula Borough",122,"Kenai Peninsula Borough",4,9,17361,7,17363,0,346,0,96
"04/23/2022","Y","Y","Kenai Peninsula Borough",122,"Kenai Peninsula Borough",4,8,17369,11,17374,0,346,0,96
"04/24/2022","Y","Y","Kenai Peninsula Borough",122,"Kenai Peninsula Borough",4,8,17377,5,17379,0,346,0,96
"04/25/2022","Y","Y","Kenai Peninsula Borough",122,"Kenai Peninsula Borough",4,22,17399,20,17399,0,346,0,96
"04/26/2022","Y","Y","Kenai Peninsula Borough",122,"Kenai Peninsula Borough",4,13,17412,13,17412,0,346,0,96
"03/05/2020","Y","Y","Ketchikan Gateway Borough",130,"Other Southeast Region - Southern",9,0,0,1,1,0,0,0,0
"03/14/2020","Y","Y","Ketchikan Gateway Borough",130,"Other Southeast Region - Southern",9,0,0,2,3,0,0,0,0
"03/16/2020","Y","Y","Ketchikan Gateway Borough",130,"Other Southeast Region - Southern",9,0,0,4,7,0,0,0,0
"03/17/2020","Y","Y","Ketchikan Gateway Borough",130,"Other Southeast Region - Southern",9,2,2,3,10,0,0,0,0
"03/18/2020","Y","Y","Ketchikan Gateway Borough",130,"Other Southeast Region - Southern",9,0,2,2,12,0,0,0,0
"03/19/2020","Y","Y","Ketchikan Gateway Borough",130,"Other Southeast Region - Southern",9,0,2,1,13,0,0,0,0
"03/20/2020","Y","Y","Ketchikan Gateway Borough",130,"Other Southeast Region - Southern",9,1,3,0,13,0,0,0,0
"03/21/2020","Y","Y","Ketchikan Gateway Borough",130,"Other Southeast Region - Southern",9,4,7,0,13,0,0,0,0
"03/22/2020","Y","Y","Ketchikan Gateway Borough",130,"Other Southeast Region - Southern",9,1,8,0,13,1,1,0,0
"03/24/2020","Y","Y","Ketchikan Gateway Borough",130,"Other Southeast Region - Southern",9,3,11,0,13,0,1,0,0
"03/25/2020","Y","Y","Ketchikan Gateway Borough",130,"Other Southeast Region - Southern",9,0,11,0,13,1,2,0,0
"03/26/2020","Y","Y","Ketchikan Gateway Borough",130,"Other Southeast Region - Southern",9,1,12,1,14,0,2,0,0
"03/28/2020","Y","Y","Ketchikan Gateway Borough",130,"Other Southeast Region - Southern",9,1,13,1,15,0,2,0,0
"04/01/2020","Y","Y","Ketchikan Gateway Borough",130,"Other Southeast Region - Southern",9,1,14,0,15,0,2,0,0
"04/11/2020","Y","Y","Ketchikan Gateway Borough",130,"Other Southeast Region - Southern",9,1,15,0,15,0,2,0,0
"04/15/2020","Y","Y","Ketchikan Gateway Borough",130,"Other Southeast Region - Southern",9,0,15,1,16,0,2,0,0
"04/20/2020","Y","Y","Ketchikan Gateway Borough",130,"Other Southeast Region - Southern",9,1,16,0,16,0,2,0,0
"06/07/2020","Y","Y","Ketchikan Gateway Borough",130,"Other Southeast Region - Southern",9,0,16,1,17,0,2,0,0
"06/10/2020","Y","Y","Ketchikan Gateway Borough",130,"Other Southeast Region - Southern",9,0,16,1,18,0,2,0,0
"06/12/2020","Y","Y","Ketchikan Gateway Borough",130,"Other Southeast Region - Southern",9,2,18,1,19,0,2,0,0
"06/13/2020","Y","Y","Ketchikan Gateway Borough",130,"Other Southeast Region - Southern",9,0,18,1,20,0,2,0,0
"06/16/2020","Y","Y","Ketchikan Gateway Borough",130,"Other Southeast Region - Southern",9,1,19,0,20,0,2,0,0
"06/17/2020","Y","Y","Ketchikan Gateway Borough",130,"Other Southeast Region - Southern",9,1,20,0,20,0,2,0,0
"06/18/2020","Y","Y","Ketchikan Gateway Borough",130,"Other Southeast Region - Southern",9,0,20,1,21,0,2,0,0
"06/23/2020","Y","Y","Ketchikan Gateway Borough",130,"Other Southeast Region - Southern",9,1,21,0,21,0,2,0,0
"06/30/2020","Y","Y","Ketchikan Gateway Borough",130,"Other Southeast Region - Southern",9,1,22,1,22,0,2,0,0
"07/04/2020","Y","Y","Ketchikan Gateway Borough",130,"Other Southeast Region - Southern",9,0,22,1,23,0,2,0,0
"07/06/2020","Y","Y","Ketchikan Gateway Borough",130,"Other Southeast Region - Southern",9,1,23,0,23,0,2,0,0
"07/16/2020","Y","Y","Ketchikan Gateway Borough",130,"Other Southeast Region - Southern",9,0,23,2,25,0,2,0,0
"07/17/2020","Y","Y","Ketchikan Gateway Borough",130,"Other Southeast Region - Southern",9,1,24,0,25,0,2,0,0
"07/18/2020","Y","Y","Ketchikan Gateway Borough",130,"Other Southeast Region - Southern",9,1,25,0,25,0,2,0,0
"07/20/2020","Y","Y","Ketchikan Gateway Borough",130,"Other Southeast Region - Southern",9,0,25,4,29,0,2,0,0
"07/21/2020","Y","Y","Ketchikan Gateway Borough",130,"Other Southeast Region - Southern",9,3,28,1,30,0,2,0,0
"07/22/2020","Y","Y","Ketchikan Gateway Borough",130,"Other Southeast Region - Southern",9,0,28,2,32,0,2,0,0
"07/23/2020","Y","Y","Ketchikan Gateway Borough",130,"Other Southeast Region - Southern",9,3,31,0,32,0,2,0,0
"07/25/2020","Y","Y","Ketchikan Gateway Borough",130,"Other Southeast Region - Southern",9,1,32,1,33,0,2,0,0
"07/27/2020","Y","Y","Ketchikan Gateway Borough",130,"Other Southeast Region - Southern",9,1,33,0,33,0,2,0,0
"07/28/2020","Y","Y","Ketchikan Gateway Borough",130,"Other Southeast Region - Southern",9,0,33,0,33,1,3,0,0
"08/09/2020","Y","Y","Ketchikan Gateway Borough",130,"Other Southeast Region - Southern",9,0,33,1,34,0,3,0,0
"08/10/2020","Y","Y","Ketchikan Gateway Borough",130,"Other Southeast Region - Southern",9,0,33,1,35,0,3,0,0
"08/11/2020","Y","Y","Ketchikan Gateway Borough",130,"Other Southeast Region - Southern",9,0,33,2,37,0,3,0,0
"08/12/2020","Y","Y","Ketchikan Gateway Borough",130,"Other Southeast Region - Southern",9,1,34,0,37,0,3,0,0
"08/13/2020","Y","Y","Ketchikan Gateway Borough",130,"Other Southeast Region - Southern",9,1,35,0,37,0,3,0,0
"08/14/2020","Y","Y","Ketchikan Gateway Borough",130,"Other Southeast Region - Southern",9,1,36,0,37,0,3,0,0
"08/18/2020","Y","Y","Ketchikan Gateway Borough",130,"Other Southeast Region - Southern",9,0,36,3,40,0,3,0,0
"08/19/2020","Y","Y","Ketchikan Gateway Borough",130,"Other Southeast Region - Southern",9,1,37,0,40,0,3,0,0
"08/21/2020","Y","Y","Ketchikan Gateway Borough",130,"Other Southeast Region - Southern",9,2,39,1,41,0,3,0,0
"08/24/2020","Y","Y","Ketchikan Gateway Borough",130,"Other Southeast Region - Southern",9,1,40,0,41,0,3,0,0
"08/27/2020","Y","Y","Ketchikan Gateway Borough",130,"Other Southeast Region - Southern",9,1,41,0,41,0,3,0,0
"08/28/2020","Y","Y","Ketchikan Gateway Borough",130,"Other Southeast Region - Southern",9,0,41,2,43,0,3,0,0
"08/29/2020","Y","Y","Ketchikan Gateway Borough",130,"Other Southeast Region - Southern",9,2,43,1,44,0,3,0,0
"08/31/2020","Y","Y","Ketchikan Gateway Borough",130,"Other Southeast Region - Southern",9,1,44,0,44,0,3,0,0
"09/09/2020","Y","Y","Ketchikan Gateway Borough",130,"Other Southeast Region - Southern",9,0,44,1,45,0,3,0,0
"09/11/2020","Y","Y","Ketchikan Gateway Borough",130,"Other Southeast Region - Southern",9,1,45,0,45,0,3,0,0
"09/15/2020","Y","Y","Ketchikan Gateway Borough",130,"Other Southeast Region - Southern",9,0,45,1,46,0,3,0,0
"09/16/2020","Y","Y","Ketchikan Gateway Borough",130,"Other Southeast Region - Southern",9,1,46,0,46,0,3,0,0
"09/25/2020","Y","Y","Ketchikan Gateway Borough",130,"Other Southeast Region - Southern",9,0,46,1,47,0,3,0,0
"09/28/2020","Y","Y","Ketchikan Gateway Borough",130,"Other Southeast Region - Southern",9,1,47,0,47,0,3,0,0
"09/30/2020","Y","Y","Ketchikan Gateway Borough",130,"Other Southeast Region - Southern",9,0,47,2,49,0,3,0,0
"10/01/2020","Y","Y","Ketchikan Gateway Borough",130,"Other Southeast Region - Southern",9,0,47,1,50,0,3,0,0
"10/05/2020","Y","Y","Ketchikan Gateway Borough",130,"Other Southeast Region - Southern",9,0,47,1,51,0,3,0,0
"10/07/2020","Y","Y","Ketchikan Gateway Borough",130,"Other Southeast Region - Southern",9,1,48,0,51,0,3,0,0
"10/08/2020","Y","Y","Ketchikan Gateway Borough",130,"Other Southeast Region - Southern",9,3,51,0,51,0,3,0,0
"10/10/2020","Y","Y","Ketchikan Gateway Borough",130,"Other Southeast Region - Southern",9,0,51,2,53,0,3,0,0
"10/13/2020","Y","Y","Ketchikan Gateway Borough",130,"Other Southeast Region - Southern",9,0,51,1,54,0,3,0,0
"10/14/2020","Y","Y","Ketchikan Gateway Borough",130,"Other Southeast Region - Southern",9,2,53,2,56,0,3,0,0
"10/16/2020","Y","Y","Ketchikan Gateway Borough",130,"Other Southeast Region - Southern",9,2,55,1,57,0,3,0,0
"10/20/2020","Y","Y","Ketchikan Gateway Borough",130,"Other Southeast Region - Southern",9,1,56,0,57,0,3,0,0
"10/23/2020","Y","Y","Ketchikan Gateway Borough",130,"Other Southeast Region - Southern",9,0,56,1,58,0,3,0,0
"10/24/2020","Y","Y","Ketchikan Gateway Borough",130,"Other Southeast Region - Southern",9,1,57,2,60,0,3,0,0
"10/25/2020","Y","Y","Ketchikan Gateway Borough",130,"Other Southeast Region - Southern",9,0,57,1,61,0,3,0,0
"10/26/2020","Y","Y","Ketchikan Gateway Borough",130,"Other Southeast Region - Southern",9,0,57,1,62,0,3,0,0
"10/27/2020","Y","Y","Ketchikan Gateway Borough",130,"Other Southeast Region - Southern",9,0,57,4,66,0,3,0,0
"10/28/2020","Y","Y","Ketchikan Gateway Borough",130,"Other Southeast Region - Southern",9,3,60,4,70,0,3,0,0
"10/29/2020","Y","Y","Ketchikan Gateway Borough",130,"Other Southeast Region - Southern",9,1,61,3,73,0,3,0,0
"10/30/2020","Y","Y","Ketchikan Gateway Borough",130,"Other Southeast Region - Southern",9,6,67,9,82,0,3,0,0
"10/31/2020","Y","Y","Ketchikan Gateway Borough",130,"Other Southeast Region - Southern",9,10,77,2,84,0,3,0,0
"11/01/2020","Y","Y","Ketchikan Gateway Borough",130,"Other Southeast Region - Southern",9,2,79,1,85,0,3,0,0
"11/02/2020","Y","Y","Ketchikan Gateway Borough",130,"Other Southeast Region - Southern",9,0,79,10,95,0,3,0,0
"11/03/2020","Y","Y","Ketchikan Gateway Borough",130,"Other Southeast Region - Southern",9,3,82,7,102,0,3,0,0
"11/04/2020","Y","Y","Ketchikan Gateway Borough",130,"Other Southeast Region - Southern",9,6,88,8,110,0,3,0,0
"11/05/2020","Y","Y","Ketchikan Gateway Borough",130,"Other Southeast Region - Southern",9,7,95,9,119,0,3,0,0
"11/06/2020","Y","Y","Ketchikan Gateway Borough",130,"Other Southeast Region - Southern",9,13,108,18,137,0,3,0,0
"11/07/2020","Y","Y","Ketchikan Gateway Borough",130,"Other Southeast Region - Southern",9,17,125,5,142,0,3,0,0
"11/08/2020","Y","Y","Ketchikan Gateway Borough",130,"Other Southeast Region - Southern",9,7,132,0,142,0,3,0,0
"11/09/2020","Y","Y","Ketchikan Gateway Borough",130,"Other Southeast Region - Southern",9,10,142,2,144,0,3,0,0
"11/10/2020","Y","Y","Ketchikan Gateway Borough",130,"Other Southeast Region - Southern",9,0,142,11,155,0,3,0,0
"11/11/2020","Y","Y","Ketchikan Gateway Borough",130,"Other Southeast Region - Southern",9,1,143,2,157,0,3,0,0
"11/12/2020","Y","Y","Ketchikan Gateway Borough",130,"Other Southeast Region - Southern",9,0,143,4,161,0,3,0,0
"11/13/2020","Y","Y","Ketchikan Gateway Borough",130,"Other Southeast Region - Southern",9,10,153,2,163,0,3,0,0
"11/14/2020","Y","Y","Ketchikan Gateway Borough",130,"Other Southeast Region - Southern",9,5,158,0,163,0,3,0,0
"11/15/2020","Y","Y","Ketchikan Gateway Borough",130,"Other Southeast Region - Southern",9,0,158,1,164,0,3,0,0
"11/17/2020","Y","Y","Ketchikan Gateway Borough",130,"Other Southeast Region - Southern",9,2,160,3,167,0,3,0,0
"11/18/2020","Y","Y","Ketchikan Gateway Borough",130,"Other Southeast Region - Southern",9,2,162,1,168,0,3,0,0
"11/20/2020","Y","Y","Ketchikan Gateway Borough",130,"Other Southeast Region - Southern",9,1,163,0,168,0,3,0,0
"11/21/2020","Y","Y","Ketchikan Gateway Borough",130,"Other Southeast Region - Southern",9,0,163,1,169,0,3,0,0
"11/22/2020","Y","Y","Ketchikan Gateway Borough",130,"Other Southeast Region - Southern",9,1,164,2,171,0,3,0,0
"11/23/2020","Y","Y","Ketchikan Gateway Borough",130,"Other Southeast Region - Southern",9,0,164,3,174,0,3,0,0
"11/24/2020","Y","Y","Ketchikan Gateway Borough",130,"Other Southeast Region - Southern",9,2,166,1,175,0,3,0,0
"11/25/2020","Y","Y","Ketchikan Gateway Borough",130,"Other Southeast Region - Southern",9,6,172,1,176,0,3,0,0
"11/26/2020","Y","Y","Ketchikan Gateway Borough",130,"Other Southeast Region - Southern",9,0,172,1,177,0,3,0,0
"11/27/2020","Y","Y","Ketchikan Gateway Borough",130,"Other Southeast Region - Southern",9,1,173,1,178,0,3,0,0
"11/28/2020","Y","Y","Ketchikan Gateway Borough",130,"Other Southeast Region - Southern",9,1,174,1,179,0,3,0,0
"11/30/2020","Y","Y","Ketchikan Gateway Borough",130,"Other Southeast Region - Southern",9,2,176,2,181,0,3,0,0
"12/01/2020","Y","Y","Ketchikan Gateway Borough",130,"Other Southeast Region - Southern",9,1,177,6,187,0,3,0,0
"12/02/2020","Y","Y","Ketchikan Gateway Borough",130,"Other Southeast Region - Southern",9,8,185,4,191,0,3,0,0
"12/03/2020","Y","Y","Ketchikan Gateway Borough",130,"Other Southeast Region - Southern",9,3,188,2,193,0,3,0,0
"12/04/2020","Y","Y","Ketchikan Gateway Borough",130,"Other Southeast Region - Southern",9,5,193,2,195,0,3,0,0
"12/05/2020","Y","Y","Ketchikan Gateway Borough",130,"Other Southeast Region - Southern",9,1,194,2,197,0,3,0,0
"12/07/2020","Y","Y","Ketchikan Gateway Borough",130,"Other Southeast Region - Southern",9,2,196,3,200,0,3,0,0
"12/08/2020","Y","Y","Ketchikan Gateway Borough",130,"Other Southeast Region - Southern",9,2,198,0,200,0,3,0,0
"12/09/2020","Y","Y","Ketchikan Gateway Borough",130,"Other Southeast Region - Southern",9,2,200,1,201,0,3,0,0
"12/10/2020","Y","Y","Ketchikan Gateway Borough",130,"Other Southeast Region - Southern",9,1,201,1,202,0,3,0,0
"12/11/2020","Y","Y","Ketchikan Gateway Borough",130,"Other Southeast Region - Southern",9,1,202,1,203,0,3,0,0
"12/12/2020","Y","Y","Ketchikan Gateway Borough",130,"Other Southeast Region - Southern",9,1,203,1,204,0,3,0,0
"12/13/2020","Y","Y","Ketchikan Gateway Borough",130,"Other Southeast Region - Southern",9,1,204,0,204,0,3,0,0
"12/16/2020","Y","Y","Ketchikan Gateway Borough",130,"Other Southeast Region - Southern",9,1,205,2,206,0,3,0,0
"12/17/2020","Y","Y","Ketchikan Gateway Borough",130,"Other Southeast Region - Southern",9,1,206,3,209,0,3,0,0
"12/18/2020","Y","Y","Ketchikan Gateway Borough",130,"Other Southeast Region - Southern",9,3,209,0,209,0,3,0,0
"12/20/2020","Y","Y","Ketchikan Gateway Borough",130,"Other Southeast Region - Southern",9,0,209,1,210,0,3,0,0
"12/21/2020","Y","Y","Ketchikan Gateway Borough",130,"Other Southeast Region - Southern",9,0,209,1,211,0,3,0,0
"12/22/2020","Y","Y","Ketchikan Gateway Borough",130,"Other Southeast Region - Southern",9,1,210,0,211,0,3,0,0
"12/23/2020","Y","Y","Ketchikan Gateway Borough",130,"Other Southeast Region - Southern",9,0,210,1,212,0,3,0,0
"12/24/2020","Y","Y","Ketchikan Gateway Borough",130,"Other Southeast Region - Southern",9,0,210,1,213,0,3,0,0
"12/25/2020","Y","Y","Ketchikan Gateway Borough",130,"Other Southeast Region - Southern",9,1,211,0,213,0,3,0,0
"12/26/2020","Y","Y","Ketchikan Gateway Borough",130,"Other Southeast Region - Southern",9,0,211,5,218,0,3,0,0
"12/28/2020","Y","Y","Ketchikan Gateway Borough",130,"Other Southeast Region - Southern",9,3,214,1,219,0,3,0,0
"12/29/2020","Y","Y","Ketchikan Gateway Borough",130,"Other Southeast Region - Southern",9,3,217,3,222,0,3,0,0
"12/30/2020","Y","Y","Ketchikan Gateway Borough",130,"Other Southeast Region - Southern",9,2,219,4,226,0,3,0,0
"12/31/2020","Y","Y","Ketchikan Gateway Borough",130,"Other Southeast Region - Southern",9,5,224,1,227,0,3,0,0
"01/01/2021","Y","Y","Ketchikan Gateway Borough",130,"Other Southeast Region - Southern",9,0,224,2,229,0,3,0,0
"01/02/2021","Y","Y","Ketchikan Gateway Borough",130,"Other Southeast Region - Southern",9,0,224,3,232,1,4,0,0
"01/04/2021","Y","Y","Ketchikan Gateway Borough",130,"Other Southeast Region - Southern",9,2,226,1,233,1,5,0,0
"01/05/2021","Y","Y","Ketchikan Gateway Borough",130,"Other Southeast Region - Southern",9,5,231,2,235,0,5,0,0
"01/06/2021","Y","Y","Ketchikan Gateway Borough",130,"Other Southeast Region - Southern",9,1,232,1,236,0,5,0,0
"01/07/2021","Y","Y","Ketchikan Gateway Borough",130,"Other Southeast Region - Southern",9,1,233,3,239,0,5,0,0
"01/08/2021","Y","Y","Ketchikan Gateway Borough",130,"Other Southeast Region - Southern",9,3,236,2,241,0,5,0,0
"01/09/2021","Y","Y","Ketchikan Gateway Borough",130,"Other Southeast Region - Southern",9,1,237,3,244,0,5,0,0
"01/10/2021","Y","Y","Ketchikan Gateway Borough",130,"Other Southeast Region - Southern",9,0,237,0,244,0,5,1,1
"01/11/2021","Y","Y","Ketchikan Gateway Borough",130,"Other Southeast Region - Southern",9,1,238,3,247,0,5,0,1
"01/12/2021","Y","Y","Ketchikan Gateway Borough",130,"Other Southeast Region - Southern",9,6,244,1,248,0,5,0,1
"01/13/2021","Y","Y","Ketchikan Gateway Borough",130,"Other Southeast Region - Southern",9,1,245,0,248,0,5,0,1
"01/14/2021","Y","Y","Ketchikan Gateway Borough",130,"Other Southeast Region - Southern",9,1,246,0,248,0,5,0,1
"01/16/2021","Y","Y","Ketchikan Gateway Borough",130,"Other Southeast Region - Southern",9,0,246,1,249,0,5,0,1
"01/19/2021","Y","Y","Ketchikan Gateway Borough",130,"Other Southeast Region - Southern",9,2,248,2,251,0,5,0,1
"01/20/2021","Y","Y","Ketchikan Gateway Borough",130,"Other Southeast Region - Southern",9,1,249,3,254,0,5,0,1
"01/21/2021","Y","Y","Ketchikan Gateway Borough",130,"Other Southeast Region - Southern",9,3,252,2,256,0,5,0,1
"01/22/2021","Y","Y","Ketchikan Gateway Borough",130,"Other Southeast Region - Southern",9,0,252,4,260,0,5,0,1
"01/23/2021","Y","Y","Ketchikan Gateway Borough",130,"Other Southeast Region - Southern",9,1,253,0,260,0,5,0,1
"01/24/2021","Y","Y","Ketchikan Gateway Borough",130,"Other Southeast Region - Southern",9,0,253,3,263,0,5,0,1
"01/25/2021","Y","Y","Ketchikan Gateway Borough",130,"Other Southeast Region - Southern",9,0,253,2,265,0,5,0,1
"01/26/2021","Y","Y","Ketchikan Gateway Borough",130,"Other Southeast Region - Southern",9,1,254,1,266,0,5,0,1
"01/27/2021","Y","Y","Ketchikan Gateway Borough",130,"Other Southeast Region - Southern",9,2,256,4,270,0,5,0,1
"01/28/2021","Y","Y","Ketchikan Gateway Borough",130,"Other Southeast Region - Southern",9,2,258,1,271,0,5,0,1
"01/29/2021","Y","Y","Ketchikan Gateway Borough",130,"Other Southeast Region - Southern",9,1,259,1,272,0,5,0,1
"01/30/2021","Y","Y","Ketchikan Gateway Borough",130,"Other Southeast Region - Southern",9,1,260,3,275,0,5,0,1
"01/31/2021","Y","Y","Ketchikan Gateway Borough",130,"Other Southeast Region - Southern",9,0,260,4,279,0,5,0,1
"02/01/2021","Y","Y","Ketchikan Gateway Borough",130,"Other Southeast Region - Southern",9,0,260,4,283,0,5,0,1
"02/02/2021","Y","Y","Ketchikan Gateway Borough",130,"Other Southeast Region - Southern",9,3,263,3,286,0,5,0,1
"02/03/2021","Y","Y","Ketchikan Gateway Borough",130,"Other Southeast Region - Southern",9,2,265,3,289,0,5,0,1
"02/04/2021","Y","Y","Ketchikan Gateway Borough",130,"Other Southeast Region - Southern",9,5,270,7,296,0,5,0,1
"02/05/2021","Y","Y","Ketchikan Gateway Borough",130,"Other Southeast Region - Southern",9,5,275,3,299,0,5,0,1
"02/06/2021","Y","Y","Ketchikan Gateway Borough",130,"Other Southeast Region - Southern",9,4,279,6,305,0,5,0,1
"02/07/2021","Y","Y","Ketchikan Gateway Borough",130,"Other Southeast Region - Southern",9,2,281,2,307,0,5,0,1
"02/08/2021","Y","Y","Ketchikan Gateway Borough",130,"Other Southeast Region - Southern",9,0,281,4,311,0,5,0,1
"02/09/2021","Y","Y","Ketchikan Gateway Borough",130,"Other Southeast Region - Southern",9,3,284,2,313,0,5,0,1
"02/10/2021","Y","Y","Ketchikan Gateway Borough",130,"Other Southeast Region - Southern",9,1,285,3,316,0,5,0,1
"02/11/2021","Y","Y","Ketchikan Gateway Borough",130,"Other Southeast Region - Southern",9,0,285,1,317,0,5,0,1
"02/12/2021","Y","Y","Ketchikan Gateway Borough",130,"Other Southeast Region - Southern",9,3,288,3,320,0,5,0,1
"02/13/2021","Y","Y","Ketchikan Gateway Borough",130,"Other Southeast Region - Southern",9,1,289,0,320,0,5,0,1
"02/14/2021","Y","Y","Ketchikan Gateway Borough",130,"Other Southeast Region - Southern",9,1,290,2,322,0,5,0,1
"02/15/2021","Y","Y","Ketchikan Gateway Borough",130,"Other Southeast Region - Southern",9,0,290,2,324,0,5,0,1
"02/16/2021","Y","Y","Ketchikan Gateway Borough",130,"Other Southeast Region - Southern",9,0,290,3,327,1,6,0,1
"02/17/2021","Y","Y","Ketchikan Gateway Borough",130,"Other Southeast Region - Southern",9,9,299,3,330,1,7,0,1
"02/18/2021","Y","Y","Ketchikan Gateway Borough",130,"Other Southeast Region - Southern",9,15,314,2,332,0,7,0,1
"02/19/2021","Y","Y","Ketchikan Gateway Borough",130,"Other Southeast Region - Southern",9,3,317,2,334,0,7,0,1
"02/20/2021","Y","Y","Ketchikan Gateway Borough",130,"Other Southeast Region - Southern",9,2,319,0,334,0,7,0,1
"02/21/2021","Y","Y","Ketchikan Gateway Borough",130,"Other Southeast Region - Southern",9,1,320,0,334,0,7,0,1
"02/22/2021","Y","Y","Ketchikan Gateway Borough",130,"Other Southeast Region - Southern",9,0,320,2,336,0,7,0,1
"02/23/2021","Y","Y","Ketchikan Gateway Borough",130,"Other Southeast Region - Southern",9,8,328,1,337,0,7,0,1
"02/24/2021","Y","Y","Ketchikan Gateway Borough",130,"Other Southeast Region - Southern",9,5,333,0,337,0,7,0,1
"03/01/2021","Y","Y","Ketchikan Gateway Borough",130,"Other Southeast Region - Southern",9,1,334,1,338,0,7,0,1
"03/02/2021","Y","Y","Ketchikan Gateway Borough",130,"Other Southeast Region - Southern",9,2,336,0,338,0,7,0,1
"03/03/2021","Y","Y","Ketchikan Gateway Borough",130,"Other Southeast Region - Southern",9,2,338,0,338,0,7,0,1
"03/09/2021","Y","Y","Ketchikan Gateway Borough",130,"Other Southeast Region - Southern",9,0,338,1,339,0,7,0,1
"03/10/2021","Y","Y","Ketchikan Gateway Borough",130,"Other Southeast Region - Southern",9,0,338,1,340,0,7,0,1
"03/12/2021","Y","Y","Ketchikan Gateway Borough",130,"Other Southeast Region - Southern",9,1,339,1,341,0,7,0,1
"03/13/2021","Y","Y","Ketchikan Gateway Borough",130,"Other Southeast Region - Southern",9,1,340,4,345,0,7,0,1
"03/14/2021","Y","Y","Ketchikan Gateway Borough",130,"Other Southeast Region - Southern",9,5,345,0,345,0,7,0,1
"03/16/2021","Y","Y","Ketchikan Gateway Borough",130,"Other Southeast Region - Southern",9,0,345,1,346,0,7,0,1
"03/17/2021","Y","Y","Ketchikan Gateway Borough",130,"Other Southeast Region - Southern",9,0,345,1,347,0,7,0,1
"03/19/2021","Y","Y","Ketchikan Gateway Borough",130,"Other Southeast Region - Southern",9,1,346,0,347,0,7,0,1
"03/20/2021","Y","Y","Ketchikan Gateway Borough",130,"Other Southeast Region - Southern",9,0,346,2,349,0,7,0,1
"03/21/2021","Y","Y","Ketchikan Gateway Borough",130,"Other Southeast Region - Southern",9,0,346,1,350,0,7,0,1
"03/22/2021","Y","Y","Ketchikan Gateway Borough",130,"Other Southeast Region - Southern",9,3,349,0,350,0,7,0,1
"03/25/2021","Y","Y","Ketchikan Gateway Borough",130,"Other Southeast Region - Southern",9,0,349,3,353,0,7,0,1
"03/26/2021","Y","Y","Ketchikan Gateway Borough",130,"Other Southeast Region - Southern",9,1,350,1,354,0,7,0,1
"03/27/2021","Y","Y","Ketchikan Gateway Borough",130,"Other Southeast Region - Southern",9,1,351,2,356,0,7,0,1
"03/28/2021","Y","Y","Ketchikan Gateway Borough",130,"Other Southeast Region - Southern",9,0,351,1,357,0,7,0,1
"03/29/2021","Y","Y","Ketchikan Gateway Borough",130,"Other Southeast Region - Southern",9,1,352,1,358,0,7,0,1
"03/30/2021","Y","Y","Ketchikan Gateway Borough",130,"Other Southeast Region - Southern",9,3,355,1,359,0,7,0,1
"03/31/2021","Y","Y","Ketchikan Gateway Borough",130,"Other Southeast Region - Southern",9,0,355,1,360,0,7,0,1
"04/01/2021","Y","Y","Ketchikan Gateway Borough",130,"Other Southeast Region - Southern",9,1,356,0,360,0,7,0,1
"04/02/2021","Y","Y","Ketchikan Gateway Borough",130,"Other Southeast Region - Southern",9,1,357,2,362,0,7,0,1
"04/03/2021","Y","Y","Ketchikan Gateway Borough",130,"Other Southeast Region - Southern",9,3,360,0,362,0,7,0,1
"04/06/2021","Y","Y","Ketchikan Gateway Borough",130,"Other Southeast Region - Southern",9,1,361,2,364,0,7,0,1
"04/08/2021","Y","Y","Ketchikan Gateway Borough",130,"Other Southeast Region - Southern",9,1,362,1,365,0,7,0,1
"04/09/2021","Y","Y","Ketchikan Gateway Borough",130,"Other Southeast Region - Southern",9,5,367,3,368,0,7,0,1
"04/10/2021","Y","Y","Ketchikan Gateway Borough",130,"Other Southeast Region - Southern",9,0,367,1,369,0,7,0,1
"04/11/2021","Y","Y","Ketchikan Gateway Borough",130,"Other Southeast Region - Southern",9,0,367,1,370,0,7,0,1
"04/12/2021","Y","Y","Ketchikan Gateway Borough",130,"Other Southeast Region - Southern",9,1,368,1,371,0,7,0,1
"04/13/2021","Y","Y","Ketchikan Gateway Borough",130,"Other Southeast Region - Southern",9,1,369,0,371,0,7,0,1
"04/14/2021","Y","Y","Ketchikan Gateway Borough",130,"Other Southeast Region - Southern",9,0,369,2,373,0,7,0,1
"04/15/2021","Y","Y","Ketchikan Gateway Borough",130,"Other Southeast Region - Southern",9,0,369,2,375,0,7,0,1
"04/16/2021","Y","Y","Ketchikan Gateway Borough",130,"Other Southeast Region - Southern",9,4,373,1,376,0,7,0,1
"04/17/2021","Y","Y","Ketchikan Gateway Borough",130,"Other Southeast Region - Southern",9,1,374,1,377,0,7,0,1
"04/18/2021","Y","Y","Ketchikan Gateway Borough",130,"Other Southeast Region - Southern",9,1,375,4,381,0,7,0,1
"04/19/2021","Y","Y","Ketchikan Gateway Borough",130,"Other Southeast Region - Southern",9,2,377,7,388,0,7,0,1
"04/20/2021","Y","Y","Ketchikan Gateway Borough",130,"Other Southeast Region - Southern",9,4,381,2,390,0,7,0,1
"04/21/2021","Y","Y","Ketchikan Gateway Borough",130,"Other Southeast Region - Southern",9,1,382,1,391,0,7,0,1
"04/22/2021","Y","Y","Ketchikan Gateway Borough",130,"Other Southeast Region - Southern",9,1,383,3,394,0,7,0,1
"04/23/2021","Y","Y","Ketchikan Gateway Borough",130,"Other Southeast Region - Southern",9,0,383,2,396,0,7,0,1
"04/24/2021","Y","Y","Ketchikan Gateway Borough",130,"Other Southeast Region - Southern",9,3,386,2,398,0,7,0,1
"04/25/2021","Y","Y","Ketchikan Gateway Borough",130,"Other Southeast Region - Southern",9,0,386,2,400,0,7,0,1
"04/26/2021","Y","Y","Ketchikan Gateway Borough",130,"Other Southeast Region - Southern",9,2,388,3,403,0,7,0,1
"04/27/2021","Y","Y","Ketchikan Gateway Borough",130,"Other Southeast Region - Southern",9,6,394,1,404,0,7,0,1
"04/28/2021","Y","Y","Ketchikan Gateway Borough",130,"Other Southeast Region - Southern",9,3,397,7,411,0,7,0,1
"04/29/2021","Y","Y","Ketchikan Gateway Borough",130,"Other Southeast Region - Southern",9,2,399,5,416,1,8,0,1
"04/30/2021","Y","Y","Ketchikan Gateway Borough",130,"Other Southeast Region - Southern",9,3,402,3,419,0,8,0,1
"05/01/2021","Y","Y","Ketchikan Gateway Borough",130,"Other Southeast Region - Southern",9,1,403,6,425,0,8,0,1
"05/02/2021","Y","Y","Ketchikan Gateway Borough",130,"Other Southeast Region - Southern",9,3,406,3,428,0,8,0,1
"05/03/2021","Y","Y","Ketchikan Gateway Borough",130,"Other Southeast Region - Southern",9,3,409,14,442,1,9,0,1
"05/04/2021","Y","Y","Ketchikan Gateway Borough",130,"Other Southeast Region - Southern",9,10,419,8,450,0,9,0,1
"05/05/2021","Y","Y","Ketchikan Gateway Borough",130,"Other Southeast Region - Southern",9,11,430,10,460,0,9,0,1
"05/06/2021","Y","Y","Ketchikan Gateway Borough",130,"Other Southeast Region - Southern",9,17,447,12,472,0,9,0,1
"05/07/2021","Y","Y","Ketchikan Gateway Borough",130,"Other Southeast Region - Southern",9,13,460,13,485,0,9,0,1
"05/08/2021","Y","Y","Ketchikan Gateway Borough",130,"Other Southeast Region - Southern",9,4,464,10,495,0,9,0,1
"05/09/2021","Y","Y","Ketchikan Gateway Borough",130,"Other Southeast Region - Southern",9,0,464,6,501,0,9,0,1
"05/10/2021","Y","Y","Ketchikan Gateway Borough",130,"Other Southeast Region - Southern",9,6,470,12,513,0,9,0,1
"05/11/2021","Y","Y","Ketchikan Gateway Borough",130,"Other Southeast Region - Southern",9,11,481,13,526,0,9,0,1
"05/12/2021","Y","Y","Ketchikan Gateway Borough",130,"Other Southeast Region - Southern",9,13,494,14,540,1,10,0,1
"05/13/2021","Y","Y","Ketchikan Gateway Borough",130,"Other Southeast Region - Southern",9,25,519,9,549,0,10,0,1
"05/14/2021","Y","Y","Ketchikan Gateway Borough",130,"Other Southeast Region - Southern",9,6,525,4,553,0,10,0,1
"05/15/2021","Y","Y","Ketchikan Gateway Borough",130,"Other Southeast Region - Southern",9,8,533,8,561,0,10,0,1
"05/16/2021","Y","Y","Ketchikan Gateway Borough",130,"Other Southeast Region - Southern",9,2,535,2,563,0,10,0,1
"05/17/2021","Y","Y","Ketchikan Gateway Borough",130,"Other Southeast Region - Southern",9,6,541,16,579,0,10,0,1
"05/18/2021","Y","Y","Ketchikan Gateway Borough",130,"Other Southeast Region - Southern",9,14,555,8,587,1,11,0,1
"05/19/2021","Y","Y","Ketchikan Gateway Borough",130,"Other Southeast Region - Southern",9,9,564,5,592,0,11,0,1
"05/20/2021","Y","Y","Ketchikan Gateway Borough",130,"Other Southeast Region - Southern",9,9,573,5,597,0,11,0,1
"05/21/2021","Y","Y","Ketchikan Gateway Borough",130,"Other Southeast Region - Southern",9,6,579,5,602,1,12,0,1
"05/22/2021","Y","Y","Ketchikan Gateway Borough",130,"Other Southeast Region - Southern",9,7,586,3,605,0,12,0,1
"05/23/2021","Y","Y","Ketchikan Gateway Borough",130,"Other Southeast Region - Southern",9,3,589,4,609,0,12,0,1
"05/24/2021","Y","Y","Ketchikan Gateway Borough",130,"Other Southeast Region - Southern",9,1,590,2,611,0,12,0,1
"05/25/2021","Y","Y","Ketchikan Gateway Borough",130,"Other Southeast Region - Southern",9,7,597,1,612,0,12,0,1
"05/26/2021","Y","Y","Ketchikan Gateway Borough",130,"Other Southeast Region - Southern",9,7,604,1,613,1,13,0,1
"05/27/2021","Y","Y","Ketchikan Gateway Borough",130,"Other Southeast Region - Southern",9,2,606,4,617,1,14,0,1
"05/28/2021","Y","Y","Ketchikan Gateway Borough",130,"Other Southeast Region - Southern",9,4,610,1,618,0,14,0,1
"05/29/2021","Y","Y","Ketchikan Gateway Borough",130,"Other Southeast Region - Southern",9,3,613,1,619,0,14,0,1
"05/31/2021","Y","Y","Ketchikan Gateway Borough",130,"Other Southeast Region - Southern",9,0,613,1,620,0,14,0,1
"06/01/2021","Y","Y","Ketchikan Gateway Borough",130,"Other Southeast Region - Southern",9,3,616,0,620,0,14,0,1
"06/02/2021","Y","Y","Ketchikan Gateway Borough",130,"Other Southeast Region - Southern",9,1,617,1,621,0,14,0,1
"06/03/2021","Y","Y","Ketchikan Gateway Borough",130,"Other Southeast Region - Southern",9,1,618,0,621,1,15,0,1
"06/04/2021","Y","Y","Ketchikan Gateway Borough",130,"Other Southeast Region - Southern",9,0,618,1,622,0,15,0,1
"06/07/2021","Y","Y","Ketchikan Gateway Borough",130,"Other Southeast Region - Southern",9,1,619,0,622,0,15,0,1
"06/08/2021","Y","Y","Ketchikan Gateway Borough",130,"Other Southeast Region - Southern",9,0,619,1,623,0,15,0,1
"06/11/2021","Y","Y","Ketchikan Gateway Borough",130,"Other Southeast Region - Southern",9,1,620,0,623,0,15,0,1
"06/12/2021","Y","Y","Ketchikan Gateway Borough",130,"Other Southeast Region - Southern",9,1,621,1,624,0,15,0,1
"06/13/2021","Y","Y","Ketchikan Gateway Borough",130,"Other Southeast Region - Southern",9,1,622,0,624,0,15,0,1
"06/22/2021","Y","Y","Ketchikan Gateway Borough",130,"Other Southeast Region - Southern",9,0,622,1,625,0,15,0,1
"06/23/2021","Y","Y","Ketchikan Gateway Borough",130,"Other Southeast Region - Southern",9,1,623,0,625,0,15,0,1
"06/28/2021","Y","Y","Ketchikan Gateway Borough",130,"Other Southeast Region - Southern",9,1,624,1,626,0,15,0,1
"06/30/2021","Y","Y","Ketchikan Gateway Borough",130,"Other Southeast Region - Southern",9,1,625,1,627,0,15,0,1
"07/04/2021","Y","Y","Ketchikan Gateway Borough",130,"Other Southeast Region - Southern",9,0,625,1,628,0,15,0,1
"07/05/2021","Y","Y","Ketchikan Gateway Borough",130,"Other Southeast Region - Southern",9,1,626,0,628,0,15,0,1
"07/06/2021","Y","Y","Ketchikan Gateway Borough",130,"Other Southeast Region - Southern",9,0,626,2,630,0,15,0,1
"07/07/2021","Y","Y","Ketchikan Gateway Borough",130,"Other Southeast Region - Southern",9,2,628,0,630,0,15,0,1
"07/08/2021","Y","Y","Ketchikan Gateway Borough",130,"Other Southeast Region - Southern",9,0,628,2,632,0,15,0,1
"07/09/2021","Y","Y","Ketchikan Gateway Borough",130,"Other Southeast Region - Southern",9,1,629,1,633,0,15,0,1
"07/10/2021","Y","Y","Ketchikan Gateway Borough",130,"Other Southeast Region - Southern",9,1,630,0,633,0,15,0,1
"07/12/2021","Y","Y","Ketchikan Gateway Borough",130,"Other Southeast Region - Southern",9,3,633,4,637,0,15,0,1
"07/13/2021","Y","Y","Ketchikan Gateway Borough",130,"Other Southeast Region - Southern",9,2,635,0,637,0,15,0,1
"07/17/2021","Y","Y","Ketchikan Gateway Borough",130,"Other Southeast Region - Southern",9,0,635,1,638,0,15,0,1
"07/19/2021","Y","Y","Ketchikan Gateway Borough",130,"Other Southeast Region - Southern",9,4,639,4,642,0,15,0,1
"07/20/2021","Y","Y","Ketchikan Gateway Borough",130,"Other Southeast Region - Southern",9,1,640,0,642,0,15,0,1
"07/22/2021","Y","Y","Ketchikan Gateway Borough",130,"Other Southeast Region - Southern",9,1,641,5,647,0,15,0,1
"07/23/2021","Y","Y","Ketchikan Gateway Borough",130,"Other Southeast Region - Southern",9,1,642,0,647,0,15,0,1
"07/24/2021","Y","Y","Ketchikan Gateway Borough",130,"Other Southeast Region - Southern",9,4,646,2,649,0,15,0,1
"07/25/2021","Y","Y","Ketchikan Gateway Borough",130,"Other Southeast Region - Southern",9,0,646,1,650,0,15,0,1
"07/26/2021","Y","Y","Ketchikan Gateway Borough",130,"Other Southeast Region - Southern",9,2,648,2,652,0,15,0,1
"07/27/2021","Y","Y","Ketchikan Gateway Borough",130,"Other Southeast Region - Southern",9,3,651,3,655,0,15,0,1
"07/28/2021","Y","Y","Ketchikan Gateway Borough",130,"Other Southeast Region - Southern",9,5,656,11,666,0,15,0,1
"07/29/2021","Y","Y","Ketchikan Gateway Borough",130,"Other Southeast Region - Southern",9,7,663,4,670,0,15,0,1
"07/30/2021","Y","Y","Ketchikan Gateway Borough",130,"Other Southeast Region - Southern",9,7,670,5,675,1,16,0,1
"07/31/2021","Y","Y","Ketchikan Gateway Borough",130,"Other Southeast Region - Southern",9,1,671,3,678,0,16,0,1
"08/01/2021","Y","Y","Ketchikan Gateway Borough",130,"Other Southeast Region - Southern",9,0,671,4,682,0,16,0,1
"08/02/2021","Y","Y","Ketchikan Gateway Borough",130,"Other Southeast Region - Southern",9,6,677,20,702,0,16,0,1
"08/03/2021","Y","Y","Ketchikan Gateway Borough",130,"Other Southeast Region - Southern",9,13,690,16,718,0,16,0,1
"08/04/2021","Y","Y","Ketchikan Gateway Borough",130,"Other Southeast Region - Southern",9,2,692,8,726,0,16,0,1
"08/05/2021","Y","Y","Ketchikan Gateway Borough",130,"Other Southeast Region - Southern",9,13,705,12,738,0,16,0,1
"08/06/2021","Y","Y","Ketchikan Gateway Borough",130,"Other Southeast Region - Southern",9,19,724,7,745,0,16,0,1
"08/07/2021","Y","Y","Ketchikan Gateway Borough",130,"Other Southeast Region - Southern",9,5,729,3,748,0,16,0,1
"08/08/2021","Y","Y","Ketchikan Gateway Borough",130,"Other Southeast Region - Southern",9,4,733,2,750,0,16,0,1
"08/09/2021","Y","Y","Ketchikan Gateway Borough",130,"Other Southeast Region - Southern",9,7,740,33,783,2,18,1,2
"08/10/2021","Y","Y","Ketchikan Gateway Borough",130,"Other Southeast Region - Southern",9,18,758,19,802,0,18,0,2
"08/11/2021","Y","Y","Ketchikan Gateway Borough",130,"Other Southeast Region - Southern",9,37,795,15,817,0,18,1,3
"08/12/2021","Y","Y","Ketchikan Gateway Borough",130,"Other Southeast Region - Southern",9,10,805,15,832,0,18,2,5
"08/13/2021","Y","Y","Ketchikan Gateway Borough",130,"Other Southeast Region - Southern",9,8,813,14,846,0,18,0,5
"08/14/2021","Y","Y","Ketchikan Gateway Borough",130,"Other Southeast Region - Southern",9,3,816,12,858,0,18,1,6
"08/15/2021","Y","Y","Ketchikan Gateway Borough",130,"Other Southeast Region - Southern",9,4,820,9,867,0,18,1,7
"08/16/2021","Y","Y","Ketchikan Gateway Borough",130,"Other Southeast Region - Southern",9,22,842,11,878,0,18,0,7
"08/17/2021","Y","Y","Ketchikan Gateway Borough",130,"Other Southeast Region - Southern",9,21,863,22,900,0,18,0,7
"08/18/2021","Y","Y","Ketchikan Gateway Borough",130,"Other Southeast Region - Southern",9,12,875,8,908,0,18,0,7
"08/19/2021","Y","Y","Ketchikan Gateway Borough",130,"Other Southeast Region - Southern",9,16,891,11,919,0,18,0,7
"08/20/2021","Y","Y","Ketchikan Gateway Borough",130,"Other Southeast Region - Southern",9,2,893,10,929,1,19,0,7
"08/21/2021","Y","Y","Ketchikan Gateway Borough",130,"Other Southeast Region - Southern",9,4,897,8,937,0,19,0,7
"08/22/2021","Y","Y","Ketchikan Gateway Borough",130,"Other Southeast Region - Southern",9,0,897,5,942,0,19,0,7
"08/23/2021","Y","Y","Ketchikan Gateway Borough",130,"Other Southeast Region - Southern",9,6,903,18,960,0,19,0,7
"08/24/2021","Y","Y","Ketchikan Gateway Borough",130,"Other Southeast Region - Southern",9,14,917,15,975,0,19,0,7
"08/25/2021","Y","Y","Ketchikan Gateway Borough",130,"Other Southeast Region - Southern",9,43,960,11,986,0,19,0,7
"08/26/2021","Y","Y","Ketchikan Gateway Borough",130,"Other Southeast Region - Southern",9,14,974,18,1004,0,19,0,7
"08/27/2021","Y","Y","Ketchikan Gateway Borough",130,"Other Southeast Region - Southern",9,16,990,22,1026,0,19,1,8
"08/28/2021","Y","Y","Ketchikan Gateway Borough",130,"Other Southeast Region - Southern",9,0,990,9,1035,0,19,0,8
"08/29/2021","Y","Y","Ketchikan Gateway Borough",130,"Other Southeast Region - Southern",9,2,992,11,1046,0,19,0,8
"08/30/2021","Y","Y","Ketchikan Gateway Borough",130,"Other Southeast Region - Southern",9,26,1018,24,1070,1,20,0,8
"08/31/2021","Y","Y","Ketchikan Gateway Borough",130,"Other Southeast Region - Southern",9,23,1041,7,1077,0,20,0,8
"09/01/2021","Y","Y","Ketchikan Gateway Borough",130,"Other Southeast Region - Southern",9,11,1052,18,1095,0,20,0,8
"09/02/2021","Y","Y","Ketchikan Gateway Borough",130,"Other Southeast Region - Southern",9,6,1058,8,1103,0,20,0,8
"09/03/2021","Y","Y","Ketchikan Gateway Borough",130,"Other Southeast Region - Southern",9,18,1076,20,1123,0,20,0,8
"09/04/2021","Y","Y","Ketchikan Gateway Borough",130,"Other Southeast Region - Southern",9,25,1101,6,1129,0,20,0,8
"09/05/2021","Y","Y","Ketchikan Gateway Borough",130,"Other Southeast Region - Southern",9,1,1102,13,1142,1,21,0,8
"09/06/2021","Y","Y","Ketchikan Gateway Borough",130,"Other Southeast Region - Southern",9,5,1107,6,1148,0,21,0,8
"09/07/2021","Y","Y","Ketchikan Gateway Borough",130,"Other Southeast Region - Southern",9,19,1126,22,1170,0,21,0,8
"09/08/2021","Y","Y","Ketchikan Gateway Borough",130,"Other Southeast Region - Southern",9,22,1148,12,1182,0,21,0,8
"09/09/2021","Y","Y","Ketchikan Gateway Borough",130,"Other Southeast Region - Southern",9,7,1155,14,1196,0,21,0,8
"09/10/2021","Y","Y","Ketchikan Gateway Borough",130,"Other Southeast Region - Southern",9,10,1165,10,1206,0,21,0,8
"09/11/2021","Y","Y","Ketchikan Gateway Borough",130,"Other Southeast Region - Southern",9,4,1169,4,1210,0,21,0,8
"09/12/2021","Y","Y","Ketchikan Gateway Borough",130,"Other Southeast Region - Southern",9,1,1170,2,1212,1,22,0,8
"09/13/2021","Y","Y","Ketchikan Gateway Borough",130,"Other Southeast Region - Southern",9,11,1181,5,1217,0,22,0,8
"09/14/2021","Y","Y","Ketchikan Gateway Borough",130,"Other Southeast Region - Southern",9,5,1186,7,1224,0,22,0,8
"09/15/2021","Y","Y","Ketchikan Gateway Borough",130,"Other Southeast Region - Southern",9,13,1199,13,1237,0,22,1,9
"09/16/2021","Y","Y","Ketchikan Gateway Borough",130,"Other Southeast Region - Southern",9,5,1204,10,1247,0,22,0,9
"09/17/2021","Y","Y","Ketchikan Gateway Borough",130,"Other Southeast Region - Southern",9,15,1219,14,1261,0,22,0,9
"09/18/2021","Y","Y","Ketchikan Gateway Borough",130,"Other Southeast Region - Southern",9,10,1229,12,1273,0,22,1,10
"09/19/2021","Y","Y","Ketchikan Gateway Borough",130,"Other Southeast Region - Southern",9,10,1239,4,1277,0,22,0,10
"09/20/2021","Y","Y","Ketchikan Gateway Borough",130,"Other Southeast Region - Southern",9,6,1245,12,1289,0,22,0,10
"09/21/2021","Y","Y","Ketchikan Gateway Borough",130,"Other Southeast Region - Southern",9,7,1252,10,1299,0,22,1,11
"09/22/2021","Y","Y","Ketchikan Gateway Borough",130,"Other Southeast Region - Southern",9,9,1261,0,1299,0,22,0,11
"09/23/2021","Y","Y","Ketchikan Gateway Borough",130,"Other Southeast Region - Southern",9,4,1265,6,1305,1,23,0,11
"09/24/2021","Y","Y","Ketchikan Gateway Borough",130,"Other Southeast Region - Southern",9,6,1271,12,1317,0,23,0,11
"09/25/2021","Y","Y","Ketchikan Gateway Borough",130,"Other Southeast Region - Southern",9,7,1278,1,1318,0,23,0,11
"09/26/2021","Y","Y","Ketchikan Gateway Borough",130,"Other Southeast Region - Southern",9,10,1288,3,1321,0,23,0,11
"09/27/2021","Y","Y","Ketchikan Gateway Borough",130,"Other Southeast Region - Southern",9,11,1299,18,1339,0,23,0,11
"09/28/2021","Y","Y","Ketchikan Gateway Borough",130,"Other Southeast Region - Southern",9,8,1307,10,1349,0,23,0,11
"09/29/2021","Y","Y","Ketchikan Gateway Borough",130,"Other Southeast Region - Southern",9,28,1335,6,1355,0,23,0,11
"09/30/2021","Y","Y","Ketchikan Gateway Borough",130,"Other Southeast Region - Southern",9,4,1339,11,1366,0,23,0,11
"10/01/2021","Y","Y","Ketchikan Gateway Borough",130,"Other Southeast Region - Southern",9,9,1348,9,1375,0,23,0,11
"10/02/2021","Y","Y","Ketchikan Gateway Borough",130,"Other Southeast Region - Southern",9,13,1361,0,1375,0,23,0,11
"10/03/2021","Y","Y","Ketchikan Gateway Borough",130,"Other Southeast Region - Southern",9,5,1366,10,1385,0,23,0,11
"10/04/2021","Y","Y","Ketchikan Gateway Borough",130,"Other Southeast Region - Southern",9,12,1378,17,1402,0,23,0,11
"10/05/2021","Y","Y","Ketchikan Gateway Borough",130,"Other Southeast Region - Southern",9,5,1383,18,1420,0,23,0,11
"10/06/2021","Y","Y","Ketchikan Gateway Borough",130,"Other Southeast Region - Southern",9,23,1406,4,1424,0,23,0,11
"10/07/2021","Y","Y","Ketchikan Gateway Borough",130,"Other Southeast Region - Southern",9,5,1411,7,1431,0,23,0,11
"10/08/2021","Y","Y","Ketchikan Gateway Borough",130,"Other Southeast Region - Southern",9,7,1418,7,1438,0,23,0,11
"10/09/2021","Y","Y","Ketchikan Gateway Borough",130,"Other Southeast Region - Southern",9,4,1422,4,1442,0,23,0,11
"10/10/2021","Y","Y","Ketchikan Gateway Borough",130,"Other Southeast Region - Southern",9,2,1424,0,1442,0,23,0,11
"10/11/2021","Y","Y","Ketchikan Gateway Borough",130,"Other Southeast Region - Southern",9,5,1429,8,1450,0,23,0,11
"10/12/2021","Y","Y","Ketchikan Gateway Borough",130,"Other Southeast Region - Southern",9,9,1438,4,1454,0,23,0,11
"10/13/2021","Y","Y","Ketchikan Gateway Borough",130,"Other Southeast Region - Southern",9,5,1443,6,1460,1,24,0,11
"10/14/2021","Y","Y","Ketchikan Gateway Borough",130,"Other Southeast Region - Southern",9,13,1456,9,1469,0,24,0,11
"10/15/2021","Y","Y","Ketchikan Gateway Borough",130,"Other Southeast Region - Southern",9,5,1461,10,1479,0,24,0,11
"10/16/2021","Y","Y","Ketchikan Gateway Borough",130,"Other Southeast Region - Southern",9,6,1467,6,1485,0,24,0,11
"10/17/2021","Y","Y","Ketchikan Gateway Borough",130,"Other Southeast Region - Southern",9,3,1470,3,1488,1,25,0,11
"10/18/2021","Y","Y","Ketchikan Gateway Borough",130,"Other Southeast Region - Southern",9,5,1475,23,1511,0,25,0,11
"10/19/2021","Y","Y","Ketchikan Gateway Borough",130,"Other Southeast Region - Southern",9,16,1491,20,1531,0,25,0,11
"10/20/2021","Y","Y","Ketchikan Gateway Borough",130,"Other Southeast Region - Southern",9,20,1511,15,1546,0,25,0,11
"10/21/2021","Y","Y","Ketchikan Gateway Borough",130,"Other Southeast Region - Southern",9,15,1526,10,1556,0,25,0,11
"10/22/2021","Y","Y","Ketchikan Gateway Borough",130,"Other Southeast Region - Southern",9,18,1544,9,1565,0,25,0,11
"10/23/2021","Y","Y","Ketchikan Gateway Borough",130,"Other Southeast Region - Southern",9,8,1552,4,1569,0,25,0,11
"10/24/2021","Y","Y","Ketchikan Gateway Borough",130,"Other Southeast Region - Southern",9,7,1559,4,1573,0,25,0,11
"10/25/2021","Y","Y","Ketchikan Gateway Borough",130,"Other Southeast Region - Southern",9,8,1567,6,1579,0,25,0,11
"10/26/2021","Y","Y","Ketchikan Gateway Borough",130,"Other Southeast Region - Southern",9,3,1570,2,1581,0,25,0,11
"10/27/2021","Y","Y","Ketchikan Gateway Borough",130,"Other Southeast Region - Southern",9,1,1571,4,1585,0,25,0,11
"10/28/2021","Y","Y","Ketchikan Gateway Borough",130,"Other Southeast Region - Southern",9,12,1583,8,1593,0,25,0,11
"10/29/2021","Y","Y","Ketchikan Gateway Borough",130,"Other Southeast Region - Southern",9,8,1591,1,1594,0,25,0,11
"10/30/2021","Y","Y","Ketchikan Gateway Borough",130,"Other Southeast Region - Southern",9,3,1594,4,1598,0,25,0,11
"10/31/2021","Y","Y","Ketchikan Gateway Borough",130,"Other Southeast Region - Southern",9,0,1594,1,1599,0,25,0,11
"11/01/2021","Y","Y","Ketchikan Gateway Borough",130,"Other Southeast Region - Southern",9,2,1596,12,1611,0,25,0,11
"11/02/2021","Y","Y","Ketchikan Gateway Borough",130,"Other Southeast Region - Southern",9,6,1602,8,1619,0,25,0,11
"11/03/2021","Y","Y","Ketchikan Gateway Borough",130,"Other Southeast Region - Southern",9,7,1609,8,1627,0,25,0,11
"11/04/2021","Y","Y","Ketchikan Gateway Borough",130,"Other Southeast Region - Southern",9,10,1619,16,1643,0,25,0,11
"11/05/2021","Y","Y","Ketchikan Gateway Borough",130,"Other Southeast Region - Southern",9,13,1632,7,1650,0,25,0,11
"11/06/2021","Y","Y","Ketchikan Gateway Borough",130,"Other Southeast Region - Southern",9,7,1639,7,1657,0,25,0,11
"11/07/2021","Y","Y","Ketchikan Gateway Borough",130,"Other Southeast Region - Southern",9,4,1643,1,1658,0,25,0,11
"11/08/2021","Y","Y","Ketchikan Gateway Borough",130,"Other Southeast Region - Southern",9,3,1646,23,1681,0,25,0,11
"11/09/2021","Y","Y","Ketchikan Gateway Borough",130,"Other Southeast Region - Southern",9,10,1656,14,1695,0,25,0,11
"11/10/2021","Y","Y","Ketchikan Gateway Borough",130,"Other Southeast Region - Southern",9,20,1676,11,1706,0,25,0,11
"11/11/2021","Y","Y","Ketchikan Gateway Borough",130,"Other Southeast Region - Southern",9,6,1682,19,1725,0,25,0,11
"11/12/2021","Y","Y","Ketchikan Gateway Borough",130,"Other Southeast Region - Southern",9,24,1706,22,1747,1,26,0,11
"11/13/2021","Y","Y","Ketchikan Gateway Borough",130,"Other Southeast Region - Southern",9,17,1723,4,1751,0,26,0,11
"11/14/2021","Y","Y","Ketchikan Gateway Borough",130,"Other Southeast Region - Southern",9,9,1732,4,1755,0,26,0,11
"11/15/2021","Y","Y","Ketchikan Gateway Borough",130,"Other Southeast Region - Southern",9,9,1741,19,1774,0,26,0,11
"11/16/2021","Y","Y","Ketchikan Gateway Borough",130,"Other Southeast Region - Southern",9,20,1761,20,1794,0,26,0,11
"11/17/2021","Y","Y","Ketchikan Gateway Borough",130,"Other Southeast Region - Southern",9,2,1763,9,1803,1,27,0,11
"11/18/2021","Y","Y","Ketchikan Gateway Borough",130,"Other Southeast Region - Southern",9,26,1789,16,1819,0,27,0,11
"11/19/2021","Y","Y","Ketchikan Gateway Borough",130,"Other Southeast Region - Southern",9,9,1798,14,1833,0,27,2,13
"11/20/2021","Y","Y","Ketchikan Gateway Borough",130,"Other Southeast Region - Southern",9,18,1816,6,1839,0,27,0,13
"11/21/2021","Y","Y","Ketchikan Gateway Borough",130,"Other Southeast Region - Southern",9,7,1823,1,1840,1,28,0,13
"11/22/2021","Y","Y","Ketchikan Gateway Borough",130,"Other Southeast Region - Southern",9,3,1826,22,1862,0,28,0,13
"11/23/2021","Y","Y","Ketchikan Gateway Borough",130,"Other Southeast Region - Southern",9,21,1847,22,1884,0,28,0,13
"11/24/2021","Y","Y","Ketchikan Gateway Borough",130,"Other Southeast Region - Southern",9,24,1871,15,1899,0,28,0,13
"11/25/2021","Y","Y","Ketchikan Gateway Borough",130,"Other Southeast Region - Southern",9,0,1871,4,1903,0,28,0,13
"11/26/2021","Y","Y","Ketchikan Gateway Borough",130,"Other Southeast Region - Southern",9,27,1898,16,1919,0,28,0,13
"11/27/2021","Y","Y","Ketchikan Gateway Borough",130,"Other Southeast Region - Southern",9,12,1910,1,1920,0,28,0,13
"11/28/2021","Y","Y","Ketchikan Gateway Borough",130,"Other Southeast Region - Southern",9,5,1915,2,1922,0,28,0,13
"11/29/2021","Y","Y","Ketchikan Gateway Borough",130,"Other Southeast Region - Southern",9,5,1920,34,1956,0,28,0,13
"11/30/2021","Y","Y","Ketchikan Gateway Borough",130,"Other Southeast Region - Southern",9,10,1930,20,1976,0,28,0,13
"12/01/2021","Y","Y","Ketchikan Gateway Borough",130,"Other Southeast Region - Southern",9,30,1960,25,2001,1,29,0,13
"12/02/2021","Y","Y","Ketchikan Gateway Borough",130,"Other Southeast Region - Southern",9,27,1987,12,2013,1,30,0,13
"12/03/2021","Y","Y","Ketchikan Gateway Borough",130,"Other Southeast Region - Southern",9,17,2004,12,2025,0,30,0,13
"12/04/2021","Y","Y","Ketchikan Gateway Borough",130,"Other Southeast Region - Southern",9,0,2004,3,2028,0,30,0,13
"12/05/2021","Y","Y","Ketchikan Gateway Borough",130,"Other Southeast Region - Southern",9,16,2020,0,2028,0,30,0,13
"12/06/2021","Y","Y","Ketchikan Gateway Borough",130,"Other Southeast Region - Southern",9,5,2025,29,2057,0,30,0,13
"12/07/2021","Y","Y","Ketchikan Gateway Borough",130,"Other Southeast Region - Southern",9,24,2049,9,2066,1,31,0,13
"12/08/2021","Y","Y","Ketchikan Gateway Borough",130,"Other Southeast Region - Southern",9,3,2052,10,2076,0,31,0,13
"12/09/2021","Y","Y","Ketchikan Gateway Borough",130,"Other Southeast Region - Southern",9,11,2063,15,2091,0,31,1,14
"12/10/2021","Y","Y","Ketchikan Gateway Borough",130,"Other Southeast Region - Southern",9,13,2076,6,2097,0,31,0,14
"12/11/2021","Y","Y","Ketchikan Gateway Borough",130,"Other Southeast Region - Southern",9,7,2083,4,2101,0,31,0,14
"12/12/2021","Y","Y","Ketchikan Gateway Borough",130,"Other Southeast Region - Southern",9,2,2085,0,2101,1,32,0,14
"12/13/2021","Y","Y","Ketchikan Gateway Borough",130,"Other Southeast Region - Southern",9,11,2096,10,2111,0,32,0,14
"12/14/2021","Y","Y","Ketchikan Gateway Borough",130,"Other Southeast Region - Southern",9,8,2104,11,2122,1,33,0,14
"12/15/2021","Y","Y","Ketchikan Gateway Borough",130,"Other Southeast Region - Southern",9,18,2122,9,2131,1,34,0,14
"12/16/2021","Y","Y","Ketchikan Gateway Borough",130,"Other Southeast Region - Southern",9,10,2132,7,2138,0,34,0,14
"12/17/2021","Y","Y","Ketchikan Gateway Borough",130,"Other Southeast Region - Southern",9,3,2135,12,2150,0,34,1,15
"12/18/2021","Y","Y","Ketchikan Gateway Borough",130,"Other Southeast Region - Southern",9,1,2136,1,2151,0,34,0,15
"12/19/2021","Y","Y","Ketchikan Gateway Borough",130,"Other Southeast Region - Southern",9,1,2137,1,2152,0,34,0,15
"12/20/2021","Y","Y","Ketchikan Gateway Borough",130,"Other Southeast Region - Southern",9,10,2147,10,2162,0,34,0,15
"12/21/2021","Y","Y","Ketchikan Gateway Borough",130,"Other Southeast Region - Southern",9,8,2155,10,2172,0,34,0,15
"12/22/2021","Y","Y","Ketchikan Gateway Borough",130,"Other Southeast Region - Southern",9,6,2161,12,2184,0,34,0,15
"12/23/2021","Y","Y","Ketchikan Gateway Borough",130,"Other Southeast Region - Southern",9,19,2180,8,2192,0,34,0,15
"12/24/2021","Y","Y","Ketchikan Gateway Borough",130,"Other Southeast Region - Southern",9,2,2182,7,2199,0,34,0,15
"12/25/2021","Y","Y","Ketchikan Gateway Borough",130,"Other Southeast Region - Southern",9,0,2182,1,2200,1,35,0,15
"12/26/2021","Y","Y","Ketchikan Gateway Borough",130,"Other Southeast Region - Southern",9,4,2186,4,2204,0,35,0,15
"12/27/2021","Y","Y","Ketchikan Gateway Borough",130,"Other Southeast Region - Southern",9,16,2202,13,2217,0,35,0,15
"12/28/2021","Y","Y","Ketchikan Gateway Borough",130,"Other Southeast Region - Southern",9,8,2210,14,2231,0,35,0,15
"12/29/2021","Y","Y","Ketchikan Gateway Borough",130,"Other Southeast Region - Southern",9,9,2219,15,2246,0,35,0,15
"12/30/2021","Y","Y","Ketchikan Gateway Borough",130,"Other Southeast Region - Southern",9,10,2229,2,2248,0,35,0,15
"12/31/2021","Y","Y","Ketchikan Gateway Borough",130,"Other Southeast Region - Southern",9,1,2230,8,2256,0,35,0,15
"01/01/2022","Y","Y","Ketchikan Gateway Borough",130,"Other Southeast Region - Southern",9,4,2234,2,2258,0,35,0,15
"01/02/2022","Y","Y","Ketchikan Gateway Borough",130,"Other Southeast Region - Southern",9,3,2237,19,2277,0,35,0,15
"01/03/2022","Y","Y","Ketchikan Gateway Borough",130,"Other Southeast Region - Southern",9,19,2256,31,2308,0,35,0,15
"01/04/2022","Y","Y","Ketchikan Gateway Borough",130,"Other Southeast Region - Southern",9,5,2261,23,2331,0,35,0,15
"01/05/2022","Y","Y","Ketchikan Gateway Borough",130,"Other Southeast Region - Southern",9,11,2272,25,2356,0,35,0,15
"01/06/2022","Y","Y","Ketchikan Gateway Borough",130,"Other Southeast Region - Southern",9,8,2280,25,2381,0,35,0,15
"01/07/2022","Y","Y","Ketchikan Gateway Borough",130,"Other Southeast Region - Southern",9,20,2300,29,2410,0,35,2,17
"01/08/2022","Y","Y","Ketchikan Gateway Borough",130,"Other Southeast Region - Southern",9,6,2306,24,2434,0,35,0,17
"01/09/2022","Y","Y","Ketchikan Gateway Borough",130,"Other Southeast Region - Southern",9,1,2307,3,2437,0,35,0,17
"01/10/2022","Y","Y","Ketchikan Gateway Borough",130,"Other Southeast Region - Southern",9,54,2361,32,2469,0,35,0,17
"01/11/2022","Y","Y","Ketchikan Gateway Borough",130,"Other Southeast Region - Southern",9,40,2401,50,2519,0,35,0,17
"01/12/2022","Y","Y","Ketchikan Gateway Borough",130,"Other Southeast Region - Southern",9,59,2460,40,2559,0,35,0,17
"01/13/2022","Y","Y","Ketchikan Gateway Borough",130,"Other Southeast Region - Southern",9,53,2513,37,2596,0,35,0,17
"01/14/2022","Y","Y","Ketchikan Gateway Borough",130,"Other Southeast Region - Southern",9,11,2524,36,2632,0,35,0,17
"01/15/2022","Y","Y","Ketchikan Gateway Borough",130,"Other Southeast Region - Southern",9,6,2530,35,2667,0,35,0,17
"01/16/2022","Y","Y","Ketchikan Gateway Borough",130,"Other Southeast Region - Southern",9,7,2537,10,2677,0,35,0,17
"01/17/2022","Y","Y","Ketchikan Gateway Borough",130,"Other Southeast Region - Southern",9,20,2557,49,2726,1,36,0,17
"01/18/2022","Y","Y","Ketchikan Gateway Borough",130,"Other Southeast Region - Southern",9,62,2619,21,2747,0,36,0,17
"01/19/2022","Y","Y","Ketchikan Gateway Borough",130,"Other Southeast Region - Southern",9,39,2658,39,2786,0,36,0,17
"01/20/2022","Y","Y","Ketchikan Gateway Borough",130,"Other Southeast Region - Southern",9,51,2709,34,2820,0,36,0,17
"01/21/2022","Y","Y","Ketchikan Gateway Borough",130,"Other Southeast Region - Southern",9,99,2808,75,2895,0,36,0,17
"01/22/2022","Y","Y","Ketchikan Gateway Borough",130,"Other Southeast Region - Southern",9,20,2828,15,2910,0,36,0,17
"01/23/2022","Y","Y","Ketchikan Gateway Borough",130,"Other Southeast Region - Southern",9,53,2881,54,2964,0,36,0,17
"01/24/2022","Y","Y","Ketchikan Gateway Borough",130,"Other Southeast Region - Southern",9,61,2942,65,3029,0,36,0,17
"01/25/2022","Y","Y","Ketchikan Gateway Borough",130,"Other Southeast Region - Southern",9,25,2967,27,3056,0,36,0,17
"01/26/2022","Y","Y","Ketchikan Gateway Borough",130,"Other Southeast Region - Southern",9,107,3074,88,3144,0,36,0,17
"01/27/2022","Y","Y","Ketchikan Gateway Borough",130,"Other Southeast Region - Southern",9,46,3120,61,3205,0,36,0,17
"01/28/2022","Y","Y","Ketchikan Gateway Borough",130,"Other Southeast Region - Southern",9,25,3145,22,3227,0,36,0,17
"01/29/2022","Y","Y","Ketchikan Gateway Borough",130,"Other Southeast Region - Southern",9,10,3155,7,3234,0,36,0,17
"01/30/2022","Y","Y","Ketchikan Gateway Borough",130,"Other Southeast Region - Southern",9,3,3158,12,3246,0,36,0,17
"01/31/2022","Y","Y","Ketchikan Gateway Borough",130,"Other Southeast Region - Southern",9,37,3195,35,3281,0,36,0,17
"02/01/2022","Y","Y","Ketchikan Gateway Borough",130,"Other Southeast Region - Southern",9,40,3235,38,3319,0,36,0,17
"02/02/2022","Y","Y","Ketchikan Gateway Borough",130,"Other Southeast Region - Southern",9,34,3269,19,3338,0,36,0,17
"02/03/2022","Y","Y","Ketchikan Gateway Borough",130,"Other Southeast Region - Southern",9,65,3334,33,3371,0,36,0,17
"02/04/2022","Y","Y","Ketchikan Gateway Borough",130,"Other Southeast Region - Southern",9,25,3359,27,3398,0,36,0,17
"02/05/2022","Y","Y","Ketchikan Gateway Borough",130,"Other Southeast Region - Southern",9,29,3388,8,3406,0,36,0,17
"02/06/2022","Y","Y","Ketchikan Gateway Borough",130,"Other Southeast Region - Southern",9,2,3390,5,3411,0,36,0,17
"02/07/2022","Y","Y","Ketchikan Gateway Borough",130,"Other Southeast Region - Southern",9,40,3430,43,3454,0,36,0,17
"02/08/2022","Y","Y","Ketchikan Gateway Borough",130,"Other Southeast Region - Southern",9,16,3446,15,3469,0,36,0,17
"02/09/2022","Y","Y","Ketchikan Gateway Borough",130,"Other Southeast Region - Southern",9,9,3455,10,3479,0,36,0,17
"02/10/2022","Y","Y","Ketchikan Gateway Borough",130,"Other Southeast Region - Southern",9,14,3469,9,3488,0,36,0,17
"02/11/2022","Y","Y","Ketchikan Gateway Borough",130,"Other Southeast Region - Southern",9,21,3490,11,3499,0,36,0,17
"02/12/2022","Y","Y","Ketchikan Gateway Borough",130,"Other Southeast Region - Southern",9,7,3497,3,3502,1,37,0,17
"02/13/2022","Y","Y","Ketchikan Gateway Borough",130,"Other Southeast Region - Southern",9,1,3498,0,3502,0,37,0,17
"02/14/2022","Y","Y","Ketchikan Gateway Borough",130,"Other Southeast Region - Southern",9,14,3512,15,3517,0,37,0,17
"02/15/2022","Y","Y","Ketchikan Gateway Borough",130,"Other Southeast Region - Southern",9,2,3514,2,3519,0,37,0,17
"02/16/2022","Y","Y","Ketchikan Gateway Borough",130,"Other Southeast Region - Southern",9,0,3514,3,3522,0,37,0,17
"02/17/2022","Y","Y","Ketchikan Gateway Borough",130,"Other Southeast Region - Southern",9,13,3527,11,3533,0,37,0,17
"02/18/2022","Y","Y","Ketchikan Gateway Borough",130,"Other Southeast Region - Southern",9,9,3536,8,3541,1,38,0,17
"02/19/2022","Y","Y","Ketchikan Gateway Borough",130,"Other Southeast Region - Southern",9,4,3540,1,3542,0,38,0,17
"02/20/2022","Y","Y","Ketchikan Gateway Borough",130,"Other Southeast Region - Southern",9,0,3540,2,3544,0,38,0,17
"02/21/2022","Y","Y","Ketchikan Gateway Borough",130,"Other Southeast Region - Southern",9,13,3553,12,3556,0,38,0,17
"02/22/2022","Y","Y","Ketchikan Gateway Borough",130,"Other Southeast Region - Southern",9,3,3556,3,3559,0,38,0,17
"02/23/2022","Y","Y","Ketchikan Gateway Borough",130,"Other Southeast Region - Southern",9,5,3561,5,3564,0,38,0,17
"02/25/2022","Y","Y","Ketchikan Gateway Borough",130,"Other Southeast Region - Southern",9,7,3568,7,3571,0,38,0,17
"02/27/2022","Y","Y","Ketchikan Gateway Borough",130,"Other Southeast Region - Southern",9,1,3569,3,3574,0,38,0,17
"02/28/2022","Y","Y","Ketchikan Gateway Borough",130,"Other Southeast Region - Southern",9,10,3579,7,3581,0,38,0,17
"03/01/2022","Y","Y","Ketchikan Gateway Borough",130,"Other Southeast Region - Southern",9,8,3587,9,3590,0,38,0,17
"03/02/2022","Y","Y","Ketchikan Gateway Borough",130,"Other Southeast Region - Southern",9,3,3590,1,3591,0,38,0,17
"03/03/2022","Y","Y","Ketchikan Gateway Borough",130,"Other Southeast Region - Southern",9,14,3604,14,3605,0,38,0,17
"03/04/2022","Y","Y","Ketchikan Gateway Borough",130,"Other Southeast Region - Southern",9,15,3619,14,3619,0,38,0,17
"03/05/2022","Y","Y","Ketchikan Gateway Borough",130,"Other Southeast Region - Southern",9,3,3622,4,3623,0,38,0,17
"03/06/2022","Y","Y","Ketchikan Gateway Borough",130,"Other Southeast Region - Southern",9,1,3623,3,3626,0,38,0,17
"03/07/2022","Y","Y","Ketchikan Gateway Borough",130,"Other Southeast Region - Southern",9,16,3639,18,3644,0,38,0,17
"03/08/2022","Y","Y","Ketchikan Gateway Borough",130,"Other Southeast Region - Southern",9,11,3650,11,3655,0,38,0,17
"03/09/2022","Y","Y","Ketchikan Gateway Borough",130,"Other Southeast Region - Southern",9,5,3655,5,3660,0,38,0,17
"03/10/2022","Y","Y","Ketchikan Gateway Borough",130,"Other Southeast Region - Southern",9,3,3658,3,3663,0,38,0,17
"03/11/2022","Y","Y","Ketchikan Gateway Borough",130,"Other Southeast Region - Southern",9,4,3662,4,3667,0,38,0,17
"03/12/2022","Y","Y","Ketchikan Gateway Borough",130,"Other Southeast Region - Southern",9,8,3670,4,3671,0,38,0,17
"03/14/2022","Y","Y","Ketchikan Gateway Borough",130,"Other Southeast Region - Southern",9,3,3673,2,3673,0,38,0,17
"03/15/2022","Y","Y","Ketchikan Gateway Borough",130,"Other Southeast Region - Southern",9,10,3683,10,3683,0,38,0,17
"03/16/2022","Y","Y","Ketchikan Gateway Borough",130,"Other Southeast Region - Southern",9,3,3686,3,3686,0,38,0,17
"03/17/2022","Y","Y","Ketchikan Gateway Borough",130,"Other Southeast Region - Southern",9,9,3695,11,3697,0,38,0,17
"03/18/2022","Y","Y","Ketchikan Gateway Borough",130,"Other Southeast Region - Southern",9,3,3698,3,3700,0,38,0,17
"03/19/2022","Y","Y","Ketchikan Gateway Borough",130,"Other Southeast Region - Southern",9,2,3700,1,3701,0,38,0,17
"03/20/2022","Y","Y","Ketchikan Gateway Borough",130,"Other Southeast Region - Southern",9,1,3701,1,3702,0,38,0,17
"03/21/2022","Y","Y","Ketchikan Gateway Borough",130,"Other Southeast Region - Southern",9,10,3711,9,3711,0,38,0,17
"03/22/2022","Y","Y","Ketchikan Gateway Borough",130,"Other Southeast Region - Southern",9,11,3722,13,3724,0,38,0,17
"03/23/2022","Y","Y","Ketchikan Gateway Borough",130,"Other Southeast Region - Southern",9,2,3724,1,3725,0,38,0,17
"03/24/2022","Y","Y","Ketchikan Gateway Borough",130,"Other Southeast Region - Southern",9,4,3728,6,3731,0,38,0,17
"03/25/2022","Y","Y","Ketchikan Gateway Borough",130,"Other Southeast Region - Southern",9,7,3735,8,3739,0,38,0,17
"03/26/2022","Y","Y","Ketchikan Gateway Borough",130,"Other Southeast Region - Southern",9,1,3736,0,3739,0,38,0,17
"03/27/2022","Y","Y","Ketchikan Gateway Borough",130,"Other Southeast Region - Southern",9,1,3737,1,3740,0,38,0,17
"03/28/2022","Y","Y","Ketchikan Gateway Borough",130,"Other Southeast Region - Southern",9,0,3737,3,3743,0,38,0,17
"03/29/2022","Y","Y","Ketchikan Gateway Borough",130,"Other Southeast Region - Southern",9,5,3742,4,3747,0,38,0,17
"03/30/2022","Y","Y","Ketchikan Gateway Borough",130,"Other Southeast Region - Southern",9,22,3764,20,3767,0,38,0,17
"03/31/2022","Y","Y","Ketchikan Gateway Borough",130,"Other Southeast Region - Southern",9,3,3767,3,3770,0,38,0,17
"04/01/2022","Y","Y","Ketchikan Gateway Borough",130,"Other Southeast Region - Southern",9,4,3771,1,3771,0,38,0,17
"04/02/2022","Y","Y","Ketchikan Gateway Borough",130,"Other Southeast Region - Southern",9,1,3772,1,3772,0,38,0,17
"04/03/2022","Y","Y","Ketchikan Gateway Borough",130,"Other Southeast Region - Southern",9,0,3772,1,3773,0,38,0,17
"04/04/2022","Y","Y","Ketchikan Gateway Borough",130,"Other Southeast Region - Southern",9,5,3777,4,3777,0,38,0,17
"04/05/2022","Y","Y","Ketchikan Gateway Borough",130,"Other Southeast Region - Southern",9,1,3778,1,3778,0,38,0,17
"04/08/2022","Y","Y","Ketchikan Gateway Borough",130,"Other Southeast Region - Southern",9,8,3786,9,3787,0,38,0,17
"04/09/2022","Y","Y","Ketchikan Gateway Borough",130,"Other Southeast Region - Southern",9,6,3792,5,3792,0,38,0,17
"04/10/2022","Y","Y","Ketchikan Gateway Borough",130,"Other Southeast Region - Southern",9,0,3792,1,3793,0,38,0,17
"04/11/2022","Y","Y","Ketchikan Gateway Borough",130,"Other Southeast Region - Southern",9,1,3793,0,3793,0,38,0,17
"04/12/2022","Y","Y","Ketchikan Gateway Borough",130,"Other Southeast Region - Southern",9,4,3797,4,3797,0,38,0,17
"04/13/2022","Y","Y","Ketchikan Gateway Borough",130,"Other Southeast Region - Southern",9,2,3799,2,3799,0,38,0,17
"04/14/2022","Y","Y","Ketchikan Gateway Borough",130,"Other Southeast Region - Southern",9,1,3800,1,3800,0,38,0,17
"04/15/2022","Y","Y","Ketchikan Gateway Borough",130,"Other Southeast Region - Southern",9,1,3801,2,3802,0,38,0,17
"04/16/2022","Y","Y","Ketchikan Gateway Borough",130,"Other Southeast Region - Southern",9,3,3804,4,3806,0,38,0,17
"04/18/2022","Y","Y","Ketchikan Gateway Borough",130,"Other Southeast Region - Southern",9,6,3810,7,3813,0,38,0,17
"04/19/2022","Y","Y","Ketchikan Gateway Borough",130,"Other Southeast Region - Southern",9,10,3820,13,3826,0,38,0,17
"04/20/2022","Y","Y","Ketchikan Gateway Borough",130,"Other Southeast Region - Southern",9,7,3827,1,3827,0,38,0,17
"04/21/2022","Y","Y","Ketchikan Gateway Borough",130,"Other Southeast Region - Southern",9,2,3829,3,3830,0,38,0,17
"04/22/2022","Y","Y","Ketchikan Gateway Borough",130,"Other Southeast Region - Southern",9,12,3841,11,3841,0,38,0,17
"04/23/2022","Y","Y","Ketchikan Gateway Borough",130,"Other Southeast Region - Southern",9,2,3843,3,3844,0,38,0,17
"04/24/2022","Y","Y","Ketchikan Gateway Borough",130,"Other Southeast Region - Southern",9,1,3844,0,3844,0,38,0,17
"04/25/2022","Y","Y","Ketchikan Gateway Borough",130,"Other Southeast Region - Southern",9,10,3854,11,3855,0,38,0,17
"04/26/2022","Y","Y","Ketchikan Gateway Borough",130,"Other Southeast Region - Southern",9,8,3862,7,3862,0,38,0,17
"04/13/2020","Y","Y","Kodiak Island Borough",150,"Southwest Region",11,0,0,1,1,0,0,0,0
"04/15/2020","Y","Y","Kodiak Island Borough",150,"Southwest Region",11,1,1,0,1,0,0,0,0
"06/06/2020","Y","Y","Kodiak Island Borough",150,"Southwest Region",11,0,1,1,2,0,0,0,0
"06/10/2020","Y","Y","Kodiak Island Borough",150,"Southwest Region",11,1,2,0,2,0,0,0,0
"06/16/2020","Y","Y","Kodiak Island Borough",150,"Southwest Region",11,1,3,1,3,0,0,0,0
"06/27/2020","Y","Y","Kodiak Island Borough",150,"Southwest Region",11,0,3,1,4,0,0,0,0
"07/03/2020","Y","Y","Kodiak Island Borough",150,"Southwest Region",11,0,3,1,5,0,0,0,0
"07/10/2020","Y","Y","Kodiak Island Borough",150,"Southwest Region",11,0,3,1,6,0,0,0,0
"07/11/2020","Y","Y","Kodiak Island Borough",150,"Southwest Region",11,1,4,0,6,0,0,0,0
"07/12/2020","Y","Y","Kodiak Island Borough",150,"Southwest Region",11,1,5,0,6,0,0,0,0
"07/29/2020","Y","Y","Kodiak Island Borough",150,"Southwest Region",11,1,6,0,6,0,0,0,0
"08/02/2020","Y","Y","Kodiak Island Borough",150,"Southwest Region",11,0,6,1,7,0,0,0,0
"08/05/2020","Y","Y","Kodiak Island Borough",150,"Southwest Region",11,0,6,3,10,0,0,0,0
"08/11/2020","Y","Y","Kodiak Island Borough",150,"Southwest Region",11,0,6,1,11,0,0,0,0
"08/12/2020","Y","Y","Kodiak Island Borough",150,"Southwest Region",11,4,10,0,11,0,0,0,0
"08/15/2020","Y","Y","Kodiak Island Borough",150,"Southwest Region",11,1,11,0,11,0,0,0,0
"08/18/2020","Y","Y","Kodiak Island Borough",150,"Southwest Region",11,1,12,2,13,0,0,0,0
"08/19/2020","Y","Y","Kodiak Island Borough",150,"Southwest Region",11,2,14,0,13,0,0,0,0
"08/25/2020","Y","Y","Kodiak Island Borough",150,"Southwest Region",11,0,14,1,14,0,0,0,0
"08/27/2020","Y","Y","Kodiak Island Borough",150,"Southwest Region",11,0,14,1,15,0,0,0,0
"08/31/2020","Y","Y","Kodiak Island Borough",150,"Southwest Region",11,1,15,1,16,0,0,0,0
"09/01/2020","Y","Y","Kodiak Island Borough",150,"Southwest Region",11,0,15,1,17,0,0,0,0
"09/02/2020","Y","Y","Kodiak Island Borough",150,"Southwest Region",11,2,17,0,17,0,0,0,0
"09/04/2020","Y","Y","Kodiak Island Borough",150,"Southwest Region",11,0,17,2,19,0,0,0,0
"09/05/2020","Y","Y","Kodiak Island Borough",150,"Southwest Region",11,1,18,0,19,0,0,0,0
"09/09/2020","Y","Y","Kodiak Island Borough",150,"Southwest Region",11,1,19,0,19,0,0,0,0
"09/13/2020","Y","Y","Kodiak Island Borough",150,"Southwest Region",11,0,19,1,20,0,0,0,0
"09/14/2020","Y","Y","Kodiak Island Borough",150,"Southwest Region",11,1,20,0,20,0,0,0,0
"09/17/2020","Y","Y","Kodiak Island Borough",150,"Southwest Region",11,0,20,1,21,0,0,0,0
"09/18/2020","Y","Y","Kodiak Island Borough",150,"Southwest Region",11,1,21,0,21,0,0,0,0
"09/20/2020","Y","Y","Kodiak Island Borough",150,"Southwest Region",11,0,21,1,22,0,0,0,0
"09/21/2020","Y","Y","Kodiak Island Borough",150,"Southwest Region",11,1,22,0,22,0,0,0,0
"09/24/2020","Y","Y","Kodiak Island Borough",150,"Southwest Region",11,0,22,1,23,0,0,0,0
"09/25/2020","Y","Y","Kodiak Island Borough",150,"Southwest Region",11,1,23,0,23,0,0,0,0
"09/28/2020","Y","Y","Kodiak Island Borough",150,"Southwest Region",11,0,23,2,25,0,0,0,0
"09/29/2020","Y","Y","Kodiak Island Borough",150,"Southwest Region",11,2,25,3,28,0,0,0,0
"09/30/2020","Y","Y","Kodiak Island Borough",150,"Southwest Region",11,2,27,4,32,0,0,0,0
"10/01/2020","Y","Y","Kodiak Island Borough",150,"Southwest Region",11,2,29,4,36,0,0,0,0
"10/02/2020","Y","Y","Kodiak Island Borough",150,"Southwest Region",11,0,29,1,37,0,0,0,0
"10/03/2020","Y","Y","Kodiak Island Borough",150,"Southwest Region",11,0,29,2,39,0,0,0,0
"10/04/2020","Y","Y","Kodiak Island Borough",150,"Southwest Region",11,2,31,1,40,0,0,0,0
"10/05/2020","Y","Y","Kodiak Island Borough",150,"Southwest Region",11,6,37,1,41,0,0,0,0
"10/07/2020","Y","Y","Kodiak Island Borough",150,"Southwest Region",11,2,39,1,42,0,0,0,0
"10/08/2020","Y","Y","Kodiak Island Borough",150,"Southwest Region",11,2,41,2,44,0,0,0,0
"10/09/2020","Y","Y","Kodiak Island Borough",150,"Southwest Region",11,0,41,1,45,0,0,0,0
"10/11/2020","Y","Y","Kodiak Island Borough",150,"Southwest Region",11,0,41,1,46,0,0,0,0
"10/12/2020","Y","Y","Kodiak Island Borough",150,"Southwest Region",11,0,41,1,47,0,0,0,0
"10/13/2020","Y","Y","Kodiak Island Borough",150,"Southwest Region",11,0,41,1,48,0,0,0,0
"10/15/2020","Y","Y","Kodiak Island Borough",150,"Southwest Region",11,5,46,2,50,0,0,0,0
"10/16/2020","Y","Y","Kodiak Island Borough",150,"Southwest Region",11,1,47,1,51,0,0,0,0
"10/19/2020","Y","Y","Kodiak Island Borough",150,"Southwest Region",11,1,48,0,51,0,0,0,0
"10/20/2020","Y","Y","Kodiak Island Borough",150,"Southwest Region",11,1,49,2,53,0,0,0,0
"10/22/2020","Y","Y","Kodiak Island Borough",150,"Southwest Region",11,1,50,4,57,0,0,0,0
"10/24/2020","Y","Y","Kodiak Island Borough",150,"Southwest Region",11,2,52,1,58,0,0,0,0
"10/25/2020","Y","Y","Kodiak Island Borough",150,"Southwest Region",11,1,53,2,60,0,0,0,0
"10/26/2020","Y","Y","Kodiak Island Borough",150,"Southwest Region",11,1,54,1,61,0,0,0,0
"10/27/2020","Y","Y","Kodiak Island Borough",150,"Southwest Region",11,0,54,12,73,0,0,0,0
"10/28/2020","Y","Y","Kodiak Island Borough",150,"Southwest Region",11,13,67,3,76,0,0,0,0
"10/29/2020","Y","Y","Kodiak Island Borough",150,"Southwest Region",11,1,68,8,84,0,0,0,0
"10/30/2020","Y","Y","Kodiak Island Borough",150,"Southwest Region",11,8,76,5,89,0,0,0,0
"10/31/2020","Y","Y","Kodiak Island Borough",150,"Southwest Region",11,4,80,1,90,0,0,0,0
"11/02/2020","Y","Y","Kodiak Island Borough",150,"Southwest Region",11,0,80,3,93,0,0,0,0
"11/03/2020","Y","Y","Kodiak Island Borough",150,"Southwest Region",11,5,85,4,97,0,0,0,0
"11/04/2020","Y","Y","Kodiak Island Borough",150,"Southwest Region",11,1,86,1,98,0,0,0,0
"11/06/2020","Y","Y","Kodiak Island Borough",150,"Southwest Region",11,6,92,3,101,0,0,0,0
"11/07/2020","Y","Y","Kodiak Island Borough",150,"Southwest Region",11,6,98,0,101,0,0,0,0
"11/09/2020","Y","Y","Kodiak Island Borough",150,"Southwest Region",11,2,100,4,105,0,0,0,0
"11/10/2020","Y","Y","Kodiak Island Borough",150,"Southwest Region",11,5,105,4,109,0,0,0,0
"11/11/2020","Y","Y","Kodiak Island Borough",150,"Southwest Region",11,3,108,5,114,0,0,0,0
"11/12/2020","Y","Y","Kodiak Island Borough",150,"Southwest Region",11,3,111,6,120,1,1,0,0
"11/13/2020","Y","Y","Kodiak Island Borough",150,"Southwest Region",11,1,112,9,129,0,1,0,0
"11/14/2020","Y","Y","Kodiak Island Borough",150,"Southwest Region",11,10,122,1,130,0,1,0,0
"11/15/2020","Y","Y","Kodiak Island Borough",150,"Southwest Region",11,1,123,0,130,0,1,0,0
"11/16/2020","Y","Y","Kodiak Island Borough",150,"Southwest Region",11,3,126,13,143,0,1,0,0
"11/17/2020","Y","Y","Kodiak Island Borough",150,"Southwest Region",11,8,134,10,153,1,2,0,0
"11/18/2020","Y","Y","Kodiak Island Borough",150,"Southwest Region",11,8,142,10,163,0,2,0,0
"11/19/2020","Y","Y","Kodiak Island Borough",150,"Southwest Region",11,10,152,20,183,0,2,0,0
"11/20/2020","Y","Y","Kodiak Island Borough",150,"Southwest Region",11,12,164,7,190,0,2,0,0
"11/21/2020","Y","Y","Kodiak Island Borough",150,"Southwest Region",11,1,165,1,191,0,2,0,0
"11/22/2020","Y","Y","Kodiak Island Borough",150,"Southwest Region",11,6,171,0,191,0,2,0,0
"11/23/2020","Y","Y","Kodiak Island Borough",150,"Southwest Region",11,15,186,15,206,0,2,0,0
"11/24/2020","Y","Y","Kodiak Island Borough",150,"Southwest Region",11,11,197,14,220,1,3,0,0
"11/25/2020","Y","Y","Kodiak Island Borough",150,"Southwest Region",11,10,207,22,242,0,3,0,0
"11/26/2020","Y","Y","Kodiak Island Borough",150,"Southwest Region",11,1,208,5,247,0,3,0,0
"11/27/2020","Y","Y","Kodiak Island Borough",150,"Southwest Region",11,12,220,7,254,0,3,0,0
"11/28/2020","Y","Y","Kodiak Island Borough",150,"Southwest Region",11,8,228,20,274,1,4,0,0
"11/29/2020","Y","Y","Kodiak Island Borough",150,"Southwest Region",11,7,235,0,274,0,4,0,0
"11/30/2020","Y","Y","Kodiak Island Borough",150,"Southwest Region",11,11,246,55,329,0,4,0,0
"12/01/2020","Y","Y","Kodiak Island Borough",150,"Southwest Region",11,22,268,33,362,2,6,1,1
"12/02/2020","Y","Y","Kodiak Island Borough",150,"Southwest Region",11,59,327,40,402,0,6,0,1
"12/03/2020","Y","Y","Kodiak Island Borough",150,"Southwest Region",11,34,361,29,431,0,6,0,1
"12/04/2020","Y","Y","Kodiak Island Borough",150,"Southwest Region",11,19,380,47,478,1,7,0,1
"12/05/2020","Y","Y","Kodiak Island Borough",150,"Southwest Region",11,29,409,12,490,0,7,0,1
"12/06/2020","Y","Y","Kodiak Island Borough",150,"Southwest Region",11,38,447,2,492,0,7,0,1
"12/07/2020","Y","Y","Kodiak Island Borough",150,"Southwest Region",11,31,478,54,546,2,9,0,1
"12/08/2020","Y","Y","Kodiak Island Borough",150,"Southwest Region",11,29,507,42,588,0,9,0,1
"12/09/2020","Y","Y","Kodiak Island Borough",150,"Southwest Region",11,44,551,35,623,1,10,1,2
"12/10/2020","Y","Y","Kodiak Island Borough",150,"Southwest Region",11,28,579,23,646,4,14,0,2
"12/11/2020","Y","Y","Kodiak Island Borough",150,"Southwest Region",11,23,602,16,662,2,16,0,2
"12/12/2020","Y","Y","Kodiak Island Borough",150,"Southwest Region",11,33,635,10,672,0,16,1,3
"12/13/2020","Y","Y","Kodiak Island Borough",150,"Southwest Region",11,11,646,1,673,1,17,0,3
"12/14/2020","Y","Y","Kodiak Island Borough",150,"Southwest Region",11,24,670,32,705,2,19,0,3
"12/15/2020","Y","Y","Kodiak Island Borough",150,"Southwest Region",11,32,702,14,719,1,20,1,4
"12/16/2020","Y","Y","Kodiak Island Borough",150,"Southwest Region",11,11,713,20,739,0,20,0,4
"12/17/2020","Y","Y","Kodiak Island Borough",150,"Southwest Region",11,18,731,13,752,0,20,0,4
"12/18/2020","Y","Y","Kodiak Island Borough",150,"Southwest Region",11,9,740,13,765,0,20,1,5
"12/19/2020","Y","Y","Kodiak Island Borough",150,"Southwest Region",11,0,740,7,772,2,22,0,5
"12/20/2020","Y","Y","Kodiak Island Borough",150,"Southwest Region",11,2,742,1,773,1,23,0,5
"12/21/2020","Y","Y","Kodiak Island Borough",150,"Southwest Region",11,27,769,23,796,0,23,0,5
"12/22/2020","Y","Y","Kodiak Island Borough",150,"Southwest Region",11,20,789,10,806,1,24,0,5
"12/23/2020","Y","Y","Kodiak Island Borough",150,"Southwest Region",11,14,803,21,827,0,24,0,5
"12/24/2020","Y","Y","Kodiak Island Borough",150,"Southwest Region",11,16,819,5,832,0,24,1,6
"12/25/2020","Y","Y","Kodiak Island Borough",150,"Southwest Region",11,6,825,2,834,1,25,0,6
"12/26/2020","Y","Y","Kodiak Island Borough",150,"Southwest Region",11,6,831,6,840,0,25,0,6
"12/27/2020","Y","Y","Kodiak Island Borough",150,"Southwest Region",11,2,833,0,840,0,25,0,6
"12/28/2020","Y","Y","Kodiak Island Borough",150,"Southwest Region",11,7,840,13,853,1,26,0,6
"12/29/2020","Y","Y","Kodiak Island Borough",150,"Southwest Region",11,12,852,12,865,0,26,0,6
"12/30/2020","Y","Y","Kodiak Island Borough",150,"Southwest Region",11,6,858,5,870,0,26,0,6
"12/31/2020","Y","Y","Kodiak Island Borough",150,"Southwest Region",11,11,869,8,878,0,26,0,6
"01/01/2021","Y","Y","Kodiak Island Borough",150,"Southwest Region",11,5,874,0,878,0,26,0,6
"01/02/2021","Y","Y","Kodiak Island Borough",150,"Southwest Region",11,1,875,2,880,0,26,0,6
"01/03/2021","Y","Y","Kodiak Island Borough",150,"Southwest Region",11,2,877,0,880,0,26,0,6
"01/04/2021","Y","Y","Kodiak Island Borough",150,"Southwest Region",11,3,880,13,893,1,27,0,6
"01/05/2021","Y","Y","Kodiak Island Borough",150,"Southwest Region",11,7,887,10,903,0,27,0,6
"01/06/2021","Y","Y","Kodiak Island Borough",150,"Southwest Region",11,6,893,4,907,0,27,0,6
"01/07/2021","Y","Y","Kodiak Island Borough",150,"Southwest Region",11,10,903,5,912,0,27,0,6
"01/08/2021","Y","Y","Kodiak Island Borough",150,"Southwest Region",11,5,908,7,919,0,27,0,6
"01/09/2021","Y","Y","Kodiak Island Borough",150,"Southwest Region",11,5,913,2,921,0,27,0,6
"01/10/2021","Y","Y","Kodiak Island Borough",150,"Southwest Region",11,5,918,1,922,0,27,0,6
"01/11/2021","Y","Y","Kodiak Island Borough",150,"Southwest Region",11,0,918,5,927,0,27,0,6
"01/12/2021","Y","Y","Kodiak Island Borough",150,"Southwest Region",11,5,923,7,934,0,27,0,6
"01/13/2021","Y","Y","Kodiak Island Borough",150,"Southwest Region",11,4,927,3,937,1,28,0,6
"01/14/2021","Y","Y","Kodiak Island Borough",150,"Southwest Region",11,8,935,5,942,0,28,0,6
"01/15/2021","Y","Y","Kodiak Island Borough",150,"Southwest Region",11,5,940,8,950,0,28,0,6
"01/16/2021","Y","Y","Kodiak Island Borough",150,"Southwest Region",11,4,944,6,956,0,28,0,6
"01/17/2021","Y","Y","Kodiak Island Borough",150,"Southwest Region",11,4,948,1,957,0,28,0,6
"01/18/2021","Y","Y","Kodiak Island Borough",150,"Southwest Region",11,5,953,0,957,0,28,0,6
"01/19/2021","Y","Y","Kodiak Island Borough",150,"Southwest Region",11,3,956,5,962,0,28,0,6
"01/20/2021","Y","Y","Kodiak Island Borough",150,"Southwest Region",11,3,959,4,966,0,28,0,6
"01/21/2021","Y","Y","Kodiak Island Borough",150,"Southwest Region",11,5,964,0,966,0,28,0,6
"01/23/2021","Y","Y","Kodiak Island Borough",150,"Southwest Region",11,0,964,2,968,0,28,0,6
"01/24/2021","Y","Y","Kodiak Island Borough",150,"Southwest Region",11,1,965,0,968,0,28,0,6
"01/25/2021","Y","Y","Kodiak Island Borough",150,"Southwest Region",11,0,965,1,969,0,28,0,6
"01/26/2021","Y","Y","Kodiak Island Borough",150,"Southwest Region",11,1,966,1,970,0,28,0,6
"01/27/2021","Y","Y","Kodiak Island Borough",150,"Southwest Region",11,1,967,4,974,0,28,0,6
"01/28/2021","Y","Y","Kodiak Island Borough",150,"Southwest Region",11,3,970,5,979,0,28,0,6
"01/29/2021","Y","Y","Kodiak Island Borough",150,"Southwest Region",11,4,974,2,981,0,28,0,6
"01/30/2021","Y","Y","Kodiak Island Borough",150,"Southwest Region",11,3,977,2,983,0,28,0,6
"01/31/2021","Y","Y","Kodiak Island Borough",150,"Southwest Region",11,3,980,0,983,0,28,0,6
"02/01/2021","Y","Y","Kodiak Island Borough",150,"Southwest Region",11,1,981,1,984,0,28,0,6
"02/02/2021","Y","Y","Kodiak Island Borough",150,"Southwest Region",11,2,983,0,984,0,28,0,6
"02/03/2021","Y","Y","Kodiak Island Borough",150,"Southwest Region",11,0,983,1,985,0,28,0,6
"02/05/2021","Y","Y","Kodiak Island Borough",150,"Southwest Region",11,1,984,1,986,0,28,0,6
"02/06/2021","Y","Y","Kodiak Island Borough",150,"Southwest Region",11,1,985,0,986,0,28,0,6
"02/08/2021","Y","Y","Kodiak Island Borough",150,"Southwest Region",11,0,985,1,987,0,28,0,6
"02/11/2021","Y","Y","Kodiak Island Borough",150,"Southwest Region",11,0,985,1,988,0,28,0,6
"02/12/2021","Y","Y","Kodiak Island Borough",150,"Southwest Region",11,0,985,3,991,0,28,0,6
"02/13/2021","Y","Y","Kodiak Island Borough",150,"Southwest Region",11,3,988,4,995,0,28,0,6
"02/14/2021","Y","Y","Kodiak Island Borough",150,"Southwest Region",11,6,994,0,995,0,28,0,6
"02/16/2021","Y","Y","Kodiak Island Borough",150,"Southwest Region",11,0,994,1,996,0,28,0,6
"02/18/2021","Y","Y","Kodiak Island Borough",150,"Southwest Region",11,1,995,0,996,0,28,0,6
"02/20/2021","Y","Y","Kodiak Island Borough",150,"Southwest Region",11,0,995,1,997,0,28,0,6
"02/22/2021","Y","Y","Kodiak Island Borough",150,"Southwest Region",11,1,996,0,997,0,28,0,6
"02/25/2021","Y","Y","Kodiak Island Borough",150,"Southwest Region",11,0,996,1,998,0,28,0,6
"02/26/2021","Y","Y","Kodiak Island Borough",150,"Southwest Region",11,1,997,0,998,0,28,0,6
"03/02/2021","Y","Y","Kodiak Island Borough",150,"Southwest Region",11,0,997,1,999,0,28,0,6
"03/04/2021","Y","Y","Kodiak Island Borough",150,"Southwest Region",11,1,998,0,999,0,28,0,6
"03/09/2021","Y","Y","Kodiak Island Borough",150,"Southwest Region",11,0,998,1,1000,0,28,0,6
"03/10/2021","Y","Y","Kodiak Island Borough",150,"Southwest Region",11,0,998,1,1001,0,28,0,6
"03/11/2021","Y","Y","Kodiak Island Borough",150,"Southwest Region",11,1,999,2,1003,0,28,0,6
"03/12/2021","Y","Y","Kodiak Island Borough",150,"Southwest Region",11,2,1001,1,1004,0,28,0,6
"03/13/2021","Y","Y","Kodiak Island Borough",150,"Southwest Region",11,2,1003,0,1004,0,28,0,6
"03/18/2021","Y","Y","Kodiak Island Borough",150,"Southwest Region",11,0,1003,2,1006,0,28,0,6
"03/19/2021","Y","Y","Kodiak Island Borough",150,"Southwest Region",11,1,1004,0,1006,0,28,0,6
"03/20/2021","Y","Y","Kodiak Island Borough",150,"Southwest Region",11,1,1005,1,1007,0,28,0,6
"03/22/2021","Y","Y","Kodiak Island Borough",150,"Southwest Region",11,1,1006,1,1008,0,28,0,6
"03/24/2021","Y","Y","Kodiak Island Borough",150,"Southwest Region",11,1,1007,0,1008,0,28,0,6
"03/25/2021","Y","Y","Kodiak Island Borough",150,"Southwest Region",11,0,1007,1,1009,0,28,0,6
"03/26/2021","Y","Y","Kodiak Island Borough",150,"Southwest Region",11,0,1007,3,1012,0,28,0,6
"03/27/2021","Y","Y","Kodiak Island Borough",150,"Southwest Region",11,2,1009,1,1013,0,28,0,6
"03/28/2021","Y","Y","Kodiak Island Borough",150,"Southwest Region",11,1,1010,0,1013,0,28,0,6
"03/29/2021","Y","Y","Kodiak Island Borough",150,"Southwest Region",11,1,1011,2,1015,0,28,0,6
"03/30/2021","Y","Y","Kodiak Island Borough",150,"Southwest Region",11,1,1012,2,1017,0,28,0,6
"03/31/2021","Y","Y","Kodiak Island Borough",150,"Southwest Region",11,1,1013,1,1018,0,28,0,6
"04/01/2021","Y","Y","Kodiak Island Borough",150,"Southwest Region",11,3,1016,0,1018,0,28,0,6
"04/02/2021","Y","Y","Kodiak Island Borough",150,"Southwest Region",11,1,1017,2,1020,0,28,0,6
"04/04/2021","Y","Y","Kodiak Island Borough",150,"Southwest Region",11,2,1019,0,1020,0,28,0,6
"04/05/2021","Y","Y","Kodiak Island Borough",150,"Southwest Region",11,0,1019,1,1021,0,28,0,6
"04/06/2021","Y","Y","Kodiak Island Borough",150,"Southwest Region",11,0,1019,1,1022,0,28,0,6
"04/07/2021","Y","Y","Kodiak Island Borough",150,"Southwest Region",11,3,1022,3,1025,2,30,0,6
"04/08/2021","Y","Y","Kodiak Island Borough",150,"Southwest Region",11,1,1023,1,1026,1,31,0,6
"04/09/2021","Y","Y","Kodiak Island Borough",150,"Southwest Region",11,2,1025,4,1030,0,31,0,6
"04/10/2021","Y","Y","Kodiak Island Borough",150,"Southwest Region",11,1,1026,0,1030,0,31,0,6
"04/13/2021","Y","Y","Kodiak Island Borough",150,"Southwest Region",11,2,1028,0,1030,0,31,0,6
"04/15/2021","Y","Y","Kodiak Island Borough",150,"Southwest Region",11,0,1028,2,1032,0,31,0,6
"04/16/2021","Y","Y","Kodiak Island Borough",150,"Southwest Region",11,1,1029,1,1033,0,31,0,6
"04/17/2021","Y","Y","Kodiak Island Borough",150,"Southwest Region",11,1,1030,0,1033,0,31,0,6
"04/18/2021","Y","Y","Kodiak Island Borough",150,"Southwest Region",11,1,1031,0,1033,0,31,0,6
"04/19/2021","Y","Y","Kodiak Island Borough",150,"Southwest Region",11,1,1032,2,1035,0,31,0,6
"04/20/2021","Y","Y","Kodiak Island Borough",150,"Southwest Region",11,1,1033,0,1035,0,31,0,6
"04/23/2021","Y","Y","Kodiak Island Borough",150,"Southwest Region",11,0,1033,3,1038,0,31,0,6
"04/25/2021","Y","Y","Kodiak Island Borough",150,"Southwest Region",11,2,1035,0,1038,0,31,0,6
"04/28/2021","Y","Y","Kodiak Island Borough",150,"Southwest Region",11,2,1037,0,1038,0,31,0,6
"04/29/2021","Y","Y","Kodiak Island Borough",150,"Southwest Region",11,0,1037,4,1042,0,31,0,6
"05/01/2021","Y","Y","Kodiak Island Borough",150,"Southwest Region",11,4,1041,0,1042,0,31,0,6
"05/07/2021","Y","Y","Kodiak Island Borough",150,"Southwest Region",11,0,1041,1,1043,0,31,0,6
"05/08/2021","Y","Y","Kodiak Island Borough",150,"Southwest Region",11,1,1042,0,1043,0,31,0,6
"05/10/2021","Y","Y","Kodiak Island Borough",150,"Southwest Region",11,0,1042,2,1045,0,31,0,6
"05/11/2021","Y","Y","Kodiak Island Borough",150,"Southwest Region",11,2,1044,0,1045,0,31,0,6
"05/13/2021","Y","Y","Kodiak Island Borough",150,"Southwest Region",11,0,1044,1,1046,0,31,0,6
"05/15/2021","Y","Y","Kodiak Island Borough",150,"Southwest Region",11,1,1045,0,1046,0,31,0,6
"05/16/2021","Y","Y","Kodiak Island Borough",150,"Southwest Region",11,0,1045,1,1047,0,31,0,6
"05/17/2021","Y","Y","Kodiak Island Borough",150,"Southwest Region",11,1,1046,0,1047,0,31,0,6
"05/19/2021","Y","Y","Kodiak Island Borough",150,"Southwest Region",11,1,1047,1,1048,0,31,0,6
"05/24/2021","Y","Y","Kodiak Island Borough",150,"Southwest Region",11,0,1047,1,1049,0,31,0,6
"05/25/2021","Y","Y","Kodiak Island Borough",150,"Southwest Region",11,5,1052,4,1053,1,32,0,6
"06/02/2021","Y","Y","Kodiak Island Borough",150,"Southwest Region",11,0,1052,1,1054,0,32,0,6
"06/03/2021","Y","Y","Kodiak Island Borough",150,"Southwest Region",11,1,1053,0,1054,0,32,0,6
"06/12/2021","Y","Y","Kodiak Island Borough",150,"Southwest Region",11,1,1054,1,1055,0,32,0,6
"06/16/2021","Y","Y","Kodiak Island Borough",150,"Southwest Region",11,0,1054,1,1056,0,32,0,6
"06/17/2021","Y","Y","Kodiak Island Borough",150,"Southwest Region",11,0,1054,1,1057,0,32,0,6
"06/18/2021","Y","Y","Kodiak Island Borough",150,"Southwest Region",11,1,1055,0,1057,0,32,0,6
"06/24/2021","Y","Y","Kodiak Island Borough",150,"Southwest Region",11,1,1056,0,1057,0,32,0,6
"07/03/2021","Y","Y","Kodiak Island Borough",150,"Southwest Region",11,0,1056,1,1058,0,32,0,6
"07/04/2021","Y","Y","Kodiak Island Borough",150,"Southwest Region",11,1,1057,0,1058,0,32,0,6
"07/05/2021","Y","Y","Kodiak Island Borough",150,"Southwest Region",11,1,1058,2,1060,0,32,0,6
"07/07/2021","Y","Y","Kodiak Island Borough",150,"Southwest Region",11,1,1059,0,1060,0,32,0,6
"07/10/2021","Y","Y","Kodiak Island Borough",150,"Southwest Region",11,1,1060,1,1061,0,32,0,6
"07/11/2021","Y","Y","Kodiak Island Borough",150,"Southwest Region",11,1,1061,1,1062,0,32,0,6
"07/12/2021","Y","Y","Kodiak Island Borough",150,"Southwest Region",11,0,1061,1,1063,0,32,0,6
"07/14/2021","Y","Y","Kodiak Island Borough",150,"Southwest Region",11,3,1064,4,1067,0,32,0,6
"07/15/2021","Y","Y","Kodiak Island Borough",150,"Southwest Region",11,1,1065,4,1071,0,32,0,6
"07/16/2021","Y","Y","Kodiak Island Borough",150,"Southwest Region",11,5,1070,4,1075,0,32,0,6
"07/17/2021","Y","Y","Kodiak Island Borough",150,"Southwest Region",11,3,1073,1,1076,0,32,0,6
"07/18/2021","Y","Y","Kodiak Island Borough",150,"Southwest Region",11,0,1073,1,1077,0,32,0,6
"07/19/2021","Y","Y","Kodiak Island Borough",150,"Southwest Region",11,7,1080,9,1086,0,32,0,6
"07/20/2021","Y","Y","Kodiak Island Borough",150,"Southwest Region",11,4,1084,3,1089,1,33,0,6
"07/21/2021","Y","Y","Kodiak Island Borough",150,"Southwest Region",11,0,1084,13,1102,0,33,0,6
"07/22/2021","Y","Y","Kodiak Island Borough",150,"Southwest Region",11,8,1092,3,1105,0,33,0,6
"07/23/2021","Y","Y","Kodiak Island Borough",150,"Southwest Region",11,14,1106,7,1112,0,33,0,6
"07/24/2021","Y","Y","Kodiak Island Borough",150,"Southwest Region",11,1,1107,6,1118,0,33,0,6
"07/25/2021","Y","Y","Kodiak Island Borough",150,"Southwest Region",11,8,1115,1,1119,0,33,0,6
"07/26/2021","Y","Y","Kodiak Island Borough",150,"Southwest Region",11,4,1119,7,1126,0,33,0,6
"07/27/2021","Y","Y","Kodiak Island Borough",150,"Southwest Region",11,3,1122,1,1127,0,33,0,6
"07/28/2021","Y","Y","Kodiak Island Borough",150,"Southwest Region",11,2,1124,3,1130,0,33,0,6
"07/29/2021","Y","Y","Kodiak Island Borough",150,"Southwest Region",11,6,1130,7,1137,0,33,0,6
"07/30/2021","Y","Y","Kodiak Island Borough",150,"Southwest Region",11,6,1136,10,1147,0,33,0,6
"07/31/2021","Y","Y","Kodiak Island Borough",150,"Southwest Region",11,7,1143,14,1161,0,33,0,6
"08/01/2021","Y","Y","Kodiak Island Borough",150,"Southwest Region",11,6,1149,1,1162,0,33,0,6
"08/02/2021","Y","Y","Kodiak Island Borough",150,"Southwest Region",11,12,1161,16,1178,1,34,0,6
"08/03/2021","Y","Y","Kodiak Island Borough",150,"Southwest Region",11,22,1183,24,1202,1,35,0,6
"08/04/2021","Y","Y","Kodiak Island Borough",150,"Southwest Region",11,18,1201,21,1223,0,35,0,6
"08/05/2021","Y","Y","Kodiak Island Borough",150,"Southwest Region",11,15,1216,9,1232,0,35,0,6
"08/06/2021","Y","Y","Kodiak Island Borough",150,"Southwest Region",11,8,1224,11,1243,1,36,0,6
"08/07/2021","Y","Y","Kodiak Island Borough",150,"Southwest Region",11,13,1237,1,1244,0,36,0,6
"08/08/2021","Y","Y","Kodiak Island Borough",150,"Southwest Region",11,0,1237,1,1245,1,37,0,6
"08/09/2021","Y","Y","Kodiak Island Borough",150,"Southwest Region",11,4,1241,20,1265,0,37,0,6
"08/10/2021","Y","Y","Kodiak Island Borough",150,"Southwest Region",11,14,1255,12,1277,0,37,0,6
"08/11/2021","Y","Y","Kodiak Island Borough",150,"Southwest Region",11,14,1269,12,1289,0,37,0,6
"08/12/2021","Y","Y","Kodiak Island Borough",150,"Southwest Region",11,16,1285,11,1300,0,37,0,6
"08/13/2021","Y","Y","Kodiak Island Borough",150,"Southwest Region",11,10,1295,16,1316,0,37,0,6
"08/14/2021","Y","Y","Kodiak Island Borough",150,"Southwest Region",11,3,1298,13,1329,0,37,0,6
"08/15/2021","Y","Y","Kodiak Island Borough",150,"Southwest Region",11,10,1308,0,1329,1,38,0,6
"08/16/2021","Y","Y","Kodiak Island Borough",150,"Southwest Region",11,9,1317,30,1359,1,39,0,6
"08/17/2021","Y","Y","Kodiak Island Borough",150,"Southwest Region",11,20,1337,11,1370,0,39,0,6
"08/18/2021","Y","Y","Kodiak Island Borough",150,"Southwest Region",11,19,1356,16,1386,1,40,0,6
"08/19/2021","Y","Y","Kodiak Island Borough",150,"Southwest Region",11,9,1365,9,1395,1,41,0,6
"08/20/2021","Y","Y","Kodiak Island Borough",150,"Southwest Region",11,16,1381,9,1404,0,41,0,6
"08/21/2021","Y","Y","Kodiak Island Borough",150,"Southwest Region",11,7,1388,6,1410,0,41,0,6
"08/22/2021","Y","Y","Kodiak Island Borough",150,"Southwest Region",11,9,1397,1,1411,1,42,0,6
"08/23/2021","Y","Y","Kodiak Island Borough",150,"Southwest Region",11,11,1408,18,1429,0,42,0,6
"08/24/2021","Y","Y","Kodiak Island Borough",150,"Southwest Region",11,16,1424,14,1443,0,42,0,6
"08/25/2021","Y","Y","Kodiak Island Borough",150,"Southwest Region",11,1,1425,7,1450,1,43,0,6
"08/26/2021","Y","Y","Kodiak Island Borough",150,"Southwest Region",11,4,1429,19,1469,0,43,0,6
"08/27/2021","Y","Y","Kodiak Island Borough",150,"Southwest Region",11,5,1434,9,1478,0,43,0,6
"08/28/2021","Y","Y","Kodiak Island Borough",150,"Southwest Region",11,16,1450,12,1490,0,43,0,6
"08/29/2021","Y","Y","Kodiak Island Borough",150,"Southwest Region",11,11,1461,0,1490,0,43,0,6
"08/30/2021","Y","Y","Kodiak Island Borough",150,"Southwest Region",11,17,1478,9,1499,0,43,1,7
"08/31/2021","Y","Y","Kodiak Island Borough",150,"Southwest Region",11,4,1482,12,1511,0,43,0,7
"09/01/2021","Y","Y","Kodiak Island Borough",150,"Southwest Region",11,6,1488,5,1516,0,43,0,7
"09/02/2021","Y","Y","Kodiak Island Borough",150,"Southwest Region",11,12,1500,3,1519,0,43,0,7
"09/03/2021","Y","Y","Kodiak Island Borough",150,"Southwest Region",11,4,1504,10,1529,0,43,0,7
"09/04/2021","Y","Y","Kodiak Island Borough",150,"Southwest Region",11,12,1516,5,1534,0,43,0,7
"09/05/2021","Y","Y","Kodiak Island Borough",150,"Southwest Region",11,6,1522,0,1534,0,43,0,7
"09/06/2021","Y","Y","Kodiak Island Borough",150,"Southwest Region",11,2,1524,1,1535,0,43,0,7
"09/07/2021","Y","Y","Kodiak Island Borough",150,"Southwest Region",11,1,1525,22,1557,0,43,0,7
"09/08/2021","Y","Y","Kodiak Island Borough",150,"Southwest Region",11,24,1549,17,1574,0,43,0,7
"09/09/2021","Y","Y","Kodiak Island Borough",150,"Southwest Region",11,5,1554,11,1585,1,44,0,7
"09/10/2021","Y","Y","Kodiak Island Borough",150,"Southwest Region",11,3,1557,20,1605,0,44,0,7
"09/11/2021","Y","Y","Kodiak Island Borough",150,"Southwest Region",11,7,1564,7,1612,0,44,0,7
"09/12/2021","Y","Y","Kodiak Island Borough",150,"Southwest Region",11,4,1568,2,1614,1,45,0,7
"09/13/2021","Y","Y","Kodiak Island Borough",150,"Southwest Region",11,14,1582,28,1642,1,46,0,7
"09/14/2021","Y","Y","Kodiak Island Borough",150,"Southwest Region",11,4,1586,23,1665,0,46,0,7
"09/15/2021","Y","Y","Kodiak Island Borough",150,"Southwest Region",11,2,1588,22,1687,0,46,0,7
"09/16/2021","Y","Y","Kodiak Island Borough",150,"Southwest Region",11,15,1603,23,1710,1,47,0,7
"09/17/2021","Y","Y","Kodiak Island Borough",150,"Southwest Region",11,8,1611,42,1752,0,47,0,7
"09/18/2021","Y","Y","Kodiak Island Borough",150,"Southwest Region",11,29,1640,10,1762,1,48,0,7
"09/19/2021","Y","Y","Kodiak Island Borough",150,"Southwest Region",11,15,1655,12,1774,0,48,0,7
"09/20/2021","Y","Y","Kodiak Island Borough",150,"Southwest Region",11,4,1659,29,1803,0,48,0,7
"09/21/2021","Y","Y","Kodiak Island Borough",150,"Southwest Region",11,24,1683,21,1824,0,48,0,7
"09/22/2021","Y","Y","Kodiak Island Borough",150,"Southwest Region",11,45,1728,27,1851,1,49,0,7
"09/23/2021","Y","Y","Kodiak Island Borough",150,"Southwest Region",11,32,1760,39,1890,0,49,0,7
"09/24/2021","Y","Y","Kodiak Island Borough",150,"Southwest Region",11,19,1779,28,1918,0,49,0,7
"09/25/2021","Y","Y","Kodiak Island Borough",150,"Southwest Region",11,60,1839,20,1938,1,50,0,7
"09/26/2021","Y","Y","Kodiak Island Borough",150,"Southwest Region",11,14,1853,1,1939,0,50,0,7
"09/27/2021","Y","Y","Kodiak Island Borough",150,"Southwest Region",11,36,1889,30,1969,1,51,0,7
"09/28/2021","Y","Y","Kodiak Island Borough",150,"Southwest Region",11,12,1901,31,2000,0,51,0,7
"09/29/2021","Y","Y","Kodiak Island Borough",150,"Southwest Region",11,40,1941,37,2037,1,52,0,7
"09/30/2021","Y","Y","Kodiak Island Borough",150,"Southwest Region",11,54,1995,23,2060,0,52,0,7
"10/01/2021","Y","Y","Kodiak Island Borough",150,"Southwest Region",11,24,2019,16,2076,0,52,0,7
"10/02/2021","Y","Y","Kodiak Island Borough",150,"Southwest Region",11,16,2035,9,2085,0,52,0,7
"10/03/2021","Y","Y","Kodiak Island Borough",150,"Southwest Region",11,10,2045,0,2085,0,52,0,7
"10/04/2021","Y","Y","Kodiak Island Borough",150,"Southwest Region",11,32,2077,28,2113,0,52,0,7
"10/05/2021","Y","Y","Kodiak Island Borough",150,"Southwest Region",11,17,2094,16,2129,0,52,0,7
"10/06/2021","Y","Y","Kodiak Island Borough",150,"Southwest Region",11,18,2112,12,2141,0,52,0,7
"10/07/2021","Y","Y","Kodiak Island Borough",150,"Southwest Region",11,17,2129,19,2160,1,53,0,7
"10/08/2021","Y","Y","Kodiak Island Borough",150,"Southwest Region",11,11,2140,13,2173,0,53,0,7
"10/09/2021","Y","Y","Kodiak Island Borough",150,"Southwest Region",11,5,2145,21,2194,1,54,0,7
"10/10/2021","Y","Y","Kodiak Island Borough",150,"Southwest Region",11,28,2173,2,2196,0,54,0,7
"10/11/2021","Y","Y","Kodiak Island Borough",150,"Southwest Region",11,9,2182,10,2206,0,54,0,7
"10/12/2021","Y","Y","Kodiak Island Borough",150,"Southwest Region",11,8,2190,29,2235,0,54,0,7
"10/13/2021","Y","Y","Kodiak Island Borough",150,"Southwest Region",11,30,2220,17,2252,0,54,0,7
"10/14/2021","Y","Y","Kodiak Island Borough",150,"Southwest Region",11,8,2228,21,2273,0,54,1,8
"10/15/2021","Y","Y","Kodiak Island Borough",150,"Southwest Region",11,11,2239,27,2300,0,54,0,8
"10/16/2021","Y","Y","Kodiak Island Borough",150,"Southwest Region",11,16,2255,14,2314,0,54,0,8
"10/17/2021","Y","Y","Kodiak Island Borough",150,"Southwest Region",11,24,2279,0,2314,0,54,0,8
"10/18/2021","Y","Y","Kodiak Island Borough",150,"Southwest Region",11,0,2279,23,2337,0,54,0,8
"10/19/2021","Y","Y","Kodiak Island Borough",150,"Southwest Region",11,31,2310,10,2347,0,54,1,9
"10/20/2021","Y","Y","Kodiak Island Borough",150,"Southwest Region",11,26,2336,11,2358,0,54,0,9
"10/21/2021","Y","Y","Kodiak Island Borough",150,"Southwest Region",11,9,2345,9,2367,0,54,0,9
"10/22/2021","Y","Y","Kodiak Island Borough",150,"Southwest Region",11,6,2351,21,2388,0,54,0,9
"10/23/2021","Y","Y","Kodiak Island Borough",150,"Southwest Region",11,16,2367,9,2397,1,55,0,9
"10/24/2021","Y","Y","Kodiak Island Borough",150,"Southwest Region",11,19,2386,1,2398,0,55,0,9
"10/25/2021","Y","Y","Kodiak Island Borough",150,"Southwest Region",11,7,2393,16,2414,0,55,0,9
"10/26/2021","Y","Y","Kodiak Island Borough",150,"Southwest Region",11,17,2410,5,2419,0,55,0,9
"10/27/2021","Y","Y","Kodiak Island Borough",150,"Southwest Region",11,3,2413,6,2425,0,55,0,9
"10/28/2021","Y","Y","Kodiak Island Borough",150,"Southwest Region",11,9,2422,8,2433,0,55,0,9
"10/29/2021","Y","Y","Kodiak Island Borough",150,"Southwest Region",11,1,2423,9,2442,0,55,0,9
"10/30/2021","Y","Y","Kodiak Island Borough",150,"Southwest Region",11,6,2429,3,2445,0,55,0,9
"10/31/2021","Y","Y","Kodiak Island Borough",150,"Southwest Region",11,2,2431,0,2445,0,55,0,9
"11/01/2021","Y","Y","Kodiak Island Borough",150,"Southwest Region",11,7,2438,11,2456,0,55,0,9
"11/02/2021","Y","Y","Kodiak Island Borough",150,"Southwest Region",11,5,2443,11,2467,0,55,0,9
"11/03/2021","Y","Y","Kodiak Island Borough",150,"Southwest Region",11,4,2447,2,2469,0,55,0,9
"11/04/2021","Y","Y","Kodiak Island Borough",150,"Southwest Region",11,10,2457,5,2474,0,55,0,9
"11/05/2021","Y","Y","Kodiak Island Borough",150,"Southwest Region",11,9,2466,2,2476,0,55,0,9
"11/06/2021","Y","Y","Kodiak Island Borough",150,"Southwest Region",11,7,2473,5,2481,0,55,0,9
"11/07/2021","Y","Y","Kodiak Island Borough",150,"Southwest Region",11,5,2478,0,2481,0,55,0,9
"11/08/2021","Y","Y","Kodiak Island Borough",150,"Southwest Region",11,0,2478,16,2497,1,56,0,9
"11/09/2021","Y","Y","Kodiak Island Borough",150,"Southwest Region",11,15,2493,11,2508,0,56,0,9
"11/10/2021","Y","Y","Kodiak Island Borough",150,"Southwest Region",11,12,2505,4,2512,0,56,0,9
"11/11/2021","Y","Y","Kodiak Island Borough",150,"Southwest Region",11,4,2509,2,2514,0,56,0,9
"11/12/2021","Y","Y","Kodiak Island Borough",150,"Southwest Region",11,2,2511,1,2515,0,56,0,9
"11/13/2021","Y","Y","Kodiak Island Borough",150,"Southwest Region",11,2,2513,0,2515,0,56,0,9
"11/15/2021","Y","Y","Kodiak Island Borough",150,"Southwest Region",11,1,2514,8,2523,0,56,0,9
"11/16/2021","Y","Y","Kodiak Island Borough",150,"Southwest Region",11,8,2522,0,2523,0,56,0,9
"11/17/2021","Y","Y","Kodiak Island Borough",150,"Southwest Region",11,0,2522,1,2524,0,56,0,9
"11/18/2021","Y","Y","Kodiak Island Borough",150,"Southwest Region",11,2,2524,3,2527,0,56,0,9
"11/19/2021","Y","Y","Kodiak Island Borough",150,"Southwest Region",11,2,2526,2,2529,0,56,0,9
"11/20/2021","Y","Y","Kodiak Island Borough",150,"Southwest Region",11,1,2527,2,2531,1,57,0,9
"11/21/2021","Y","Y","Kodiak Island Borough",150,"Southwest Region",11,2,2529,0,2531,0,57,0,9
"11/22/2021","Y","Y","Kodiak Island Borough",150,"Southwest Region",11,0,2529,1,2532,0,57,0,9
"11/23/2021","Y","Y","Kodiak Island Borough",150,"Southwest Region",11,1,2530,1,2533,0,57,0,9
"11/24/2021","Y","Y","Kodiak Island Borough",150,"Southwest Region",11,6,2536,5,2538,1,58,0,9
"11/26/2021","Y","Y","Kodiak Island Borough",150,"Southwest Region",11,1,2537,1,2539,0,58,0,9
"11/27/2021","Y","Y","Kodiak Island Borough",150,"Southwest Region",11,1,2538,0,2539,0,58,0,9
"11/28/2021","Y","Y","Kodiak Island Borough",150,"Southwest Region",11,0,2538,2,2541,0,58,0,9
"11/29/2021","Y","Y","Kodiak Island Borough",150,"Southwest Region",11,1,2539,4,2545,0,58,0,9
"11/30/2021","Y","Y","Kodiak Island Borough",150,"Southwest Region",11,3,2542,4,2549,0,58,0,9
"12/02/2021","Y","Y","Kodiak Island Borough",150,"Southwest Region",11,3,2545,0,2549,0,58,0,9
"12/03/2021","Y","Y","Kodiak Island Borough",150,"Southwest Region",11,3,2548,4,2553,0,58,0,9
"12/04/2021","Y","Y","Kodiak Island Borough",150,"Southwest Region",11,0,2548,2,2555,0,58,1,10
"12/05/2021","Y","Y","Kodiak Island Borough",150,"Southwest Region",11,3,2551,0,2555,0,58,0,10
"12/06/2021","Y","Y","Kodiak Island Borough",150,"Southwest Region",11,2,2553,6,2561,0,58,0,10
"12/07/2021","Y","Y","Kodiak Island Borough",150,"Southwest Region",11,6,2559,2,2563,0,58,0,10
"12/08/2021","Y","Y","Kodiak Island Borough",150,"Southwest Region",11,3,2562,1,2564,0,58,0,10
"12/09/2021","Y","Y","Kodiak Island Borough",150,"Southwest Region",11,2,2564,2,2566,0,58,0,10
"12/10/2021","Y","Y","Kodiak Island Borough",150,"Southwest Region",11,4,2568,5,2571,0,58,0,10
"12/11/2021","Y","Y","Kodiak Island Borough",150,"Southwest Region",11,0,2568,2,2573,0,58,0,10
"12/12/2021","Y","Y","Kodiak Island Borough",150,"Southwest Region",11,2,2570,1,2574,0,58,0,10
"12/13/2021","Y","Y","Kodiak Island Borough",150,"Southwest Region",11,0,2570,1,2575,0,58,0,10
"12/14/2021","Y","Y","Kodiak Island Borough",150,"Southwest Region",11,0,2570,2,2577,0,58,0,10
"12/15/2021","Y","Y","Kodiak Island Borough",150,"Southwest Region",11,5,2575,1,2578,0,58,0,10
"12/16/2021","Y","Y","Kodiak Island Borough",150,"Southwest Region",11,1,2576,2,2580,0,58,0,10
"12/18/2021","Y","Y","Kodiak Island Borough",150,"Southwest Region",11,2,2578,0,2580,0,58,0,10
"12/20/2021","Y","Y","Kodiak Island Borough",150,"Southwest Region",11,0,2578,1,2581,1,59,0,10
"12/21/2021","Y","Y","Kodiak Island Borough",150,"Southwest Region",11,1,2579,2,2583,0,59,0,10
"12/22/2021","Y","Y","Kodiak Island Borough",150,"Southwest Region",11,2,2581,2,2585,0,59,0,10
"12/23/2021","Y","Y","Kodiak Island Borough",150,"Southwest Region",11,4,2585,8,2593,0,59,0,10
"12/24/2021","Y","Y","Kodiak Island Borough",150,"Southwest Region",11,6,2591,0,2593,0,59,0,10
"12/27/2021","Y","Y","Kodiak Island Borough",150,"Southwest Region",11,2,2593,24,2617,0,59,0,10
"12/28/2021","Y","Y","Kodiak Island Borough",150,"Southwest Region",11,20,2613,9,2626,0,59,0,10
"12/29/2021","Y","Y","Kodiak Island Borough",150,"Southwest Region",11,8,2621,12,2638,0,59,0,10
"12/30/2021","Y","Y","Kodiak Island Borough",150,"Southwest Region",11,12,2633,14,2652,0,59,0,10
"12/31/2021","Y","Y","Kodiak Island Borough",150,"Southwest Region",11,3,2636,9,2661,0,59,0,10
"01/01/2022","Y","Y","Kodiak Island Borough",150,"Southwest Region",11,8,2644,3,2664,0,59,0,10
"01/02/2022","Y","Y","Kodiak Island Borough",150,"Southwest Region",11,2,2646,5,2669,0,59,0,10
"01/03/2022","Y","Y","Kodiak Island Borough",150,"Southwest Region",11,17,2663,40,2709,0,59,0,10
"01/04/2022","Y","Y","Kodiak Island Borough",150,"Southwest Region",11,5,2668,82,2791,0,59,0,10
"01/05/2022","Y","Y","Kodiak Island Borough",150,"Southwest Region",11,69,2737,86,2877,0,59,0,10
"01/06/2022","Y","Y","Kodiak Island Borough",150,"Southwest Region",11,75,2812,71,2948,0,59,0,10
"01/07/2022","Y","Y","Kodiak Island Borough",150,"Southwest Region",11,111,2923,103,3051,0,59,0,10
"01/08/2022","Y","Y","Kodiak Island Borough",150,"Southwest Region",11,45,2968,61,3112,0,59,0,10
"01/09/2022","Y","Y","Kodiak Island Borough",150,"Southwest Region",11,20,2988,28,3140,0,59,0,10
"01/10/2022","Y","Y","Kodiak Island Borough",150,"Southwest Region",11,26,3014,41,3181,0,59,0,10
"01/11/2022","Y","Y","Kodiak Island Borough",150,"Southwest Region",11,77,3091,113,3294,0,59,0,10
"01/12/2022","Y","Y","Kodiak Island Borough",150,"Southwest Region",11,89,3180,107,3401,0,59,0,10
"01/13/2022","Y","Y","Kodiak Island Borough",150,"Southwest Region",11,105,3285,78,3479,0,59,0,10
"01/14/2022","Y","Y","Kodiak Island Borough",150,"Southwest Region",11,63,3348,85,3564,0,59,0,10
"01/15/2022","Y","Y","Kodiak Island Borough",150,"Southwest Region",11,66,3414,54,3618,0,59,0,10
"01/16/2022","Y","Y","Kodiak Island Borough",150,"Southwest Region",11,39,3453,23,3641,0,59,0,10
"01/17/2022","Y","Y","Kodiak Island Borough",150,"Southwest Region",11,54,3507,39,3680,0,59,0,10
"01/18/2022","Y","Y","Kodiak Island Borough",150,"Southwest Region",11,27,3534,50,3730,0,59,0,10
"01/19/2022","Y","Y","Kodiak Island Borough",150,"Southwest Region",11,71,3605,73,3803,0,59,0,10
"01/20/2022","Y","Y","Kodiak Island Borough",150,"Southwest Region",11,133,3738,57,3860,0,59,0,10
"01/21/2022","Y","Y","Kodiak Island Borough",150,"Southwest Region",11,60,3798,42,3902,0,59,0,10
"01/22/2022","Y","Y","Kodiak Island Borough",150,"Southwest Region",11,35,3833,34,3936,0,59,0,10
"01/23/2022","Y","Y","Kodiak Island Borough",150,"Southwest Region",11,43,3876,35,3971,1,60,0,10
"01/24/2022","Y","Y","Kodiak Island Borough",150,"Southwest Region",11,12,3888,31,4002,1,61,0,10
"01/25/2022","Y","Y","Kodiak Island Borough",150,"Southwest Region",11,82,3970,65,4067,2,63,0,10
"01/26/2022","Y","Y","Kodiak Island Borough",150,"Southwest Region",11,51,4021,36,4103,0,63,0,10
"01/27/2022","Y","Y","Kodiak Island Borough",150,"Southwest Region",11,63,4084,49,4152,0,63,1,11
"01/28/2022","Y","Y","Kodiak Island Borough",150,"Southwest Region",11,32,4116,32,4184,0,63,0,11
"01/29/2022","Y","Y","Kodiak Island Borough",150,"Southwest Region",11,20,4136,19,4203,0,63,0,11
"01/30/2022","Y","Y","Kodiak Island Borough",150,"Southwest Region",11,16,4152,13,4216,0,63,0,11
"01/31/2022","Y","Y","Kodiak Island Borough",150,"Southwest Region",11,20,4172,22,4238,0,63,0,11
"02/01/2022","Y","Y","Kodiak Island Borough",150,"Southwest Region",11,49,4221,15,4253,0,63,0,11
"02/02/2022","Y","Y","Kodiak Island Borough",150,"Southwest Region",11,23,4244,22,4275,0,63,0,11
"02/03/2022","Y","Y","Kodiak Island Borough",150,"Southwest Region",11,19,4263,21,4296,0,63,0,11
"02/04/2022","Y","Y","Kodiak Island Borough",150,"Southwest Region",11,48,4311,36,4332,0,63,0,11
"02/05/2022","Y","Y","Kodiak Island Borough",150,"Southwest Region",11,8,4319,5,4337,0,63,0,11
"02/06/2022","Y","Y","Kodiak Island Borough",150,"Southwest Region",11,7,4326,4,4341,0,63,0,11
"02/07/2022","Y","Y","Kodiak Island Borough",150,"Southwest Region",11,34,4360,29,4370,0,63,0,11
"02/08/2022","Y","Y","Kodiak Island Borough",150,"Southwest Region",11,43,4403,39,4409,0,63,1,12
"02/09/2022","Y","Y","Kodiak Island Borough",150,"Southwest Region",11,32,4435,34,4443,0,63,0,12
"02/10/2022","Y","Y","Kodiak Island Borough",150,"Southwest Region",11,9,4444,5,4448,0,63,0,12
"02/11/2022","Y","Y","Kodiak Island Borough",150,"Southwest Region",11,20,4464,21,4469,0,63,0,12
"02/12/2022","Y","Y","Kodiak Island Borough",150,"Southwest Region",11,12,4476,15,4484,0,63,0,12
"02/13/2022","Y","Y","Kodiak Island Borough",150,"Southwest Region",11,13,4489,14,4498,0,63,0,12
"02/14/2022","Y","Y","Kodiak Island Borough",150,"Southwest Region",11,13,4502,14,4512,0,63,0,12
"02/15/2022","Y","Y","Kodiak Island Borough",150,"Southwest Region",11,3,4505,5,4517,0,63,0,12
"02/16/2022","Y","Y","Kodiak Island Borough",150,"Southwest Region",11,31,4536,28,4545,0,63,0,12
"02/17/2022","Y","Y","Kodiak Island Borough",150,"Southwest Region",11,8,4544,6,4551,0,63,0,12
"02/18/2022","Y","Y","Kodiak Island Borough",150,"Southwest Region",11,4,4548,6,4557,0,63,0,12
"02/19/2022","Y","Y","Kodiak Island Borough",150,"Southwest Region",11,14,4562,11,4568,0,63,0,12
"02/20/2022","Y","Y","Kodiak Island Borough",150,"Southwest Region",11,11,4573,10,4578,0,63,0,12
"02/21/2022","Y","Y","Kodiak Island Borough",150,"Southwest Region",11,1,4574,4,4582,0,63,0,12
"02/22/2022","Y","Y","Kodiak Island Borough",150,"Southwest Region",11,5,4579,3,4585,0,63,0,12
"02/23/2022","Y","Y","Kodiak Island Borough",150,"Southwest Region",11,17,4596,19,4604,0,63,0,12
"02/24/2022","Y","Y","Kodiak Island Borough",150,"Southwest Region",11,12,4608,9,4613,0,63,0,12
"02/25/2022","Y","Y","Kodiak Island Borough",150,"Southwest Region",11,16,4624,12,4625,0,63,0,12
"02/26/2022","Y","Y","Kodiak Island Borough",150,"Southwest Region",11,6,4630,5,4630,0,63,0,12
"02/27/2022","Y","Y","Kodiak Island Borough",150,"Southwest Region",11,5,4635,5,4635,0,63,0,12
"02/28/2022","Y","Y","Kodiak Island Borough",150,"Southwest Region",11,5,4640,5,4640,0,63,0,12
"03/01/2022","Y","Y","Kodiak Island Borough",150,"Southwest Region",11,7,4647,9,4649,0,63,0,12
"03/02/2022","Y","Y","Kodiak Island Borough",150,"Southwest Region",11,2,4649,2,4651,0,63,0,12
"03/03/2022","Y","Y","Kodiak Island Borough",150,"Southwest Region",11,5,4654,3,4654,0,63,0,12
"03/04/2022","Y","Y","Kodiak Island Borough",150,"Southwest Region",11,6,4660,6,4660,0,63,0,12
"03/05/2022","Y","Y","Kodiak Island Borough",150,"Southwest Region",11,2,4662,3,4663,0,63,0,12
"03/06/2022","Y","Y","Kodiak Island Borough",150,"Southwest Region",11,2,4664,2,4665,0,63,0,12
"03/07/2022","Y","Y","Kodiak Island Borough",150,"Southwest Region",11,4,4668,6,4671,0,63,0,12
"03/08/2022","Y","Y","Kodiak Island Borough",150,"Southwest Region",11,6,4674,4,4675,0,63,0,12
"03/09/2022","Y","Y","Kodiak Island Borough",150,"Southwest Region",11,6,4680,6,4681,0,63,0,12
"03/10/2022","Y","Y","Kodiak Island Borough",150,"Southwest Region",11,2,4682,2,4683,0,63,0,12
"03/11/2022","Y","Y","Kodiak Island Borough",150,"Southwest Region",11,2,4684,1,4684,0,63,0,12
"03/12/2022","Y","Y","Kodiak Island Borough",150,"Southwest Region",11,3,4687,6,4690,0,63,0,12
"03/13/2022","Y","Y","Kodiak Island Borough",150,"Southwest Region",11,2,4689,1,4691,0,63,0,12
"03/14/2022","Y","Y","Kodiak Island Borough",150,"Southwest Region",11,3,4692,1,4692,0,63,0,12
"03/15/2022","Y","Y","Kodiak Island Borough",150,"Southwest Region",11,5,4697,5,4697,0,63,0,12
"03/16/2022","Y","Y","Kodiak Island Borough",150,"Southwest Region",11,3,4700,3,4700,0,63,0,12
"03/17/2022","Y","Y","Kodiak Island Borough",150,"Southwest Region",11,3,4703,3,4703,0,63,0,12
"03/18/2022","Y","Y","Kodiak Island Borough",150,"Southwest Region",11,1,4704,1,4704,0,63,0,12
"03/19/2022","Y","Y","Kodiak Island Borough",150,"Southwest Region",11,2,4706,2,4706,0,63,0,12
"03/20/2022","Y","Y","Kodiak Island Borough",150,"Southwest Region",11,4,4710,4,4710,0,63,0,12
"03/22/2022","Y","Y","Kodiak Island Borough",150,"Southwest Region",11,6,4716,6,4716,0,63,0,12
"03/23/2022","Y","Y","Kodiak Island Borough",150,"Southwest Region",11,2,4718,2,4718,0,63,0,12
"03/24/2022","Y","Y","Kodiak Island Borough",150,"Southwest Region",11,3,4721,3,4721,0,63,0,12
"03/25/2022","Y","Y","Kodiak Island Borough",150,"Southwest Region",11,1,4722,2,4723,0,63,0,12
"03/26/2022","Y","Y","Kodiak Island Borough",150,"Southwest Region",11,3,4725,3,4726,0,63,0,12
"03/27/2022","Y","Y","Kodiak Island Borough",150,"Southwest Region",11,1,4726,1,4727,0,63,0,12
"03/28/2022","Y","Y","Kodiak Island Borough",150,"Southwest Region",11,1,4727,1,4728,0,63,0,12
"03/29/2022","Y","Y","Kodiak Island Borough",150,"Southwest Region",11,0,4727,1,4729,0,63,0,12
"03/30/2022","Y","Y","Kodiak Island Borough",150,"Southwest Region",11,2,4729,3,4732,0,63,0,12
"03/31/2022","Y","Y","Kodiak Island Borough",150,"Southwest Region",11,3,4732,5,4737,0,63,0,12
"04/01/2022","Y","Y","Kodiak Island Borough",150,"Southwest Region",11,10,4742,8,4745,0,63,0,12
"04/02/2022","Y","Y","Kodiak Island Borough",150,"Southwest Region",11,0,4742,2,4747,0,63,0,12
"04/03/2022","Y","Y","Kodiak Island Borough",150,"Southwest Region",11,4,4746,3,4750,0,63,0,12
"04/04/2022","Y","Y","Kodiak Island Borough",150,"Southwest Region",11,2,4748,1,4751,0,63,0,12
"04/05/2022","Y","Y","Kodiak Island Borough",150,"Southwest Region",11,3,4751,3,4754,0,63,0,12
"04/06/2022","Y","Y","Kodiak Island Borough",150,"Southwest Region",11,7,4758,4,4758,0,63,0,12
"04/07/2022","Y","Y","Kodiak Island Borough",150,"Southwest Region",11,1,4759,1,4759,0,63,0,12
"04/08/2022","Y","Y","Kodiak Island Borough",150,"Southwest Region",11,1,4760,1,4760,0,63,0,12
"04/09/2022","Y","Y","Kodiak Island Borough",150,"Southwest Region",11,2,4762,2,4762,0,63,0,12
"04/12/2022","Y","Y","Kodiak Island Borough",150,"Southwest Region",11,3,4765,4,4766,0,63,0,12
"04/13/2022","Y","Y","Kodiak Island Borough",150,"Southwest Region",11,4,4769,3,4769,0,63,0,12
"04/14/2022","Y","Y","Kodiak Island Borough",150,"Southwest Region",11,0,4769,1,4770,0,63,0,12
"04/15/2022","Y","Y","Kodiak Island Borough",150,"Southwest Region",11,4,4773,4,4774,0,63,0,12
"04/16/2022","Y","Y","Kodiak Island Borough",150,"Southwest Region",11,4,4777,5,4779,0,63,0,12
"04/17/2022","Y","Y","Kodiak Island Borough",150,"Southwest Region",11,2,4779,0,4779,0,63,0,12
"04/19/2022","Y","Y","Kodiak Island Borough",150,"Southwest Region",11,1,4780,2,4781,0,63,0,12
"04/20/2022","Y","Y","Kodiak Island Borough",150,"Southwest Region",11,1,4781,0,4781,0,63,0,12
"04/21/2022","Y","Y","Kodiak Island Borough",150,"Southwest Region",11,2,4783,2,4783,0,63,0,12
"04/22/2022","Y","Y","Kodiak Island Borough",150,"Southwest Region",11,1,4784,1,4784,0,63,0,12
"04/23/2022","Y","Y","Kodiak Island Borough",150,"Southwest Region",11,2,4786,2,4786,0,63,0,12
"04/26/2022","Y","Y","Kodiak Island Borough",150,"Southwest Region",11,1,4787,1,4787,0,63,0,12
"06/30/2020","Y","Y","Kusilvak Census Area",158,"Y-K Delta Region",10,0,0,1,1,0,0,0,0
"07/02/2020","Y","Y","Kusilvak Census Area",158,"Y-K Delta Region",10,1,1,0,1,0,0,0,0
"07/06/2020","Y","Y","Kusilvak Census Area",158,"Y-K Delta Region",10,0,1,1,2,0,0,0,0
"07/07/2020","Y","Y","Kusilvak Census Area",158,"Y-K Delta Region",10,1,2,1,3,0,0,0,0
"07/14/2020","Y","Y","Kusilvak Census Area",158,"Y-K Delta Region",10,1,3,0,3,0,0,0,0
"07/26/2020","Y","Y","Kusilvak Census Area",158,"Y-K Delta Region",10,1,4,1,4,0,0,0,0
"08/01/2020","Y","Y","Kusilvak Census Area",158,"Y-K Delta Region",10,0,4,1,5,0,0,0,0
"08/02/2020","Y","Y","Kusilvak Census Area",158,"Y-K Delta Region",10,1,5,1,6,0,0,0,0
"08/03/2020","Y","Y","Kusilvak Census Area",158,"Y-K Delta Region",10,1,6,1,7,0,0,0,0
"08/06/2020","Y","Y","Kusilvak Census Area",158,"Y-K Delta Region",10,0,6,1,8,0,0,0,0
"08/10/2020","Y","Y","Kusilvak Census Area",158,"Y-K Delta Region",10,1,7,0,8,0,0,0,0
"08/13/2020","Y","Y","Kusilvak Census Area",158,"Y-K Delta Region",10,1,8,0,8,0,0,0,0
"09/09/2020","Y","Y","Kusilvak Census Area",158,"Y-K Delta Region",10,1,9,1,9,0,0,0,0
"09/14/2020","Y","Y","Kusilvak Census Area",158,"Y-K Delta Region",10,2,11,2,11,0,0,0,0
"09/17/2020","Y","Y","Kusilvak Census Area",158,"Y-K Delta Region",10,0,11,1,12,0,0,0,0
"09/20/2020","Y","Y","Kusilvak Census Area",158,"Y-K Delta Region",10,1,12,0,12,0,0,0,0
"09/25/2020","Y","Y","Kusilvak Census Area",158,"Y-K Delta Region",10,0,12,2,14,0,0,0,0
"09/26/2020","Y","Y","Kusilvak Census Area",158,"Y-K Delta Region",10,1,13,0,14,0,0,0,0
"09/27/2020","Y","Y","Kusilvak Census Area",158,"Y-K Delta Region",10,1,14,0,14,0,0,0,0
"09/28/2020","Y","Y","Kusilvak Census Area",158,"Y-K Delta Region",10,0,14,2,16,0,0,0,0
"09/30/2020","Y","Y","Kusilvak Census Area",158,"Y-K Delta Region",10,0,14,2,18,0,0,0,0
"10/02/2020","Y","Y","Kusilvak Census Area",158,"Y-K Delta Region",10,0,14,3,21,0,0,0,0
"10/04/2020","Y","Y","Kusilvak Census Area",158,"Y-K Delta Region",10,1,15,0,21,0,0,0,0
"10/05/2020","Y","Y","Kusilvak Census Area",158,"Y-K Delta Region",10,0,15,1,22,0,0,0,0
"10/06/2020","Y","Y","Kusilvak Census Area",158,"Y-K Delta Region",10,0,15,1,23,0,0,0,0
"10/07/2020","Y","Y","Kusilvak Census Area",158,"Y-K Delta Region",10,0,15,1,24,0,0,0,0
"10/08/2020","Y","Y","Kusilvak Census Area",158,"Y-K Delta Region",10,1,16,0,24,0,0,0,0
"10/09/2020","Y","Y","Kusilvak Census Area",158,"Y-K Delta Region",10,1,17,1,25,0,0,0,0
"10/10/2020","Y","Y","Kusilvak Census Area",158,"Y-K Delta Region",10,2,19,1,26,0,0,0,0
"10/11/2020","Y","Y","Kusilvak Census Area",158,"Y-K Delta Region",10,3,22,1,27,0,0,0,0
"10/12/2020","Y","Y","Kusilvak Census Area",158,"Y-K Delta Region",10,2,24,1,28,0,0,0,0
"10/13/2020","Y","Y","Kusilvak Census Area",158,"Y-K Delta Region",10,3,27,64,92,0,0,0,0
"10/14/2020","Y","Y","Kusilvak Census Area",158,"Y-K Delta Region",10,2,29,36,128,0,0,0,0
"10/15/2020","Y","Y","Kusilvak Census Area",158,"Y-K Delta Region",10,1,30,59,187,1,1,0,0
"10/16/2020","Y","Y","Kusilvak Census Area",158,"Y-K Delta Region",10,2,32,3,190,0,1,0,0
"10/17/2020","Y","Y","Kusilvak Census Area",158,"Y-K Delta Region",10,2,34,6,196,0,1,0,0
"10/18/2020","Y","Y","Kusilvak Census Area",158,"Y-K Delta Region",10,6,40,3,199,0,1,0,0
"10/19/2020","Y","Y","Kusilvak Census Area",158,"Y-K Delta Region",10,4,44,3,202,0,1,0,0
"10/20/2020","Y","Y","Kusilvak Census Area",158,"Y-K Delta Region",10,3,47,1,203,0,1,0,0
"10/21/2020","Y","Y","Kusilvak Census Area",158,"Y-K Delta Region",10,69,116,8,211,0,1,0,0
"10/22/2020","Y","Y","Kusilvak Census Area",158,"Y-K Delta Region",10,3,119,12,223,0,1,0,0
"10/23/2020","Y","Y","Kusilvak Census Area",158,"Y-K Delta Region",10,46,165,0,223,0,1,0,0
"10/24/2020","Y","Y","Kusilvak Census Area",158,"Y-K Delta Region",10,18,183,1,224,0,1,0,0
"10/25/2020","Y","Y","Kusilvak Census Area",158,"Y-K Delta Region",10,9,192,17,241,0,1,0,0
"10/26/2020","Y","Y","Kusilvak Census Area",158,"Y-K Delta Region",10,16,208,44,285,0,1,0,0
"10/27/2020","Y","Y","Kusilvak Census Area",158,"Y-K Delta Region",10,1,209,21,306,0,1,0,0
"10/28/2020","Y","Y","Kusilvak Census Area",158,"Y-K Delta Region",10,15,224,26,332,0,1,0,0
"10/29/2020","Y","Y","Kusilvak Census Area",158,"Y-K Delta Region",10,0,224,1,333,0,1,0,0
"10/30/2020","Y","Y","Kusilvak Census Area",158,"Y-K Delta Region",10,16,240,4,337,1,2,0,0
"10/31/2020","Y","Y","Kusilvak Census Area",158,"Y-K Delta Region",10,11,251,1,338,0,2,0,0
"11/01/2020","Y","Y","Kusilvak Census Area",158,"Y-K Delta Region",10,9,260,0,338,0,2,1,1
"11/02/2020","Y","Y","Kusilvak Census Area",158,"Y-K Delta Region",10,19,279,1,339,0,2,0,1
"11/03/2020","Y","Y","Kusilvak Census Area",158,"Y-K Delta Region",10,1,280,2,341,0,2,0,1
"11/04/2020","Y","Y","Kusilvak Census Area",158,"Y-K Delta Region",10,4,284,4,345,0,2,0,1
"11/05/2020","Y","Y","Kusilvak Census Area",158,"Y-K Delta Region",10,12,296,6,351,0,2,0,1
"11/06/2020","Y","Y","Kusilvak Census Area",158,"Y-K Delta Region",10,20,316,12,363,1,3,0,1
"11/07/2020","Y","Y","Kusilvak Census Area",158,"Y-K Delta Region",10,8,324,5,368,0,3,0,1
"11/08/2020","Y","Y","Kusilvak Census Area",158,"Y-K Delta Region",10,12,336,1,369,0,3,0,1
"11/09/2020","Y","Y","Kusilvak Census Area",158,"Y-K Delta Region",10,11,347,3,372,0,3,0,1
"11/10/2020","Y","Y","Kusilvak Census Area",158,"Y-K Delta Region",10,1,348,6,378,0,3,0,1
"11/11/2020","Y","Y","Kusilvak Census Area",158,"Y-K Delta Region",10,3,351,5,383,0,3,0,1
"11/12/2020","Y","Y","Kusilvak Census Area",158,"Y-K Delta Region",10,2,353,10,393,0,3,0,1
"11/13/2020","Y","Y","Kusilvak Census Area",158,"Y-K Delta Region",10,4,357,10,403,0,3,0,1
"11/14/2020","Y","Y","Kusilvak Census Area",158,"Y-K Delta Region",10,1,358,2,405,0,3,0,1
"11/15/2020","Y","Y","Kusilvak Census Area",158,"Y-K Delta Region",10,4,362,4,409,0,3,0,1
"11/16/2020","Y","Y","Kusilvak Census Area",158,"Y-K Delta Region",10,3,365,10,419,0,3,0,1
"11/17/2020","Y","Y","Kusilvak Census Area",158,"Y-K Delta Region",10,15,380,12,431,0,3,0,1
"11/18/2020","Y","Y","Kusilvak Census Area",158,"Y-K Delta Region",10,5,385,8,439,0,3,0,1
"11/19/2020","Y","Y","Kusilvak Census Area",158,"Y-K Delta Region",10,7,392,6,445,0,3,0,1
"11/20/2020","Y","Y","Kusilvak Census Area",158,"Y-K Delta Region",10,7,399,17,462,0,3,0,1
"11/21/2020","Y","Y","Kusilvak Census Area",158,"Y-K Delta Region",10,8,407,2,464,0,3,0,1
"11/22/2020","Y","Y","Kusilvak Census Area",158,"Y-K Delta Region",10,4,411,3,467,0,3,0,1
"11/23/2020","Y","Y","Kusilvak Census Area",158,"Y-K Delta Region",10,2,413,12,479,0,3,0,1
"11/24/2020","Y","Y","Kusilvak Census Area",158,"Y-K Delta Region",10,5,418,26,505,2,5,0,1
"11/25/2020","Y","Y","Kusilvak Census Area",158,"Y-K Delta Region",10,7,425,29,534,0,5,1,2
"11/26/2020","Y","Y","Kusilvak Census Area",158,"Y-K Delta Region",10,3,428,6,540,0,5,0,2
"11/27/2020","Y","Y","Kusilvak Census Area",158,"Y-K Delta Region",10,13,441,7,547,0,5,0,2
"11/28/2020","Y","Y","Kusilvak Census Area",158,"Y-K Delta Region",10,16,457,25,572,0,5,0,2
"11/29/2020","Y","Y","Kusilvak Census Area",158,"Y-K Delta Region",10,7,464,7,579,0,5,0,2
"11/30/2020","Y","Y","Kusilvak Census Area",158,"Y-K Delta Region",10,7,471,18,597,1,6,0,2
"12/01/2020","Y","Y","Kusilvak Census Area",158,"Y-K Delta Region",10,1,472,20,617,0,6,0,2
"12/02/2020","Y","Y","Kusilvak Census Area",158,"Y-K Delta Region",10,15,487,32,649,0,6,0,2
"12/03/2020","Y","Y","Kusilvak Census Area",158,"Y-K Delta Region",10,7,494,18,667,0,6,0,2
"12/04/2020","Y","Y","Kusilvak Census Area",158,"Y-K Delta Region",10,27,521,32,699,1,7,0,2
"12/05/2020","Y","Y","Kusilvak Census Area",158,"Y-K Delta Region",10,3,524,19,718,0,7,0,2
"12/06/2020","Y","Y","Kusilvak Census Area",158,"Y-K Delta Region",10,11,535,11,729,0,7,0,2
"12/07/2020","Y","Y","Kusilvak Census Area",158,"Y-K Delta Region",10,24,559,13,742,0,7,0,2
"12/08/2020","Y","Y","Kusilvak Census Area",158,"Y-K Delta Region",10,41,600,16,758,0,7,0,2
"12/09/2020","Y","Y","Kusilvak Census Area",158,"Y-K Delta Region",10,12,612,13,771,0,7,0,2
"12/10/2020","Y","Y","Kusilvak Census Area",158,"Y-K Delta Region",10,37,649,11,782,1,8,0,2
"12/11/2020","Y","Y","Kusilvak Census Area",158,"Y-K Delta Region",10,16,665,9,791,0,8,0,2
"12/12/2020","Y","Y","Kusilvak Census Area",158,"Y-K Delta Region",10,22,687,2,793,0,8,0,2
"12/13/2020","Y","Y","Kusilvak Census Area",158,"Y-K Delta Region",10,16,703,2,795,1,9,0,2
"12/14/2020","Y","Y","Kusilvak Census Area",158,"Y-K Delta Region",10,10,713,14,809,0,9,0,2
"12/15/2020","Y","Y","Kusilvak Census Area",158,"Y-K Delta Region",10,11,724,22,831,0,9,0,2
"12/16/2020","Y","Y","Kusilvak Census Area",158,"Y-K Delta Region",10,7,731,10,841,0,9,0,2
"12/17/2020","Y","Y","Kusilvak Census Area",158,"Y-K Delta Region",10,1,732,5,846,0,9,0,2
"12/18/2020","Y","Y","Kusilvak Census Area",158,"Y-K Delta Region",10,2,734,9,855,0,9,0,2
"12/19/2020","Y","Y","Kusilvak Census Area",158,"Y-K Delta Region",10,0,734,2,857,0,9,0,2
"12/20/2020","Y","Y","Kusilvak Census Area",158,"Y-K Delta Region",10,13,747,3,860,0,9,0,2
"12/21/2020","Y","Y","Kusilvak Census Area",158,"Y-K Delta Region",10,5,752,5,865,0,9,0,2
"12/22/2020","Y","Y","Kusilvak Census Area",158,"Y-K Delta Region",10,1,753,3,868,0,9,0,2
"12/23/2020","Y","Y","Kusilvak Census Area",158,"Y-K Delta Region",10,0,753,1,869,0,9,0,2
"12/25/2020","Y","Y","Kusilvak Census Area",158,"Y-K Delta Region",10,3,756,0,869,0,9,0,2
"12/26/2020","Y","Y","Kusilvak Census Area",158,"Y-K Delta Region",10,3,759,0,869,0,9,0,2
"12/28/2020","Y","Y","Kusilvak Census Area",158,"Y-K Delta Region",10,0,759,9,878,0,9,0,2
"12/29/2020","Y","Y","Kusilvak Census Area",158,"Y-K Delta Region",10,3,762,5,883,0,9,0,2
"12/30/2020","Y","Y","Kusilvak Census Area",158,"Y-K Delta Region",10,50,812,1,884,0,9,0,2
"12/31/2020","Y","Y","Kusilvak Census Area",158,"Y-K Delta Region",10,29,841,0,884,0,9,0,2
"01/01/2021","Y","Y","Kusilvak Census Area",158,"Y-K Delta Region",10,11,852,3,887,0,9,0,2
"01/02/2021","Y","Y","Kusilvak Census Area",158,"Y-K Delta Region",10,10,862,1,888,0,9,0,2
"01/03/2021","Y","Y","Kusilvak Census Area",158,"Y-K Delta Region",10,14,876,4,892,0,9,0,2
"01/04/2021","Y","Y","Kusilvak Census Area",158,"Y-K Delta Region",10,2,878,14,906,0,9,1,3
"01/05/2021","Y","Y","Kusilvak Census Area",158,"Y-K Delta Region",10,5,883,29,935,0,9,0,3
"01/06/2021","Y","Y","Kusilvak Census Area",158,"Y-K Delta Region",10,10,893,13,948,0,9,0,3
"01/07/2021","Y","Y","Kusilvak Census Area",158,"Y-K Delta Region",10,16,909,14,962,0,9,0,3
"01/08/2021","Y","Y","Kusilvak Census Area",158,"Y-K Delta Region",10,13,922,7,969,0,9,0,3
"01/09/2021","Y","Y","Kusilvak Census Area",158,"Y-K Delta Region",10,3,925,8,977,0,9,0,3
"01/10/2021","Y","Y","Kusilvak Census Area",158,"Y-K Delta Region",10,1,926,7,984,0,9,0,3
"01/11/2021","Y","Y","Kusilvak Census Area",158,"Y-K Delta Region",10,8,934,18,1002,0,9,0,3
"01/12/2021","Y","Y","Kusilvak Census Area",158,"Y-K Delta Region",10,8,942,8,1010,0,9,0,3
"01/13/2021","Y","Y","Kusilvak Census Area",158,"Y-K Delta Region",10,9,951,13,1023,0,9,0,3
"01/14/2021","Y","Y","Kusilvak Census Area",158,"Y-K Delta Region",10,13,964,13,1036,1,10,0,3
"01/15/2021","Y","Y","Kusilvak Census Area",158,"Y-K Delta Region",10,15,979,27,1063,0,10,0,3
"01/16/2021","Y","Y","Kusilvak Census Area",158,"Y-K Delta Region",10,20,999,4,1067,0,10,0,3
"01/17/2021","Y","Y","Kusilvak Census Area",158,"Y-K Delta Region",10,10,1009,1,1068,0,10,0,3
"01/18/2021","Y","Y","Kusilvak Census Area",158,"Y-K Delta Region",10,15,1024,4,1072,0,10,0,3
"01/19/2021","Y","Y","Kusilvak Census Area",158,"Y-K Delta Region",10,11,1035,21,1093,0,10,0,3
"01/20/2021","Y","Y","Kusilvak Census Area",158,"Y-K Delta Region",10,32,1067,3,1096,0,10,0,3
"01/21/2021","Y","Y","Kusilvak Census Area",158,"Y-K Delta Region",10,4,1071,9,1105,0,10,0,3
"01/22/2021","Y","Y","Kusilvak Census Area",158,"Y-K Delta Region",10,13,1084,8,1113,0,10,0,3
"01/23/2021","Y","Y","Kusilvak Census Area",158,"Y-K Delta Region",10,9,1093,1,1114,0,10,0,3
"01/24/2021","Y","Y","Kusilvak Census Area",158,"Y-K Delta Region",10,0,1093,5,1119,0,10,0,3
"01/25/2021","Y","Y","Kusilvak Census Area",158,"Y-K Delta Region",10,5,1098,2,1121,0,10,0,3
"01/26/2021","Y","Y","Kusilvak Census Area",158,"Y-K Delta Region",10,6,1104,4,1125,2,12,0,3
"01/27/2021","Y","Y","Kusilvak Census Area",158,"Y-K Delta Region",10,7,1111,7,1132,0,12,0,3
"01/28/2021","Y","Y","Kusilvak Census Area",158,"Y-K Delta Region",10,5,1116,15,1147,0,12,0,3
"01/29/2021","Y","Y","Kusilvak Census Area",158,"Y-K Delta Region",10,10,1126,1,1148,0,12,0,3
"01/30/2021","Y","Y","Kusilvak Census Area",158,"Y-K Delta Region",10,9,1135,0,1148,0,12,0,3
"01/31/2021","Y","Y","Kusilvak Census Area",158,"Y-K Delta Region",10,0,1135,1,1149,0,12,0,3
"02/01/2021","Y","Y","Kusilvak Census Area",158,"Y-K Delta Region",10,0,1135,3,1152,0,12,0,3
"02/02/2021","Y","Y","Kusilvak Census Area",158,"Y-K Delta Region",10,1,1136,10,1162,0,12,0,3
"02/03/2021","Y","Y","Kusilvak Census Area",158,"Y-K Delta Region",10,17,1153,6,1168,0,12,0,3
"02/04/2021","Y","Y","Kusilvak Census Area",158,"Y-K Delta Region",10,6,1159,2,1170,0,12,0,3
"02/05/2021","Y","Y","Kusilvak Census Area",158,"Y-K Delta Region",10,7,1166,9,1179,0,12,0,3
"02/06/2021","Y","Y","Kusilvak Census Area",158,"Y-K Delta Region",10,2,1168,1,1180,0,12,0,3
"02/07/2021","Y","Y","Kusilvak Census Area",158,"Y-K Delta Region",10,0,1168,1,1181,0,12,0,3
"02/08/2021","Y","Y","Kusilvak Census Area",158,"Y-K Delta Region",10,2,1170,7,1188,0,12,0,3
"02/09/2021","Y","Y","Kusilvak Census Area",158,"Y-K Delta Region",10,6,1176,2,1190,0,12,0,3
"02/10/2021","Y","Y","Kusilvak Census Area",158,"Y-K Delta Region",10,8,1184,4,1194,0,12,0,3
"02/11/2021","Y","Y","Kusilvak Census Area",158,"Y-K Delta Region",10,4,1188,0,1194,0,12,0,3
"02/12/2021","Y","Y","Kusilvak Census Area",158,"Y-K Delta Region",10,6,1194,2,1196,0,12,0,3
"02/13/2021","Y","Y","Kusilvak Census Area",158,"Y-K Delta Region",10,1,1195,0,1196,0,12,0,3
"02/14/2021","Y","Y","Kusilvak Census Area",158,"Y-K Delta Region",10,0,1195,1,1197,0,12,0,3
"02/16/2021","Y","Y","Kusilvak Census Area",158,"Y-K Delta Region",10,0,1195,3,1200,0,12,0,3
"02/17/2021","Y","Y","Kusilvak Census Area",158,"Y-K Delta Region",10,4,1199,3,1203,0,12,0,3
"02/18/2021","Y","Y","Kusilvak Census Area",158,"Y-K Delta Region",10,0,1199,5,1208,0,12,0,3
"02/19/2021","Y","Y","Kusilvak Census Area",158,"Y-K Delta Region",10,5,1204,0,1208,0,12,0,3
"02/20/2021","Y","Y","Kusilvak Census Area",158,"Y-K Delta Region",10,2,1206,1,1209,0,12,0,3
"02/22/2021","Y","Y","Kusilvak Census Area",158,"Y-K Delta Region",10,0,1206,1,1210,0,12,0,3
"02/23/2021","Y","Y","Kusilvak Census Area",158,"Y-K Delta Region",10,2,1208,1,1211,0,12,0,3
"02/24/2021","Y","Y","Kusilvak Census Area",158,"Y-K Delta Region",10,0,1208,3,1214,0,12,0,3
"02/25/2021","Y","Y","Kusilvak Census Area",158,"Y-K Delta Region",10,1,1209,1,1215,0,12,0,3
"02/26/2021","Y","Y","Kusilvak Census Area",158,"Y-K Delta Region",10,0,1209,5,1220,0,12,0,3
"02/27/2021","Y","Y","Kusilvak Census Area",158,"Y-K Delta Region",10,3,1212,0,1220,0,12,1,4
"02/28/2021","Y","Y","Kusilvak Census Area",158,"Y-K Delta Region",10,1,1213,0,1220,0,12,0,4
"03/01/2021","Y","Y","Kusilvak Census Area",158,"Y-K Delta Region",10,8,1221,2,1222,0,12,0,4
"03/02/2021","Y","Y","Kusilvak Census Area",158,"Y-K Delta Region",10,1,1222,0,1222,0,12,0,4
"03/04/2021","Y","Y","Kusilvak Census Area",158,"Y-K Delta Region",10,0,1222,2,1224,0,12,0,4
"03/05/2021","Y","Y","Kusilvak Census Area",158,"Y-K Delta Region",10,1,1223,0,1224,0,12,0,4
"03/08/2021","Y","Y","Kusilvak Census Area",158,"Y-K Delta Region",10,0,1223,1,1225,0,12,0,4
"03/09/2021","Y","Y","Kusilvak Census Area",158,"Y-K Delta Region",10,1,1224,1,1226,0,12,0,4
"03/10/2021","Y","Y","Kusilvak Census Area",158,"Y-K Delta Region",10,1,1225,2,1228,0,12,0,4
"03/11/2021","Y","Y","Kusilvak Census Area",158,"Y-K Delta Region",10,1,1226,0,1228,0,12,0,4
"03/14/2021","Y","Y","Kusilvak Census Area",158,"Y-K Delta Region",10,1,1227,0,1228,0,12,0,4
"03/15/2021","Y","Y","Kusilvak Census Area",158,"Y-K Delta Region",10,0,1227,1,1229,0,12,0,4
"03/19/2021","Y","Y","Kusilvak Census Area",158,"Y-K Delta Region",10,2,1229,0,1229,0,12,0,4
"03/26/2021","Y","Y","Kusilvak Census Area",158,"Y-K Delta Region",10,0,1229,3,1232,0,12,0,4
"03/29/2021","Y","Y","Kusilvak Census Area",158,"Y-K Delta Region",10,0,1229,1,1233,0,12,0,4
"03/30/2021","Y","Y","Kusilvak Census Area",158,"Y-K Delta Region",10,0,1229,1,1234,0,12,0,4
"03/31/2021","Y","Y","Kusilvak Census Area",158,"Y-K Delta Region",10,2,1231,0,1234,0,12,0,4
"04/01/2021","Y","Y","Kusilvak Census Area",158,"Y-K Delta Region",10,2,1233,1,1235,0,12,0,4
"04/02/2021","Y","Y","Kusilvak Census Area",158,"Y-K Delta Region",10,1,1234,0,1235,0,12,0,4
"04/04/2021","Y","Y","Kusilvak Census Area",158,"Y-K Delta Region",10,1,1235,1,1236,0,12,0,4
"04/05/2021","Y","Y","Kusilvak Census Area",158,"Y-K Delta Region",10,1,1236,1,1237,0,12,0,4
"04/06/2021","Y","Y","Kusilvak Census Area",158,"Y-K Delta Region",10,0,1236,4,1241,0,12,0,4
"04/07/2021","Y","Y","Kusilvak Census Area",158,"Y-K Delta Region",10,5,1241,1,1242,0,12,0,4
"04/09/2021","Y","Y","Kusilvak Census Area",158,"Y-K Delta Region",10,0,1241,1,1243,0,12,0,4
"04/10/2021","Y","Y","Kusilvak Census Area",158,"Y-K Delta Region",10,0,1241,1,1244,0,12,0,4
"04/12/2021","Y","Y","Kusilvak Census Area",158,"Y-K Delta Region",10,0,1241,1,1245,0,12,0,4
"04/13/2021","Y","Y","Kusilvak Census Area",158,"Y-K Delta Region",10,1,1242,3,1248,0,12,0,4
"04/14/2021","Y","Y","Kusilvak Census Area",158,"Y-K Delta Region",10,3,1245,0,1248,0,12,0,4
"04/16/2021","Y","Y","Kusilvak Census Area",158,"Y-K Delta Region",10,0,1245,3,1251,0,12,0,4
"04/19/2021","Y","Y","Kusilvak Census Area",158,"Y-K Delta Region",10,1,1246,7,1258,0,12,0,4
"04/20/2021","Y","Y","Kusilvak Census Area",158,"Y-K Delta Region",10,9,1255,1,1259,0,12,0,4
"04/21/2021","Y","Y","Kusilvak Census Area",158,"Y-K Delta Region",10,2,1257,4,1263,0,12,0,4
"04/22/2021","Y","Y","Kusilvak Census Area",158,"Y-K Delta Region",10,3,1260,3,1266,0,12,0,4
"04/23/2021","Y","Y","Kusilvak Census Area",158,"Y-K Delta Region",10,4,1264,1,1267,0,12,0,4
"04/26/2021","Y","Y","Kusilvak Census Area",158,"Y-K Delta Region",10,0,1264,6,1273,0,12,0,4
"04/27/2021","Y","Y","Kusilvak Census Area",158,"Y-K Delta Region",10,7,1271,2,1275,0,12,0,4
"04/28/2021","Y","Y","Kusilvak Census Area",158,"Y-K Delta Region",10,3,1274,1,1276,0,12,0,4
"04/29/2021","Y","Y","Kusilvak Census Area",158,"Y-K Delta Region",10,1,1275,1,1277,0,12,0,4
"04/30/2021","Y","Y","Kusilvak Census Area",158,"Y-K Delta Region",10,0,1275,1,1278,0,12,0,4
"05/01/2021","Y","Y","Kusilvak Census Area",158,"Y-K Delta Region",10,1,1276,0,1278,0,12,0,4
"05/03/2021","Y","Y","Kusilvak Census Area",158,"Y-K Delta Region",10,1,1277,2,1280,0,12,0,4
"05/04/2021","Y","Y","Kusilvak Census Area",158,"Y-K Delta Region",10,1,1278,0,1280,0,12,0,4
"05/06/2021","Y","Y","Kusilvak Census Area",158,"Y-K Delta Region",10,0,1278,2,1282,0,12,0,4
"05/07/2021","Y","Y","Kusilvak Census Area",158,"Y-K Delta Region",10,0,1278,1,1283,0,12,0,4
"05/10/2021","Y","Y","Kusilvak Census Area",158,"Y-K Delta Region",10,4,1282,0,1283,0,12,0,4
"05/12/2021","Y","Y","Kusilvak Census Area",158,"Y-K Delta Region",10,0,1282,5,1288,0,12,0,4
"05/13/2021","Y","Y","Kusilvak Census Area",158,"Y-K Delta Region",10,4,1286,0,1288,0,12,0,4
"05/17/2021","Y","Y","Kusilvak Census Area",158,"Y-K Delta Region",10,0,1286,5,1293,0,12,0,4
"05/18/2021","Y","Y","Kusilvak Census Area",158,"Y-K Delta Region",10,4,1290,6,1299,0,12,0,4
"05/19/2021","Y","Y","Kusilvak Census Area",158,"Y-K Delta Region",10,7,1297,1,1300,0,12,0,4
"05/20/2021","Y","Y","Kusilvak Census Area",158,"Y-K Delta Region",10,1,1298,0,1300,0,12,0,4
"05/21/2021","Y","Y","Kusilvak Census Area",158,"Y-K Delta Region",10,0,1298,2,1302,0,12,0,4
"05/22/2021","Y","Y","Kusilvak Census Area",158,"Y-K Delta Region",10,2,1300,0,1302,0,12,0,4
"05/25/2021","Y","Y","Kusilvak Census Area",158,"Y-K Delta Region",10,0,1300,4,1306,0,12,0,4
"05/26/2021","Y","Y","Kusilvak Census Area",158,"Y-K Delta Region",10,2,1302,5,1311,0,12,0,4
"05/27/2021","Y","Y","Kusilvak Census Area",158,"Y-K Delta Region",10,6,1308,1,1312,0,12,0,4
"05/28/2021","Y","Y","Kusilvak Census Area",158,"Y-K Delta Region",10,1,1309,2,1314,0,12,0,4
"06/02/2021","Y","Y","Kusilvak Census Area",158,"Y-K Delta Region",10,0,1309,1,1315,0,12,0,4
"06/03/2021","Y","Y","Kusilvak Census Area",158,"Y-K Delta Region",10,4,1313,3,1318,0,12,0,4
"06/05/2021","Y","Y","Kusilvak Census Area",158,"Y-K Delta Region",10,2,1315,0,1318,0,12,0,4
"06/07/2021","Y","Y","Kusilvak Census Area",158,"Y-K Delta Region",10,1,1316,1,1319,0,12,0,4
"06/08/2021","Y","Y","Kusilvak Census Area",158,"Y-K Delta Region",10,1,1317,1,1320,0,12,0,4
"06/09/2021","Y","Y","Kusilvak Census Area",158,"Y-K Delta Region",10,1,1318,2,1322,0,12,0,4
"06/10/2021","Y","Y","Kusilvak Census Area",158,"Y-K Delta Region",10,0,1318,1,1323,0,12,0,4
"06/11/2021","Y","Y","Kusilvak Census Area",158,"Y-K Delta Region",10,1,1319,4,1327,0,12,0,4
"06/12/2021","Y","Y","Kusilvak Census Area",158,"Y-K Delta Region",10,2,1321,1,1328,0,12,0,4
"06/14/2021","Y","Y","Kusilvak Census Area",158,"Y-K Delta Region",10,0,1321,2,1330,0,12,0,4
"06/15/2021","Y","Y","Kusilvak Census Area",158,"Y-K Delta Region",10,3,1324,9,1339,0,12,0,4
"06/16/2021","Y","Y","Kusilvak Census Area",158,"Y-K Delta Region",10,5,1329,9,1348,0,12,0,4
"06/17/2021","Y","Y","Kusilvak Census Area",158,"Y-K Delta Region",10,14,1343,7,1355,0,12,0,4
"06/18/2021","Y","Y","Kusilvak Census Area",158,"Y-K Delta Region",10,8,1351,8,1363,0,12,0,4
"06/19/2021","Y","Y","Kusilvak Census Area",158,"Y-K Delta Region",10,1,1352,1,1364,0,12,0,4
"06/20/2021","Y","Y","Kusilvak Census Area",158,"Y-K Delta Region",10,0,1352,1,1365,0,12,0,4
"06/21/2021","Y","Y","Kusilvak Census Area",158,"Y-K Delta Region",10,5,1357,10,1375,0,12,0,4
"06/22/2021","Y","Y","Kusilvak Census Area",158,"Y-K Delta Region",10,10,1367,10,1385,0,12,0,4
"06/23/2021","Y","Y","Kusilvak Census Area",158,"Y-K Delta Region",10,2,1369,3,1388,0,12,0,4
"06/24/2021","Y","Y","Kusilvak Census Area",158,"Y-K Delta Region",10,9,1378,3,1391,0,12,0,4
"06/25/2021","Y","Y","Kusilvak Census Area",158,"Y-K Delta Region",10,8,1386,16,1407,0,12,0,4
"06/26/2021","Y","Y","Kusilvak Census Area",158,"Y-K Delta Region",10,6,1392,0,1407,0,12,0,4
"06/28/2021","Y","Y","Kusilvak Census Area",158,"Y-K Delta Region",10,0,1392,6,1413,0,12,0,4
"06/29/2021","Y","Y","Kusilvak Census Area",158,"Y-K Delta Region",10,7,1399,5,1418,0,12,0,4
"06/30/2021","Y","Y","Kusilvak Census Area",158,"Y-K Delta Region",10,13,1412,1,1419,0,12,0,4
"07/01/2021","Y","Y","Kusilvak Census Area",158,"Y-K Delta Region",10,1,1413,3,1422,0,12,0,4
"07/02/2021","Y","Y","Kusilvak Census Area",158,"Y-K Delta Region",10,7,1420,8,1430,0,12,0,4
"07/03/2021","Y","Y","Kusilvak Census Area",158,"Y-K Delta Region",10,1,1421,0,1430,0,12,0,4
"07/05/2021","Y","Y","Kusilvak Census Area",158,"Y-K Delta Region",10,0,1421,1,1431,0,12,0,4
"07/06/2021","Y","Y","Kusilvak Census Area",158,"Y-K Delta Region",10,0,1421,2,1433,0,12,0,4
"07/07/2021","Y","Y","Kusilvak Census Area",158,"Y-K Delta Region",10,2,1423,1,1434,0,12,0,4
"07/08/2021","Y","Y","Kusilvak Census Area",158,"Y-K Delta Region",10,1,1424,2,1436,0,12,0,4
"07/09/2021","Y","Y","Kusilvak Census Area",158,"Y-K Delta Region",10,8,1432,3,1439,0,12,0,4
"07/10/2021","Y","Y","Kusilvak Census Area",158,"Y-K Delta Region",10,0,1432,3,1442,0,12,0,4
"07/12/2021","Y","Y","Kusilvak Census Area",158,"Y-K Delta Region",10,8,1440,2,1444,1,13,0,4
"07/13/2021","Y","Y","Kusilvak Census Area",158,"Y-K Delta Region",10,3,1443,4,1448,1,14,0,4
"07/14/2021","Y","Y","Kusilvak Census Area",158,"Y-K Delta Region",10,3,1446,1,1449,0,14,0,4
"07/15/2021","Y","Y","Kusilvak Census Area",158,"Y-K Delta Region",10,2,1448,1,1450,0,14,0,4
"07/16/2021","Y","Y","Kusilvak Census Area",158,"Y-K Delta Region",10,1,1449,2,1452,0,14,0,4
"07/19/2021","Y","Y","Kusilvak Census Area",158,"Y-K Delta Region",10,0,1449,4,1456,0,14,0,4
"07/20/2021","Y","Y","Kusilvak Census Area",158,"Y-K Delta Region",10,4,1453,3,1459,0,14,0,4
"07/21/2021","Y","Y","Kusilvak Census Area",158,"Y-K Delta Region",10,2,1455,4,1463,0,14,0,4
"07/22/2021","Y","Y","Kusilvak Census Area",158,"Y-K Delta Region",10,4,1459,2,1465,0,14,0,4
"07/23/2021","Y","Y","Kusilvak Census Area",158,"Y-K Delta Region",10,4,1463,2,1467,0,14,0,4
"07/26/2021","Y","Y","Kusilvak Census Area",158,"Y-K Delta Region",10,0,1463,7,1474,0,14,1,5
"07/27/2021","Y","Y","Kusilvak Census Area",158,"Y-K Delta Region",10,3,1466,5,1479,0,14,0,5
"07/28/2021","Y","Y","Kusilvak Census Area",158,"Y-K Delta Region",10,7,1473,2,1481,0,14,0,5
"07/29/2021","Y","Y","Kusilvak Census Area",158,"Y-K Delta Region",10,7,1480,0,1481,0,14,0,5
"07/30/2021","Y","Y","Kusilvak Census Area",158,"Y-K Delta Region",10,0,1480,4,1485,0,14,0,5
"07/31/2021","Y","Y","Kusilvak Census Area",158,"Y-K Delta Region",10,1,1481,4,1489,0,14,0,5
"08/01/2021","Y","Y","Kusilvak Census Area",158,"Y-K Delta Region",10,1,1482,2,1491,0,14,0,5
"08/02/2021","Y","Y","Kusilvak Census Area",158,"Y-K Delta Region",10,7,1489,0,1491,0,14,0,5
"08/04/2021","Y","Y","Kusilvak Census Area",158,"Y-K Delta Region",10,0,1489,2,1493,0,14,0,5
"08/05/2021","Y","Y","Kusilvak Census Area",158,"Y-K Delta Region",10,1,1490,8,1501,0,14,0,5
"08/06/2021","Y","Y","Kusilvak Census Area",158,"Y-K Delta Region",10,0,1490,4,1505,0,14,0,5
"08/07/2021","Y","Y","Kusilvak Census Area",158,"Y-K Delta Region",10,3,1493,0,1505,0,14,0,5
"08/08/2021","Y","Y","Kusilvak Census Area",158,"Y-K Delta Region",10,8,1501,1,1506,0,14,0,5
"08/09/2021","Y","Y","Kusilvak Census Area",158,"Y-K Delta Region",10,1,1502,1,1507,0,14,0,5
"08/10/2021","Y","Y","Kusilvak Census Area",158,"Y-K Delta Region",10,0,1502,5,1512,0,14,0,5
"08/11/2021","Y","Y","Kusilvak Census Area",158,"Y-K Delta Region",10,2,1504,11,1523,0,14,0,5
"08/12/2021","Y","Y","Kusilvak Census Area",158,"Y-K Delta Region",10,3,1507,2,1525,0,14,0,5
"08/13/2021","Y","Y","Kusilvak Census Area",158,"Y-K Delta Region",10,5,1512,11,1536,0,14,0,5
"08/14/2021","Y","Y","Kusilvak Census Area",158,"Y-K Delta Region",10,4,1516,0,1536,0,14,0,5
"08/15/2021","Y","Y","Kusilvak Census Area",158,"Y-K Delta Region",10,0,1516,1,1537,0,14,0,5
"08/16/2021","Y","Y","Kusilvak Census Area",158,"Y-K Delta Region",10,3,1519,9,1546,0,14,0,5
"08/17/2021","Y","Y","Kusilvak Census Area",158,"Y-K Delta Region",10,1,1520,3,1549,0,14,0,5
"08/18/2021","Y","Y","Kusilvak Census Area",158,"Y-K Delta Region",10,7,1527,9,1558,0,14,0,5
"08/19/2021","Y","Y","Kusilvak Census Area",158,"Y-K Delta Region",10,12,1539,3,1561,0,14,0,5
"08/20/2021","Y","Y","Kusilvak Census Area",158,"Y-K Delta Region",10,7,1546,1,1562,0,14,0,5
"08/21/2021","Y","Y","Kusilvak Census Area",158,"Y-K Delta Region",10,7,1553,0,1562,0,14,0,5
"08/22/2021","Y","Y","Kusilvak Census Area",158,"Y-K Delta Region",10,2,1555,0,1562,1,15,0,5
"08/23/2021","Y","Y","Kusilvak Census Area",158,"Y-K Delta Region",10,0,1555,9,1571,0,15,0,5
"08/24/2021","Y","Y","Kusilvak Census Area",158,"Y-K Delta Region",10,2,1557,9,1580,0,15,0,5
"08/25/2021","Y","Y","Kusilvak Census Area",158,"Y-K Delta Region",10,0,1557,7,1587,0,15,0,5
"08/26/2021","Y","Y","Kusilvak Census Area",158,"Y-K Delta Region",10,5,1562,3,1590,0,15,0,5
"08/27/2021","Y","Y","Kusilvak Census Area",158,"Y-K Delta Region",10,23,1585,9,1599,0,15,0,5
"08/28/2021","Y","Y","Kusilvak Census Area",158,"Y-K Delta Region",10,2,1587,2,1601,0,15,0,5
"08/29/2021","Y","Y","Kusilvak Census Area",158,"Y-K Delta Region",10,3,1590,2,1603,0,15,0,5
"08/30/2021","Y","Y","Kusilvak Census Area",158,"Y-K Delta Region",10,5,1595,5,1608,0,15,0,5
"08/31/2021","Y","Y","Kusilvak Census Area",158,"Y-K Delta Region",10,5,1600,10,1618,0,15,0,5
"09/01/2021","Y","Y","Kusilvak Census Area",158,"Y-K Delta Region",10,10,1610,7,1625,0,15,0,5
"09/02/2021","Y","Y","Kusilvak Census Area",158,"Y-K Delta Region",10,6,1616,6,1631,0,15,1,6
"09/03/2021","Y","Y","Kusilvak Census Area",158,"Y-K Delta Region",10,6,1622,6,1637,0,15,0,6
"09/04/2021","Y","Y","Kusilvak Census Area",158,"Y-K Delta Region",10,6,1628,0,1637,0,15,0,6
"09/06/2021","Y","Y","Kusilvak Census Area",158,"Y-K Delta Region",10,2,1630,0,1637,0,15,0,6
"09/07/2021","Y","Y","Kusilvak Census Area",158,"Y-K Delta Region",10,1,1631,13,1650,0,15,0,6
"09/08/2021","Y","Y","Kusilvak Census Area",158,"Y-K Delta Region",10,11,1642,9,1659,0,15,0,6
"09/09/2021","Y","Y","Kusilvak Census Area",158,"Y-K Delta Region",10,11,1653,7,1666,0,15,0,6
"09/10/2021","Y","Y","Kusilvak Census Area",158,"Y-K Delta Region",10,4,1657,0,1666,0,15,0,6
"09/11/2021","Y","Y","Kusilvak Census Area",158,"Y-K Delta Region",10,0,1657,1,1667,0,15,0,6
"09/13/2021","Y","Y","Kusilvak Census Area",158,"Y-K Delta Region",10,0,1657,14,1681,0,15,0,6
"09/14/2021","Y","Y","Kusilvak Census Area",158,"Y-K Delta Region",10,8,1665,14,1695,1,16,0,6
"09/15/2021","Y","Y","Kusilvak Census Area",158,"Y-K Delta Region",10,9,1674,15,1710,0,16,0,6
"09/16/2021","Y","Y","Kusilvak Census Area",158,"Y-K Delta Region",10,14,1688,16,1726,0,16,0,6
"09/17/2021","Y","Y","Kusilvak Census Area",158,"Y-K Delta Region",10,13,1701,18,1744,0,16,0,6
"09/18/2021","Y","Y","Kusilvak Census Area",158,"Y-K Delta Region",10,10,1711,0,1744,0,16,0,6
"09/19/2021","Y","Y","Kusilvak Census Area",158,"Y-K Delta Region",10,2,1713,1,1745,0,16,0,6
"09/20/2021","Y","Y","Kusilvak Census Area",158,"Y-K Delta Region",10,9,1722,7,1752,0,16,0,6
"09/21/2021","Y","Y","Kusilvak Census Area",158,"Y-K Delta Region",10,8,1730,5,1757,0,16,0,6
"09/22/2021","Y","Y","Kusilvak Census Area",158,"Y-K Delta Region",10,12,1742,13,1770,0,16,0,6
"09/23/2021","Y","Y","Kusilvak Census Area",158,"Y-K Delta Region",10,12,1754,5,1775,0,16,0,6
"09/24/2021","Y","Y","Kusilvak Census Area",158,"Y-K Delta Region",10,6,1760,7,1782,0,16,0,6
"09/25/2021","Y","Y","Kusilvak Census Area",158,"Y-K Delta Region",10,4,1764,0,1782,0,16,0,6
"09/26/2021","Y","Y","Kusilvak Census Area",158,"Y-K Delta Region",10,0,1764,2,1784,0,16,0,6
"09/27/2021","Y","Y","Kusilvak Census Area",158,"Y-K Delta Region",10,14,1778,8,1792,0,16,0,6
"09/28/2021","Y","Y","Kusilvak Census Area",158,"Y-K Delta Region",10,8,1786,10,1802,0,16,0,6
"09/29/2021","Y","Y","Kusilvak Census Area",158,"Y-K Delta Region",10,14,1800,5,1807,1,17,1,7
"09/30/2021","Y","Y","Kusilvak Census Area",158,"Y-K Delta Region",10,5,1805,5,1812,0,17,0,7
"10/01/2021","Y","Y","Kusilvak Census Area",158,"Y-K Delta Region",10,4,1809,7,1819,0,17,0,7
"10/02/2021","Y","Y","Kusilvak Census Area",158,"Y-K Delta Region",10,2,1811,0,1819,0,17,0,7
"10/04/2021","Y","Y","Kusilvak Census Area",158,"Y-K Delta Region",10,7,1818,7,1826,0,17,0,7
"10/05/2021","Y","Y","Kusilvak Census Area",158,"Y-K Delta Region",10,7,1825,11,1837,0,17,0,7
"10/06/2021","Y","Y","Kusilvak Census Area",158,"Y-K Delta Region",10,10,1835,13,1850,0,17,0,7
"10/07/2021","Y","Y","Kusilvak Census Area",158,"Y-K Delta Region",10,12,1847,53,1903,0,17,0,7
"10/08/2021","Y","Y","Kusilvak Census Area",158,"Y-K Delta Region",10,53,1900,6,1909,0,17,0,7
"10/09/2021","Y","Y","Kusilvak Census Area",158,"Y-K Delta Region",10,1,1901,11,1920,0,17,0,7
"10/10/2021","Y","Y","Kusilvak Census Area",158,"Y-K Delta Region",10,2,1903,1,1921,0,17,0,7
"10/11/2021","Y","Y","Kusilvak Census Area",158,"Y-K Delta Region",10,16,1919,15,1936,0,17,0,7
"10/12/2021","Y","Y","Kusilvak Census Area",158,"Y-K Delta Region",10,13,1932,16,1952,0,17,0,7
"10/13/2021","Y","Y","Kusilvak Census Area",158,"Y-K Delta Region",10,19,1951,7,1959,0,17,0,7
"10/14/2021","Y","Y","Kusilvak Census Area",158,"Y-K Delta Region",10,7,1958,30,1989,0,17,0,7
"10/15/2021","Y","Y","Kusilvak Census Area",158,"Y-K Delta Region",10,24,1982,7,1996,0,17,0,7
"10/16/2021","Y","Y","Kusilvak Census Area",158,"Y-K Delta Region",10,4,1986,7,2003,0,17,1,8
"10/17/2021","Y","Y","Kusilvak Census Area",158,"Y-K Delta Region",10,2,1988,2,2005,0,17,0,8
"10/18/2021","Y","Y","Kusilvak Census Area",158,"Y-K Delta Region",10,0,1988,19,2024,0,17,0,8
"10/19/2021","Y","Y","Kusilvak Census Area",158,"Y-K Delta Region",10,34,2022,6,2030,0,17,0,8
"10/20/2021","Y","Y","Kusilvak Census Area",158,"Y-K Delta Region",10,6,2028,15,2045,0,17,0,8
"10/21/2021","Y","Y","Kusilvak Census Area",158,"Y-K Delta Region",10,14,2042,5,2050,0,17,0,8
"10/22/2021","Y","Y","Kusilvak Census Area",158,"Y-K Delta Region",10,3,2045,4,2054,0,17,0,8
"10/23/2021","Y","Y","Kusilvak Census Area",158,"Y-K Delta Region",10,3,2048,1,2055,0,17,0,8
"10/24/2021","Y","Y","Kusilvak Census Area",158,"Y-K Delta Region",10,0,2048,6,2061,1,18,0,8
"10/25/2021","Y","Y","Kusilvak Census Area",158,"Y-K Delta Region",10,11,2059,8,2069,1,19,0,8
"10/26/2021","Y","Y","Kusilvak Census Area",158,"Y-K Delta Region",10,5,2064,1,2070,0,19,0,8
"10/27/2021","Y","Y","Kusilvak Census Area",158,"Y-K Delta Region",10,0,2064,3,2073,0,19,0,8
"10/28/2021","Y","Y","Kusilvak Census Area",158,"Y-K Delta Region",10,9,2073,12,2085,0,19,0,8
"10/29/2021","Y","Y","Kusilvak Census Area",158,"Y-K Delta Region",10,1,2074,10,2095,0,19,0,8
"10/30/2021","Y","Y","Kusilvak Census Area",158,"Y-K Delta Region",10,3,2077,1,2096,0,19,0,8
"10/31/2021","Y","Y","Kusilvak Census Area",158,"Y-K Delta Region",10,4,2081,2,2098,1,20,0,8
"11/01/2021","Y","Y","Kusilvak Census Area",158,"Y-K Delta Region",10,1,2082,11,2109,0,20,0,8
"11/02/2021","Y","Y","Kusilvak Census Area",158,"Y-K Delta Region",10,1,2083,13,2122,0,20,0,8
"11/03/2021","Y","Y","Kusilvak Census Area",158,"Y-K Delta Region",10,32,2115,1,2123,0,20,1,9
"11/04/2021","Y","Y","Kusilvak Census Area",158,"Y-K Delta Region",10,5,2120,4,2127,0,20,0,9
"11/05/2021","Y","Y","Kusilvak Census Area",158,"Y-K Delta Region",10,0,2120,2,2129,0,20,0,9
"11/06/2021","Y","Y","Kusilvak Census Area",158,"Y-K Delta Region",10,4,2124,0,2129,0,20,0,9
"11/07/2021","Y","Y","Kusilvak Census Area",158,"Y-K Delta Region",10,1,2125,2,2131,0,20,1,10
"11/08/2021","Y","Y","Kusilvak Census Area",158,"Y-K Delta Region",10,5,2130,4,2135,1,21,0,10
"11/09/2021","Y","Y","Kusilvak Census Area",158,"Y-K Delta Region",10,4,2134,10,2145,0,21,0,10
"11/10/2021","Y","Y","Kusilvak Census Area",158,"Y-K Delta Region",10,6,2140,5,2150,0,21,1,11
"11/11/2021","Y","Y","Kusilvak Census Area",158,"Y-K Delta Region",10,3,2143,0,2150,0,21,0,11
"11/12/2021","Y","Y","Kusilvak Census Area",158,"Y-K Delta Region",10,5,2148,11,2161,0,21,0,11
"11/13/2021","Y","Y","Kusilvak Census Area",158,"Y-K Delta Region",10,9,2157,12,2173,0,21,0,11
"11/15/2021","Y","Y","Kusilvak Census Area",158,"Y-K Delta Region",10,14,2171,7,2180,0,21,0,11
"11/16/2021","Y","Y","Kusilvak Census Area",158,"Y-K Delta Region",10,7,2178,7,2187,0,21,0,11
"11/17/2021","Y","Y","Kusilvak Census Area",158,"Y-K Delta Region",10,5,2183,5,2192,0,21,0,11
"11/18/2021","Y","Y","Kusilvak Census Area",158,"Y-K Delta Region",10,7,2190,2,2194,0,21,0,11
"11/19/2021","Y","Y","Kusilvak Census Area",158,"Y-K Delta Region",10,2,2192,4,2198,0,21,0,11
"11/20/2021","Y","Y","Kusilvak Census Area",158,"Y-K Delta Region",10,0,2192,1,2199,0,21,0,11
"11/21/2021","Y","Y","Kusilvak Census Area",158,"Y-K Delta Region",10,2,2194,0,2199,0,21,0,11
"11/22/2021","Y","Y","Kusilvak Census Area",158,"Y-K Delta Region",10,2,2196,6,2205,0,21,0,11
"11/23/2021","Y","Y","Kusilvak Census Area",158,"Y-K Delta Region",10,7,2203,19,2224,0,21,0,11
"11/24/2021","Y","Y","Kusilvak Census Area",158,"Y-K Delta Region",10,20,2223,4,2228,0,21,0,11
"11/26/2021","Y","Y","Kusilvak Census Area",158,"Y-K Delta Region",10,3,2226,9,2237,0,21,0,11
"11/27/2021","Y","Y","Kusilvak Census Area",158,"Y-K Delta Region",10,9,2235,0,2237,0,21,0,11
"11/29/2021","Y","Y","Kusilvak Census Area",158,"Y-K Delta Region",10,0,2235,7,2244,0,21,0,11
"11/30/2021","Y","Y","Kusilvak Census Area",158,"Y-K Delta Region",10,8,2243,9,2253,0,21,0,11
"12/01/2021","Y","Y","Kusilvak Census Area",158,"Y-K Delta Region",10,9,2252,21,2274,0,21,0,11
"12/02/2021","Y","Y","Kusilvak Census Area",158,"Y-K Delta Region",10,34,2286,22,2296,0,21,0,11
"12/03/2021","Y","Y","Kusilvak Census Area",158,"Y-K Delta Region",10,10,2296,2,2298,0,21,0,11
"12/04/2021","Y","Y","Kusilvak Census Area",158,"Y-K Delta Region",10,1,2297,1,2299,0,21,0,11
"12/05/2021","Y","Y","Kusilvak Census Area",158,"Y-K Delta Region",10,1,2298,2,2301,0,21,0,11
"12/06/2021","Y","Y","Kusilvak Census Area",158,"Y-K Delta Region",10,3,2301,6,2307,1,22,0,11
"12/07/2021","Y","Y","Kusilvak Census Area",158,"Y-K Delta Region",10,9,2310,13,2320,0,22,0,11
"12/08/2021","Y","Y","Kusilvak Census Area",158,"Y-K Delta Region",10,12,2322,5,2325,0,22,0,11
"12/09/2021","Y","Y","Kusilvak Census Area",158,"Y-K Delta Region",10,24,2346,22,2347,0,22,0,11
"12/10/2021","Y","Y","Kusilvak Census Area",158,"Y-K Delta Region",10,7,2353,17,2364,0,22,0,11
"12/12/2021","Y","Y","Kusilvak Census Area",158,"Y-K Delta Region",10,0,2353,0,2364,0,22,1,12
"12/13/2021","Y","Y","Kusilvak Census Area",158,"Y-K Delta Region",10,0,2353,2,2366,0,22,0,12
"12/14/2021","Y","Y","Kusilvak Census Area",158,"Y-K Delta Region",10,21,2374,15,2381,0,22,0,12
"12/15/2021","Y","Y","Kusilvak Census Area",158,"Y-K Delta Region",10,9,2383,5,2386,0,22,0,12
"12/16/2021","Y","Y","Kusilvak Census Area",158,"Y-K Delta Region",10,9,2392,10,2396,0,22,0,12
"12/17/2021","Y","Y","Kusilvak Census Area",158,"Y-K Delta Region",10,13,2405,10,2406,0,22,0,12
"12/20/2021","Y","Y","Kusilvak Census Area",158,"Y-K Delta Region",10,5,2410,6,2412,0,22,0,12
"12/21/2021","Y","Y","Kusilvak Census Area",158,"Y-K Delta Region",10,0,2410,7,2419,0,22,0,12
"12/22/2021","Y","Y","Kusilvak Census Area",158,"Y-K Delta Region",10,27,2437,19,2438,0,22,0,12
"12/23/2021","Y","Y","Kusilvak Census Area",158,"Y-K Delta Region",10,3,2440,3,2441,0,22,0,12
"12/25/2021","Y","Y","Kusilvak Census Area",158,"Y-K Delta Region",10,0,2440,1,2442,0,22,0,12
"12/26/2021","Y","Y","Kusilvak Census Area",158,"Y-K Delta Region",10,0,2440,1,2443,0,22,0,12
"12/27/2021","Y","Y","Kusilvak Census Area",158,"Y-K Delta Region",10,2,2442,2,2445,0,22,0,12
"12/28/2021","Y","Y","Kusilvak Census Area",158,"Y-K Delta Region",10,3,2445,2,2447,0,22,0,12
"12/29/2021","Y","Y","Kusilvak Census Area",158,"Y-K Delta Region",10,7,2452,6,2453,0,22,0,12
"12/30/2021","Y","Y","Kusilvak Census Area",158,"Y-K Delta Region",10,3,2455,5,2458,0,22,0,12
"12/31/2021","Y","Y","Kusilvak Census Area",158,"Y-K Delta Region",10,1,2456,1,2459,0,22,0,12
"01/01/2022","Y","Y","Kusilvak Census Area",158,"Y-K Delta Region",10,1,2457,1,2460,0,22,0,12
"01/02/2022","Y","Y","Kusilvak Census Area",158,"Y-K Delta Region",10,0,2457,2,2462,0,22,0,12
"01/03/2022","Y","Y","Kusilvak Census Area",158,"Y-K Delta Region",10,6,2463,24,2486,0,22,0,12
"01/04/2022","Y","Y","Kusilvak Census Area",158,"Y-K Delta Region",10,40,2503,39,2525,0,22,0,12
"01/05/2022","Y","Y","Kusilvak Census Area",158,"Y-K Delta Region",10,20,2523,15,2540,0,22,0,12
"01/06/2022","Y","Y","Kusilvak Census Area",158,"Y-K Delta Region",10,12,2535,14,2554,0,22,0,12
"01/07/2022","Y","Y","Kusilvak Census Area",158,"Y-K Delta Region",10,7,2542,16,2570,0,22,0,12
"01/08/2022","Y","Y","Kusilvak Census Area",158,"Y-K Delta Region",10,1,2543,0,2570,0,22,0,12
"01/09/2022","Y","Y","Kusilvak Census Area",158,"Y-K Delta Region",10,10,2553,9,2579,0,22,0,12
"01/10/2022","Y","Y","Kusilvak Census Area",158,"Y-K Delta Region",10,22,2575,54,2633,0,22,0,12
"01/11/2022","Y","Y","Kusilvak Census Area",158,"Y-K Delta Region",10,41,2616,52,2685,0,22,0,12
"01/12/2022","Y","Y","Kusilvak Census Area",158,"Y-K Delta Region",10,43,2659,49,2734,0,22,0,12
"01/13/2022","Y","Y","Kusilvak Census Area",158,"Y-K Delta Region",10,57,2716,67,2801,0,22,0,12
"01/14/2022","Y","Y","Kusilvak Census Area",158,"Y-K Delta Region",10,26,2742,29,2830,0,22,0,12
"01/15/2022","Y","Y","Kusilvak Census Area",158,"Y-K Delta Region",10,15,2757,3,2833,0,22,0,12
"01/16/2022","Y","Y","Kusilvak Census Area",158,"Y-K Delta Region",10,16,2773,5,2838,0,22,0,12
"01/17/2022","Y","Y","Kusilvak Census Area",158,"Y-K Delta Region",10,1,2774,18,2856,0,22,0,12
"01/18/2022","Y","Y","Kusilvak Census Area",158,"Y-K Delta Region",10,48,2822,41,2897,0,22,0,12
"01/19/2022","Y","Y","Kusilvak Census Area",158,"Y-K Delta Region",10,70,2892,74,2971,0,22,0,12
"01/20/2022","Y","Y","Kusilvak Census Area",158,"Y-K Delta Region",10,70,2962,40,3011,0,22,0,12
"01/21/2022","Y","Y","Kusilvak Census Area",158,"Y-K Delta Region",10,27,2989,40,3051,0,22,0,12
"01/22/2022","Y","Y","Kusilvak Census Area",158,"Y-K Delta Region",10,22,3011,4,3055,0,22,0,12
"01/23/2022","Y","Y","Kusilvak Census Area",158,"Y-K Delta Region",10,3,3014,2,3057,0,22,0,12
"01/24/2022","Y","Y","Kusilvak Census Area",158,"Y-K Delta Region",10,28,3042,59,3116,0,22,0,12
"01/25/2022","Y","Y","Kusilvak Census Area",158,"Y-K Delta Region",10,64,3106,39,3155,0,22,0,12
"01/26/2022","Y","Y","Kusilvak Census Area",158,"Y-K Delta Region",10,31,3137,32,3187,0,22,0,12
"01/27/2022","Y","Y","Kusilvak Census Area",158,"Y-K Delta Region",10,40,3177,33,3220,0,22,0,12
"01/28/2022","Y","Y","Kusilvak Census Area",158,"Y-K Delta Region",10,23,3200,37,3257,0,22,0,12
"01/29/2022","Y","Y","Kusilvak Census Area",158,"Y-K Delta Region",10,9,3209,6,3263,0,22,0,12
"01/30/2022","Y","Y","Kusilvak Census Area",158,"Y-K Delta Region",10,1,3210,2,3265,0,22,0,12
"01/31/2022","Y","Y","Kusilvak Census Area",158,"Y-K Delta Region",10,81,3291,92,3357,0,22,0,12
"02/01/2022","Y","Y","Kusilvak Census Area",158,"Y-K Delta Region",10,43,3334,37,3394,0,22,0,12
"02/02/2022","Y","Y","Kusilvak Census Area",158,"Y-K Delta Region",10,25,3359,31,3425,0,22,0,12
"02/03/2022","Y","Y","Kusilvak Census Area",158,"Y-K Delta Region",10,57,3416,42,3467,0,22,0,12
"02/04/2022","Y","Y","Kusilvak Census Area",158,"Y-K Delta Region",10,28,3444,36,3503,0,22,0,12
"02/05/2022","Y","Y","Kusilvak Census Area",158,"Y-K Delta Region",10,6,3450,1,3504,0,22,0,12
"02/06/2022","Y","Y","Kusilvak Census Area",158,"Y-K Delta Region",10,15,3465,3,3507,0,22,0,12
"02/07/2022","Y","Y","Kusilvak Census Area",158,"Y-K Delta Region",10,5,3470,47,3554,0,22,0,12
"02/08/2022","Y","Y","Kusilvak Census Area",158,"Y-K Delta Region",10,19,3489,28,3582,0,22,0,12
"02/09/2022","Y","Y","Kusilvak Census Area",158,"Y-K Delta Region",10,18,3507,34,3616,0,22,0,12
"02/10/2022","Y","Y","Kusilvak Census Area",158,"Y-K Delta Region",10,6,3513,35,3651,0,22,0,12
"02/11/2022","Y","Y","Kusilvak Census Area",158,"Y-K Delta Region",10,33,3546,18,3669,0,22,0,12
"02/12/2022","Y","Y","Kusilvak Census Area",158,"Y-K Delta Region",10,13,3559,0,3669,0,22,0,12
"02/13/2022","Y","Y","Kusilvak Census Area",158,"Y-K Delta Region",10,5,3564,2,3671,0,22,0,12
"02/14/2022","Y","Y","Kusilvak Census Area",158,"Y-K Delta Region",10,4,3568,18,3689,0,22,0,12
"02/15/2022","Y","Y","Kusilvak Census Area",158,"Y-K Delta Region",10,15,3583,28,3717,0,22,0,12
"02/16/2022","Y","Y","Kusilvak Census Area",158,"Y-K Delta Region",10,5,3588,21,3738,0,22,0,12
"02/17/2022","Y","Y","Kusilvak Census Area",158,"Y-K Delta Region",10,7,3595,10,3748,0,22,0,12
"02/18/2022","Y","Y","Kusilvak Census Area",158,"Y-K Delta Region",10,16,3611,8,3756,0,22,0,12
"02/19/2022","Y","Y","Kusilvak Census Area",158,"Y-K Delta Region",10,11,3622,6,3762,0,22,0,12
"02/20/2022","Y","Y","Kusilvak Census Area",158,"Y-K Delta Region",10,3,3625,5,3767,0,22,0,12
"02/21/2022","Y","Y","Kusilvak Census Area",158,"Y-K Delta Region",10,0,3625,3,3770,0,22,0,12
"02/22/2022","Y","Y","Kusilvak Census Area",158,"Y-K Delta Region",10,1,3626,15,3785,0,22,0,12
"02/23/2022","Y","Y","Kusilvak Census Area",158,"Y-K Delta Region",10,6,3632,14,3799,0,22,0,12
"02/24/2022","Y","Y","Kusilvak Census Area",158,"Y-K Delta Region",10,2,3634,13,3812,0,22,0,12
"02/25/2022","Y","Y","Kusilvak Census Area",158,"Y-K Delta Region",10,4,3638,11,3823,0,22,0,12
"02/26/2022","Y","Y","Kusilvak Census Area",158,"Y-K Delta Region",10,28,3666,7,3830,0,22,0,12
"02/28/2022","Y","Y","Kusilvak Census Area",158,"Y-K Delta Region",10,2,3668,14,3844,0,22,0,12
"03/01/2022","Y","Y","Kusilvak Census Area",158,"Y-K Delta Region",10,13,3681,8,3852,0,22,0,12
"03/02/2022","Y","Y","Kusilvak Census Area",158,"Y-K Delta Region",10,4,3685,5,3857,0,22,0,12
"03/03/2022","Y","Y","Kusilvak Census Area",158,"Y-K Delta Region",10,6,3691,18,3875,0,22,0,12
"03/04/2022","Y","Y","Kusilvak Census Area",158,"Y-K Delta Region",10,6,3697,14,3889,0,22,0,12
"03/05/2022","Y","Y","Kusilvak Census Area",158,"Y-K Delta Region",10,4,3701,1,3890,0,22,0,12
"03/06/2022","Y","Y","Kusilvak Census Area",158,"Y-K Delta Region",10,1,3702,1,3891,0,22,0,12
"03/07/2022","Y","Y","Kusilvak Census Area",158,"Y-K Delta Region",10,0,3702,26,3917,0,22,0,12
"03/08/2022","Y","Y","Kusilvak Census Area",158,"Y-K Delta Region",10,204,3906,4,3921,0,22,0,12
"03/09/2022","Y","Y","Kusilvak Census Area",158,"Y-K Delta Region",10,13,3919,2,3923,0,22,0,12
"03/10/2022","Y","Y","Kusilvak Census Area",158,"Y-K Delta Region",10,29,3948,27,3950,0,22,0,12
"03/11/2022","Y","Y","Kusilvak Census Area",158,"Y-K Delta Region",10,2,3950,2,3952,0,22,0,12
"03/12/2022","Y","Y","Kusilvak Census Area",158,"Y-K Delta Region",10,1,3951,0,3952,0,22,0,12
"03/14/2022","Y","Y","Kusilvak Census Area",158,"Y-K Delta Region",10,6,3957,9,3961,0,22,0,12
"03/15/2022","Y","Y","Kusilvak Census Area",158,"Y-K Delta Region",10,8,3965,12,3973,0,22,0,12
"03/16/2022","Y","Y","Kusilvak Census Area",158,"Y-K Delta Region",10,8,3973,1,3974,0,22,0,12
"03/17/2022","Y","Y","Kusilvak Census Area",158,"Y-K Delta Region",10,2,3975,2,3976,0,22,0,12
"03/18/2022","Y","Y","Kusilvak Census Area",158,"Y-K Delta Region",10,1,3976,1,3977,0,22,0,12
"03/19/2022","Y","Y","Kusilvak Census Area",158,"Y-K Delta Region",10,1,3977,1,3978,0,22,0,12
"03/21/2022","Y","Y","Kusilvak Census Area",158,"Y-K Delta Region",10,1,3978,9,3987,0,22,0,12
"03/22/2022","Y","Y","Kusilvak Census Area",158,"Y-K Delta Region",10,11,3989,5,3992,0,22,0,12
"03/23/2022","Y","Y","Kusilvak Census Area",158,"Y-K Delta Region",10,2,3991,0,3992,0,22,0,12
"03/24/2022","Y","Y","Kusilvak Census Area",158,"Y-K Delta Region",10,0,3991,1,3993,0,22,0,12
"03/25/2022","Y","Y","Kusilvak Census Area",158,"Y-K Delta Region",10,1,3992,2,3995,0,22,0,12
"03/26/2022","Y","Y","Kusilvak Census Area",158,"Y-K Delta Region",10,2,3994,1,3996,0,22,0,12
"03/27/2022","Y","Y","Kusilvak Census Area",158,"Y-K Delta Region",10,1,3995,0,3996,0,22,0,12
"03/28/2022","Y","Y","Kusilvak Census Area",158,"Y-K Delta Region",10,2,3997,3,3999,0,22,0,12
"03/29/2022","Y","Y","Kusilvak Census Area",158,"Y-K Delta Region",10,2,3999,1,4000,0,22,0,12
"03/30/2022","Y","Y","Kusilvak Census Area",158,"Y-K Delta Region",10,1,4000,1,4001,0,22,0,12
"04/01/2022","Y","Y","Kusilvak Census Area",158,"Y-K Delta Region",10,4,4004,3,4004,0,22,0,12
"04/04/2022","Y","Y","Kusilvak Census Area",158,"Y-K Delta Region",10,0,4004,2,4006,0,22,0,12
"04/05/2022","Y","Y","Kusilvak Census Area",158,"Y-K Delta Region",10,3,4007,4,4010,0,22,0,12
"04/06/2022","Y","Y","Kusilvak Census Area",158,"Y-K Delta Region",10,8,4015,6,4016,0,22,0,12
"04/07/2022","Y","Y","Kusilvak Census Area",158,"Y-K Delta Region",10,5,4020,4,4020,0,22,0,12
"04/08/2022","Y","Y","Kusilvak Census Area",158,"Y-K Delta Region",10,1,4021,4,4024,0,22,0,12
"04/09/2022","Y","Y","Kusilvak Census Area",158,"Y-K Delta Region",10,5,4026,2,4026,0,22,0,12
"04/11/2022","Y","Y","Kusilvak Census Area",158,"Y-K Delta Region",10,0,4026,1,4027,0,22,0,12
"04/12/2022","Y","Y","Kusilvak Census Area",158,"Y-K Delta Region",10,6,4032,8,4035,0,22,0,12
"04/13/2022","Y","Y","Kusilvak Census Area",158,"Y-K Delta Region",10,4,4036,1,4036,0,22,0,12
"04/15/2022","Y","Y","Kusilvak Census Area",158,"Y-K Delta Region",10,2,4038,2,4038,0,22,0,12
"04/18/2022","Y","Y","Kusilvak Census Area",158,"Y-K Delta Region",10,7,4045,7,4045,0,22,0,12
"04/19/2022","Y","Y","Kusilvak Census Area",158,"Y-K Delta Region",10,7,4052,8,4053,0,22,0,12
"04/20/2022","Y","Y","Kusilvak Census Area",158,"Y-K Delta Region",10,1,4053,0,4053,0,22,0,12
"04/21/2022","Y","Y","Kusilvak Census Area",158,"Y-K Delta Region",10,3,4056,3,4056,0,22,0,12
"04/22/2022","Y","Y","Kusilvak Census Area",158,"Y-K Delta Region",10,2,4058,2,4058,0,22,0,12
"04/23/2022","Y","Y","Kusilvak Census Area",158,"Y-K Delta Region",10,1,4059,2,4060,0,22,0,12
"04/25/2022","Y","Y","Kusilvak Census Area",158,"Y-K Delta Region",10,1,4060,1,4061,0,22,0,12
"04/26/2022","Y","Y","Kusilvak Census Area",158,"Y-K Delta Region",10,4,4064,3,4064,0,22,0,12
"03/16/2020","Y","Y","Matanuska-Susitna Borough",170,"Matanuska-Susitna Borough",5,0,0,1,1,0,0,0,0
"03/17/2020","Y","Y","Matanuska-Susitna Borough",170,"Matanuska-Susitna Borough",5,0,0,2,3,0,0,0,0
"03/18/2020","Y","Y","Matanuska-Susitna Borough",170,"Matanuska-Susitna Borough",5,0,0,1,4,0,0,0,0
"03/22/2020","Y","Y","Matanuska-Susitna Borough",170,"Matanuska-Susitna Borough",5,2,2,0,4,0,0,0,0
"03/26/2020","Y","Y","Matanuska-Susitna Borough",170,"Matanuska-Susitna Borough",5,0,2,2,6,0,0,0,0
"03/30/2020","Y","Y","Matanuska-Susitna Borough",170,"Matanuska-Susitna Borough",5,1,3,0,6,0,0,0,0
"03/31/2020","Y","Y","Matanuska-Susitna Borough",170,"Matanuska-Susitna Borough",5,0,3,1,7,0,0,0,0
"04/01/2020","Y","Y","Matanuska-Susitna Borough",170,"Matanuska-Susitna Borough",5,1,4,2,9,0,0,0,0
"04/04/2020","Y","Y","Matanuska-Susitna Borough",170,"Matanuska-Susitna Borough",5,0,4,1,10,0,0,0,0
"04/05/2020","Y","Y","Matanuska-Susitna Borough",170,"Matanuska-Susitna Borough",5,0,4,1,11,0,0,0,0
"04/06/2020","Y","Y","Matanuska-Susitna Borough",170,"Matanuska-Susitna Borough",5,0,4,2,13,1,1,0,0
"04/07/2020","Y","Y","Matanuska-Susitna Borough",170,"Matanuska-Susitna Borough",5,2,6,2,15,0,1,0,0
"04/08/2020","Y","Y","Matanuska-Susitna Borough",170,"Matanuska-Susitna Borough",5,1,7,2,17,0,1,0,0
"04/09/2020","Y","Y","Matanuska-Susitna Borough",170,"Matanuska-Susitna Borough",5,2,9,0,17,0,1,0,0
"04/10/2020","Y","Y","Matanuska-Susitna Borough",170,"Matanuska-Susitna Borough",5,1,10,1,18,0,1,0,0
"04/11/2020","Y","Y","Matanuska-Susitna Borough",170,"Matanuska-Susitna Borough",5,3,13,0,18,0,1,0,0
"04/12/2020","Y","Y","Matanuska-Susitna Borough",170,"Matanuska-Susitna Borough",5,0,13,0,18,0,1,1,1
"04/13/2020","Y","Y","Matanuska-Susitna Borough",170,"Matanuska-Susitna Borough",5,1,14,0,18,0,1,0,1
"04/17/2020","Y","Y","Matanuska-Susitna Borough",170,"Matanuska-Susitna Borough",5,2,16,0,18,0,1,0,1
"04/18/2020","Y","Y","Matanuska-Susitna Borough",170,"Matanuska-Susitna Borough",5,1,17,2,20,0,1,0,1
"04/19/2020","Y","Y","Matanuska-Susitna Borough",170,"Matanuska-Susitna Borough",5,1,18,0,20,0,1,0,1
"04/21/2020","Y","Y","Matanuska-Susitna Borough",170,"Matanuska-Susitna Borough",5,1,19,0,20,0,1,0,1
"04/26/2020","Y","Y","Matanuska-Susitna Borough",170,"Matanuska-Susitna Borough",5,1,20,0,20,0,1,0,1
"05/10/2020","Y","Y","Matanuska-Susitna Borough",170,"Matanuska-Susitna Borough",5,0,20,1,21,0,1,0,1
"05/17/2020","Y","Y","Matanuska-Susitna Borough",170,"Matanuska-Susitna Borough",5,1,21,0,21,0,1,0,1
"05/20/2020","Y","Y","Matanuska-Susitna Borough",170,"Matanuska-Susitna Borough",5,0,21,1,22,0,1,0,1
"05/22/2020","Y","Y","Matanuska-Susitna Borough",170,"Matanuska-Susitna Borough",5,2,23,0,22,0,1,0,1
"05/23/2020","Y","Y","Matanuska-Susitna Borough",170,"Matanuska-Susitna Borough",5,0,23,1,23,0,1,0,1
"05/24/2020","Y","Y","Matanuska-Susitna Borough",170,"Matanuska-Susitna Borough",5,0,23,1,24,0,1,0,1
"05/25/2020","Y","Y","Matanuska-Susitna Borough",170,"Matanuska-Susitna Borough",5,0,23,1,25,0,1,0,1
"05/28/2020","Y","Y","Matanuska-Susitna Borough",170,"Matanuska-Susitna Borough",5,0,23,1,26,0,1,0,1
"05/29/2020","Y","Y","Matanuska-Susitna Borough",170,"Matanuska-Susitna Borough",5,1,24,4,30,0,1,0,1
"05/30/2020","Y","Y","Matanuska-Susitna Borough",170,"Matanuska-Susitna Borough",5,4,28,1,31,0,1,0,1
"05/31/2020","Y","Y","Matanuska-Susitna Borough",170,"Matanuska-Susitna Borough",5,0,28,1,32,0,1,0,1
"06/02/2020","Y","Y","Matanuska-Susitna Borough",170,"Matanuska-Susitna Borough",5,5,33,4,36,0,1,0,1
"06/03/2020","Y","Y","Matanuska-Susitna Borough",170,"Matanuska-Susitna Borough",5,1,34,0,36,0,1,0,1
"06/04/2020","Y","Y","Matanuska-Susitna Borough",170,"Matanuska-Susitna Borough",5,0,34,1,37,0,1,0,1
"06/05/2020","Y","Y","Matanuska-Susitna Borough",170,"Matanuska-Susitna Borough",5,0,34,1,38,0,1,0,1
"06/07/2020","Y","Y","Matanuska-Susitna Borough",170,"Matanuska-Susitna Borough",5,2,36,2,40,0,1,0,1
"06/08/2020","Y","Y","Matanuska-Susitna Borough",170,"Matanuska-Susitna Borough",5,0,36,2,42,0,1,0,1
"06/09/2020","Y","Y","Matanuska-Susitna Borough",170,"Matanuska-Susitna Borough",5,1,37,2,44,0,1,0,1
"06/10/2020","Y","Y","Matanuska-Susitna Borough",170,"Matanuska-Susitna Borough",5,1,38,3,47,0,1,0,1
"06/11/2020","Y","Y","Matanuska-Susitna Borough",170,"Matanuska-Susitna Borough",5,2,40,0,47,0,1,0,1
"06/12/2020","Y","Y","Matanuska-Susitna Borough",170,"Matanuska-Susitna Borough",5,2,42,0,47,1,2,0,1
"06/13/2020","Y","Y","Matanuska-Susitna Borough",170,"Matanuska-Susitna Borough",5,1,43,3,50,0,2,0,1
"06/14/2020","Y","Y","Matanuska-Susitna Borough",170,"Matanuska-Susitna Borough",5,1,44,3,53,0,2,0,1
"06/15/2020","Y","Y","Matanuska-Susitna Borough",170,"Matanuska-Susitna Borough",5,1,45,1,54,0,2,0,1
"06/16/2020","Y","Y","Matanuska-Susitna Borough",170,"Matanuska-Susitna Borough",5,2,47,2,56,0,2,0,1
"06/17/2020","Y","Y","Matanuska-Susitna Borough",170,"Matanuska-Susitna Borough",5,3,50,1,57,0,2,0,1
"06/18/2020","Y","Y","Matanuska-Susitna Borough",170,"Matanuska-Susitna Borough",5,2,52,2,59,0,2,0,1
"06/19/2020","Y","Y","Matanuska-Susitna Borough",170,"Matanuska-Susitna Borough",5,1,53,1,60,0,2,0,1
"06/20/2020","Y","Y","Matanuska-Susitna Borough",170,"Matanuska-Susitna Borough",5,1,54,3,63,0,2,0,1
"06/21/2020","Y","Y","Matanuska-Susitna Borough",170,"Matanuska-Susitna Borough",5,2,56,2,65,0,2,0,1
"06/22/2020","Y","Y","Matanuska-Susitna Borough",170,"Matanuska-Susitna Borough",5,2,58,5,70,0,2,0,1
"06/23/2020","Y","Y","Matanuska-Susitna Borough",170,"Matanuska-Susitna Borough",5,2,60,3,73,0,2,0,1
"06/24/2020","Y","Y","Matanuska-Susitna Borough",170,"Matanuska-Susitna Borough",5,3,63,4,77,0,2,0,1
"06/25/2020","Y","Y","Matanuska-Susitna Borough",170,"Matanuska-Susitna Borough",5,4,67,2,79,0,2,0,1
"06/26/2020","Y","Y","Matanuska-Susitna Borough",170,"Matanuska-Susitna Borough",5,4,71,1,80,0,2,0,1
"06/27/2020","Y","Y","Matanuska-Susitna Borough",170,"Matanuska-Susitna Borough",5,4,75,3,83,0,2,0,1
"06/28/2020","Y","Y","Matanuska-Susitna Borough",170,"Matanuska-Susitna Borough",5,3,78,6,89,0,2,0,1
"06/29/2020","Y","Y","Matanuska-Susitna Borough",170,"Matanuska-Susitna Borough",5,2,80,13,102,0,2,0,1
"06/30/2020","Y","Y","Matanuska-Susitna Borough",170,"Matanuska-Susitna Borough",5,7,87,7,109,0,2,0,1
"07/01/2020","Y","Y","Matanuska-Susitna Borough",170,"Matanuska-Susitna Borough",5,14,101,6,115,1,3,0,1
"07/02/2020","Y","Y","Matanuska-Susitna Borough",170,"Matanuska-Susitna Borough",5,5,106,4,119,2,5,0,1
"07/03/2020","Y","Y","Matanuska-Susitna Borough",170,"Matanuska-Susitna Borough",5,7,113,4,123,0,5,0,1
"07/04/2020","Y","Y","Matanuska-Susitna Borough",170,"Matanuska-Susitna Borough",5,1,114,1,124,0,5,0,1
"07/05/2020","Y","Y","Matanuska-Susitna Borough",170,"Matanuska-Susitna Borough",5,1,115,5,129,1,6,1,2
"07/06/2020","Y","Y","Matanuska-Susitna Borough",170,"Matanuska-Susitna Borough",5,2,117,6,135,0,6,0,2
"07/07/2020","Y","Y","Matanuska-Susitna Borough",170,"Matanuska-Susitna Borough",5,3,120,8,143,0,6,0,2
"07/08/2020","Y","Y","Matanuska-Susitna Borough",170,"Matanuska-Susitna Borough",5,6,126,14,157,0,6,0,2
"07/09/2020","Y","Y","Matanuska-Susitna Borough",170,"Matanuska-Susitna Borough",5,4,130,5,162,1,7,0,2
"07/10/2020","Y","Y","Matanuska-Susitna Borough",170,"Matanuska-Susitna Borough",5,3,133,5,167,0,7,0,2
"07/11/2020","Y","Y","Matanuska-Susitna Borough",170,"Matanuska-Susitna Borough",5,12,145,2,169,1,8,0,2
"07/12/2020","Y","Y","Matanuska-Susitna Borough",170,"Matanuska-Susitna Borough",5,6,151,0,169,0,8,0,2
"07/13/2020","Y","Y","Matanuska-Susitna Borough",170,"Matanuska-Susitna Borough",5,7,158,7,176,0,8,0,2
"07/14/2020","Y","Y","Matanuska-Susitna Borough",170,"Matanuska-Susitna Borough",5,3,161,6,182,0,8,0,2
"07/15/2020","Y","Y","Matanuska-Susitna Borough",170,"Matanuska-Susitna Borough",5,2,163,4,186,1,9,0,2
"07/16/2020","Y","Y","Matanuska-Susitna Borough",170,"Matanuska-Susitna Borough",5,5,168,10,196,0,9,0,2
"07/17/2020","Y","Y","Matanuska-Susitna Borough",170,"Matanuska-Susitna Borough",5,6,174,7,203,0,9,0,2
"07/18/2020","Y","Y","Matanuska-Susitna Borough",170,"Matanuska-Susitna Borough",5,9,183,4,207,0,9,0,2
"07/19/2020","Y","Y","Matanuska-Susitna Borough",170,"Matanuska-Susitna Borough",5,7,190,4,211,0,9,0,2
"07/20/2020","Y","Y","Matanuska-Susitna Borough",170,"Matanuska-Susitna Borough",5,6,196,6,217,0,9,0,2
"07/21/2020","Y","Y","Matanuska-Susitna Borough",170,"Matanuska-Susitna Borough",5,8,204,13,230,1,10,0,2
"07/22/2020","Y","Y","Matanuska-Susitna Borough",170,"Matanuska-Susitna Borough",5,9,213,4,234,0,10,0,2
"07/23/2020","Y","Y","Matanuska-Susitna Borough",170,"Matanuska-Susitna Borough",5,1,214,3,237,0,10,0,2
"07/24/2020","Y","Y","Matanuska-Susitna Borough",170,"Matanuska-Susitna Borough",5,9,223,5,242,0,10,0,2
"07/25/2020","Y","Y","Matanuska-Susitna Borough",170,"Matanuska-Susitna Borough",5,5,228,7,249,0,10,0,2
"07/26/2020","Y","Y","Matanuska-Susitna Borough",170,"Matanuska-Susitna Borough",5,9,237,13,262,0,10,0,2
"07/27/2020","Y","Y","Matanuska-Susitna Borough",170,"Matanuska-Susitna Borough",5,6,243,14,276,0,10,0,2
"07/28/2020","Y","Y","Matanuska-Susitna Borough",170,"Matanuska-Susitna Borough",5,4,247,8,284,0,10,0,2
"07/29/2020","Y","Y","Matanuska-Susitna Borough",170,"Matanuska-Susitna Borough",5,13,260,16,300,1,11,0,2
"07/30/2020","Y","Y","Matanuska-Susitna Borough",170,"Matanuska-Susitna Borough",5,9,269,6,306,0,11,0,2
"07/31/2020","Y","Y","Matanuska-Susitna Borough",170,"Matanuska-Susitna Borough",5,20,289,5,311,0,11,0,2
"08/01/2020","Y","Y","Matanuska-Susitna Borough",170,"Matanuska-Susitna Borough",5,14,303,1,312,0,11,0,2
"08/02/2020","Y","Y","Matanuska-Susitna Borough",170,"Matanuska-Susitna Borough",5,4,307,3,315,0,11,0,2
"08/03/2020","Y","Y","Matanuska-Susitna Borough",170,"Matanuska-Susitna Borough",5,5,312,7,322,0,11,0,2
"08/04/2020","Y","Y","Matanuska-Susitna Borough",170,"Matanuska-Susitna Borough",5,3,315,7,329,0,11,0,2
"08/05/2020","Y","Y","Matanuska-Susitna Borough",170,"Matanuska-Susitna Borough",5,1,316,7,336,0,11,0,2
"08/06/2020","Y","Y","Matanuska-Susitna Borough",170,"Matanuska-Susitna Borough",5,3,319,4,340,0,11,0,2
"08/07/2020","Y","Y","Matanuska-Susitna Borough",170,"Matanuska-Susitna Borough",5,6,325,4,344,0,11,0,2
"08/08/2020","Y","Y","Matanuska-Susitna Borough",170,"Matanuska-Susitna Borough",5,15,340,8,352,0,11,0,2
"08/09/2020","Y","Y","Matanuska-Susitna Borough",170,"Matanuska-Susitna Borough",5,9,349,3,355,0,11,0,2
"08/10/2020","Y","Y","Matanuska-Susitna Borough",170,"Matanuska-Susitna Borough",5,4,353,6,361,0,11,0,2
"08/11/2020","Y","Y","Matanuska-Susitna Borough",170,"Matanuska-Susitna Borough",5,2,355,4,365,0,11,0,2
"08/12/2020","Y","Y","Matanuska-Susitna Borough",170,"Matanuska-Susitna Borough",5,8,363,6,371,0,11,0,2
"08/13/2020","Y","Y","Matanuska-Susitna Borough",170,"Matanuska-Susitna Borough",5,2,365,10,381,0,11,0,2
"08/14/2020","Y","Y","Matanuska-Susitna Borough",170,"Matanuska-Susitna Borough",5,7,372,5,386,0,11,0,2
"08/15/2020","Y","Y","Matanuska-Susitna Borough",170,"Matanuska-Susitna Borough",5,7,379,9,395,0,11,0,2
"08/16/2020","Y","Y","Matanuska-Susitna Borough",170,"Matanuska-Susitna Borough",5,2,381,3,398,0,11,0,2
"08/17/2020","Y","Y","Matanuska-Susitna Borough",170,"Matanuska-Susitna Borough",5,8,389,4,402,0,11,0,2
"08/18/2020","Y","Y","Matanuska-Susitna Borough",170,"Matanuska-Susitna Borough",5,8,397,9,411,0,11,0,2
"08/19/2020","Y","Y","Matanuska-Susitna Borough",170,"Matanuska-Susitna Borough",5,9,406,15,426,0,11,0,2
"08/20/2020","Y","Y","Matanuska-Susitna Borough",170,"Matanuska-Susitna Borough",5,5,411,6,432,0,11,0,2
"08/21/2020","Y","Y","Matanuska-Susitna Borough",170,"Matanuska-Susitna Borough",5,11,422,9,441,0,11,0,2
"08/22/2020","Y","Y","Matanuska-Susitna Borough",170,"Matanuska-Susitna Borough",5,12,434,6,447,2,13,0,2
"08/23/2020","Y","Y","Matanuska-Susitna Borough",170,"Matanuska-Susitna Borough",5,7,441,4,451,0,13,0,2
"08/24/2020","Y","Y","Matanuska-Susitna Borough",170,"Matanuska-Susitna Borough",5,5,446,6,457,0,13,0,2
"08/25/2020","Y","Y","Matanuska-Susitna Borough",170,"Matanuska-Susitna Borough",5,6,452,6,463,1,14,0,2
"08/26/2020","Y","Y","Matanuska-Susitna Borough",170,"Matanuska-Susitna Borough",5,12,464,8,471,0,14,0,2
"08/27/2020","Y","Y","Matanuska-Susitna Borough",170,"Matanuska-Susitna Borough",5,3,467,2,473,0,14,0,2
"08/28/2020","Y","Y","Matanuska-Susitna Borough",170,"Matanuska-Susitna Borough",5,2,469,1,474,0,14,0,2
"08/29/2020","Y","Y","Matanuska-Susitna Borough",170,"Matanuska-Susitna Borough",5,2,471,1,475,0,14,0,2
"08/30/2020","Y","Y","Matanuska-Susitna Borough",170,"Matanuska-Susitna Borough",5,0,471,3,478,1,15,0,2
"08/31/2020","Y","Y","Matanuska-Susitna Borough",170,"Matanuska-Susitna Borough",5,4,475,9,487,0,15,0,2
"09/01/2020","Y","Y","Matanuska-Susitna Borough",170,"Matanuska-Susitna Borough",5,4,479,11,498,0,15,0,2
"09/02/2020","Y","Y","Matanuska-Susitna Borough",170,"Matanuska-Susitna Borough",5,5,484,6,504,0,15,0,2
"09/03/2020","Y","Y","Matanuska-Susitna Borough",170,"Matanuska-Susitna Borough",5,8,492,2,506,0,15,0,2
"09/04/2020","Y","Y","Matanuska-Susitna Borough",170,"Matanuska-Susitna Borough",5,9,501,0,506,0,15,0,2
"09/05/2020","Y","Y","Matanuska-Susitna Borough",170,"Matanuska-Susitna Borough",5,5,506,3,509,0,15,0,2
"09/06/2020","Y","Y","Matanuska-Susitna Borough",170,"Matanuska-Susitna Borough",5,4,510,5,514,1,16,0,2
"09/07/2020","Y","Y","Matanuska-Susitna Borough",170,"Matanuska-Susitna Borough",5,3,513,2,516,0,16,0,2
"09/08/2020","Y","Y","Matanuska-Susitna Borough",170,"Matanuska-Susitna Borough",5,0,513,1,517,0,16,0,2
"09/09/2020","Y","Y","Matanuska-Susitna Borough",170,"Matanuska-Susitna Borough",5,5,518,10,527,0,16,0,2
"09/10/2020","Y","Y","Matanuska-Susitna Borough",170,"Matanuska-Susitna Borough",5,8,526,14,541,0,16,0,2
"09/11/2020","Y","Y","Matanuska-Susitna Borough",170,"Matanuska-Susitna Borough",5,2,528,4,545,0,16,0,2
"09/12/2020","Y","Y","Matanuska-Susitna Borough",170,"Matanuska-Susitna Borough",5,7,535,2,547,0,16,0,2
"09/13/2020","Y","Y","Matanuska-Susitna Borough",170,"Matanuska-Susitna Borough",5,6,541,1,548,0,16,0,2
"09/14/2020","Y","Y","Matanuska-Susitna Borough",170,"Matanuska-Susitna Borough",5,4,545,9,557,0,16,0,2
"09/15/2020","Y","Y","Matanuska-Susitna Borough",170,"Matanuska-Susitna Borough",5,3,548,5,562,0,16,0,2
"09/16/2020","Y","Y","Matanuska-Susitna Borough",170,"Matanuska-Susitna Borough",5,7,555,11,573,0,16,0,2
"09/17/2020","Y","Y","Matanuska-Susitna Borough",170,"Matanuska-Susitna Borough",5,10,565,3,576,1,17,0,2
"09/18/2020","Y","Y","Matanuska-Susitna Borough",170,"Matanuska-Susitna Borough",5,6,571,7,583,0,17,0,2
"09/19/2020","Y","Y","Matanuska-Susitna Borough",170,"Matanuska-Susitna Borough",5,4,575,2,585,0,17,0,2
"09/20/2020","Y","Y","Matanuska-Susitna Borough",170,"Matanuska-Susitna Borough",5,1,576,6,591,0,17,0,2
"09/21/2020","Y","Y","Matanuska-Susitna Borough",170,"Matanuska-Susitna Borough",5,4,580,5,596,1,18,0,2
"09/22/2020","Y","Y","Matanuska-Susitna Borough",170,"Matanuska-Susitna Borough",5,4,584,8,604,0,18,0,2
"09/23/2020","Y","Y","Matanuska-Susitna Borough",170,"Matanuska-Susitna Borough",5,4,588,4,608,0,18,0,2
"09/24/2020","Y","Y","Matanuska-Susitna Borough",170,"Matanuska-Susitna Borough",5,2,590,4,612,0,18,0,2
"09/25/2020","Y","Y","Matanuska-Susitna Borough",170,"Matanuska-Susitna Borough",5,2,592,11,623,0,18,0,2
"09/26/2020","Y","Y","Matanuska-Susitna Borough",170,"Matanuska-Susitna Borough",5,4,596,5,628,0,18,0,2
"09/27/2020","Y","Y","Matanuska-Susitna Borough",170,"Matanuska-Susitna Borough",5,3,599,4,632,0,18,0,2
"09/28/2020","Y","Y","Matanuska-Susitna Borough",170,"Matanuska-Susitna Borough",5,18,617,14,646,0,18,0,2
"09/29/2020","Y","Y","Matanuska-Susitna Borough",170,"Matanuska-Susitna Borough",5,4,621,10,656,0,18,0,2
"09/30/2020","Y","Y","Matanuska-Susitna Borough",170,"Matanuska-Susitna Borough",5,10,631,7,663,0,18,0,2
"10/01/2020","Y","Y","Matanuska-Susitna Borough",170,"Matanuska-Susitna Borough",5,6,637,10,673,0,18,0,2
"10/02/2020","Y","Y","Matanuska-Susitna Borough",170,"Matanuska-Susitna Borough",5,14,651,14,687,0,18,0,2
"10/03/2020","Y","Y","Matanuska-Susitna Borough",170,"Matanuska-Susitna Borough",5,8,659,5,692,1,19,0,2
"10/04/2020","Y","Y","Matanuska-Susitna Borough",170,"Matanuska-Susitna Borough",5,9,668,6,698,0,19,0,2
"10/05/2020","Y","Y","Matanuska-Susitna Borough",170,"Matanuska-Susitna Borough",5,11,679,11,709,0,19,0,2
"10/06/2020","Y","Y","Matanuska-Susitna Borough",170,"Matanuska-Susitna Borough",5,1,680,16,725,0,19,0,2
"10/07/2020","Y","Y","Matanuska-Susitna Borough",170,"Matanuska-Susitna Borough",5,8,688,13,738,1,20,0,2
"10/08/2020","Y","Y","Matanuska-Susitna Borough",170,"Matanuska-Susitna Borough",5,11,699,15,753,1,21,0,2
"10/09/2020","Y","Y","Matanuska-Susitna Borough",170,"Matanuska-Susitna Borough",5,18,717,17,770,0,21,0,2
"10/10/2020","Y","Y","Matanuska-Susitna Borough",170,"Matanuska-Susitna Borough",5,19,736,13,783,0,21,0,2
"10/11/2020","Y","Y","Matanuska-Susitna Borough",170,"Matanuska-Susitna Borough",5,11,747,3,786,0,21,0,2
"10/12/2020","Y","Y","Matanuska-Susitna Borough",170,"Matanuska-Susitna Borough",5,12,759,24,810,1,22,0,2
"10/13/2020","Y","Y","Matanuska-Susitna Borough",170,"Matanuska-Susitna Borough",5,4,763,20,830,0,22,0,2
"10/14/2020","Y","Y","Matanuska-Susitna Borough",170,"Matanuska-Susitna Borough",5,11,774,23,853,0,22,0,2
"10/15/2020","Y","Y","Matanuska-Susitna Borough",170,"Matanuska-Susitna Borough",5,17,791,30,883,0,22,0,2
"10/16/2020","Y","Y","Matanuska-Susitna Borough",170,"Matanuska-Susitna Borough",5,24,815,46,929,1,23,0,2
"10/17/2020","Y","Y","Matanuska-Susitna Borough",170,"Matanuska-Susitna Borough",5,19,834,28,957,0,23,0,2
"10/18/2020","Y","Y","Matanuska-Susitna Borough",170,"Matanuska-Susitna Borough",5,16,850,22,979,1,24,0,2
"10/19/2020","Y","Y","Matanuska-Susitna Borough",170,"Matanuska-Susitna Borough",5,24,874,69,1048,1,25,0,2
"10/20/2020","Y","Y","Matanuska-Susitna Borough",170,"Matanuska-Susitna Borough",5,17,891,57,1105,0,25,0,2
"10/21/2020","Y","Y","Matanuska-Susitna Borough",170,"Matanuska-Susitna Borough",5,25,916,47,1152,1,26,0,2
"10/22/2020","Y","Y","Matanuska-Susitna Borough",170,"Matanuska-Susitna Borough",5,30,946,65,1217,0,26,0,2
"10/23/2020","Y","Y","Matanuska-Susitna Borough",170,"Matanuska-Susitna Borough",5,34,980,82,1299,1,27,0,2
"10/24/2020","Y","Y","Matanuska-Susitna Borough",170,"Matanuska-Susitna Borough",5,72,1052,40,1339,0,27,1,3
"10/25/2020","Y","Y","Matanuska-Susitna Borough",170,"Matanuska-Susitna Borough",5,81,1133,28,1367,2,29,0,3
"10/26/2020","Y","Y","Matanuska-Susitna Borough",170,"Matanuska-Susitna Borough",5,57,1190,103,1470,0,29,0,3
"10/27/2020","Y","Y","Matanuska-Susitna Borough",170,"Matanuska-Susitna Borough",5,100,1290,86,1556,0,29,1,4
"10/28/2020","Y","Y","Matanuska-Susitna Borough",170,"Matanuska-Susitna Borough",5,81,1371,92,1648,0,29,0,4
"10/29/2020","Y","Y","Matanuska-Susitna Borough",170,"Matanuska-Susitna Borough",5,66,1437,112,1760,0,29,0,4
"10/30/2020","Y","Y","Matanuska-Susitna Borough",170,"Matanuska-Susitna Borough",5,28,1465,89,1849,1,30,1,5
"10/31/2020","Y","Y","Matanuska-Susitna Borough",170,"Matanuska-Susitna Borough",5,69,1534,32,1881,0,30,0,5
"11/01/2020","Y","Y","Matanuska-Susitna Borough",170,"Matanuska-Susitna Borough",5,69,1603,45,1926,1,31,0,5
"11/02/2020","Y","Y","Matanuska-Susitna Borough",170,"Matanuska-Susitna Borough",5,48,1651,120,2046,1,32,0,5
"11/03/2020","Y","Y","Matanuska-Susitna Borough",170,"Matanuska-Susitna Borough",5,87,1738,88,2134,1,33,0,5
"11/04/2020","Y","Y","Matanuska-Susitna Borough",170,"Matanuska-Susitna Borough",5,39,1777,76,2210,0,33,0,5
"11/05/2020","Y","Y","Matanuska-Susitna Borough",170,"Matanuska-Susitna Borough",5,67,1844,121,2331,1,34,0,5
"11/06/2020","Y","Y","Matanuska-Susitna Borough",170,"Matanuska-Susitna Borough",5,73,1917,77,2408,2,36,0,5
"11/07/2020","Y","Y","Matanuska-Susitna Borough",170,"Matanuska-Susitna Borough",5,49,1966,59,2467,0,36,0,5
"11/08/2020","Y","Y","Matanuska-Susitna Borough",170,"Matanuska-Susitna Borough",5,58,2024,57,2524,1,37,1,6
"11/09/2020","Y","Y","Matanuska-Susitna Borough",170,"Matanuska-Susitna Borough",5,56,2080,112,2636,2,39,0,6
"11/10/2020","Y","Y","Matanuska-Susitna Borough",170,"Matanuska-Susitna Borough",5,73,2153,107,2743,0,39,0,6
"11/11/2020","Y","Y","Matanuska-Susitna Borough",170,"Matanuska-Susitna Borough",5,50,2203,99,2842,0,39,0,6
"11/12/2020","Y","Y","Matanuska-Susitna Borough",170,"Matanuska-Susitna Borough",5,89,2292,106,2948,1,40,0,6
"11/13/2020","Y","Y","Matanuska-Susitna Borough",170,"Matanuska-Susitna Borough",5,43,2335,156,3104,0,40,0,6
"11/14/2020","Y","Y","Matanuska-Susitna Borough",170,"Matanuska-Susitna Borough",5,45,2380,55,3159,0,40,0,6
"11/15/2020","Y","Y","Matanuska-Susitna Borough",170,"Matanuska-Susitna Borough",5,32,2412,47,3206,1,41,1,7
"11/16/2020","Y","Y","Matanuska-Susitna Borough",170,"Matanuska-Susitna Borough",5,33,2445,142,3348,0,41,0,7
"11/17/2020","Y","Y","Matanuska-Susitna Borough",170,"Matanuska-Susitna Borough",5,46,2491,120,3468,2,43,1,8
"11/18/2020","Y","Y","Matanuska-Susitna Borough",170,"Matanuska-Susitna Borough",5,37,2528,125,3593,0,43,0,8
"11/19/2020","Y","Y","Matanuska-Susitna Borough",170,"Matanuska-Susitna Borough",5,48,2576,119,3712,0,43,0,8
"11/20/2020","Y","Y","Matanuska-Susitna Borough",170,"Matanuska-Susitna Borough",5,38,2614,76,3788,1,44,0,8
"11/21/2020","Y","Y","Matanuska-Susitna Borough",170,"Matanuska-Susitna Borough",5,38,2652,42,3830,1,45,0,8
"11/22/2020","Y","Y","Matanuska-Susitna Borough",170,"Matanuska-Susitna Borough",5,26,2678,36,3866,3,48,1,9
"11/23/2020","Y","Y","Matanuska-Susitna Borough",170,"Matanuska-Susitna Borough",5,36,2714,196,4062,2,50,0,9
"11/24/2020","Y","Y","Matanuska-Susitna Borough",170,"Matanuska-Susitna Borough",5,43,2757,96,4158,1,51,1,10
"11/25/2020","Y","Y","Matanuska-Susitna Borough",170,"Matanuska-Susitna Borough",5,125,2882,310,4468,1,52,0,10
"11/26/2020","Y","Y","Matanuska-Susitna Borough",170,"Matanuska-Susitna Borough",5,366,3248,11,4479,1,53,0,10
"11/27/2020","Y","Y","Matanuska-Susitna Borough",170,"Matanuska-Susitna Borough",5,129,3377,64,4543,2,55,1,11
"11/28/2020","Y","Y","Matanuska-Susitna Borough",170,"Matanuska-Susitna Borough",5,132,3509,77,4620,2,57,0,11
"11/29/2020","Y","Y","Matanuska-Susitna Borough",170,"Matanuska-Susitna Borough",5,150,3659,35,4655,1,58,1,12
"11/30/2020","Y","Y","Matanuska-Susitna Borough",170,"Matanuska-Susitna Borough",5,197,3856,98,4753,1,59,3,15
"12/01/2020","Y","Y","Matanuska-Susitna Borough",170,"Matanuska-Susitna Borough",5,245,4101,190,4943,2,61,0,15
"12/02/2020","Y","Y","Matanuska-Susitna Borough",170,"Matanuska-Susitna Borough",5,200,4301,70,5013,0,61,0,15
"12/03/2020","Y","Y","Matanuska-Susitna Borough",170,"Matanuska-Susitna Borough",5,256,4557,106,5119,4,65,1,16
"12/04/2020","Y","Y","Matanuska-Susitna Borough",170,"Matanuska-Susitna Borough",5,207,4764,44,5163,0,65,0,16
"12/05/2020","Y","Y","Matanuska-Susitna Borough",170,"Matanuska-Susitna Borough",5,186,4950,83,5246,1,66,0,16
"12/06/2020","Y","Y","Matanuska-Susitna Borough",170,"Matanuska-Susitna Borough",5,118,5068,36,5282,0,66,0,16
"12/07/2020","Y","Y","Matanuska-Susitna Borough",170,"Matanuska-Susitna Borough",5,45,5113,65,5347,1,67,1,17
"12/08/2020","Y","Y","Matanuska-Susitna Borough",170,"Matanuska-Susitna Borough",5,86,5199,109,5456,0,67,0,17
"12/09/2020","Y","Y","Matanuska-Susitna Borough",170,"Matanuska-Susitna Borough",5,56,5255,56,5512,2,69,1,18
"12/10/2020","Y","Y","Matanuska-Susitna Borough",170,"Matanuska-Susitna Borough",5,75,5330,88,5600,0,69,0,18
"12/11/2020","Y","Y","Matanuska-Susitna Borough",170,"Matanuska-Susitna Borough",5,64,5394,57,5657,0,69,1,19
"12/12/2020","Y","Y","Matanuska-Susitna Borough",170,"Matanuska-Susitna Borough",5,118,5512,42,5699,0,69,0,19
"12/13/2020","Y","Y","Matanuska-Susitna Borough",170,"Matanuska-Susitna Borough",5,18,5530,18,5717,0,69,0,19
"12/14/2020","Y","Y","Matanuska-Susitna Borough",170,"Matanuska-Susitna Borough",5,35,5565,68,5785,0,69,0,19
"12/15/2020","Y","Y","Matanuska-Susitna Borough",170,"Matanuska-Susitna Borough",5,125,5690,59,5844,1,70,0,19
"12/16/2020","Y","Y","Matanuska-Susitna Borough",170,"Matanuska-Susitna Borough",5,63,5753,60,5904,0,70,1,20
"12/17/2020","Y","Y","Matanuska-Susitna Borough",170,"Matanuska-Susitna Borough",5,64,5817,62,5966,1,71,0,20
"12/18/2020","Y","Y","Matanuska-Susitna Borough",170,"Matanuska-Susitna Borough",5,52,5869,75,6041,0,71,1,21
"12/19/2020","Y","Y","Matanuska-Susitna Borough",170,"Matanuska-Susitna Borough",5,11,5880,38,6079,0,71,1,22
"12/20/2020","Y","Y","Matanuska-Susitna Borough",170,"Matanuska-Susitna Borough",5,11,5891,24,6103,0,71,2,24
"12/21/2020","Y","Y","Matanuska-Susitna Borough",170,"Matanuska-Susitna Borough",5,107,5998,48,6151,0,71,1,25
"12/22/2020","Y","Y","Matanuska-Susitna Borough",170,"Matanuska-Susitna Borough",5,66,6064,49,6200,3,74,1,26
"12/23/2020","Y","Y","Matanuska-Susitna Borough",170,"Matanuska-Susitna Borough",5,50,6114,49,6249,0,74,0,26
"12/24/2020","Y","Y","Matanuska-Susitna Borough",170,"Matanuska-Susitna Borough",5,16,6130,15,6264,0,74,0,26
"12/25/2020","Y","Y","Matanuska-Susitna Borough",170,"Matanuska-Susitna Borough",5,13,6143,15,6279,0,74,1,27
"12/26/2020","Y","Y","Matanuska-Susitna Borough",170,"Matanuska-Susitna Borough",5,78,6221,46,6325,1,75,1,28
"12/27/2020","Y","Y","Matanuska-Susitna Borough",170,"Matanuska-Susitna Borough",5,32,6253,62,6387,0,75,0,28
"12/28/2020","Y","Y","Matanuska-Susitna Borough",170,"Matanuska-Susitna Borough",5,42,6295,67,6454,1,76,0,28
"12/29/2020","Y","Y","Matanuska-Susitna Borough",170,"Matanuska-Susitna Borough",5,97,6392,47,6501,0,76,2,30
"12/30/2020","Y","Y","Matanuska-Susitna Borough",170,"Matanuska-Susitna Borough",5,35,6427,65,6566,1,77,0,30
"12/31/2020","Y","Y","Matanuska-Susitna Borough",170,"Matanuska-Susitna Borough",5,73,6500,33,6599,0,77,0,30
"01/01/2021","Y","Y","Matanuska-Susitna Borough",170,"Matanuska-Susitna Borough",5,34,6534,20,6619,0,77,0,30
"01/02/2021","Y","Y","Matanuska-Susitna Borough",170,"Matanuska-Susitna Borough",5,35,6569,47,6666,0,77,0,30
"01/03/2021","Y","Y","Matanuska-Susitna Borough",170,"Matanuska-Susitna Borough",5,43,6612,44,6710,2,79,1,31
"01/04/2021","Y","Y","Matanuska-Susitna Borough",170,"Matanuska-Susitna Borough",5,36,6648,62,6772,0,79,0,31
"01/05/2021","Y","Y","Matanuska-Susitna Borough",170,"Matanuska-Susitna Borough",5,57,6705,60,6832,1,80,0,31
"01/06/2021","Y","Y","Matanuska-Susitna Borough",170,"Matanuska-Susitna Borough",5,63,6768,50,6882,0,80,0,31
"01/07/2021","Y","Y","Matanuska-Susitna Borough",170,"Matanuska-Susitna Borough",5,69,6837,44,6926,0,80,1,32
"01/08/2021","Y","Y","Matanuska-Susitna Borough",170,"Matanuska-Susitna Borough",5,57,6894,44,6970,1,81,0,32
"01/09/2021","Y","Y","Matanuska-Susitna Borough",170,"Matanuska-Susitna Borough",5,49,6943,17,6987,1,82,0,32
"01/10/2021","Y","Y","Matanuska-Susitna Borough",170,"Matanuska-Susitna Borough",5,18,6961,35,7022,0,82,0,32
"01/11/2021","Y","Y","Matanuska-Susitna Borough",170,"Matanuska-Susitna Borough",5,23,6984,37,7059,0,82,0,32
"01/12/2021","Y","Y","Matanuska-Susitna Borough",170,"Matanuska-Susitna Borough",5,26,7010,32,7091,1,83,0,32
"01/13/2021","Y","Y","Matanuska-Susitna Borough",170,"Matanuska-Susitna Borough",5,53,7063,45,7136,0,83,0,32
"01/14/2021","Y","Y","Matanuska-Susitna Borough",170,"Matanuska-Susitna Borough",5,49,7112,37,7173,0,83,0,32
"01/15/2021","Y","Y","Matanuska-Susitna Borough",170,"Matanuska-Susitna Borough",5,35,7147,29,7202,0,83,0,32
"01/16/2021","Y","Y","Matanuska-Susitna Borough",170,"Matanuska-Susitna Borough",5,28,7175,17,7219,0,83,0,32
"01/17/2021","Y","Y","Matanuska-Susitna Borough",170,"Matanuska-Susitna Borough",5,16,7191,34,7253,1,84,0,32
"01/18/2021","Y","Y","Matanuska-Susitna Borough",170,"Matanuska-Susitna Borough",5,30,7221,30,7283,0,84,0,32
"01/19/2021","Y","Y","Matanuska-Susitna Borough",170,"Matanuska-Susitna Borough",5,35,7256,23,7306,1,85,0,32
"01/20/2021","Y","Y","Matanuska-Susitna Borough",170,"Matanuska-Susitna Borough",5,30,7286,28,7334,0,85,0,32
"01/21/2021","Y","Y","Matanuska-Susitna Borough",170,"Matanuska-Susitna Borough",5,39,7325,27,7361,0,85,0,32
"01/22/2021","Y","Y","Matanuska-Susitna Borough",170,"Matanuska-Susitna Borough",5,27,7352,19,7380,1,86,0,32
"01/23/2021","Y","Y","Matanuska-Susitna Borough",170,"Matanuska-Susitna Borough",5,20,7372,10,7390,1,87,1,33
"01/24/2021","Y","Y","Matanuska-Susitna Borough",170,"Matanuska-Susitna Borough",5,7,7379,16,7406,1,88,0,33
"01/25/2021","Y","Y","Matanuska-Susitna Borough",170,"Matanuska-Susitna Borough",5,20,7399,39,7445,1,89,0,33
"01/26/2021","Y","Y","Matanuska-Susitna Borough",170,"Matanuska-Susitna Borough",5,34,7433,27,7472,0,89,0,33
"01/27/2021","Y","Y","Matanuska-Susitna Borough",170,"Matanuska-Susitna Borough",5,16,7449,17,7489,0,89,0,33
"01/28/2021","Y","Y","Matanuska-Susitna Borough",170,"Matanuska-Susitna Borough",5,38,7487,20,7509,0,89,0,33
"01/29/2021","Y","Y","Matanuska-Susitna Borough",170,"Matanuska-Susitna Borough",5,6,7493,20,7529,0,89,1,34
"01/30/2021","Y","Y","Matanuska-Susitna Borough",170,"Matanuska-Susitna Borough",5,7,7500,18,7547,0,89,0,34
"01/31/2021","Y","Y","Matanuska-Susitna Borough",170,"Matanuska-Susitna Borough",5,22,7522,15,7562,0,89,0,34
"02/01/2021","Y","Y","Matanuska-Susitna Borough",170,"Matanuska-Susitna Borough",5,25,7547,59,7621,0,89,0,34
"02/02/2021","Y","Y","Matanuska-Susitna Borough",170,"Matanuska-Susitna Borough",5,59,7606,51,7672,0,89,0,34
"02/03/2021","Y","Y","Matanuska-Susitna Borough",170,"Matanuska-Susitna Borough",5,32,7638,42,7714,0,89,0,34
"02/04/2021","Y","Y","Matanuska-Susitna Borough",170,"Matanuska-Susitna Borough",5,51,7689,34,7748,0,89,0,34
"02/05/2021","Y","Y","Matanuska-Susitna Borough",170,"Matanuska-Susitna Borough",5,17,7706,28,7776,0,89,0,34
"02/06/2021","Y","Y","Matanuska-Susitna Borough",170,"Matanuska-Susitna Borough",5,59,7765,35,7811,0,89,0,34
"02/07/2021","Y","Y","Matanuska-Susitna Borough",170,"Matanuska-Susitna Borough",5,36,7801,31,7842,0,89,1,35
"02/08/2021","Y","Y","Matanuska-Susitna Borough",170,"Matanuska-Susitna Borough",5,31,7832,57,7899,1,90,0,35
"02/09/2021","Y","Y","Matanuska-Susitna Borough",170,"Matanuska-Susitna Borough",5,49,7881,32,7931,0,90,0,35
"02/10/2021","Y","Y","Matanuska-Susitna Borough",170,"Matanuska-Susitna Borough",5,27,7908,45,7976,0,90,0,35
"02/11/2021","Y","Y","Matanuska-Susitna Borough",170,"Matanuska-Susitna Borough",5,33,7941,36,8012,0,90,0,35
"02/12/2021","Y","Y","Matanuska-Susitna Borough",170,"Matanuska-Susitna Borough",5,7,7948,33,8045,0,90,0,35
"02/13/2021","Y","Y","Matanuska-Susitna Borough",170,"Matanuska-Susitna Borough",5,91,8039,48,8093,0,90,0,35
"02/14/2021","Y","Y","Matanuska-Susitna Borough",170,"Matanuska-Susitna Borough",5,29,8068,10,8103,0,90,0,35
"02/15/2021","Y","Y","Matanuska-Susitna Borough",170,"Matanuska-Susitna Borough",5,21,8089,65,8168,1,91,0,35
"02/16/2021","Y","Y","Matanuska-Susitna Borough",170,"Matanuska-Susitna Borough",5,13,8102,36,8204,2,93,0,35
"02/17/2021","Y","Y","Matanuska-Susitna Borough",170,"Matanuska-Susitna Borough",5,83,8185,44,8248,1,94,0,35
"02/18/2021","Y","Y","Matanuska-Susitna Borough",170,"Matanuska-Susitna Borough",5,51,8236,29,8277,0,94,0,35
"02/19/2021","Y","Y","Matanuska-Susitna Borough",170,"Matanuska-Susitna Borough",5,38,8274,41,8318,1,95,0,35
"02/20/2021","Y","Y","Matanuska-Susitna Borough",170,"Matanuska-Susitna Borough",5,30,8304,20,8338,3,98,0,35
"02/21/2021","Y","Y","Matanuska-Susitna Borough",170,"Matanuska-Susitna Borough",5,22,8326,16,8354,2,100,0,35
"02/22/2021","Y","Y","Matanuska-Susitna Borough",170,"Matanuska-Susitna Borough",5,18,8344,54,8408,1,101,0,35
"02/23/2021","Y","Y","Matanuska-Susitna Borough",170,"Matanuska-Susitna Borough",5,54,8398,52,8460,0,101,0,35
"02/24/2021","Y","Y","Matanuska-Susitna Borough",170,"Matanuska-Susitna Borough",5,46,8444,42,8502,0,101,0,35
"02/25/2021","Y","Y","Matanuska-Susitna Borough",170,"Matanuska-Susitna Borough",5,39,8483,58,8560,0,101,0,35
"02/26/2021","Y","Y","Matanuska-Susitna Borough",170,"Matanuska-Susitna Borough",5,57,8540,34,8594,2,103,1,36
"02/27/2021","Y","Y","Matanuska-Susitna Borough",170,"Matanuska-Susitna Borough",5,30,8570,31,8625,1,104,0,36
"02/28/2021","Y","Y","Matanuska-Susitna Borough",170,"Matanuska-Susitna Borough",5,39,8609,29,8654,0,104,0,36
"03/01/2021","Y","Y","Matanuska-Susitna Borough",170,"Matanuska-Susitna Borough",5,34,8643,55,8709,0,104,0,36
"03/02/2021","Y","Y","Matanuska-Susitna Borough",170,"Matanuska-Susitna Borough",5,53,8696,38,8747,0,104,0,36
"03/03/2021","Y","Y","Matanuska-Susitna Borough",170,"Matanuska-Susitna Borough",5,37,8733,39,8786,0,104,0,36
"03/04/2021","Y","Y","Matanuska-Susitna Borough",170,"Matanuska-Susitna Borough",5,39,8772,48,8834,2,106,0,36
"03/05/2021","Y","Y","Matanuska-Susitna Borough",170,"Matanuska-Susitna Borough",5,44,8816,39,8873,0,106,0,36
"03/06/2021","Y","Y","Matanuska-Susitna Borough",170,"Matanuska-Susitna Borough",5,40,8856,28,8901,0,106,0,36
"03/07/2021","Y","Y","Matanuska-Susitna Borough",170,"Matanuska-Susitna Borough",5,19,8875,19,8920,1,107,0,36
"03/08/2021","Y","Y","Matanuska-Susitna Borough",170,"Matanuska-Susitna Borough",5,29,8904,59,8979,0,107,0,36
"03/09/2021","Y","Y","Matanuska-Susitna Borough",170,"Matanuska-Susitna Borough",5,48,8952,88,9067,0,107,0,36
"03/10/2021","Y","Y","Matanuska-Susitna Borough",170,"Matanuska-Susitna Borough",5,81,9033,41,9108,0,107,0,36
"03/11/2021","Y","Y","Matanuska-Susitna Borough",170,"Matanuska-Susitna Borough",5,47,9080,49,9157,2,109,0,36
"03/12/2021","Y","Y","Matanuska-Susitna Borough",170,"Matanuska-Susitna Borough",5,51,9131,52,9209,2,111,0,36
"03/13/2021","Y","Y","Matanuska-Susitna Borough",170,"Matanuska-Susitna Borough",5,40,9171,16,9225,1,112,0,36
"03/14/2021","Y","Y","Matanuska-Susitna Borough",170,"Matanuska-Susitna Borough",5,12,9183,28,9253,0,112,0,36
"03/15/2021","Y","Y","Matanuska-Susitna Borough",170,"Matanuska-Susitna Borough",5,35,9218,57,9310,1,113,1,37
"03/16/2021","Y","Y","Matanuska-Susitna Borough",170,"Matanuska-Susitna Borough",5,65,9283,40,9350,0,113,1,38
"03/17/2021","Y","Y","Matanuska-Susitna Borough",170,"Matanuska-Susitna Borough",5,30,9313,43,9393,1,114,0,38
"03/18/2021","Y","Y","Matanuska-Susitna Borough",170,"Matanuska-Susitna Borough",5,22,9335,54,9447,2,116,0,38
"03/19/2021","Y","Y","Matanuska-Susitna Borough",170,"Matanuska-Susitna Borough",5,45,9380,45,9492,1,117,0,38
"03/20/2021","Y","Y","Matanuska-Susitna Borough",170,"Matanuska-Susitna Borough",5,29,9409,25,9517,1,118,0,38
"03/21/2021","Y","Y","Matanuska-Susitna Borough",170,"Matanuska-Susitna Borough",5,18,9427,22,9539,1,119,0,38
"03/22/2021","Y","Y","Matanuska-Susitna Borough",170,"Matanuska-Susitna Borough",5,56,9483,44,9583,0,119,0,38
"03/23/2021","Y","Y","Matanuska-Susitna Borough",170,"Matanuska-Susitna Borough",5,47,9530,37,9620,0,119,1,39
"03/24/2021","Y","Y","Matanuska-Susitna Borough",170,"Matanuska-Susitna Borough",5,35,9565,62,9682,0,119,0,39
"03/25/2021","Y","Y","Matanuska-Susitna Borough",170,"Matanuska-Susitna Borough",5,95,9660,62,9744,0,119,0,39
"03/26/2021","Y","Y","Matanuska-Susitna Borough",170,"Matanuska-Susitna Borough",5,53,9713,57,9801,4,123,0,39
"03/27/2021","Y","Y","Matanuska-Susitna Borough",170,"Matanuska-Susitna Borough",5,53,9766,25,9826,1,124,0,39
"03/28/2021","Y","Y","Matanuska-Susitna Borough",170,"Matanuska-Susitna Borough",5,33,9799,33,9859,1,125,0,39
"03/29/2021","Y","Y","Matanuska-Susitna Borough",170,"Matanuska-Susitna Borough",5,52,9851,58,9917,1,126,0,39
"03/30/2021","Y","Y","Matanuska-Susitna Borough",170,"Matanuska-Susitna Borough",5,42,9893,53,9970,1,127,1,40
"03/31/2021","Y","Y","Matanuska-Susitna Borough",170,"Matanuska-Susitna Borough",5,60,9953,55,10025,2,129,1,41
"04/01/2021","Y","Y","Matanuska-Susitna Borough",170,"Matanuska-Susitna Borough",5,56,10009,57,10082,3,132,0,41
"04/02/2021","Y","Y","Matanuska-Susitna Borough",170,"Matanuska-Susitna Borough",5,65,10074,62,10144,2,134,0,41
"04/03/2021","Y","Y","Matanuska-Susitna Borough",170,"Matanuska-Susitna Borough",5,54,10128,30,10174,1,135,0,41
"04/04/2021","Y","Y","Matanuska-Susitna Borough",170,"Matanuska-Susitna Borough",5,29,10157,14,10188,0,135,1,42
"04/05/2021","Y","Y","Matanuska-Susitna Borough",170,"Matanuska-Susitna Borough",5,30,10187,88,10276,0,135,0,42
"04/06/2021","Y","Y","Matanuska-Susitna Borough",170,"Matanuska-Susitna Borough",5,72,10259,64,10340,3,138,1,43
"04/07/2021","Y","Y","Matanuska-Susitna Borough",170,"Matanuska-Susitna Borough",5,64,10323,75,10415,2,140,0,43
"04/08/2021","Y","Y","Matanuska-Susitna Borough",170,"Matanuska-Susitna Borough",5,76,10399,46,10461,1,141,0,43
"04/09/2021","Y","Y","Matanuska-Susitna Borough",170,"Matanuska-Susitna Borough",5,46,10445,42,10503,1,142,0,43
"04/10/2021","Y","Y","Matanuska-Susitna Borough",170,"Matanuska-Susitna Borough",5,35,10480,23,10526,1,143,0,43
"04/11/2021","Y","Y","Matanuska-Susitna Borough",170,"Matanuska-Susitna Borough",5,26,10506,45,10571,1,144,1,44
"04/12/2021","Y","Y","Matanuska-Susitna Borough",170,"Matanuska-Susitna Borough",5,52,10558,80,10651,1,145,0,44
"04/13/2021","Y","Y","Matanuska-Susitna Borough",170,"Matanuska-Susitna Borough",5,66,10624,63,10714,1,146,1,45
"04/14/2021","Y","Y","Matanuska-Susitna Borough",170,"Matanuska-Susitna Borough",5,80,10704,62,10776,0,146,2,47
"04/15/2021","Y","Y","Matanuska-Susitna Borough",170,"Matanuska-Susitna Borough",5,49,10753,51,10827,1,147,2,49
"04/16/2021","Y","Y","Matanuska-Susitna Borough",170,"Matanuska-Susitna Borough",5,47,10800,52,10879,0,147,1,50
"04/17/2021","Y","Y","Matanuska-Susitna Borough",170,"Matanuska-Susitna Borough",5,55,10855,25,10904,1,148,0,50
"04/18/2021","Y","Y","Matanuska-Susitna Borough",170,"Matanuska-Susitna Borough",5,25,10880,27,10931,1,149,0,50
"04/19/2021","Y","Y","Matanuska-Susitna Borough",170,"Matanuska-Susitna Borough",5,35,10915,54,10985,3,152,0,50
"04/20/2021","Y","Y","Matanuska-Susitna Borough",170,"Matanuska-Susitna Borough",5,48,10963,24,11009,1,153,0,50
"04/21/2021","Y","Y","Matanuska-Susitna Borough",170,"Matanuska-Susitna Borough",5,28,10991,46,11055,0,153,1,51
"04/22/2021","Y","Y","Matanuska-Susitna Borough",170,"Matanuska-Susitna Borough",5,35,11026,35,11090,0,153,0,51
"04/23/2021","Y","Y","Matanuska-Susitna Borough",170,"Matanuska-Susitna Borough",5,30,11056,31,11121,0,153,1,52
"04/24/2021","Y","Y","Matanuska-Susitna Borough",170,"Matanuska-Susitna Borough",5,38,11094,21,11142,1,154,0,52
"04/25/2021","Y","Y","Matanuska-Susitna Borough",170,"Matanuska-Susitna Borough",5,19,11113,30,11172,0,154,0,52
"04/26/2021","Y","Y","Matanuska-Susitna Borough",170,"Matanuska-Susitna Borough",5,29,11142,43,11215,1,155,0,52
"04/27/2021","Y","Y","Matanuska-Susitna Borough",170,"Matanuska-Susitna Borough",5,42,11184,17,11232,3,158,0,52
"04/28/2021","Y","Y","Matanuska-Susitna Borough",170,"Matanuska-Susitna Borough",5,32,11216,36,11268,2,160,1,53
"04/29/2021","Y","Y","Matanuska-Susitna Borough",170,"Matanuska-Susitna Borough",5,32,11248,20,11288,3,163,1,54
"04/30/2021","Y","Y","Matanuska-Susitna Borough",170,"Matanuska-Susitna Borough",5,18,11266,22,11310,1,164,1,55
"05/01/2021","Y","Y","Matanuska-Susitna Borough",170,"Matanuska-Susitna Borough",5,17,11283,17,11327,2,166,1,56
"05/02/2021","Y","Y","Matanuska-Susitna Borough",170,"Matanuska-Susitna Borough",5,12,11295,20,11347,0,166,0,56
"05/03/2021","Y","Y","Matanuska-Susitna Borough",170,"Matanuska-Susitna Borough",5,24,11319,29,11376,0,166,1,57
"05/04/2021","Y","Y","Matanuska-Susitna Borough",170,"Matanuska-Susitna Borough",5,38,11357,20,11396,0,166,1,58
"05/05/2021","Y","Y","Matanuska-Susitna Borough",170,"Matanuska-Susitna Borough",5,14,11371,17,11413,1,167,2,60
"05/06/2021","Y","Y","Matanuska-Susitna Borough",170,"Matanuska-Susitna Borough",5,16,11387,17,11430,1,168,0,60
"05/07/2021","Y","Y","Matanuska-Susitna Borough",170,"Matanuska-Susitna Borough",5,18,11405,18,11448,1,169,1,61
"05/08/2021","Y","Y","Matanuska-Susitna Borough",170,"Matanuska-Susitna Borough",5,26,11431,3,11451,1,170,1,62
"05/09/2021","Y","Y","Matanuska-Susitna Borough",170,"Matanuska-Susitna Borough",5,10,11441,8,11459,1,171,0,62
"05/10/2021","Y","Y","Matanuska-Susitna Borough",170,"Matanuska-Susitna Borough",5,17,11458,23,11482,0,171,0,62
"05/11/2021","Y","Y","Matanuska-Susitna Borough",170,"Matanuska-Susitna Borough",5,15,11473,10,11492,2,173,1,63
"05/12/2021","Y","Y","Matanuska-Susitna Borough",170,"Matanuska-Susitna Borough",5,10,11483,17,11509,0,173,0,63
"05/13/2021","Y","Y","Matanuska-Susitna Borough",170,"Matanuska-Susitna Borough",5,17,11500,6,11515,0,173,0,63
"05/14/2021","Y","Y","Matanuska-Susitna Borough",170,"Matanuska-Susitna Borough",5,5,11505,11,11526,0,173,1,64
"05/15/2021","Y","Y","Matanuska-Susitna Borough",170,"Matanuska-Susitna Borough",5,7,11512,7,11533,0,173,0,64
"05/16/2021","Y","Y","Matanuska-Susitna Borough",170,"Matanuska-Susitna Borough",5,3,11515,6,11539,0,173,0,64
"05/17/2021","Y","Y","Matanuska-Susitna Borough",170,"Matanuska-Susitna Borough",5,8,11523,14,11553,1,174,1,65
"05/18/2021","Y","Y","Matanuska-Susitna Borough",170,"Matanuska-Susitna Borough",5,15,11538,6,11559,0,174,0,65
"05/19/2021","Y","Y","Matanuska-Susitna Borough",170,"Matanuska-Susitna Borough",5,11,11549,7,11566,1,175,0,65
"05/20/2021","Y","Y","Matanuska-Susitna Borough",170,"Matanuska-Susitna Borough",5,10,11559,6,11572,0,175,0,65
"05/21/2021","Y","Y","Matanuska-Susitna Borough",170,"Matanuska-Susitna Borough",5,6,11565,4,11576,0,175,0,65
"05/22/2021","Y","Y","Matanuska-Susitna Borough",170,"Matanuska-Susitna Borough",5,3,11568,4,11580,0,175,0,65
"05/23/2021","Y","Y","Matanuska-Susitna Borough",170,"Matanuska-Susitna Borough",5,4,11572,4,11584,0,175,0,65
"05/24/2021","Y","Y","Matanuska-Susitna Borough",170,"Matanuska-Susitna Borough",5,3,11575,3,11587,0,175,0,65
"05/25/2021","Y","Y","Matanuska-Susitna Borough",170,"Matanuska-Susitna Borough",5,4,11579,7,11594,0,175,0,65
"05/26/2021","Y","Y","Matanuska-Susitna Borough",170,"Matanuska-Susitna Borough",5,5,11584,8,11602,1,176,0,65
"05/27/2021","Y","Y","Matanuska-Susitna Borough",170,"Matanuska-Susitna Borough",5,7,11591,6,11608,0,176,0,65
"05/28/2021","Y","Y","Matanuska-Susitna Borough",170,"Matanuska-Susitna Borough",5,3,11594,3,11611,0,176,0,65
"05/29/2021","Y","Y","Matanuska-Susitna Borough",170,"Matanuska-Susitna Borough",5,3,11597,2,11613,0,176,0,65
"05/30/2021","Y","Y","Matanuska-Susitna Borough",170,"Matanuska-Susitna Borough",5,6,11603,4,11617,1,177,0,65
"05/31/2021","Y","Y","Matanuska-Susitna Borough",170,"Matanuska-Susitna Borough",5,8,11611,8,11625,0,177,0,65
"06/01/2021","Y","Y","Matanuska-Susitna Borough",170,"Matanuska-Susitna Borough",5,6,11617,6,11631,0,177,0,65
"06/02/2021","Y","Y","Matanuska-Susitna Borough",170,"Matanuska-Susitna Borough",5,8,11625,4,11635,0,177,0,65
"06/03/2021","Y","Y","Matanuska-Susitna Borough",170,"Matanuska-Susitna Borough",5,8,11633,3,11638,0,177,0,65
"06/04/2021","Y","Y","Matanuska-Susitna Borough",170,"Matanuska-Susitna Borough",5,1,11634,7,11645,2,179,0,65
"06/05/2021","Y","Y","Matanuska-Susitna Borough",170,"Matanuska-Susitna Borough",5,9,11643,1,11646,0,179,0,65
"06/06/2021","Y","Y","Matanuska-Susitna Borough",170,"Matanuska-Susitna Borough",5,1,11644,1,11647,0,179,0,65
"06/07/2021","Y","Y","Matanuska-Susitna Borough",170,"Matanuska-Susitna Borough",5,2,11646,6,11653,0,179,1,66
"06/08/2021","Y","Y","Matanuska-Susitna Borough",170,"Matanuska-Susitna Borough",5,3,11649,4,11657,0,179,0,66
"06/09/2021","Y","Y","Matanuska-Susitna Borough",170,"Matanuska-Susitna Borough",5,1,11650,1,11658,0,179,0,66
"06/10/2021","Y","Y","Matanuska-Susitna Borough",170,"Matanuska-Susitna Borough",5,0,11650,3,11661,0,179,0,66
"06/11/2021","Y","Y","Matanuska-Susitna Borough",170,"Matanuska-Susitna Borough",5,1,11651,1,11662,0,179,0,66
"06/12/2021","Y","Y","Matanuska-Susitna Borough",170,"Matanuska-Susitna Borough",5,2,11653,2,11664,1,180,0,66
"06/13/2021","Y","Y","Matanuska-Susitna Borough",170,"Matanuska-Susitna Borough",5,3,11656,3,11667,0,180,0,66
"06/14/2021","Y","Y","Matanuska-Susitna Borough",170,"Matanuska-Susitna Borough",5,1,11657,6,11673,2,182,0,66
"06/15/2021","Y","Y","Matanuska-Susitna Borough",170,"Matanuska-Susitna Borough",5,3,11660,3,11676,0,182,0,66
"06/16/2021","Y","Y","Matanuska-Susitna Borough",170,"Matanuska-Susitna Borough",5,7,11667,2,11678,0,182,0,66
"06/17/2021","Y","Y","Matanuska-Susitna Borough",170,"Matanuska-Susitna Borough",5,1,11668,5,11683,0,182,0,66
"06/18/2021","Y","Y","Matanuska-Susitna Borough",170,"Matanuska-Susitna Borough",5,6,11674,4,11687,0,182,0,66
"06/19/2021","Y","Y","Matanuska-Susitna Borough",170,"Matanuska-Susitna Borough",5,5,11679,4,11691,1,183,0,66
"06/20/2021","Y","Y","Matanuska-Susitna Borough",170,"Matanuska-Susitna Borough",5,3,11682,2,11693,0,183,0,66
"06/21/2021","Y","Y","Matanuska-Susitna Borough",170,"Matanuska-Susitna Borough",5,4,11686,4,11697,1,184,0,66
"06/22/2021","Y","Y","Matanuska-Susitna Borough",170,"Matanuska-Susitna Borough",5,6,11692,9,11706,0,184,0,66
"06/23/2021","Y","Y","Matanuska-Susitna Borough",170,"Matanuska-Susitna Borough",5,5,11697,2,11708,1,185,0,66
"06/24/2021","Y","Y","Matanuska-Susitna Borough",170,"Matanuska-Susitna Borough",5,3,11700,2,11710,1,186,0,66
"06/25/2021","Y","Y","Matanuska-Susitna Borough",170,"Matanuska-Susitna Borough",5,6,11706,3,11713,0,186,0,66
"06/26/2021","Y","Y","Matanuska-Susitna Borough",170,"Matanuska-Susitna Borough",5,1,11707,0,11713,0,186,0,66
"06/27/2021","Y","Y","Matanuska-Susitna Borough",170,"Matanuska-Susitna Borough",5,1,11708,4,11717,0,186,0,66
"06/28/2021","Y","Y","Matanuska-Susitna Borough",170,"Matanuska-Susitna Borough",5,5,11713,8,11725,0,186,0,66
"06/29/2021","Y","Y","Matanuska-Susitna Borough",170,"Matanuska-Susitna Borough",5,4,11717,0,11725,0,186,0,66
"06/30/2021","Y","Y","Matanuska-Susitna Borough",170,"Matanuska-Susitna Borough",5,0,11717,7,11732,0,186,0,66
"07/01/2021","Y","Y","Matanuska-Susitna Borough",170,"Matanuska-Susitna Borough",5,7,11724,4,11736,0,186,0,66
"07/02/2021","Y","Y","Matanuska-Susitna Borough",170,"Matanuska-Susitna Borough",5,1,11725,2,11738,0,186,0,66
"07/03/2021","Y","Y","Matanuska-Susitna Borough",170,"Matanuska-Susitna Borough",5,3,11728,0,11738,0,186,0,66
"07/04/2021","Y","Y","Matanuska-Susitna Borough",170,"Matanuska-Susitna Borough",5,0,11728,1,11739,0,186,0,66
"07/05/2021","Y","Y","Matanuska-Susitna Borough",170,"Matanuska-Susitna Borough",5,3,11731,3,11742,0,186,0,66
"07/06/2021","Y","Y","Matanuska-Susitna Borough",170,"Matanuska-Susitna Borough",5,8,11739,4,11746,1,187,0,66
"07/07/2021","Y","Y","Matanuska-Susitna Borough",170,"Matanuska-Susitna Borough",5,2,11741,2,11748,0,187,0,66
"07/08/2021","Y","Y","Matanuska-Susitna Borough",170,"Matanuska-Susitna Borough",5,1,11742,8,11756,0,187,0,66
"07/09/2021","Y","Y","Matanuska-Susitna Borough",170,"Matanuska-Susitna Borough",5,6,11748,6,11762,0,187,0,66
"07/10/2021","Y","Y","Matanuska-Susitna Borough",170,"Matanuska-Susitna Borough",5,1,11749,6,11768,1,188,0,66
"07/11/2021","Y","Y","Matanuska-Susitna Borough",170,"Matanuska-Susitna Borough",5,1,11750,4,11772,0,188,0,66
"07/12/2021","Y","Y","Matanuska-Susitna Borough",170,"Matanuska-Susitna Borough",5,16,11766,6,11778,0,188,0,66
"07/13/2021","Y","Y","Matanuska-Susitna Borough",170,"Matanuska-Susitna Borough",5,7,11773,4,11782,0,188,0,66
"07/14/2021","Y","Y","Matanuska-Susitna Borough",170,"Matanuska-Susitna Borough",5,2,11775,11,11793,0,188,0,66
"07/15/2021","Y","Y","Matanuska-Susitna Borough",170,"Matanuska-Susitna Borough",5,9,11784,17,11810,0,188,0,66
"07/16/2021","Y","Y","Matanuska-Susitna Borough",170,"Matanuska-Susitna Borough",5,15,11799,21,11831,1,189,0,66
"07/17/2021","Y","Y","Matanuska-Susitna Borough",170,"Matanuska-Susitna Borough",5,7,11806,12,11843,1,190,0,66
"07/18/2021","Y","Y","Matanuska-Susitna Borough",170,"Matanuska-Susitna Borough",5,4,11810,12,11855,0,190,0,66
"07/19/2021","Y","Y","Matanuska-Susitna Borough",170,"Matanuska-Susitna Borough",5,29,11839,20,11875,0,190,0,66
"07/20/2021","Y","Y","Matanuska-Susitna Borough",170,"Matanuska-Susitna Borough",5,9,11848,18,11893,0,190,0,66
"07/21/2021","Y","Y","Matanuska-Susitna Borough",170,"Matanuska-Susitna Borough",5,7,11855,21,11914,1,191,0,66
"07/22/2021","Y","Y","Matanuska-Susitna Borough",170,"Matanuska-Susitna Borough",5,28,11883,21,11935,0,191,0,66
"07/23/2021","Y","Y","Matanuska-Susitna Borough",170,"Matanuska-Susitna Borough",5,39,11922,17,11952,0,191,0,66
"07/24/2021","Y","Y","Matanuska-Susitna Borough",170,"Matanuska-Susitna Borough",5,5,11927,11,11963,1,192,0,66
"07/25/2021","Y","Y","Matanuska-Susitna Borough",170,"Matanuska-Susitna Borough",5,2,11929,10,11973,0,192,0,66
"07/26/2021","Y","Y","Matanuska-Susitna Borough",170,"Matanuska-Susitna Borough",5,6,11935,23,11996,0,192,0,66
"07/27/2021","Y","Y","Matanuska-Susitna Borough",170,"Matanuska-Susitna Borough",5,31,11966,32,12028,2,194,0,66
"07/28/2021","Y","Y","Matanuska-Susitna Borough",170,"Matanuska-Susitna Borough",5,31,11997,20,12048,0,194,0,66
"07/29/2021","Y","Y","Matanuska-Susitna Borough",170,"Matanuska-Susitna Borough",5,15,12012,19,12067,1,195,0,66
"07/30/2021","Y","Y","Matanuska-Susitna Borough",170,"Matanuska-Susitna Borough",5,25,12037,41,12108,1,196,0,66
"07/31/2021","Y","Y","Matanuska-Susitna Borough",170,"Matanuska-Susitna Borough",5,29,12066,21,12129,0,196,0,66
"08/01/2021","Y","Y","Matanuska-Susitna Borough",170,"Matanuska-Susitna Borough",5,27,12093,24,12153,0,196,0,66
"08/02/2021","Y","Y","Matanuska-Susitna Borough",170,"Matanuska-Susitna Borough",5,11,12104,58,12211,1,197,0,66
"08/03/2021","Y","Y","Matanuska-Susitna Borough",170,"Matanuska-Susitna Borough",5,34,12138,37,12248,1,198,0,66
"08/04/2021","Y","Y","Matanuska-Susitna Borough",170,"Matanuska-Susitna Borough",5,32,12170,49,12297,0,198,1,67
"08/05/2021","Y","Y","Matanuska-Susitna Borough",170,"Matanuska-Susitna Borough",5,48,12218,61,12358,2,200,0,67
"08/06/2021","Y","Y","Matanuska-Susitna Borough",170,"Matanuska-Susitna Borough",5,27,12245,29,12387,0,200,0,67
"08/07/2021","Y","Y","Matanuska-Susitna Borough",170,"Matanuska-Susitna Borough",5,52,12297,32,12419,0,200,1,68
"08/08/2021","Y","Y","Matanuska-Susitna Borough",170,"Matanuska-Susitna Borough",5,19,12316,34,12453,2,202,0,68
"08/09/2021","Y","Y","Matanuska-Susitna Borough",170,"Matanuska-Susitna Borough",5,20,12336,67,12520,1,203,0,68
"08/10/2021","Y","Y","Matanuska-Susitna Borough",170,"Matanuska-Susitna Borough",5,69,12405,44,12564,1,204,1,69
"08/11/2021","Y","Y","Matanuska-Susitna Borough",170,"Matanuska-Susitna Borough",5,19,12424,46,12610,3,207,1,70
"08/12/2021","Y","Y","Matanuska-Susitna Borough",170,"Matanuska-Susitna Borough",5,27,12451,65,12675,2,209,1,71
"08/13/2021","Y","Y","Matanuska-Susitna Borough",170,"Matanuska-Susitna Borough",5,22,12473,48,12723,0,209,1,72
"08/14/2021","Y","Y","Matanuska-Susitna Borough",170,"Matanuska-Susitna Borough",5,31,12504,47,12770,0,209,2,74
"08/15/2021","Y","Y","Matanuska-Susitna Borough",170,"Matanuska-Susitna Borough",5,43,12547,35,12805,1,210,2,76
"08/16/2021","Y","Y","Matanuska-Susitna Borough",170,"Matanuska-Susitna Borough",5,46,12593,87,12892,0,210,0,76
"08/17/2021","Y","Y","Matanuska-Susitna Borough",170,"Matanuska-Susitna Borough",5,75,12668,81,12973,1,211,0,76
"08/18/2021","Y","Y","Matanuska-Susitna Borough",170,"Matanuska-Susitna Borough",5,94,12762,67,13040,2,213,0,76
"08/19/2021","Y","Y","Matanuska-Susitna Borough",170,"Matanuska-Susitna Borough",5,78,12840,48,13088,0,213,1,77
"08/20/2021","Y","Y","Matanuska-Susitna Borough",170,"Matanuska-Susitna Borough",5,47,12887,54,13142,2,215,0,77
"08/21/2021","Y","Y","Matanuska-Susitna Borough",170,"Matanuska-Susitna Borough",5,52,12939,45,13187,2,217,0,77
"08/22/2021","Y","Y","Matanuska-Susitna Borough",170,"Matanuska-Susitna Borough",5,13,12952,45,13232,1,218,0,77
"08/23/2021","Y","Y","Matanuska-Susitna Borough",170,"Matanuska-Susitna Borough",5,66,13018,122,13354,1,219,2,79
"08/24/2021","Y","Y","Matanuska-Susitna Borough",170,"Matanuska-Susitna Borough",5,81,13099,110,13464,0,219,0,79
"08/25/2021","Y","Y","Matanuska-Susitna Borough",170,"Matanuska-Susitna Borough",5,105,13204,110,13574,1,220,0,79
"08/26/2021","Y","Y","Matanuska-Susitna Borough",170,"Matanuska-Susitna Borough",5,74,13278,122,13696,0,220,1,80
"08/27/2021","Y","Y","Matanuska-Susitna Borough",170,"Matanuska-Susitna Borough",5,58,13336,106,13802,1,221,2,82
"08/28/2021","Y","Y","Matanuska-Susitna Borough",170,"Matanuska-Susitna Borough",5,15,13351,60,13862,2,223,0,82
"08/29/2021","Y","Y","Matanuska-Susitna Borough",170,"Matanuska-Susitna Borough",5,12,13363,79,13941,1,224,0,82
"08/30/2021","Y","Y","Matanuska-Susitna Borough",170,"Matanuska-Susitna Borough",5,120,13483,149,14090,2,226,0,82
"08/31/2021","Y","Y","Matanuska-Susitna Borough",170,"Matanuska-Susitna Borough",5,93,13576,177,14267,1,227,0,82
"09/01/2021","Y","Y","Matanuska-Susitna Borough",170,"Matanuska-Susitna Borough",5,102,13678,167,14434,0,227,1,83
"09/02/2021","Y","Y","Matanuska-Susitna Borough",170,"Matanuska-Susitna Borough",5,78,13756,146,14580,0,227,1,84
"09/03/2021","Y","Y","Matanuska-Susitna Borough",170,"Matanuska-Susitna Borough",5,183,13939,157,14737,2,229,1,85
"09/04/2021","Y","Y","Matanuska-Susitna Borough",170,"Matanuska-Susitna Borough",5,76,14015,78,14815,2,231,1,86
"09/05/2021","Y","Y","Matanuska-Susitna Borough",170,"Matanuska-Susitna Borough",5,21,14036,99,14914,4,235,0,86
"09/06/2021","Y","Y","Matanuska-Susitna Borough",170,"Matanuska-Susitna Borough",5,111,14147,119,15033,1,236,2,88
"09/07/2021","Y","Y","Matanuska-Susitna Borough",170,"Matanuska-Susitna Borough",5,123,14270,206,15239,4,240,0,88
"09/08/2021","Y","Y","Matanuska-Susitna Borough",170,"Matanuska-Susitna Borough",5,155,14425,191,15430,3,243,0,88
"09/09/2021","Y","Y","Matanuska-Susitna Borough",170,"Matanuska-Susitna Borough",5,130,14555,159,15589,1,244,1,89
"09/10/2021","Y","Y","Matanuska-Susitna Borough",170,"Matanuska-Susitna Borough",5,76,14631,151,15740,1,245,2,91
"09/11/2021","Y","Y","Matanuska-Susitna Borough",170,"Matanuska-Susitna Borough",5,96,14727,89,15829,1,246,1,92
"09/12/2021","Y","Y","Matanuska-Susitna Borough",170,"Matanuska-Susitna Borough",5,52,14779,99,15928,1,247,0,92
"09/13/2021","Y","Y","Matanuska-Susitna Borough",170,"Matanuska-Susitna Borough",5,145,14924,213,16141,2,249,1,93
"09/14/2021","Y","Y","Matanuska-Susitna Borough",170,"Matanuska-Susitna Borough",5,118,15042,163,16304,2,251,1,94
"09/15/2021","Y","Y","Matanuska-Susitna Borough",170,"Matanuska-Susitna Borough",5,184,15226,165,16469,3,254,1,95
"09/16/2021","Y","Y","Matanuska-Susitna Borough",170,"Matanuska-Susitna Borough",5,110,15336,135,16604,1,255,0,95
"09/17/2021","Y","Y","Matanuska-Susitna Borough",170,"Matanuska-Susitna Borough",5,85,15421,124,16728,3,258,1,96
"09/18/2021","Y","Y","Matanuska-Susitna Borough",170,"Matanuska-Susitna Borough",5,54,15475,72,16800,2,260,1,97
"09/19/2021","Y","Y","Matanuska-Susitna Borough",170,"Matanuska-Susitna Borough",5,76,15551,96,16896,3,263,6,103
"09/20/2021","Y","Y","Matanuska-Susitna Borough",170,"Matanuska-Susitna Borough",5,95,15646,178,17074,1,264,2,105
"09/21/2021","Y","Y","Matanuska-Susitna Borough",170,"Matanuska-Susitna Borough",5,285,15931,152,17226,1,265,1,106
"09/22/2021","Y","Y","Matanuska-Susitna Borough",170,"Matanuska-Susitna Borough",5,144,16075,120,17346,1,266,0,106
"09/23/2021","Y","Y","Matanuska-Susitna Borough",170,"Matanuska-Susitna Borough",5,421,16496,115,17461,4,270,1,107
"09/24/2021","Y","Y","Matanuska-Susitna Borough",170,"Matanuska-Susitna Borough",5,152,16648,134,17595,3,273,2,109
"09/25/2021","Y","Y","Matanuska-Susitna Borough",170,"Matanuska-Susitna Borough",5,278,16926,70,17665,1,274,4,113
"09/26/2021","Y","Y","Matanuska-Susitna Borough",170,"Matanuska-Susitna Borough",5,468,17394,98,17763,2,276,0,113
"09/27/2021","Y","Y","Matanuska-Susitna Borough",170,"Matanuska-Susitna Borough",5,59,17453,165,17928,1,277,2,115
"09/28/2021","Y","Y","Matanuska-Susitna Borough",170,"Matanuska-Susitna Borough",5,162,17615,148,18076,1,278,0,115
"09/29/2021","Y","Y","Matanuska-Susitna Borough",170,"Matanuska-Susitna Borough",5,144,17759,166,18242,1,279,1,116
"09/30/2021","Y","Y","Matanuska-Susitna Borough",170,"Matanuska-Susitna Borough",5,151,17910,127,18369,0,279,3,119
"10/01/2021","Y","Y","Matanuska-Susitna Borough",170,"Matanuska-Susitna Borough",5,266,18176,128,18497,1,280,1,120
"10/02/2021","Y","Y","Matanuska-Susitna Borough",170,"Matanuska-Susitna Borough",5,118,18294,64,18561,1,281,2,122
"10/03/2021","Y","Y","Matanuska-Susitna Borough",170,"Matanuska-Susitna Borough",5,22,18316,82,18643,1,282,0,122
"10/04/2021","Y","Y","Matanuska-Susitna Borough",170,"Matanuska-Susitna Borough",5,153,18469,168,18811,1,283,1,123
"10/05/2021","Y","Y","Matanuska-Susitna Borough",170,"Matanuska-Susitna Borough",5,56,18525,140,18951,1,284,1,124
"10/06/2021","Y","Y","Matanuska-Susitna Borough",170,"Matanuska-Susitna Borough",5,152,18677,154,19105,1,285,1,125
"10/07/2021","Y","Y","Matanuska-Susitna Borough",170,"Matanuska-Susitna Borough",5,66,18743,156,19261,3,288,3,128
"10/08/2021","Y","Y","Matanuska-Susitna Borough",170,"Matanuska-Susitna Borough",5,79,18822,134,19395,4,292,0,128
"10/09/2021","Y","Y","Matanuska-Susitna Borough",170,"Matanuska-Susitna Borough",5,249,19071,76,19471,0,292,1,129
"10/10/2021","Y","Y","Matanuska-Susitna Borough",170,"Matanuska-Susitna Borough",5,140,19211,86,19557,1,293,3,132
"10/11/2021","Y","Y","Matanuska-Susitna Borough",170,"Matanuska-Susitna Borough",5,30,19241,207,19764,3,296,2,134
"10/12/2021","Y","Y","Matanuska-Susitna Borough",170,"Matanuska-Susitna Borough",5,297,19538,163,19927,4,300,0,134
"10/13/2021","Y","Y","Matanuska-Susitna Borough",170,"Matanuska-Susitna Borough",5,191,19729,144,20071,2,302,0,134
"10/14/2021","Y","Y","Matanuska-Susitna Borough",170,"Matanuska-Susitna Borough",5,144,19873,159,20230,4,306,1,135
"10/15/2021","Y","Y","Matanuska-Susitna Borough",170,"Matanuska-Susitna Borough",5,82,19955,163,20393,1,307,2,137
"10/16/2021","Y","Y","Matanuska-Susitna Borough",170,"Matanuska-Susitna Borough",5,243,20198,85,20478,1,308,0,137
"10/17/2021","Y","Y","Matanuska-Susitna Borough",170,"Matanuska-Susitna Borough",5,120,20318,85,20563,3,311,3,140
"10/18/2021","Y","Y","Matanuska-Susitna Borough",170,"Matanuska-Susitna Borough",5,131,20449,196,20759,2,313,2,142
"10/19/2021","Y","Y","Matanuska-Susitna Borough",170,"Matanuska-Susitna Borough",5,87,20536,132,20891,1,314,3,145
"10/20/2021","Y","Y","Matanuska-Susitna Borough",170,"Matanuska-Susitna Borough",5,156,20692,126,21017,1,315,2,147
"10/21/2021","Y","Y","Matanuska-Susitna Borough",170,"Matanuska-Susitna Borough",5,160,20852,116,21133,3,318,4,151
"10/22/2021","Y","Y","Matanuska-Susitna Borough",170,"Matanuska-Susitna Borough",5,33,20885,135,21268,3,321,1,152
"10/23/2021","Y","Y","Matanuska-Susitna Borough",170,"Matanuska-Susitna Borough",5,161,21046,68,21336,2,323,1,153
"10/24/2021","Y","Y","Matanuska-Susitna Borough",170,"Matanuska-Susitna Borough",5,29,21075,59,21395,4,327,2,155
"10/25/2021","Y","Y","Matanuska-Susitna Borough",170,"Matanuska-Susitna Borough",5,201,21276,202,21597,4,331,3,158
"10/26/2021","Y","Y","Matanuska-Susitna Borough",170,"Matanuska-Susitna Borough",5,57,21333,125,21722,2,333,3,161
"10/27/2021","Y","Y","Matanuska-Susitna Borough",170,"Matanuska-Susitna Borough",5,198,21531,116,21838,2,335,2,163
"10/28/2021","Y","Y","Matanuska-Susitna Borough",170,"Matanuska-Susitna Borough",5,121,21652,103,21941,1,336,2,165
"10/29/2021","Y","Y","Matanuska-Susitna Borough",170,"Matanuska-Susitna Borough",5,105,21757,87,22028,0,336,1,166
"10/30/2021","Y","Y","Matanuska-Susitna Borough",170,"Matanuska-Susitna Borough",5,100,21857,55,22083,1,337,0,166
"10/31/2021","Y","Y","Matanuska-Susitna Borough",170,"Matanuska-Susitna Borough",5,34,21891,54,22137,0,337,2,168
"11/01/2021","Y","Y","Matanuska-Susitna Borough",170,"Matanuska-Susitna Borough",5,114,22005,144,22281,2,339,1,169
"11/02/2021","Y","Y","Matanuska-Susitna Borough",170,"Matanuska-Susitna Borough",5,106,22111,89,22370,0,339,1,170
"11/03/2021","Y","Y","Matanuska-Susitna Borough",170,"Matanuska-Susitna Borough",5,52,22163,96,22466,0,339,0,170
"11/04/2021","Y","Y","Matanuska-Susitna Borough",170,"Matanuska-Susitna Borough",5,193,22356,90,22556,2,341,2,172
"11/05/2021","Y","Y","Matanuska-Susitna Borough",170,"Matanuska-Susitna Borough",5,48,22404,95,22651,1,342,1,173
"11/06/2021","Y","Y","Matanuska-Susitna Borough",170,"Matanuska-Susitna Borough",5,123,22527,31,22682,1,343,0,173
"11/07/2021","Y","Y","Matanuska-Susitna Borough",170,"Matanuska-Susitna Borough",5,31,22558,51,22733,0,343,1,174
"11/08/2021","Y","Y","Matanuska-Susitna Borough",170,"Matanuska-Susitna Borough",5,115,22673,102,22835,1,344,2,176
"11/09/2021","Y","Y","Matanuska-Susitna Borough",170,"Matanuska-Susitna Borough",5,67,22740,84,22919,1,345,0,176
"11/10/2021","Y","Y","Matanuska-Susitna Borough",170,"Matanuska-Susitna Borough",5,39,22779,75,22994,1,346,0,176
"11/11/2021","Y","Y","Matanuska-Susitna Borough",170,"Matanuska-Susitna Borough",5,130,22909,56,23050,3,349,1,177
"11/12/2021","Y","Y","Matanuska-Susitna Borough",170,"Matanuska-Susitna Borough",5,67,22976,63,23113,0,349,0,177
"11/13/2021","Y","Y","Matanuska-Susitna Borough",170,"Matanuska-Susitna Borough",5,72,23048,43,23156,1,350,2,179
"11/14/2021","Y","Y","Matanuska-Susitna Borough",170,"Matanuska-Susitna Borough",5,48,23096,45,23201,1,351,1,180
"11/15/2021","Y","Y","Matanuska-Susitna Borough",170,"Matanuska-Susitna Borough",5,49,23145,100,23301,2,353,0,180
"11/16/2021","Y","Y","Matanuska-Susitna Borough",170,"Matanuska-Susitna Borough",5,68,23213,66,23367,0,353,0,180
"11/17/2021","Y","Y","Matanuska-Susitna Borough",170,"Matanuska-Susitna Borough",5,86,23299,53,23420,1,354,0,180
"11/18/2021","Y","Y","Matanuska-Susitna Borough",170,"Matanuska-Susitna Borough",5,79,23378,75,23495,0,354,0,180
"11/19/2021","Y","Y","Matanuska-Susitna Borough",170,"Matanuska-Susitna Borough",5,45,23423,53,23548,4,358,1,181
"11/20/2021","Y","Y","Matanuska-Susitna Borough",170,"Matanuska-Susitna Borough",5,62,23485,31,23579,1,359,2,183
"11/21/2021","Y","Y","Matanuska-Susitna Borough",170,"Matanuska-Susitna Borough",5,18,23503,35,23614,1,360,0,183
"11/22/2021","Y","Y","Matanuska-Susitna Borough",170,"Matanuska-Susitna Borough",5,14,23517,92,23706,2,362,2,185
"11/23/2021","Y","Y","Matanuska-Susitna Borough",170,"Matanuska-Susitna Borough",5,97,23614,48,23754,2,364,0,185
"11/24/2021","Y","Y","Matanuska-Susitna Borough",170,"Matanuska-Susitna Borough",5,92,23706,38,23792,1,365,0,185
"11/25/2021","Y","Y","Matanuska-Susitna Borough",170,"Matanuska-Susitna Borough",5,11,23717,15,23807,2,367,1,186
"11/26/2021","Y","Y","Matanuska-Susitna Borough",170,"Matanuska-Susitna Borough",5,69,23786,42,23849,0,367,0,186
"11/27/2021","Y","Y","Matanuska-Susitna Borough",170,"Matanuska-Susitna Borough",5,44,23830,25,23874,1,368,0,186
"11/28/2021","Y","Y","Matanuska-Susitna Borough",170,"Matanuska-Susitna Borough",5,12,23842,28,23902,1,369,0,186
"11/29/2021","Y","Y","Matanuska-Susitna Borough",170,"Matanuska-Susitna Borough",5,34,23876,61,23963,2,371,0,186
"11/30/2021","Y","Y","Matanuska-Susitna Borough",170,"Matanuska-Susitna Borough",5,57,23933,30,23993,0,371,0,186
"12/01/2021","Y","Y","Matanuska-Susitna Borough",170,"Matanuska-Susitna Borough",5,56,23989,43,24036,1,372,1,187
"12/02/2021","Y","Y","Matanuska-Susitna Borough",170,"Matanuska-Susitna Borough",5,45,24034,43,24079,2,374,2,189
"12/03/2021","Y","Y","Matanuska-Susitna Borough",170,"Matanuska-Susitna Borough",5,43,24077,65,24144,1,375,0,189
"12/04/2021","Y","Y","Matanuska-Susitna Borough",170,"Matanuska-Susitna Borough",5,8,24085,24,24168,1,376,1,190
"12/05/2021","Y","Y","Matanuska-Susitna Borough",170,"Matanuska-Susitna Borough",5,46,24131,8,24176,1,377,0,190
"12/06/2021","Y","Y","Matanuska-Susitna Borough",170,"Matanuska-Susitna Borough",5,51,24182,41,24217,1,378,2,192
"12/07/2021","Y","Y","Matanuska-Susitna Borough",170,"Matanuska-Susitna Borough",5,29,24211,27,24244,1,379,0,192
"12/08/2021","Y","Y","Matanuska-Susitna Borough",170,"Matanuska-Susitna Borough",5,33,24244,36,24280,0,379,0,192
"12/09/2021","Y","Y","Matanuska-Susitna Borough",170,"Matanuska-Susitna Borough",5,25,24269,29,24309,3,382,1,193
"12/10/2021","Y","Y","Matanuska-Susitna Borough",170,"Matanuska-Susitna Borough",5,45,24314,42,24351,0,382,0,193
"12/11/2021","Y","Y","Matanuska-Susitna Borough",170,"Matanuska-Susitna Borough",5,25,24339,23,24374,1,383,2,195
"12/12/2021","Y","Y","Matanuska-Susitna Borough",170,"Matanuska-Susitna Borough",5,8,24347,17,24391,0,383,0,195
"12/13/2021","Y","Y","Matanuska-Susitna Borough",170,"Matanuska-Susitna Borough",5,4,24351,18,24409,1,384,0,195
"12/14/2021","Y","Y","Matanuska-Susitna Borough",170,"Matanuska-Susitna Borough",5,62,24413,45,24454,2,386,1,196
"12/15/2021","Y","Y","Matanuska-Susitna Borough",170,"Matanuska-Susitna Borough",5,34,24447,23,24477,0,386,0,196
"12/16/2021","Y","Y","Matanuska-Susitna Borough",170,"Matanuska-Susitna Borough",5,25,24472,13,24490,2,388,0,196
"12/17/2021","Y","Y","Matanuska-Susitna Borough",170,"Matanuska-Susitna Borough",5,17,24489,17,24507,2,390,1,197
"12/18/2021","Y","Y","Matanuska-Susitna Borough",170,"Matanuska-Susitna Borough",5,9,24498,5,24512,0,390,0,197
"12/19/2021","Y","Y","Matanuska-Susitna Borough",170,"Matanuska-Susitna Borough",5,26,24524,25,24537,2,392,1,198
"12/20/2021","Y","Y","Matanuska-Susitna Borough",170,"Matanuska-Susitna Borough",5,8,24532,13,24550,0,392,0,198
"12/21/2021","Y","Y","Matanuska-Susitna Borough",170,"Matanuska-Susitna Borough",5,12,24544,20,24570,1,393,1,199
"12/22/2021","Y","Y","Matanuska-Susitna Borough",170,"Matanuska-Susitna Borough",5,29,24573,22,24592,0,393,0,199
"12/23/2021","Y","Y","Matanuska-Susitna Borough",170,"Matanuska-Susitna Borough",5,29,24602,57,24649,0,393,0,199
"12/24/2021","Y","Y","Matanuska-Susitna Borough",170,"Matanuska-Susitna Borough",5,10,24612,19,24668,1,394,0,199
"12/25/2021","Y","Y","Matanuska-Susitna Borough",170,"Matanuska-Susitna Borough",5,3,24615,9,24677,0,394,1,200
"12/26/2021","Y","Y","Matanuska-Susitna Borough",170,"Matanuska-Susitna Borough",5,14,24629,26,24703,0,394,1,201
"12/27/2021","Y","Y","Matanuska-Susitna Borough",170,"Matanuska-Susitna Borough",5,66,24695,107,24810,0,394,0,201
"12/28/2021","Y","Y","Matanuska-Susitna Borough",170,"Matanuska-Susitna Borough",5,60,24755,77,24887,0,394,1,202
"12/29/2021","Y","Y","Matanuska-Susitna Borough",170,"Matanuska-Susitna Borough",5,100,24855,70,24957,0,394,0,202
"12/30/2021","Y","Y","Matanuska-Susitna Borough",170,"Matanuska-Susitna Borough",5,94,24949,76,25033,0,394,0,202
"12/31/2021","Y","Y","Matanuska-Susitna Borough",170,"Matanuska-Susitna Borough",5,17,24966,70,25103,1,395,0,202
"01/01/2022","Y","Y","Matanuska-Susitna Borough",170,"Matanuska-Susitna Borough",5,85,25051,22,25125,0,395,0,202
"01/02/2022","Y","Y","Matanuska-Susitna Borough",170,"Matanuska-Susitna Borough",5,17,25068,21,25146,0,395,0,202
"01/03/2022","Y","Y","Matanuska-Susitna Borough",170,"Matanuska-Susitna Borough",5,55,25123,32,25178,1,396,0,202
"01/04/2022","Y","Y","Matanuska-Susitna Borough",170,"Matanuska-Susitna Borough",5,19,25142,55,25233,0,396,0,202
"01/05/2022","Y","Y","Matanuska-Susitna Borough",170,"Matanuska-Susitna Borough",5,32,25174,81,25314,1,397,0,202
"01/06/2022","Y","Y","Matanuska-Susitna Borough",170,"Matanuska-Susitna Borough",5,101,25275,102,25416,2,399,1,203
"01/07/2022","Y","Y","Matanuska-Susitna Borough",170,"Matanuska-Susitna Borough",5,108,25383,140,25556,1,400,0,203
"01/08/2022","Y","Y","Matanuska-Susitna Borough",170,"Matanuska-Susitna Borough",5,34,25417,59,25615,1,401,0,203
"01/09/2022","Y","Y","Matanuska-Susitna Borough",170,"Matanuska-Susitna Borough",5,41,25458,59,25674,0,401,1,204
"01/10/2022","Y","Y","Matanuska-Susitna Borough",170,"Matanuska-Susitna Borough",5,198,25656,179,25853,0,401,1,205
"01/11/2022","Y","Y","Matanuska-Susitna Borough",170,"Matanuska-Susitna Borough",5,127,25783,177,26030,0,401,0,205
"01/12/2022","Y","Y","Matanuska-Susitna Borough",170,"Matanuska-Susitna Borough",5,183,25966,195,26225,1,402,1,206
"01/13/2022","Y","Y","Matanuska-Susitna Borough",170,"Matanuska-Susitna Borough",5,201,26167,158,26383,0,402,0,206
"01/14/2022","Y","Y","Matanuska-Susitna Borough",170,"Matanuska-Susitna Borough",5,228,26395,270,26653,1,403,0,206
"01/15/2022","Y","Y","Matanuska-Susitna Borough",170,"Matanuska-Susitna Borough",5,224,26619,218,26871,1,404,0,206
"01/16/2022","Y","Y","Matanuska-Susitna Borough",170,"Matanuska-Susitna Borough",5,159,26778,158,27029,1,405,0,206
"01/17/2022","Y","Y","Matanuska-Susitna Borough",170,"Matanuska-Susitna Borough",5,132,26910,170,27199,1,406,2,208
"01/18/2022","Y","Y","Matanuska-Susitna Borough",170,"Matanuska-Susitna Borough",5,178,27088,190,27389,0,406,0,208
"01/19/2022","Y","Y","Matanuska-Susitna Borough",170,"Matanuska-Susitna Borough",5,403,27491,384,27773,0,406,0,208
"01/20/2022","Y","Y","Matanuska-Susitna Borough",170,"Matanuska-Susitna Borough",5,349,27840,358,28131,2,408,0,208
"01/21/2022","Y","Y","Matanuska-Susitna Borough",170,"Matanuska-Susitna Borough",5,294,28134,302,28433,1,409,0,208
"01/22/2022","Y","Y","Matanuska-Susitna Borough",170,"Matanuska-Susitna Borough",5,203,28337,207,28640,0,409,0,208
"01/23/2022","Y","Y","Matanuska-Susitna Borough",170,"Matanuska-Susitna Borough",5,90,28427,129,28769,0,409,4,212
"01/24/2022","Y","Y","Matanuska-Susitna Borough",170,"Matanuska-Susitna Borough",5,445,28872,602,29371,1,410,0,212
"01/25/2022","Y","Y","Matanuska-Susitna Borough",170,"Matanuska-Susitna Borough",5,311,29183,255,29626,1,411,0,212
"01/26/2022","Y","Y","Matanuska-Susitna Borough",170,"Matanuska-Susitna Borough",5,345,29528,322,29948,3,414,0,212
"01/27/2022","Y","Y","Matanuska-Susitna Borough",170,"Matanuska-Susitna Borough",5,442,29970,303,30251,1,415,0,212
"01/28/2022","Y","Y","Matanuska-Susitna Borough",170,"Matanuska-Susitna Borough",5,335,30305,249,30500,1,416,0,212
"01/29/2022","Y","Y","Matanuska-Susitna Borough",170,"Matanuska-Susitna Borough",5,227,30532,226,30726,1,417,0,212
"01/30/2022","Y","Y","Matanuska-Susitna Borough",170,"Matanuska-Susitna Borough",5,74,30606,63,30789,0,417,1,213
"01/31/2022","Y","Y","Matanuska-Susitna Borough",170,"Matanuska-Susitna Borough",5,315,30921,303,31092,0,417,1,214
"02/01/2022","Y","Y","Matanuska-Susitna Borough",170,"Matanuska-Susitna Borough",5,220,31141,195,31287,0,417,0,214
"02/02/2022","Y","Y","Matanuska-Susitna Borough",170,"Matanuska-Susitna Borough",5,249,31390,228,31515,0,417,0,214
"02/03/2022","Y","Y","Matanuska-Susitna Borough",170,"Matanuska-Susitna Borough",5,203,31593,197,31712,1,418,0,214
"02/04/2022","Y","Y","Matanuska-Susitna Borough",170,"Matanuska-Susitna Borough",5,201,31794,181,31893,0,418,0,214
"02/05/2022","Y","Y","Matanuska-Susitna Borough",170,"Matanuska-Susitna Borough",5,131,31925,123,32016,0,418,0,214
"02/06/2022","Y","Y","Matanuska-Susitna Borough",170,"Matanuska-Susitna Borough",5,29,31954,24,32040,0,418,1,215
"02/07/2022","Y","Y","Matanuska-Susitna Borough",170,"Matanuska-Susitna Borough",5,123,32077,122,32162,1,419,1,216
"02/08/2022","Y","Y","Matanuska-Susitna Borough",170,"Matanuska-Susitna Borough",5,156,32233,144,32306,2,421,3,219
"02/09/2022","Y","Y","Matanuska-Susitna Borough",170,"Matanuska-Susitna Borough",5,117,32350,121,32427,0,421,0,219
"02/10/2022","Y","Y","Matanuska-Susitna Borough",170,"Matanuska-Susitna Borough",5,89,32439,99,32526,0,421,2,221
"02/11/2022","Y","Y","Matanuska-Susitna Borough",170,"Matanuska-Susitna Borough",5,98,32537,97,32623,0,421,1,222
"02/12/2022","Y","Y","Matanuska-Susitna Borough",170,"Matanuska-Susitna Borough",5,38,32575,33,32656,2,423,0,222
"02/13/2022","Y","Y","Matanuska-Susitna Borough",170,"Matanuska-Susitna Borough",5,27,32602,18,32674,1,424,0,222
"02/14/2022","Y","Y","Matanuska-Susitna Borough",170,"Matanuska-Susitna Borough",5,31,32633,43,32717,2,426,1,223
"02/15/2022","Y","Y","Matanuska-Susitna Borough",170,"Matanuska-Susitna Borough",5,63,32696,42,32759,2,428,0,223
"02/16/2022","Y","Y","Matanuska-Susitna Borough",170,"Matanuska-Susitna Borough",5,77,32773,79,32838,1,429,0,223
"02/17/2022","Y","Y","Matanuska-Susitna Borough",170,"Matanuska-Susitna Borough",5,52,32825,46,32884,1,430,0,223
"02/18/2022","Y","Y","Matanuska-Susitna Borough",170,"Matanuska-Susitna Borough",5,51,32876,56,32940,0,430,0,223
"02/19/2022","Y","Y","Matanuska-Susitna Borough",170,"Matanuska-Susitna Borough",5,30,32906,13,32953,1,431,0,223
"02/20/2022","Y","Y","Matanuska-Susitna Borough",170,"Matanuska-Susitna Borough",5,14,32920,11,32964,0,431,2,225
"02/21/2022","Y","Y","Matanuska-Susitna Borough",170,"Matanuska-Susitna Borough",5,77,32997,88,33052,0,431,0,225
"02/22/2022","Y","Y","Matanuska-Susitna Borough",170,"Matanuska-Susitna Borough",5,47,33044,38,33090,0,431,1,226
"02/23/2022","Y","Y","Matanuska-Susitna Borough",170,"Matanuska-Susitna Borough",5,20,33064,19,33109,0,431,0,226
"02/24/2022","Y","Y","Matanuska-Susitna Borough",170,"Matanuska-Susitna Borough",5,49,33113,41,33150,0,431,0,226
"02/25/2022","Y","Y","Matanuska-Susitna Borough",170,"Matanuska-Susitna Borough",5,53,33166,33,33183,0,431,0,226
"02/26/2022","Y","Y","Matanuska-Susitna Borough",170,"Matanuska-Susitna Borough",5,13,33179,15,33198,1,432,0,226
"02/27/2022","Y","Y","Matanuska-Susitna Borough",170,"Matanuska-Susitna Borough",5,8,33187,7,33205,0,432,0,226
"02/28/2022","Y","Y","Matanuska-Susitna Borough",170,"Matanuska-Susitna Borough",5,11,33198,16,33221,0,432,0,226
"03/01/2022","Y","Y","Matanuska-Susitna Borough",170,"Matanuska-Susitna Borough",5,30,33228,22,33243,0,432,0,226
"03/02/2022","Y","Y","Matanuska-Susitna Borough",170,"Matanuska-Susitna Borough",5,50,33278,50,33293,0,432,0,226
"03/03/2022","Y","Y","Matanuska-Susitna Borough",170,"Matanuska-Susitna Borough",5,25,33303,24,33317,0,432,1,227
"03/04/2022","Y","Y","Matanuska-Susitna Borough",170,"Matanuska-Susitna Borough",5,25,33328,23,33340,1,433,0,227
"03/05/2022","Y","Y","Matanuska-Susitna Borough",170,"Matanuska-Susitna Borough",5,5,33333,4,33344,0,433,0,227
"03/06/2022","Y","Y","Matanuska-Susitna Borough",170,"Matanuska-Susitna Borough",5,5,33338,6,33350,1,434,0,227
"03/07/2022","Y","Y","Matanuska-Susitna Borough",170,"Matanuska-Susitna Borough",5,22,33360,19,33369,0,434,0,227
"03/08/2022","Y","Y","Matanuska-Susitna Borough",170,"Matanuska-Susitna Borough",5,15,33375,18,33387,1,435,0,227
"03/09/2022","Y","Y","Matanuska-Susitna Borough",170,"Matanuska-Susitna Borough",5,7,33382,13,33400,0,435,0,227
"03/10/2022","Y","Y","Matanuska-Susitna Borough",170,"Matanuska-Susitna Borough",5,15,33397,19,33419,0,435,0,227
"03/11/2022","Y","Y","Matanuska-Susitna Borough",170,"Matanuska-Susitna Borough",5,30,33427,24,33443,0,435,0,227
"03/12/2022","Y","Y","Matanuska-Susitna Borough",170,"Matanuska-Susitna Borough",5,13,33440,11,33454,0,435,0,227
"03/13/2022","Y","Y","Matanuska-Susitna Borough",170,"Matanuska-Susitna Borough",5,5,33445,4,33458,0,435,0,227
"03/14/2022","Y","Y","Matanuska-Susitna Borough",170,"Matanuska-Susitna Borough",5,17,33462,20,33478,0,435,0,227
"03/15/2022","Y","Y","Matanuska-Susitna Borough",170,"Matanuska-Susitna Borough",5,20,33482,14,33492,0,435,0,227
"03/16/2022","Y","Y","Matanuska-Susitna Borough",170,"Matanuska-Susitna Borough",5,11,33493,12,33504,0,435,0,227
"03/17/2022","Y","Y","Matanuska-Susitna Borough",170,"Matanuska-Susitna Borough",5,30,33523,31,33535,0,435,0,227
"03/18/2022","Y","Y","Matanuska-Susitna Borough",170,"Matanuska-Susitna Borough",5,11,33534,13,33548,0,435,0,227
"03/19/2022","Y","Y","Matanuska-Susitna Borough",170,"Matanuska-Susitna Borough",5,7,33541,13,33561,0,435,0,227
"03/20/2022","Y","Y","Matanuska-Susitna Borough",170,"Matanuska-Susitna Borough",5,6,33547,7,33568,0,435,0,227
"03/21/2022","Y","Y","Matanuska-Susitna Borough",170,"Matanuska-Susitna Borough",5,33,33580,33,33601,0,435,0,227
"03/22/2022","Y","Y","Matanuska-Susitna Borough",170,"Matanuska-Susitna Borough",5,15,33595,16,33617,0,435,0,227
"03/23/2022","Y","Y","Matanuska-Susitna Borough",170,"Matanuska-Susitna Borough",5,9,33604,14,33631,0,435,0,227
"03/24/2022","Y","Y","Matanuska-Susitna Borough",170,"Matanuska-Susitna Borough",5,23,33627,16,33647,0,435,0,227
"03/25/2022","Y","Y","Matanuska-Susitna Borough",170,"Matanuska-Susitna Borough",5,14,33641,12,33659,1,436,0,227
"03/26/2022","Y","Y","Matanuska-Susitna Borough",170,"Matanuska-Susitna Borough",5,5,33646,9,33668,0,436,0,227
"03/27/2022","Y","Y","Matanuska-Susitna Borough",170,"Matanuska-Susitna Borough",5,6,33652,11,33679,0,436,0,227
"03/28/2022","Y","Y","Matanuska-Susitna Borough",170,"Matanuska-Susitna Borough",5,5,33657,10,33689,0,436,0,227
"03/29/2022","Y","Y","Matanuska-Susitna Borough",170,"Matanuska-Susitna Borough",5,26,33683,24,33713,0,436,0,227
"03/30/2022","Y","Y","Matanuska-Susitna Borough",170,"Matanuska-Susitna Borough",5,26,33709,15,33728,0,436,0,227
"03/31/2022","Y","Y","Matanuska-Susitna Borough",170,"Matanuska-Susitna Borough",5,11,33720,9,33737,0,436,0,227
"04/01/2022","Y","Y","Matanuska-Susitna Borough",170,"Matanuska-Susitna Borough",5,30,33750,34,33771,0,436,0,227
"04/02/2022","Y","Y","Matanuska-Susitna Borough",170,"Matanuska-Susitna Borough",5,13,33763,11,33782,0,436,0,227
"04/03/2022","Y","Y","Matanuska-Susitna Borough",170,"Matanuska-Susitna Borough",5,13,33776,9,33791,0,436,0,227
"04/04/2022","Y","Y","Matanuska-Susitna Borough",170,"Matanuska-Susitna Borough",5,19,33795,19,33810,0,436,0,227
"04/05/2022","Y","Y","Matanuska-Susitna Borough",170,"Matanuska-Susitna Borough",5,16,33811,16,33826,0,436,0,227
"04/06/2022","Y","Y","Matanuska-Susitna Borough",170,"Matanuska-Susitna Borough",5,20,33831,24,33850,0,436,0,227
"04/07/2022","Y","Y","Matanuska-Susitna Borough",170,"Matanuska-Susitna Borough",5,15,33846,13,33863,0,436,0,227
"04/08/2022","Y","Y","Matanuska-Susitna Borough",170,"Matanuska-Susitna Borough",5,22,33868,27,33890,0,436,0,227
"04/09/2022","Y","Y","Matanuska-Susitna Borough",170,"Matanuska-Susitna Borough",5,13,33881,11,33901,0,436,0,227
"04/10/2022","Y","Y","Matanuska-Susitna Borough",170,"Matanuska-Susitna Borough",5,10,33891,4,33905,0,436,0,227
"04/11/2022","Y","Y","Matanuska-Susitna Borough",170,"Matanuska-Susitna Borough",5,12,33903,22,33927,0,436,0,227
"04/12/2022","Y","Y","Matanuska-Susitna Borough",170,"Matanuska-Susitna Borough",5,26,33929,28,33955,0,436,0,227
"04/13/2022","Y","Y","Matanuska-Susitna Borough",170,"Matanuska-Susitna Borough",5,18,33947,14,33969,0,436,0,227
"04/14/2022","Y","Y","Matanuska-Susitna Borough",170,"Matanuska-Susitna Borough",5,23,33970,19,33988,0,436,0,227
"04/15/2022","Y","Y","Matanuska-Susitna Borough",170,"Matanuska-Susitna Borough",5,12,33982,13,34001,0,436,0,227
"04/16/2022","Y","Y","Matanuska-Susitna Borough",170,"Matanuska-Susitna Borough",5,30,34012,25,34026,0,436,0,227
"04/17/2022","Y","Y","Matanuska-Susitna Borough",170,"Matanuska-Susitna Borough",5,8,34020,7,34033,0,436,0,227
"04/18/2022","Y","Y","Matanuska-Susitna Borough",170,"Matanuska-Susitna Borough",5,5,34025,15,34048,0,436,0,227
"04/19/2022","Y","Y","Matanuska-Susitna Borough",170,"Matanuska-Susitna Borough",5,32,34057,39,34087,0,436,0,227
"04/20/2022","Y","Y","Matanuska-Susitna Borough",170,"Matanuska-Susitna Borough",5,27,34084,12,34099,0,436,0,227
"04/21/2022","Y","Y","Matanuska-Susitna Borough",170,"Matanuska-Susitna Borough",5,14,34098,13,34112,0,436,0,227
"04/22/2022","Y","Y","Matanuska-Susitna Borough",170,"Matanuska-Susitna Borough",5,20,34118,22,34134,0,436,0,227
"04/23/2022","Y","Y","Matanuska-Susitna Borough",170,"Matanuska-Susitna Borough",5,13,34131,13,34147,0,436,0,227
"04/24/2022","Y","Y","Matanuska-Susitna Borough",170,"Matanuska-Susitna Borough",5,15,34146,16,34163,0,436,0,227
"04/25/2022","Y","Y","Matanuska-Susitna Borough",170,"Matanuska-Susitna Borough",5,22,34168,8,34171,0,436,0,227
"04/26/2022","Y","Y","Matanuska-Susitna Borough",170,"Matanuska-Susitna Borough",5,32,34200,29,34200,0,436,0,227
"04/05/2020","Y","Y","Nome Census Area",180,"Northwest Region",6,0,0,1,1,0,0,0,0
"04/14/2020","Y","Y","Nome Census Area",180,"Northwest Region",6,1,1,0,1,0,0,0,0
"05/17/2020","Y","Y","Nome Census Area",180,"Northwest Region",6,0,1,1,2,0,0,0,0
"05/21/2020","Y","Y","Nome Census Area",180,"Northwest Region",6,1,2,0,2,0,0,0,0
"05/22/2020","Y","Y","Nome Census Area",180,"Northwest Region",6,1,3,1,3,0,0,0,0
"06/08/2020","Y","Y","Nome Census Area",180,"Northwest Region",6,1,4,1,4,0,0,0,0
"06/12/2020","Y","Y","Nome Census Area",180,"Northwest Region",6,1,5,1,5,0,0,0,0
"06/22/2020","Y","Y","Nome Census Area",180,"Northwest Region",6,1,6,1,6,0,0,0,0
"06/24/2020","Y","Y","Nome Census Area",180,"Northwest Region",6,0,6,1,7,0,0,0,0
"06/28/2020","Y","Y","Nome Census Area",180,"Northwest Region",6,1,7,0,7,0,0,0,0
"06/30/2020","Y","Y","Nome Census Area",180,"Northwest Region",6,1,8,2,9,0,0,0,0
"07/02/2020","Y","Y","Nome Census Area",180,"Northwest Region",6,1,9,0,9,0,0,0,0
"07/06/2020","Y","Y","Nome Census Area",180,"Northwest Region",6,0,9,1,10,0,0,0,0
"07/08/2020","Y","Y","Nome Census Area",180,"Northwest Region",6,1,10,1,11,0,0,0,0
"07/09/2020","Y","Y","Nome Census Area",180,"Northwest Region",6,2,12,2,13,0,0,0,0
"07/10/2020","Y","Y","Nome Census Area",180,"Northwest Region",6,0,12,2,15,0,0,0,0
"07/11/2020","Y","Y","Nome Census Area",180,"Northwest Region",6,3,15,0,15,0,0,0,0
"07/14/2020","Y","Y","Nome Census Area",180,"Northwest Region",6,0,15,1,16,0,0,0,0
"07/18/2020","Y","Y","Nome Census Area",180,"Northwest Region",6,1,16,0,16,0,0,0,0
"07/22/2020","Y","Y","Nome Census Area",180,"Northwest Region",6,0,16,1,17,0,0,0,0
"07/23/2020","Y","Y","Nome Census Area",180,"Northwest Region",6,1,17,0,17,0,0,0,0
"07/27/2020","Y","Y","Nome Census Area",180,"Northwest Region",6,0,17,1,18,0,0,0,0
"07/28/2020","Y","Y","Nome Census Area",180,"Northwest Region",6,0,17,1,19,0,0,0,0
"08/03/2020","Y","Y","Nome Census Area",180,"Northwest Region",6,2,19,1,20,0,0,0,0
"08/08/2020","Y","Y","Nome Census Area",180,"Northwest Region",6,0,19,1,21,0,0,0,0
"08/09/2020","Y","Y","Nome Census Area",180,"Northwest Region",6,0,19,1,22,0,0,0,0
"08/11/2020","Y","Y","Nome Census Area",180,"Northwest Region",6,0,19,3,25,1,1,0,0
"08/12/2020","Y","Y","Nome Census Area",180,"Northwest Region",6,3,22,0,25,0,1,0,0
"08/14/2020","Y","Y","Nome Census Area",180,"Northwest Region",6,0,22,1,26,0,1,0,0
"08/16/2020","Y","Y","Nome Census Area",180,"Northwest Region",6,2,24,0,26,0,1,0,0
"08/17/2020","Y","Y","Nome Census Area",180,"Northwest Region",6,1,25,1,27,0,1,0,0
"08/18/2020","Y","Y","Nome Census Area",180,"Northwest Region",6,1,26,0,27,0,1,0,0
"08/19/2020","Y","Y","Nome Census Area",180,"Northwest Region",6,1,27,3,30,1,2,0,0
"08/20/2020","Y","Y","Nome Census Area",180,"Northwest Region",6,3,30,2,32,0,2,0,0
"08/22/2020","Y","Y","Nome Census Area",180,"Northwest Region",6,1,31,1,33,0,2,0,0
"08/24/2020","Y","Y","Nome Census Area",180,"Northwest Region",6,1,32,0,33,0,2,0,0
"08/25/2020","Y","Y","Nome Census Area",180,"Northwest Region",6,0,32,3,36,0,2,0,0
"08/26/2020","Y","Y","Nome Census Area",180,"Northwest Region",6,0,32,4,40,0,2,0,0
"08/27/2020","Y","Y","Nome Census Area",180,"Northwest Region",6,3,35,1,41,0,2,0,0
"08/28/2020","Y","Y","Nome Census Area",180,"Northwest Region",6,1,36,0,41,0,2,0,0
"08/29/2020","Y","Y","Nome Census Area",180,"Northwest Region",6,3,39,0,41,0,2,0,0
"08/30/2020","Y","Y","Nome Census Area",180,"Northwest Region",6,2,41,1,42,0,2,0,0
"08/31/2020","Y","Y","Nome Census Area",180,"Northwest Region",6,0,41,1,43,0,2,0,0
"09/02/2020","Y","Y","Nome Census Area",180,"Northwest Region",6,3,44,2,45,0,2,0,0
"09/03/2020","Y","Y","Nome Census Area",180,"Northwest Region",6,0,44,1,46,0,2,0,0
"09/05/2020","Y","Y","Nome Census Area",180,"Northwest Region",6,1,45,1,47,0,2,0,0
"09/06/2020","Y","Y","Nome Census Area",180,"Northwest Region",6,1,46,0,47,0,2,0,0
"09/07/2020","Y","Y","Nome Census Area",180,"Northwest Region",6,0,46,1,48,0,2,0,0
"09/08/2020","Y","Y","Nome Census Area",180,"Northwest Region",6,1,47,0,48,0,2,0,0
"09/09/2020","Y","Y","Nome Census Area",180,"Northwest Region",6,0,47,2,50,0,2,0,0
"09/10/2020","Y","Y","Nome Census Area",180,"Northwest Region",6,1,48,0,50,0,2,0,0
"09/11/2020","Y","Y","Nome Census Area",180,"Northwest Region",6,2,50,0,50,0,2,0,0
"09/13/2020","Y","Y","Nome Census Area",180,"Northwest Region",6,0,50,2,52,0,2,0,0
"09/15/2020","Y","Y","Nome Census Area",180,"Northwest Region",6,0,50,1,53,0,2,0,0
"09/16/2020","Y","Y","Nome Census Area",180,"Northwest Region",6,1,51,2,55,0,2,0,0
"09/19/2020","Y","Y","Nome Census Area",180,"Northwest Region",6,6,57,2,57,0,2,0,0
"09/21/2020","Y","Y","Nome Census Area",180,"Northwest Region",6,0,57,2,59,0,2,0,0
"09/22/2020","Y","Y","Nome Census Area",180,"Northwest Region",6,0,57,3,62,0,2,0,0
"09/23/2020","Y","Y","Nome Census Area",180,"Northwest Region",6,4,61,3,65,0,2,0,0
"09/24/2020","Y","Y","Nome Census Area",180,"Northwest Region",6,3,64,2,67,0,2,0,0
"09/25/2020","Y","Y","Nome Census Area",180,"Northwest Region",6,2,66,3,70,0,2,0,0
"09/26/2020","Y","Y","Nome Census Area",180,"Northwest Region",6,3,69,0,70,0,2,0,0
"09/27/2020","Y","Y","Nome Census Area",180,"Northwest Region",6,2,71,4,74,0,2,0,0
"09/28/2020","Y","Y","Nome Census Area",180,"Northwest Region",6,0,71,6,80,0,2,0,0
"09/29/2020","Y","Y","Nome Census Area",180,"Northwest Region",6,2,73,1,81,0,2,0,0
"09/30/2020","Y","Y","Nome Census Area",180,"Northwest Region",6,6,79,0,81,0,2,0,0
"10/01/2020","Y","Y","Nome Census Area",180,"Northwest Region",6,3,82,1,82,0,2,0,0
"10/02/2020","Y","Y","Nome Census Area",180,"Northwest Region",6,0,82,2,84,0,2,0,0
"10/03/2020","Y","Y","Nome Census Area",180,"Northwest Region",6,0,82,1,85,0,2,0,0
"10/04/2020","Y","Y","Nome Census Area",180,"Northwest Region",6,1,83,0,85,0,2,0,0
"10/05/2020","Y","Y","Nome Census Area",180,"Northwest Region",6,1,84,3,88,0,2,0,0
"10/06/2020","Y","Y","Nome Census Area",180,"Northwest Region",6,12,96,10,98,0,2,0,0
"10/07/2020","Y","Y","Nome Census Area",180,"Northwest Region",6,2,98,0,98,0,2,0,0
"10/08/2020","Y","Y","Nome Census Area",180,"Northwest Region",6,2,100,2,100,0,2,0,0
"10/09/2020","Y","Y","Nome Census Area",180,"Northwest Region",6,2,102,3,103,0,2,0,0
"10/10/2020","Y","Y","Nome Census Area",180,"Northwest Region",6,0,102,1,104,0,2,0,0
"10/11/2020","Y","Y","Nome Census Area",180,"Northwest Region",6,1,103,0,104,0,2,0,0
"10/13/2020","Y","Y","Nome Census Area",180,"Northwest Region",6,4,107,4,108,0,2,0,0
"10/16/2020","Y","Y","Nome Census Area",180,"Northwest Region",6,1,108,2,110,0,2,0,0
"10/17/2020","Y","Y","Nome Census Area",180,"Northwest Region",6,0,108,1,111,0,2,0,0
"10/19/2020","Y","Y","Nome Census Area",180,"Northwest Region",6,1,109,4,115,0,2,0,0
"10/20/2020","Y","Y","Nome Census Area",180,"Northwest Region",6,3,112,8,123,0,2,0,0
"10/21/2020","Y","Y","Nome Census Area",180,"Northwest Region",6,8,120,1,124,0,2,0,0
"10/22/2020","Y","Y","Nome Census Area",180,"Northwest Region",6,1,121,1,125,0,2,0,0
"10/23/2020","Y","Y","Nome Census Area",180,"Northwest Region",6,1,122,2,127,0,2,0,0
"10/24/2020","Y","Y","Nome Census Area",180,"Northwest Region",6,3,125,1,128,0,2,0,0
"10/26/2020","Y","Y","Nome Census Area",180,"Northwest Region",6,4,129,4,132,0,2,0,0
"10/27/2020","Y","Y","Nome Census Area",180,"Northwest Region",6,0,129,3,135,0,2,0,0
"10/28/2020","Y","Y","Nome Census Area",180,"Northwest Region",6,0,129,1,136,0,2,0,0
"10/29/2020","Y","Y","Nome Census Area",180,"Northwest Region",6,0,129,4,140,0,2,0,0
"10/30/2020","Y","Y","Nome Census Area",180,"Northwest Region",6,4,133,0,140,0,2,0,0
"10/31/2020","Y","Y","Nome Census Area",180,"Northwest Region",6,1,134,0,140,0,2,0,0
"11/01/2020","Y","Y","Nome Census Area",180,"Northwest Region",6,3,137,2,142,0,2,0,0
"11/02/2020","Y","Y","Nome Census Area",180,"Northwest Region",6,1,138,3,145,0,2,0,0
"11/03/2020","Y","Y","Nome Census Area",180,"Northwest Region",6,2,140,1,146,0,2,0,0
"11/04/2020","Y","Y","Nome Census Area",180,"Northwest Region",6,2,142,4,150,0,2,0,0
"11/05/2020","Y","Y","Nome Census Area",180,"Northwest Region",6,2,144,2,152,0,2,0,0
"11/06/2020","Y","Y","Nome Census Area",180,"Northwest Region",6,3,147,0,152,0,2,0,0
"11/07/2020","Y","Y","Nome Census Area",180,"Northwest Region",6,2,149,1,153,0,2,0,0
"11/08/2020","Y","Y","Nome Census Area",180,"Northwest Region",6,0,149,1,154,0,2,0,0
"11/09/2020","Y","Y","Nome Census Area",180,"Northwest Region",6,1,150,1,155,0,2,0,0
"11/10/2020","Y","Y","Nome Census Area",180,"Northwest Region",6,1,151,2,157,0,2,0,0
"11/11/2020","Y","Y","Nome Census Area",180,"Northwest Region",6,1,152,5,162,0,2,0,0
"11/12/2020","Y","Y","Nome Census Area",180,"Northwest Region",6,4,156,3,165,0,2,0,0
"11/13/2020","Y","Y","Nome Census Area",180,"Northwest Region",6,1,157,4,169,0,2,0,0
"11/14/2020","Y","Y","Nome Census Area",180,"Northwest Region",6,3,160,2,171,0,2,0,0
"11/15/2020","Y","Y","Nome Census Area",180,"Northwest Region",6,3,163,1,172,0,2,0,0
"11/16/2020","Y","Y","Nome Census Area",180,"Northwest Region",6,2,165,3,175,0,2,0,0
"11/17/2020","Y","Y","Nome Census Area",180,"Northwest Region",6,1,166,4,179,0,2,0,0
"11/18/2020","Y","Y","Nome Census Area",180,"Northwest Region",6,5,171,2,181,0,2,0,0
"11/19/2020","Y","Y","Nome Census Area",180,"Northwest Region",6,3,174,3,184,0,2,0,0
"11/20/2020","Y","Y","Nome Census Area",180,"Northwest Region",6,4,178,13,197,0,2,0,0
"11/21/2020","Y","Y","Nome Census Area",180,"Northwest Region",6,3,181,7,204,0,2,0,0
"11/22/2020","Y","Y","Nome Census Area",180,"Northwest Region",6,5,186,1,205,0,2,0,0
"11/23/2020","Y","Y","Nome Census Area",180,"Northwest Region",6,15,201,6,211,0,2,0,0
"11/24/2020","Y","Y","Nome Census Area",180,"Northwest Region",6,5,206,0,211,0,2,0,0
"11/25/2020","Y","Y","Nome Census Area",180,"Northwest Region",6,1,207,15,226,0,2,0,0
"11/26/2020","Y","Y","Nome Census Area",180,"Northwest Region",6,3,210,2,228,0,2,0,0
"11/27/2020","Y","Y","Nome Census Area",180,"Northwest Region",6,10,220,5,233,0,2,0,0
"11/28/2020","Y","Y","Nome Census Area",180,"Northwest Region",6,4,224,0,233,0,2,0,0
"11/29/2020","Y","Y","Nome Census Area",180,"Northwest Region",6,1,225,1,234,0,2,0,0
"11/30/2020","Y","Y","Nome Census Area",180,"Northwest Region",6,4,229,6,240,1,3,0,0
"12/01/2020","Y","Y","Nome Census Area",180,"Northwest Region",6,5,234,1,241,0,3,0,0
"12/02/2020","Y","Y","Nome Census Area",180,"Northwest Region",6,6,240,2,243,0,3,0,0
"12/03/2020","Y","Y","Nome Census Area",180,"Northwest Region",6,1,241,0,243,0,3,0,0
"12/04/2020","Y","Y","Nome Census Area",180,"Northwest Region",6,0,241,1,244,0,3,0,0
"12/06/2020","Y","Y","Nome Census Area",180,"Northwest Region",6,2,243,1,245,0,3,0,0
"12/07/2020","Y","Y","Nome Census Area",180,"Northwest Region",6,2,245,1,246,0,3,0,0
"12/08/2020","Y","Y","Nome Census Area",180,"Northwest Region",6,0,245,1,247,0,3,0,0
"12/09/2020","Y","Y","Nome Census Area",180,"Northwest Region",6,0,245,1,248,0,3,0,0
"12/10/2020","Y","Y","Nome Census Area",180,"Northwest Region",6,0,245,1,249,0,3,0,0
"12/11/2020","Y","Y","Nome Census Area",180,"Northwest Region",6,2,247,3,252,0,3,0,0
"12/12/2020","Y","Y","Nome Census Area",180,"Northwest Region",6,3,250,1,253,1,4,0,0
"12/13/2020","Y","Y","Nome Census Area",180,"Northwest Region",6,2,252,5,258,0,4,0,0
"12/14/2020","Y","Y","Nome Census Area",180,"Northwest Region",6,1,253,1,259,0,4,0,0
"12/15/2020","Y","Y","Nome Census Area",180,"Northwest Region",6,5,258,1,260,0,4,0,0
"12/16/2020","Y","Y","Nome Census Area",180,"Northwest Region",6,2,260,0,260,0,4,0,0
"12/17/2020","Y","Y","Nome Census Area",180,"Northwest Region",6,0,260,1,261,0,4,0,0
"12/20/2020","Y","Y","Nome Census Area",180,"Northwest Region",6,1,261,1,262,0,4,0,0
"12/22/2020","Y","Y","Nome Census Area",180,"Northwest Region",6,1,262,1,263,0,4,0,0
"12/23/2020","Y","Y","Nome Census Area",180,"Northwest Region",6,2,264,3,266,0,4,0,0
"12/25/2020","Y","Y","Nome Census Area",180,"Northwest Region",6,2,266,0,266,0,4,0,0
"12/26/2020","Y","Y","Nome Census Area",180,"Northwest Region",6,1,267,1,267,0,4,0,0
"12/27/2020","Y","Y","Nome Census Area",180,"Northwest Region",6,1,268,2,269,0,4,0,0
"12/28/2020","Y","Y","Nome Census Area",180,"Northwest Region",6,1,269,2,271,0,4,0,0
"12/29/2020","Y","Y","Nome Census Area",180,"Northwest Region",6,2,271,1,272,0,4,0,0
"12/30/2020","Y","Y","Nome Census Area",180,"Northwest Region",6,0,271,1,273,0,4,0,0
"12/31/2020","Y","Y","Nome Census Area",180,"Northwest Region",6,1,272,3,276,0,4,0,0
"01/01/2021","Y","Y","Nome Census Area",180,"Northwest Region",6,3,275,1,277,0,4,0,0
"01/02/2021","Y","Y","Nome Census Area",180,"Northwest Region",6,1,276,0,277,0,4,0,0
"01/03/2021","Y","Y","Nome Census Area",180,"Northwest Region",6,1,277,0,277,0,4,0,0
"01/06/2021","Y","Y","Nome Census Area",180,"Northwest Region",6,0,277,2,279,0,4,0,0
"01/08/2021","Y","Y","Nome Census Area",180,"Northwest Region",6,2,279,1,280,0,4,0,0
"01/09/2021","Y","Y","Nome Census Area",180,"Northwest Region",6,0,279,2,282,0,4,0,0
"01/10/2021","Y","Y","Nome Census Area",180,"Northwest Region",6,2,281,2,284,0,4,0,0
"01/11/2021","Y","Y","Nome Census Area",180,"Northwest Region",6,1,282,3,287,0,4,0,0
"01/12/2021","Y","Y","Nome Census Area",180,"Northwest Region",6,3,285,2,289,0,4,0,0
"01/13/2021","Y","Y","Nome Census Area",180,"Northwest Region",6,4,289,2,291,0,4,0,0
"01/14/2021","Y","Y","Nome Census Area",180,"Northwest Region",6,0,289,1,292,0,4,0,0
"01/15/2021","Y","Y","Nome Census Area",180,"Northwest Region",6,1,290,1,293,0,4,0,0
"01/16/2021","Y","Y","Nome Census Area",180,"Northwest Region",6,2,292,1,294,0,4,0,0
"01/17/2021","Y","Y","Nome Census Area",180,"Northwest Region",6,1,293,0,294,0,4,0,0
"01/19/2021","Y","Y","Nome Census Area",180,"Northwest Region",6,0,293,2,296,0,4,0,0
"01/20/2021","Y","Y","Nome Census Area",180,"Northwest Region",6,0,293,3,299,0,4,0,0
"01/21/2021","Y","Y","Nome Census Area",180,"Northwest Region",6,5,298,1,300,0,4,0,0
"01/22/2021","Y","Y","Nome Census Area",180,"Northwest Region",6,1,299,0,300,0,4,0,0
"01/23/2021","Y","Y","Nome Census Area",180,"Northwest Region",6,0,299,1,301,0,4,0,0
"01/25/2021","Y","Y","Nome Census Area",180,"Northwest Region",6,1,300,1,302,0,4,0,0
"01/26/2021","Y","Y","Nome Census Area",180,"Northwest Region",6,1,301,0,302,0,4,0,0
"01/28/2021","Y","Y","Nome Census Area",180,"Northwest Region",6,0,301,1,303,0,4,0,0
"01/29/2021","Y","Y","Nome Census Area",180,"Northwest Region",6,1,302,1,304,0,4,0,0
"01/30/2021","Y","Y","Nome Census Area",180,"Northwest Region",6,1,303,0,304,0,4,0,0
"01/31/2021","Y","Y","Nome Census Area",180,"Northwest Region",6,0,303,1,305,0,4,0,0
"02/01/2021","Y","Y","Nome Census Area",180,"Northwest Region",6,0,303,1,306,0,4,0,0
"02/02/2021","Y","Y","Nome Census Area",180,"Northwest Region",6,2,305,1,307,0,4,0,0
"02/03/2021","Y","Y","Nome Census Area",180,"Northwest Region",6,1,306,2,309,0,4,0,0
"02/04/2021","Y","Y","Nome Census Area",180,"Northwest Region",6,0,306,3,312,0,4,0,0
"02/05/2021","Y","Y","Nome Census Area",180,"Northwest Region",6,2,308,1,313,0,4,0,0
"02/06/2021","Y","Y","Nome Census Area",180,"Northwest Region",6,1,309,0,313,0,4,0,0
"02/07/2021","Y","Y","Nome Census Area",180,"Northwest Region",6,2,311,0,313,0,4,0,0
"02/08/2021","Y","Y","Nome Census Area",180,"Northwest Region",6,0,311,1,314,0,4,0,0
"02/09/2021","Y","Y","Nome Census Area",180,"Northwest Region",6,1,312,0,314,0,4,0,0
"02/10/2021","Y","Y","Nome Census Area",180,"Northwest Region",6,0,312,1,315,0,4,0,0
"02/13/2021","Y","Y","Nome Census Area",180,"Northwest Region",6,1,313,0,315,0,4,0,0
"02/14/2021","Y","Y","Nome Census Area",180,"Northwest Region",6,0,313,1,316,0,4,0,0
"02/17/2021","Y","Y","Nome Census Area",180,"Northwest Region",6,1,314,0,316,0,4,0,0
"02/22/2021","Y","Y","Nome Census Area",180,"Northwest Region",6,0,314,1,317,0,4,0,0
"02/23/2021","Y","Y","Nome Census Area",180,"Northwest Region",6,1,315,1,318,0,4,0,0
"02/24/2021","Y","Y","Nome Census Area",180,"Northwest Region",6,1,316,1,319,0,4,0,0
"02/25/2021","Y","Y","Nome Census Area",180,"Northwest Region",6,1,317,1,320,0,4,0,0
"02/27/2021","Y","Y","Nome Census Area",180,"Northwest Region",6,1,318,0,320,0,4,0,0
"03/01/2021","Y","Y","Nome Census Area",180,"Northwest Region",6,0,318,2,322,0,4,0,0
"03/03/2021","Y","Y","Nome Census Area",180,"Northwest Region",6,2,320,0,322,0,4,0,0
"03/08/2021","Y","Y","Nome Census Area",180,"Northwest Region",6,0,320,1,323,0,4,0,0
"03/09/2021","Y","Y","Nome Census Area",180,"Northwest Region",6,1,321,0,323,0,4,0,0
"03/11/2021","Y","Y","Nome Census Area",180,"Northwest Region",6,0,321,1,324,0,4,0,0
"03/12/2021","Y","Y","Nome Census Area",180,"Northwest Region",6,1,322,0,324,0,4,0,0
"03/14/2021","Y","Y","Nome Census Area",180,"Northwest Region",6,0,322,1,325,0,4,0,0
"03/16/2021","Y","Y","Nome Census Area",180,"Northwest Region",6,1,323,0,325,0,4,0,0
"03/17/2021","Y","Y","Nome Census Area",180,"Northwest Region",6,0,323,2,327,0,4,0,0
"03/18/2021","Y","Y","Nome Census Area",180,"Northwest Region",6,0,323,1,328,0,4,0,0
"03/19/2021","Y","Y","Nome Census Area",180,"Northwest Region",6,2,325,0,328,0,4,0,0
"03/20/2021","Y","Y","Nome Census Area",180,"Northwest Region",6,1,326,0,328,0,4,0,0
"03/22/2021","Y","Y","Nome Census Area",180,"Northwest Region",6,0,326,1,329,0,4,0,0
"03/24/2021","Y","Y","Nome Census Area",180,"Northwest Region",6,1,327,1,330,0,4,0,0
"03/25/2021","Y","Y","Nome Census Area",180,"Northwest Region",6,0,327,1,331,0,4,0,0
"03/27/2021","Y","Y","Nome Census Area",180,"Northwest Region",6,1,328,0,331,0,4,0,0
"03/28/2021","Y","Y","Nome Census Area",180,"Northwest Region",6,1,329,0,331,0,4,0,0
"03/29/2021","Y","Y","Nome Census Area",180,"Northwest Region",6,0,329,2,333,0,4,0,0
"03/30/2021","Y","Y","Nome Census Area",180,"Northwest Region",6,0,329,1,334,0,4,0,0
"03/31/2021","Y","Y","Nome Census Area",180,"Northwest Region",6,2,331,0,334,0,4,0,0
"04/02/2021","Y","Y","Nome Census Area",180,"Northwest Region",6,1,332,0,334,0,4,0,0
"04/06/2021","Y","Y","Nome Census Area",180,"Northwest Region",6,0,332,1,335,0,4,0,0
"04/07/2021","Y","Y","Nome Census Area",180,"Northwest Region",6,1,333,3,338,0,4,0,0
"04/08/2021","Y","Y","Nome Census Area",180,"Northwest Region",6,4,337,1,339,0,4,0,0
"04/12/2021","Y","Y","Nome Census Area",180,"Northwest Region",6,0,337,1,340,0,4,0,0
"04/13/2021","Y","Y","Nome Census Area",180,"Northwest Region",6,1,338,0,340,0,4,0,0
"04/14/2021","Y","Y","Nome Census Area",180,"Northwest Region",6,0,338,2,342,0,4,0,0
"04/15/2021","Y","Y","Nome Census Area",180,"Northwest Region",6,2,340,0,342,0,4,0,0
"04/19/2021","Y","Y","Nome Census Area",180,"Northwest Region",6,1,341,2,344,0,4,0,0
"04/21/2021","Y","Y","Nome Census Area",180,"Northwest Region",6,1,342,0,344,0,4,0,0
"04/23/2021","Y","Y","Nome Census Area",180,"Northwest Region",6,0,342,1,345,0,4,0,0
"04/24/2021","Y","Y","Nome Census Area",180,"Northwest Region",6,0,342,1,346,0,4,0,0
"04/26/2021","Y","Y","Nome Census Area",180,"Northwest Region",6,1,343,0,346,0,4,0,0
"04/27/2021","Y","Y","Nome Census Area",180,"Northwest Region",6,1,344,0,346,0,4,0,0
"05/01/2021","Y","Y","Nome Census Area",180,"Northwest Region",6,0,344,1,347,0,4,0,0
"05/02/2021","Y","Y","Nome Census Area",180,"Northwest Region",6,0,344,3,350,0,4,0,0
"05/03/2021","Y","Y","Nome Census Area",180,"Northwest Region",6,3,347,0,350,0,4,0,0
"05/04/2021","Y","Y","Nome Census Area",180,"Northwest Region",6,1,348,0,350,0,4,0,0
"05/05/2021","Y","Y","Nome Census Area",180,"Northwest Region",6,0,348,2,352,0,4,0,0
"05/06/2021","Y","Y","Nome Census Area",180,"Northwest Region",6,3,351,2,354,0,4,0,0
"05/08/2021","Y","Y","Nome Census Area",180,"Northwest Region",6,1,352,1,355,0,4,0,0
"05/09/2021","Y","Y","Nome Census Area",180,"Northwest Region",6,0,352,1,356,0,4,0,0
"05/10/2021","Y","Y","Nome Census Area",180,"Northwest Region",6,1,353,1,357,0,4,0,0
"05/12/2021","Y","Y","Nome Census Area",180,"Northwest Region",6,2,355,1,358,0,4,0,0
"05/14/2021","Y","Y","Nome Census Area",180,"Northwest Region",6,1,356,0,358,0,4,0,0
"05/16/2021","Y","Y","Nome Census Area",180,"Northwest Region",6,0,356,1,359,0,4,0,0
"05/17/2021","Y","Y","Nome Census Area",180,"Northwest Region",6,1,357,0,359,0,4,0,0
"05/19/2021","Y","Y","Nome Census Area",180,"Northwest Region",6,0,357,1,360,0,4,0,0
"05/20/2021","Y","Y","Nome Census Area",180,"Northwest Region",6,1,358,1,361,0,4,0,0
"05/21/2021","Y","Y","Nome Census Area",180,"Northwest Region",6,1,359,0,361,0,4,0,0
"05/26/2021","Y","Y","Nome Census Area",180,"Northwest Region",6,0,359,1,362,0,4,0,0
"05/28/2021","Y","Y","Nome Census Area",180,"Northwest Region",6,1,360,1,363,0,4,0,0
"05/29/2021","Y","Y","Nome Census Area",180,"Northwest Region",6,0,360,7,370,0,4,0,0
"05/30/2021","Y","Y","Nome Census Area",180,"Northwest Region",6,8,368,1,371,0,4,0,0
"05/31/2021","Y","Y","Nome Census Area",180,"Northwest Region",6,1,369,0,371,0,4,0,0
"06/01/2021","Y","Y","Nome Census Area",180,"Northwest Region",6,0,369,1,372,0,4,0,0
"06/03/2021","Y","Y","Nome Census Area",180,"Northwest Region",6,0,369,1,373,1,5,0,0
"06/04/2021","Y","Y","Nome Census Area",180,"Northwest Region",6,1,370,2,375,0,5,0,0
"06/05/2021","Y","Y","Nome Census Area",180,"Northwest Region",6,1,371,0,375,0,5,0,0
"06/06/2021","Y","Y","Nome Census Area",180,"Northwest Region",6,2,373,0,375,0,5,0,0
"06/07/2021","Y","Y","Nome Census Area",180,"Northwest Region",6,4,377,6,381,0,5,0,0
"06/08/2021","Y","Y","Nome Census Area",180,"Northwest Region",6,1,378,0,381,0,5,0,0
"06/09/2021","Y","Y","Nome Census Area",180,"Northwest Region",6,0,378,3,384,0,5,0,0
"06/10/2021","Y","Y","Nome Census Area",180,"Northwest Region",6,0,378,1,385,0,5,0,0
"06/11/2021","Y","Y","Nome Census Area",180,"Northwest Region",6,5,383,1,386,0,5,0,0
"06/13/2021","Y","Y","Nome Census Area",180,"Northwest Region",6,1,384,0,386,0,5,0,0
"06/15/2021","Y","Y","Nome Census Area",180,"Northwest Region",6,0,384,0,386,1,6,0,0
"06/20/2021","Y","Y","Nome Census Area",180,"Northwest Region",6,0,384,1,387,0,6,0,0
"06/21/2021","Y","Y","Nome Census Area",180,"Northwest Region",6,0,384,1,388,0,6,0,0
"06/22/2021","Y","Y","Nome Census Area",180,"Northwest Region",6,1,385,7,395,0,6,0,0
"06/23/2021","Y","Y","Nome Census Area",180,"Northwest Region",6,7,392,1,396,0,6,0,0
"06/24/2021","Y","Y","Nome Census Area",180,"Northwest Region",6,2,394,1,397,0,6,0,0
"06/25/2021","Y","Y","Nome Census Area",180,"Northwest Region",6,0,394,1,398,0,6,0,0
"06/26/2021","Y","Y","Nome Census Area",180,"Northwest Region",6,2,396,1,399,0,6,0,0
"06/27/2021","Y","Y","Nome Census Area",180,"Northwest Region",6,0,396,1,400,0,6,0,0
"06/28/2021","Y","Y","Nome Census Area",180,"Northwest Region",6,1,397,1,401,0,6,0,0
"06/29/2021","Y","Y","Nome Census Area",180,"Northwest Region",6,1,398,2,403,0,6,0,0
"06/30/2021","Y","Y","Nome Census Area",180,"Northwest Region",6,3,401,2,405,0,6,0,0
"07/02/2021","Y","Y","Nome Census Area",180,"Northwest Region",6,4,405,2,407,0,6,0,0
"07/11/2021","Y","Y","Nome Census Area",180,"Northwest Region",6,0,405,1,408,0,6,0,0
"07/12/2021","Y","Y","Nome Census Area",180,"Northwest Region",6,1,406,1,409,0,6,0,0
"07/13/2021","Y","Y","Nome Census Area",180,"Northwest Region",6,1,407,0,409,0,6,0,0
"07/14/2021","Y","Y","Nome Census Area",180,"Northwest Region",6,1,408,1,410,0,6,0,0
"07/20/2021","Y","Y","Nome Census Area",180,"Northwest Region",6,0,408,5,415,0,6,0,0
"07/21/2021","Y","Y","Nome Census Area",180,"Northwest Region",6,0,408,5,420,0,6,0,0
"07/22/2021","Y","Y","Nome Census Area",180,"Northwest Region",6,10,418,0,420,0,6,0,0
"07/23/2021","Y","Y","Nome Census Area",180,"Northwest Region",6,0,418,1,421,0,6,0,0
"07/24/2021","Y","Y","Nome Census Area",180,"Northwest Region",6,0,418,1,422,0,6,0,0
"07/25/2021","Y","Y","Nome Census Area",180,"Northwest Region",6,2,420,1,423,0,6,0,0
"07/26/2021","Y","Y","Nome Census Area",180,"Northwest Region",6,0,420,1,424,0,6,0,0
"07/27/2021","Y","Y","Nome Census Area",180,"Northwest Region",6,2,422,5,429,0,6,0,0
"07/28/2021","Y","Y","Nome Census Area",180,"Northwest Region",6,0,422,5,434,0,6,0,0
"07/29/2021","Y","Y","Nome Census Area",180,"Northwest Region",6,5,427,1,435,0,6,0,0
"07/30/2021","Y","Y","Nome Census Area",180,"Northwest Region",6,5,432,3,438,0,6,0,0
"07/31/2021","Y","Y","Nome Census Area",180,"Northwest Region",6,2,434,1,439,0,6,0,0
"08/01/2021","Y","Y","Nome Census Area",180,"Northwest Region",6,2,436,6,445,0,6,0,0
"08/02/2021","Y","Y","Nome Census Area",180,"Northwest Region",6,2,438,19,464,0,6,0,0
"08/03/2021","Y","Y","Nome Census Area",180,"Northwest Region",6,6,444,15,479,0,6,0,0
"08/04/2021","Y","Y","Nome Census Area",180,"Northwest Region",6,20,464,6,485,0,6,0,0
"08/05/2021","Y","Y","Nome Census Area",180,"Northwest Region",6,19,483,7,492,0,6,0,0
"08/07/2021","Y","Y","Nome Census Area",180,"Northwest Region",6,0,483,11,503,0,6,0,0
"08/08/2021","Y","Y","Nome Census Area",180,"Northwest Region",6,6,489,19,522,0,6,0,0
"08/09/2021","Y","Y","Nome Census Area",180,"Northwest Region",6,2,491,31,553,0,6,0,0
"08/10/2021","Y","Y","Nome Census Area",180,"Northwest Region",6,31,522,32,585,0,6,0,0
"08/11/2021","Y","Y","Nome Census Area",180,"Northwest Region",6,1,523,11,596,0,6,0,0
"08/12/2021","Y","Y","Nome Census Area",180,"Northwest Region",6,0,523,52,648,1,7,0,0
"08/13/2021","Y","Y","Nome Census Area",180,"Northwest Region",6,29,552,29,677,0,7,0,0
"08/14/2021","Y","Y","Nome Census Area",180,"Northwest Region",6,47,599,0,677,0,7,0,0
"08/15/2021","Y","Y","Nome Census Area",180,"Northwest Region",6,0,599,2,679,0,7,0,0
"08/16/2021","Y","Y","Nome Census Area",180,"Northwest Region",6,10,609,39,718,0,7,0,0
"08/17/2021","Y","Y","Nome Census Area",180,"Northwest Region",6,44,653,17,735,1,8,0,0
"08/18/2021","Y","Y","Nome Census Area",180,"Northwest Region",6,37,690,10,745,0,8,0,0
"08/19/2021","Y","Y","Nome Census Area",180,"Northwest Region",6,6,696,32,777,0,8,0,0
"08/20/2021","Y","Y","Nome Census Area",180,"Northwest Region",6,9,705,13,790,0,8,0,0
"08/21/2021","Y","Y","Nome Census Area",180,"Northwest Region",6,0,705,12,802,0,8,0,0
"08/22/2021","Y","Y","Nome Census Area",180,"Northwest Region",6,31,736,3,805,0,8,0,0
"08/23/2021","Y","Y","Nome Census Area",180,"Northwest Region",6,32,768,32,837,1,9,0,0
"08/24/2021","Y","Y","Nome Census Area",180,"Northwest Region",6,33,801,11,848,0,9,0,0
"08/25/2021","Y","Y","Nome Census Area",180,"Northwest Region",6,10,811,4,852,0,9,0,0
"08/26/2021","Y","Y","Nome Census Area",180,"Northwest Region",6,0,811,10,862,0,9,0,0
"08/27/2021","Y","Y","Nome Census Area",180,"Northwest Region",6,29,840,18,880,0,9,0,0
"08/28/2021","Y","Y","Nome Census Area",180,"Northwest Region",6,9,849,3,883,0,9,0,0
"08/29/2021","Y","Y","Nome Census Area",180,"Northwest Region",6,16,865,2,885,0,9,0,0
"08/30/2021","Y","Y","Nome Census Area",180,"Northwest Region",6,12,877,6,891,0,9,0,0
"08/31/2021","Y","Y","Nome Census Area",180,"Northwest Region",6,3,880,5,896,0,9,0,0
"09/01/2021","Y","Y","Nome Census Area",180,"Northwest Region",6,5,885,5,901,0,9,0,0
"09/02/2021","Y","Y","Nome Census Area",180,"Northwest Region",6,7,892,5,906,0,9,0,0
"09/03/2021","Y","Y","Nome Census Area",180,"Northwest Region",6,5,897,0,906,0,9,0,0
"09/04/2021","Y","Y","Nome Census Area",180,"Northwest Region",6,4,901,1,907,0,9,0,0
"09/05/2021","Y","Y","Nome Census Area",180,"Northwest Region",6,0,901,5,912,0,9,0,0
"09/06/2021","Y","Y","Nome Census Area",180,"Northwest Region",6,0,901,1,913,0,9,0,0
"09/07/2021","Y","Y","Nome Census Area",180,"Northwest Region",6,6,907,8,921,0,9,0,0
"09/08/2021","Y","Y","Nome Census Area",180,"Northwest Region",6,0,907,10,931,0,9,0,0
"09/09/2021","Y","Y","Nome Census Area",180,"Northwest Region",6,9,916,2,933,0,9,0,0
"09/10/2021","Y","Y","Nome Census Area",180,"Northwest Region",6,10,926,4,937,0,9,0,0
"09/11/2021","Y","Y","Nome Census Area",180,"Northwest Region",6,3,929,1,938,0,9,0,0
"09/12/2021","Y","Y","Nome Census Area",180,"Northwest Region",6,3,932,1,939,0,9,0,0
"09/13/2021","Y","Y","Nome Census Area",180,"Northwest Region",6,2,934,8,947,0,9,0,0
"09/14/2021","Y","Y","Nome Census Area",180,"Northwest Region",6,1,935,7,954,0,9,0,0
"09/15/2021","Y","Y","Nome Census Area",180,"Northwest Region",6,6,941,9,963,0,9,0,0
"09/16/2021","Y","Y","Nome Census Area",180,"Northwest Region",6,4,945,2,965,0,9,0,0
"09/17/2021","Y","Y","Nome Census Area",180,"Northwest Region",6,8,953,0,965,0,9,0,0
"09/18/2021","Y","Y","Nome Census Area",180,"Northwest Region",6,2,955,0,965,0,9,0,0
"09/20/2021","Y","Y","Nome Census Area",180,"Northwest Region",6,0,955,19,984,0,9,0,0
"09/21/2021","Y","Y","Nome Census Area",180,"Northwest Region",6,0,955,10,994,0,9,0,0
"09/22/2021","Y","Y","Nome Census Area",180,"Northwest Region",6,18,973,10,1004,0,9,0,0
"09/23/2021","Y","Y","Nome Census Area",180,"Northwest Region",6,12,985,12,1016,0,9,0,0
"09/24/2021","Y","Y","Nome Census Area",180,"Northwest Region",6,12,997,13,1029,0,9,0,0
"09/25/2021","Y","Y","Nome Census Area",180,"Northwest Region",6,11,1008,1,1030,0,9,0,0
"09/26/2021","Y","Y","Nome Census Area",180,"Northwest Region",6,14,1022,7,1037,0,9,0,0
"09/27/2021","Y","Y","Nome Census Area",180,"Northwest Region",6,6,1028,9,1046,0,9,0,0
"09/28/2021","Y","Y","Nome Census Area",180,"Northwest Region",6,4,1032,14,1060,0,9,0,0
"09/29/2021","Y","Y","Nome Census Area",180,"Northwest Region",6,8,1040,12,1072,0,9,0,0
"09/30/2021","Y","Y","Nome Census Area",180,"Northwest Region",6,10,1050,13,1085,0,9,0,0
"10/01/2021","Y","Y","Nome Census Area",180,"Northwest Region",6,8,1058,10,1095,0,9,0,0
"10/02/2021","Y","Y","Nome Census Area",180,"Northwest Region",6,16,1074,12,1107,0,9,0,0
"10/03/2021","Y","Y","Nome Census Area",180,"Northwest Region",6,10,1084,1,1108,0,9,0,0
"10/04/2021","Y","Y","Nome Census Area",180,"Northwest Region",6,11,1095,24,1132,0,9,0,0
"10/05/2021","Y","Y","Nome Census Area",180,"Northwest Region",6,11,1106,10,1142,1,10,0,0
"10/06/2021","Y","Y","Nome Census Area",180,"Northwest Region",6,6,1112,6,1148,0,10,0,0
"10/07/2021","Y","Y","Nome Census Area",180,"Northwest Region",6,23,1135,22,1170,0,10,0,0
"10/08/2021","Y","Y","Nome Census Area",180,"Northwest Region",6,6,1141,20,1190,0,10,0,0
"10/09/2021","Y","Y","Nome Census Area",180,"Northwest Region",6,26,1167,1,1191,0,10,0,0
"10/10/2021","Y","Y","Nome Census Area",180,"Northwest Region",6,20,1187,22,1213,0,10,0,0
"10/11/2021","Y","Y","Nome Census Area",180,"Northwest Region",6,7,1194,1,1214,0,10,0,0
"10/12/2021","Y","Y","Nome Census Area",180,"Northwest Region",6,9,1203,21,1235,0,10,0,0
"10/13/2021","Y","Y","Nome Census Area",180,"Northwest Region",6,12,1215,15,1250,0,10,1,1
"10/14/2021","Y","Y","Nome Census Area",180,"Northwest Region",6,17,1232,14,1264,1,11,0,1
"10/15/2021","Y","Y","Nome Census Area",180,"Northwest Region",6,21,1253,16,1280,0,11,0,1
"10/16/2021","Y","Y","Nome Census Area",180,"Northwest Region",6,10,1263,3,1283,0,11,0,1
"10/17/2021","Y","Y","Nome Census Area",180,"Northwest Region",6,14,1277,3,1286,0,11,0,1
"10/18/2021","Y","Y","Nome Census Area",180,"Northwest Region",6,3,1280,26,1312,0,11,0,1
"10/19/2021","Y","Y","Nome Census Area",180,"Northwest Region",6,3,1283,15,1327,0,11,0,1
"10/20/2021","Y","Y","Nome Census Area",180,"Northwest Region",6,22,1305,31,1358,0,11,0,1
"10/21/2021","Y","Y","Nome Census Area",180,"Northwest Region",6,35,1340,23,1381,0,11,0,1
"10/22/2021","Y","Y","Nome Census Area",180,"Northwest Region",6,5,1345,12,1393,0,11,0,1
"10/23/2021","Y","Y","Nome Census Area",180,"Northwest Region",6,26,1371,4,1397,0,11,0,1
"10/24/2021","Y","Y","Nome Census Area",180,"Northwest Region",6,10,1381,11,1408,0,11,0,1
"10/25/2021","Y","Y","Nome Census Area",180,"Northwest Region",6,22,1403,23,1431,0,11,0,1
"10/26/2021","Y","Y","Nome Census Area",180,"Northwest Region",6,13,1416,33,1464,0,11,1,2
"10/27/2021","Y","Y","Nome Census Area",180,"Northwest Region",6,10,1426,40,1504,0,11,0,2
"10/28/2021","Y","Y","Nome Census Area",180,"Northwest Region",6,34,1460,32,1536,0,11,0,2
"10/29/2021","Y","Y","Nome Census Area",180,"Northwest Region",6,34,1494,49,1585,0,11,0,2
"10/30/2021","Y","Y","Nome Census Area",180,"Northwest Region",6,37,1531,18,1603,0,11,0,2
"10/31/2021","Y","Y","Nome Census Area",180,"Northwest Region",6,48,1579,19,1622,0,11,0,2
"11/01/2021","Y","Y","Nome Census Area",180,"Northwest Region",6,29,1608,55,1677,0,11,0,2
"11/02/2021","Y","Y","Nome Census Area",180,"Northwest Region",6,16,1624,30,1707,0,11,0,2
"11/03/2021","Y","Y","Nome Census Area",180,"Northwest Region",6,30,1654,34,1741,0,11,0,2
"11/04/2021","Y","Y","Nome Census Area",180,"Northwest Region",6,51,1705,23,1764,0,11,0,2
"11/05/2021","Y","Y","Nome Census Area",180,"Northwest Region",6,15,1720,56,1820,0,11,0,2
"11/06/2021","Y","Y","Nome Census Area",180,"Northwest Region",6,61,1781,17,1837,0,11,0,2
"11/07/2021","Y","Y","Nome Census Area",180,"Northwest Region",6,26,1807,12,1849,0,11,0,2
"11/08/2021","Y","Y","Nome Census Area",180,"Northwest Region",6,24,1831,24,1873,1,12,0,2
"11/09/2021","Y","Y","Nome Census Area",180,"Northwest Region",6,19,1850,31,1904,0,12,0,2
"11/10/2021","Y","Y","Nome Census Area",180,"Northwest Region",6,28,1878,37,1941,0,12,1,3
"11/11/2021","Y","Y","Nome Census Area",180,"Northwest Region",6,6,1884,4,1945,0,12,0,3
"11/12/2021","Y","Y","Nome Census Area",180,"Northwest Region",6,47,1931,35,1980,0,12,0,3
"11/13/2021","Y","Y","Nome Census Area",180,"Northwest Region",6,6,1937,20,2000,0,12,0,3
"11/14/2021","Y","Y","Nome Census Area",180,"Northwest Region",6,40,1977,7,2007,0,12,0,3
"11/15/2021","Y","Y","Nome Census Area",180,"Northwest Region",6,9,1986,28,2035,0,12,0,3
"11/16/2021","Y","Y","Nome Census Area",180,"Northwest Region",6,38,2024,25,2060,0,12,0,3
"11/17/2021","Y","Y","Nome Census Area",180,"Northwest Region",6,20,2044,20,2080,0,12,0,3
"11/18/2021","Y","Y","Nome Census Area",180,"Northwest Region",6,28,2072,8,2088,0,12,0,3
"11/19/2021","Y","Y","Nome Census Area",180,"Northwest Region",6,2,2074,14,2102,0,12,0,3
"11/20/2021","Y","Y","Nome Census Area",180,"Northwest Region",6,11,2085,3,2105,0,12,0,3
"11/21/2021","Y","Y","Nome Census Area",180,"Northwest Region",6,4,2089,16,2121,0,12,0,3
"11/22/2021","Y","Y","Nome Census Area",180,"Northwest Region",6,18,2107,21,2142,0,12,0,3
"11/23/2021","Y","Y","Nome Census Area",180,"Northwest Region",6,9,2116,15,2157,0,12,0,3
"11/24/2021","Y","Y","Nome Census Area",180,"Northwest Region",6,20,2136,9,2166,0,12,0,3
"11/25/2021","Y","Y","Nome Census Area",180,"Northwest Region",6,14,2150,0,2166,0,12,0,3
"11/26/2021","Y","Y","Nome Census Area",180,"Northwest Region",6,13,2163,2,2168,0,12,0,3
"11/27/2021","Y","Y","Nome Census Area",180,"Northwest Region",6,3,2166,3,2171,0,12,0,3
"11/28/2021","Y","Y","Nome Census Area",180,"Northwest Region",6,3,2169,4,2175,0,12,1,4
"11/29/2021","Y","Y","Nome Census Area",180,"Northwest Region",6,4,2173,7,2182,0,12,0,4
"11/30/2021","Y","Y","Nome Census Area",180,"Northwest Region",6,10,2183,18,2200,0,12,0,4
"12/01/2021","Y","Y","Nome Census Area",180,"Northwest Region",6,17,2200,11,2211,0,12,0,4
"12/02/2021","Y","Y","Nome Census Area",180,"Northwest Region",6,14,2214,15,2226,1,13,0,4
"12/03/2021","Y","Y","Nome Census Area",180,"Northwest Region",6,14,2228,10,2236,0,13,0,4
"12/04/2021","Y","Y","Nome Census Area",180,"Northwest Region",6,0,2228,3,2239,0,13,0,4
"12/05/2021","Y","Y","Nome Census Area",180,"Northwest Region",6,6,2234,0,2239,0,13,0,4
"12/06/2021","Y","Y","Nome Census Area",180,"Northwest Region",6,2,2236,2,2241,1,14,0,4
"12/07/2021","Y","Y","Nome Census Area",180,"Northwest Region",6,11,2247,9,2250,0,14,0,4
"12/08/2021","Y","Y","Nome Census Area",180,"Northwest Region",6,7,2254,8,2258,0,14,0,4
"12/09/2021","Y","Y","Nome Census Area",180,"Northwest Region",6,17,2271,20,2278,0,14,0,4
"12/10/2021","Y","Y","Nome Census Area",180,"Northwest Region",6,9,2280,12,2290,0,14,0,4
"12/11/2021","Y","Y","Nome Census Area",180,"Northwest Region",6,6,2286,1,2291,0,14,0,4
"12/12/2021","Y","Y","Nome Census Area",180,"Northwest Region",6,6,2292,4,2295,0,14,0,4
"12/13/2021","Y","Y","Nome Census Area",180,"Northwest Region",6,1,2293,2,2297,0,14,0,4
"12/14/2021","Y","Y","Nome Census Area",180,"Northwest Region",6,4,2297,4,2301,0,14,0,4
"12/15/2021","Y","Y","Nome Census Area",180,"Northwest Region",6,15,2312,13,2314,0,14,0,4
"12/17/2021","Y","Y","Nome Census Area",180,"Northwest Region",6,9,2321,14,2328,0,14,0,4
"12/18/2021","Y","Y","Nome Census Area",180,"Northwest Region",6,13,2334,8,2336,0,14,0,4
"12/19/2021","Y","Y","Nome Census Area",180,"Northwest Region",6,2,2336,2,2338,0,14,0,4
"12/20/2021","Y","Y","Nome Census Area",180,"Northwest Region",6,2,2338,2,2340,0,14,0,4
"12/21/2021","Y","Y","Nome Census Area",180,"Northwest Region",6,4,2342,4,2344,0,14,0,4
"12/22/2021","Y","Y","Nome Census Area",180,"Northwest Region",6,7,2349,9,2353,0,14,0,4
"12/23/2021","Y","Y","Nome Census Area",180,"Northwest Region",6,3,2352,1,2354,0,14,0,4
"12/24/2021","Y","Y","Nome Census Area",180,"Northwest Region",6,1,2353,2,2356,0,14,0,4
"12/25/2021","Y","Y","Nome Census Area",180,"Northwest Region",6,1,2354,1,2357,0,14,0,4
"12/26/2021","Y","Y","Nome Census Area",180,"Northwest Region",6,1,2355,1,2358,0,14,1,5
"12/28/2021","Y","Y","Nome Census Area",180,"Northwest Region",6,4,2359,4,2362,0,14,0,5
"12/29/2021","Y","Y","Nome Census Area",180,"Northwest Region",6,5,2364,9,2371,0,14,0,5
"12/30/2021","Y","Y","Nome Census Area",180,"Northwest Region",6,6,2370,1,2372,0,14,0,5
"12/31/2021","Y","Y","Nome Census Area",180,"Northwest Region",6,3,2373,3,2375,1,15,0,5
"01/01/2022","Y","Y","Nome Census Area",180,"Northwest Region",6,5,2378,5,2380,0,15,0,5
"01/02/2022","Y","Y","Nome Census Area",180,"Northwest Region",6,2,2380,3,2383,0,15,0,5
"01/03/2022","Y","Y","Nome Census Area",180,"Northwest Region",6,10,2390,19,2402,0,15,0,5
"01/04/2022","Y","Y","Nome Census Area",180,"Northwest Region",6,27,2417,34,2436,0,15,0,5
"01/05/2022","Y","Y","Nome Census Area",180,"Northwest Region",6,27,2444,17,2453,0,15,0,5
"01/06/2022","Y","Y","Nome Census Area",180,"Northwest Region",6,16,2460,19,2472,0,15,0,5
"01/07/2022","Y","Y","Nome Census Area",180,"Northwest Region",6,27,2487,28,2500,0,15,0,5
"01/08/2022","Y","Y","Nome Census Area",180,"Northwest Region",6,31,2518,29,2529,0,15,0,5
"01/09/2022","Y","Y","Nome Census Area",180,"Northwest Region",6,26,2544,24,2553,0,15,0,5
"01/10/2022","Y","Y","Nome Census Area",180,"Northwest Region",6,19,2563,23,2576,0,15,0,5
"01/11/2022","Y","Y","Nome Census Area",180,"Northwest Region",6,47,2610,42,2618,0,15,0,5
"01/12/2022","Y","Y","Nome Census Area",180,"Northwest Region",6,51,2661,56,2674,0,15,0,5
"01/13/2022","Y","Y","Nome Census Area",180,"Northwest Region",6,49,2710,47,2721,0,15,0,5
"01/14/2022","Y","Y","Nome Census Area",180,"Northwest Region",6,40,2750,51,2772,1,16,0,5
"01/15/2022","Y","Y","Nome Census Area",180,"Northwest Region",6,35,2785,34,2806,0,16,0,5
"01/16/2022","Y","Y","Nome Census Area",180,"Northwest Region",6,16,2801,18,2824,0,16,0,5
"01/17/2022","Y","Y","Nome Census Area",180,"Northwest Region",6,18,2819,26,2850,0,16,0,5
"01/18/2022","Y","Y","Nome Census Area",180,"Northwest Region",6,70,2889,81,2931,0,16,0,5
"01/19/2022","Y","Y","Nome Census Area",180,"Northwest Region",6,111,3000,104,3035,0,16,0,5
"01/20/2022","Y","Y","Nome Census Area",180,"Northwest Region",6,97,3097,94,3129,0,16,0,5
"01/21/2022","Y","Y","Nome Census Area",180,"Northwest Region",6,81,3178,81,3210,0,16,0,5
"01/22/2022","Y","Y","Nome Census Area",180,"Northwest Region",6,77,3255,74,3284,0,16,0,5
"01/23/2022","Y","Y","Nome Census Area",180,"Northwest Region",6,28,3283,27,3311,0,16,0,5
"01/24/2022","Y","Y","Nome Census Area",180,"Northwest Region",6,38,3321,66,3377,0,16,0,5
"01/25/2022","Y","Y","Nome Census Area",180,"Northwest Region",6,136,3457,125,3502,0,16,0,5
"01/26/2022","Y","Y","Nome Census Area",180,"Northwest Region",6,102,3559,96,3598,0,16,0,5
"01/27/2022","Y","Y","Nome Census Area",180,"Northwest Region",6,103,3662,103,3701,0,16,0,5
"01/28/2022","Y","Y","Nome Census Area",180,"Northwest Region",6,33,3695,42,3743,0,16,0,5
"01/29/2022","Y","Y","Nome Census Area",180,"Northwest Region",6,78,3773,70,3813,0,16,0,5
"01/30/2022","Y","Y","Nome Census Area",180,"Northwest Region",6,90,3863,80,3893,0,16,0,5
"01/31/2022","Y","Y","Nome Census Area",180,"Northwest Region",6,75,3938,79,3972,0,16,0,5
"02/01/2022","Y","Y","Nome Census Area",180,"Northwest Region",6,3,3941,21,3993,0,16,0,5
"02/02/2022","Y","Y","Nome Census Area",180,"Northwest Region",6,134,4075,125,4118,0,16,0,5
"02/03/2022","Y","Y","Nome Census Area",180,"Northwest Region",6,84,4159,76,4194,0,16,0,5
"02/04/2022","Y","Y","Nome Census Area",180,"Northwest Region",6,70,4229,81,4275,0,16,0,5
"02/05/2022","Y","Y","Nome Census Area",180,"Northwest Region",6,0,4229,1,4276,0,16,0,5
"02/06/2022","Y","Y","Nome Census Area",180,"Northwest Region",6,79,4308,55,4331,0,16,0,5
"02/07/2022","Y","Y","Nome Census Area",180,"Northwest Region",6,4,4312,16,4347,0,16,0,5
"02/08/2022","Y","Y","Nome Census Area",180,"Northwest Region",6,218,4530,194,4541,0,16,0,5
"02/09/2022","Y","Y","Nome Census Area",180,"Northwest Region",6,104,4634,101,4642,0,16,0,5
"02/10/2022","Y","Y","Nome Census Area",180,"Northwest Region",6,0,4634,8,4650,1,17,0,5
"02/11/2022","Y","Y","Nome Census Area",180,"Northwest Region",6,61,4695,70,4720,0,17,0,5
"02/12/2022","Y","Y","Nome Census Area",180,"Northwest Region",6,92,4787,80,4800,1,18,0,5
"02/13/2022","Y","Y","Nome Census Area",180,"Northwest Region",6,58,4845,50,4850,0,18,0,5
"02/14/2022","Y","Y","Nome Census Area",180,"Northwest Region",6,14,4859,16,4866,0,18,0,5
"02/15/2022","Y","Y","Nome Census Area",180,"Northwest Region",6,6,4865,7,4873,0,18,0,5
"02/16/2022","Y","Y","Nome Census Area",180,"Northwest Region",6,124,4989,132,5005,0,18,0,5
"02/17/2022","Y","Y","Nome Census Area",180,"Northwest Region",6,15,5004,14,5019,0,18,0,5
"02/18/2022","Y","Y","Nome Census Area",180,"Northwest Region",6,59,5063,54,5073,0,18,0,5
"02/19/2022","Y","Y","Nome Census Area",180,"Northwest Region",6,27,5090,25,5098,0,18,0,5
"02/20/2022","Y","Y","Nome Census Area",180,"Northwest Region",6,36,5126,30,5128,0,18,0,5
"02/21/2022","Y","Y","Nome Census Area",180,"Northwest Region",6,8,5134,7,5135,0,18,0,5
"02/22/2022","Y","Y","Nome Census Area",180,"Northwest Region",6,1,5135,11,5146,0,18,0,5
"02/23/2022","Y","Y","Nome Census Area",180,"Northwest Region",6,53,5188,46,5192,0,18,0,5
"02/24/2022","Y","Y","Nome Census Area",180,"Northwest Region",6,45,5233,45,5237,0,18,0,5
"02/25/2022","Y","Y","Nome Census Area",180,"Northwest Region",6,11,5244,13,5250,0,18,0,5
"02/26/2022","Y","Y","Nome Census Area",180,"Northwest Region",6,34,5278,29,5279,0,18,0,5
"02/27/2022","Y","Y","Nome Census Area",180,"Northwest Region",6,17,5295,18,5297,0,18,0,5
"02/28/2022","Y","Y","Nome Census Area",180,"Northwest Region",6,11,5306,13,5310,0,18,0,5
"03/01/2022","Y","Y","Nome Census Area",180,"Northwest Region",6,42,5348,51,5361,0,18,0,5
"03/02/2022","Y","Y","Nome Census Area",180,"Northwest Region",6,43,5391,34,5395,0,18,0,5
"03/03/2022","Y","Y","Nome Census Area",180,"Northwest Region",6,34,5425,35,5430,0,18,0,5
"03/04/2022","Y","Y","Nome Census Area",180,"Northwest Region",6,29,5454,30,5460,0,18,0,5
"03/05/2022","Y","Y","Nome Census Area",180,"Northwest Region",6,0,5454,1,5461,0,18,0,5
"03/06/2022","Y","Y","Nome Census Area",180,"Northwest Region",6,14,5468,12,5473,0,18,0,5
"03/07/2022","Y","Y","Nome Census Area",180,"Northwest Region",6,2,5470,6,5479,0,18,0,5
"03/08/2022","Y","Y","Nome Census Area",180,"Northwest Region",6,39,5509,42,5521,0,18,0,5
"03/09/2022","Y","Y","Nome Census Area",180,"Northwest Region",6,38,5547,30,5551,0,18,0,5
"03/10/2022","Y","Y","Nome Census Area",180,"Northwest Region",6,31,5578,31,5582,0,18,0,5
"03/11/2022","Y","Y","Nome Census Area",180,"Northwest Region",6,16,5594,13,5595,0,18,0,5
"03/12/2022","Y","Y","Nome Census Area",180,"Northwest Region",6,13,5607,14,5609,0,18,0,5
"03/13/2022","Y","Y","Nome Census Area",180,"Northwest Region",6,8,5615,7,5616,0,18,0,5
"03/14/2022","Y","Y","Nome Census Area",180,"Northwest Region",6,6,5621,10,5626,0,18,0,5
"03/15/2022","Y","Y","Nome Census Area",180,"Northwest Region",6,18,5639,21,5647,0,18,0,5
"03/16/2022","Y","Y","Nome Census Area",180,"Northwest Region",6,28,5667,24,5671,0,18,0,5
"03/17/2022","Y","Y","Nome Census Area",180,"Northwest Region",6,29,5696,26,5697,0,18,0,5
"03/18/2022","Y","Y","Nome Census Area",180,"Northwest Region",6,12,5708,19,5716,0,18,0,5
"03/19/2022","Y","Y","Nome Census Area",180,"Northwest Region",6,28,5736,20,5736,0,18,0,5
"03/20/2022","Y","Y","Nome Census Area",180,"Northwest Region",6,3,5739,10,5746,0,18,0,5
"03/21/2022","Y","Y","Nome Census Area",180,"Northwest Region",6,0,5739,3,5749,0,18,0,5
"03/22/2022","Y","Y","Nome Census Area",180,"Northwest Region",6,45,5784,40,5789,0,18,0,5
"03/23/2022","Y","Y","Nome Census Area",180,"Northwest Region",6,30,5814,28,5817,0,18,0,5
"03/24/2022","Y","Y","Nome Census Area",180,"Northwest Region",6,24,5838,27,5844,0,18,0,5
"03/25/2022","Y","Y","Nome Census Area",180,"Northwest Region",6,19,5857,16,5860,0,18,0,5
"03/26/2022","Y","Y","Nome Census Area",180,"Northwest Region",6,10,5867,7,5867,0,18,0,5
"03/27/2022","Y","Y","Nome Census Area",180,"Northwest Region",6,10,5877,10,5877,0,18,0,5
"03/28/2022","Y","Y","Nome Census Area",180,"Northwest Region",6,1,5878,4,5881,0,18,0,5
"03/29/2022","Y","Y","Nome Census Area",180,"Northwest Region",6,0,5878,4,5885,0,18,0,5
"03/30/2022","Y","Y","Nome Census Area",180,"Northwest Region",6,20,5898,19,5904,0,18,0,5
"03/31/2022","Y","Y","Nome Census Area",180,"Northwest Region",6,20,5918,20,5924,0,18,0,5
"04/01/2022","Y","Y","Nome Census Area",180,"Northwest Region",6,19,5937,23,5947,0,18,0,5
"04/02/2022","Y","Y","Nome Census Area",180,"Northwest Region",6,7,5944,4,5951,0,18,0,5
"04/03/2022","Y","Y","Nome Census Area",180,"Northwest Region",6,8,5952,1,5952,0,18,0,5
"04/04/2022","Y","Y","Nome Census Area",180,"Northwest Region",6,2,5954,4,5956,0,18,0,5
"04/06/2022","Y","Y","Nome Census Area",180,"Northwest Region",6,36,5990,35,5991,0,18,0,5
"04/07/2022","Y","Y","Nome Census Area",180,"Northwest Region",6,10,6000,11,6002,0,18,0,5
"04/08/2022","Y","Y","Nome Census Area",180,"Northwest Region",6,17,6017,15,6017,0,18,0,5
"04/09/2022","Y","Y","Nome Census Area",180,"Northwest Region",6,5,6022,5,6022,0,18,0,5
"04/11/2022","Y","Y","Nome Census Area",180,"Northwest Region",6,2,6024,8,6030,0,18,0,5
"04/12/2022","Y","Y","Nome Census Area",180,"Northwest Region",6,28,6052,23,6053,0,18,0,5
"04/13/2022","Y","Y","Nome Census Area",180,"Northwest Region",6,24,6076,23,6076,0,18,0,5
"04/15/2022","Y","Y","Nome Census Area",180,"Northwest Region",6,25,6101,27,6103,0,18,0,5
"04/16/2022","Y","Y","Nome Census Area",180,"Northwest Region",6,12,6113,10,6113,0,18,0,5
"04/18/2022","Y","Y","Nome Census Area",180,"Northwest Region",6,2,6115,7,6120,0,18,0,5
"04/19/2022","Y","Y","Nome Census Area",180,"Northwest Region",6,14,6129,20,6140,0,18,0,5
"04/20/2022","Y","Y","Nome Census Area",180,"Northwest Region",6,10,6139,1,6141,0,18,0,5
"04/21/2022","Y","Y","Nome Census Area",180,"Northwest Region",6,5,6144,3,6144,0,18,0,5
"04/22/2022","Y","Y","Nome Census Area",180,"Northwest Region",6,4,6148,4,6148,0,18,0,5
"04/23/2022","Y","Y","Nome Census Area",180,"Northwest Region",6,3,6151,3,6151,0,18,0,5
"04/24/2022","Y","Y","Nome Census Area",180,"Northwest Region",6,1,6152,1,6152,0,18,0,5
"04/26/2022","Y","Y","Nome Census Area",180,"Northwest Region",6,5,6157,5,6157,0,18,0,5
"05/22/2020","Y","Y","North Slope Borough",185,"Northwest Region",6,0,0,1,1,0,0,0,0
"05/27/2020","Y","Y","North Slope Borough",185,"Northwest Region",6,1,1,0,1,0,0,0,0
"06/16/2020","Y","Y","North Slope Borough",185,"Northwest Region",6,1,2,3,4,1,1,0,0
"06/18/2020","Y","Y","North Slope Borough",185,"Northwest Region",6,1,3,0,4,0,1,0,0
"06/21/2020","Y","Y","North Slope Borough",185,"Northwest Region",6,1,4,0,4,0,1,0,0
"07/10/2020","Y","Y","North Slope Borough",185,"Northwest Region",6,0,4,1,5,0,1,0,0
"07/12/2020","Y","Y","North Slope Borough",185,"Northwest Region",6,1,5,0,5,0,1,0,0
"07/13/2020","Y","Y","North Slope Borough",185,"Northwest Region",6,0,5,1,6,0,1,0,0
"07/17/2020","Y","Y","North Slope Borough",185,"Northwest Region",6,1,6,0,6,0,1,0,0
"07/18/2020","Y","Y","North Slope Borough",185,"Northwest Region",6,0,6,1,7,0,1,0,0
"07/19/2020","Y","Y","North Slope Borough",185,"Northwest Region",6,0,6,1,8,0,1,0,0
"07/20/2020","Y","Y","North Slope Borough",185,"Northwest Region",6,1,7,1,9,0,1,0,0
"07/21/2020","Y","Y","North Slope Borough",185,"Northwest Region",6,1,8,1,10,0,1,0,0
"07/24/2020","Y","Y","North Slope Borough",185,"Northwest Region",6,0,8,1,11,0,1,0,0
"07/25/2020","Y","Y","North Slope Borough",185,"Northwest Region",6,0,8,4,15,0,1,0,0
"07/26/2020","Y","Y","North Slope Borough",185,"Northwest Region",6,3,11,0,15,0,1,0,0
"07/27/2020","Y","Y","North Slope Borough",185,"Northwest Region",6,1,12,0,15,0,1,0,0
"07/29/2020","Y","Y","North Slope Borough",185,"Northwest Region",6,3,15,0,15,0,1,0,0
"07/30/2020","Y","Y","North Slope Borough",185,"Northwest Region",6,0,15,2,17,0,1,0,0
"07/31/2020","Y","Y","North Slope Borough",185,"Northwest Region",6,0,15,1,18,0,1,0,0
"08/02/2020","Y","Y","North Slope Borough",185,"Northwest Region",6,2,17,1,19,0,1,0,0
"08/03/2020","Y","Y","North Slope Borough",185,"Northwest Region",6,1,18,0,19,1,2,0,0
"08/04/2020","Y","Y","North Slope Borough",185,"Northwest Region",6,0,18,1,20,0,2,0,0
"08/06/2020","Y","Y","North Slope Borough",185,"Northwest Region",6,0,18,1,21,0,2,0,0
"08/07/2020","Y","Y","North Slope Borough",185,"Northwest Region",6,2,20,0,21,0,2,0,0
"08/09/2020","Y","Y","North Slope Borough",185,"Northwest Region",6,0,20,0,21,1,3,0,0
"08/10/2020","Y","Y","North Slope Borough",185,"Northwest Region",6,1,21,1,22,0,3,0,0
"08/11/2020","Y","Y","North Slope Borough",185,"Northwest Region",6,0,21,1,23,0,3,0,0
"08/12/2020","Y","Y","North Slope Borough",185,"Northwest Region",6,1,22,1,24,0,3,0,0
"08/14/2020","Y","Y","North Slope Borough",185,"Northwest Region",6,1,23,3,27,0,3,0,0
"08/15/2020","Y","Y","North Slope Borough",185,"Northwest Region",6,2,25,0,27,0,3,0,0
"08/16/2020","Y","Y","North Slope Borough",185,"Northwest Region",6,1,26,2,29,0,3,0,0
"08/17/2020","Y","Y","North Slope Borough",185,"Northwest Region",6,0,26,1,30,0,3,0,0
"08/18/2020","Y","Y","North Slope Borough",185,"Northwest Region",6,2,28,0,30,0,3,0,0
"08/19/2020","Y","Y","North Slope Borough",185,"Northwest Region",6,1,29,0,30,0,3,0,0
"08/21/2020","Y","Y","North Slope Borough",185,"Northwest Region",6,1,30,2,32,0,3,0,0
"08/22/2020","Y","Y","North Slope Borough",185,"Northwest Region",6,0,30,1,33,0,3,0,0
"08/24/2020","Y","Y","North Slope Borough",185,"Northwest Region",6,3,33,2,35,0,3,0,0
"08/25/2020","Y","Y","North Slope Borough",185,"Northwest Region",6,0,33,2,37,0,3,0,0
"08/26/2020","Y","Y","North Slope Borough",185,"Northwest Region",6,1,34,1,38,0,3,0,0
"08/27/2020","Y","Y","North Slope Borough",185,"Northwest Region",6,2,36,1,39,0,3,0,0
"08/29/2020","Y","Y","North Slope Borough",185,"Northwest Region",6,3,39,1,40,0,3,0,0
"08/31/2020","Y","Y","North Slope Borough",185,"Northwest Region",6,0,39,6,46,1,4,0,0
"09/01/2020","Y","Y","North Slope Borough",185,"Northwest Region",6,2,41,4,50,0,4,0,0
"09/02/2020","Y","Y","North Slope Borough",185,"Northwest Region",6,1,42,0,50,0,4,0,0
"09/03/2020","Y","Y","North Slope Borough",185,"Northwest Region",6,1,43,1,51,0,4,0,0
"09/04/2020","Y","Y","North Slope Borough",185,"Northwest Region",6,5,48,5,56,0,4,0,0
"09/05/2020","Y","Y","North Slope Borough",185,"Northwest Region",6,3,51,2,58,0,4,0,0
"09/06/2020","Y","Y","North Slope Borough",185,"Northwest Region",6,1,52,1,59,0,4,0,0
"09/07/2020","Y","Y","North Slope Borough",185,"Northwest Region",6,2,54,0,59,0,4,0,0
"09/08/2020","Y","Y","North Slope Borough",185,"Northwest Region",6,1,55,1,60,0,4,0,0
"09/09/2020","Y","Y","North Slope Borough",185,"Northwest Region",6,2,57,0,60,0,4,0,0
"09/10/2020","Y","Y","North Slope Borough",185,"Northwest Region",6,2,59,2,62,0,4,0,0
"09/11/2020","Y","Y","North Slope Borough",185,"Northwest Region",6,1,60,1,63,0,4,0,0
"09/12/2020","Y","Y","North Slope Borough",185,"Northwest Region",6,1,61,1,64,1,5,0,0
"09/13/2020","Y","Y","North Slope Borough",185,"Northwest Region",6,2,63,2,66,0,5,0,0
"09/14/2020","Y","Y","North Slope Borough",185,"Northwest Region",6,1,64,4,70,0,5,0,0
"09/15/2020","Y","Y","North Slope Borough",185,"Northwest Region",6,2,66,6,76,0,5,0,0
"09/16/2020","Y","Y","North Slope Borough",185,"Northwest Region",6,6,72,3,79,0,5,0,0
"09/17/2020","Y","Y","North Slope Borough",185,"Northwest Region",6,5,77,5,84,0,5,0,0
"09/18/2020","Y","Y","North Slope Borough",185,"Northwest Region",6,4,81,9,93,0,5,0,0
"09/19/2020","Y","Y","North Slope Borough",185,"Northwest Region",6,3,84,6,99,0,5,0,0
"09/20/2020","Y","Y","North Slope Borough",185,"Northwest Region",6,5,89,6,105,0,5,0,0
"09/21/2020","Y","Y","North Slope Borough",185,"Northwest Region",6,0,89,4,109,0,5,0,0
"09/22/2020","Y","Y","North Slope Borough",185,"Northwest Region",6,3,92,4,113,0,5,0,0
"09/23/2020","Y","Y","North Slope Borough",185,"Northwest Region",6,16,108,4,117,0,5,0,0
"09/24/2020","Y","Y","North Slope Borough",185,"Northwest Region",6,3,111,4,121,0,5,0,0
"09/25/2020","Y","Y","North Slope Borough",185,"Northwest Region",6,5,116,3,124,0,5,0,0
"09/26/2020","Y","Y","North Slope Borough",185,"Northwest Region",6,1,117,1,125,0,5,0,0
"09/27/2020","Y","Y","North Slope Borough",185,"Northwest Region",6,1,118,3,128,1,6,0,0
"09/28/2020","Y","Y","North Slope Borough",185,"Northwest Region",6,7,125,6,134,0,6,0,0
"09/29/2020","Y","Y","North Slope Borough",185,"Northwest Region",6,2,127,2,136,0,6,0,0
"09/30/2020","Y","Y","North Slope Borough",185,"Northwest Region",6,4,131,2,138,0,6,0,0
"10/01/2020","Y","Y","North Slope Borough",185,"Northwest Region",6,5,136,2,140,0,6,0,0
"10/02/2020","Y","Y","North Slope Borough",185,"Northwest Region",6,4,140,6,146,0,6,0,0
"10/03/2020","Y","Y","North Slope Borough",185,"Northwest Region",6,1,141,1,147,0,6,0,0
"10/04/2020","Y","Y","North Slope Borough",185,"Northwest Region",6,0,141,2,149,2,8,0,0
"10/05/2020","Y","Y","North Slope Borough",185,"Northwest Region",6,2,143,2,151,0,8,0,0
"10/06/2020","Y","Y","North Slope Borough",185,"Northwest Region",6,0,143,4,155,0,8,0,0
"10/07/2020","Y","Y","North Slope Borough",185,"Northwest Region",6,5,148,4,159,0,8,0,0
"10/08/2020","Y","Y","North Slope Borough",185,"Northwest Region",6,2,150,4,163,0,8,0,0
"10/09/2020","Y","Y","North Slope Borough",185,"Northwest Region",6,1,151,4,167,0,8,0,0
"10/10/2020","Y","Y","North Slope Borough",185,"Northwest Region",6,3,154,1,168,0,8,0,0
"10/11/2020","Y","Y","North Slope Borough",185,"Northwest Region",6,5,159,6,174,0,8,0,0
"10/12/2020","Y","Y","North Slope Borough",185,"Northwest Region",6,9,168,8,182,0,8,0,0
"10/13/2020","Y","Y","North Slope Borough",185,"Northwest Region",6,4,172,13,195,0,8,0,0
"10/14/2020","Y","Y","North Slope Borough",185,"Northwest Region",6,2,174,7,202,0,8,0,0
"10/15/2020","Y","Y","North Slope Borough",185,"Northwest Region",6,13,187,4,206,0,8,0,0
"10/16/2020","Y","Y","North Slope Borough",185,"Northwest Region",6,5,192,3,209,0,8,0,0
"10/17/2020","Y","Y","North Slope Borough",185,"Northwest Region",6,6,198,4,213,0,8,0,0
"10/18/2020","Y","Y","North Slope Borough",185,"Northwest Region",6,1,199,1,214,0,8,0,0
"10/19/2020","Y","Y","North Slope Borough",185,"Northwest Region",6,6,205,1,215,1,9,0,0
"10/20/2020","Y","Y","North Slope Borough",185,"Northwest Region",6,3,208,3,218,0,9,0,0
"10/21/2020","Y","Y","North Slope Borough",185,"Northwest Region",6,4,212,9,227,0,9,0,0
"10/22/2020","Y","Y","North Slope Borough",185,"Northwest Region",6,8,220,8,235,0,9,0,0
"10/23/2020","Y","Y","North Slope Borough",185,"Northwest Region",6,1,221,5,240,0,9,0,0
"10/24/2020","Y","Y","North Slope Borough",185,"Northwest Region",6,6,227,2,242,0,9,0,0
"10/25/2020","Y","Y","North Slope Borough",185,"Northwest Region",6,1,228,3,245,0,9,0,0
"10/26/2020","Y","Y","North Slope Borough",185,"Northwest Region",6,15,243,6,251,0,9,0,0
"10/27/2020","Y","Y","North Slope Borough",185,"Northwest Region",6,1,244,1,252,0,9,0,0
"10/28/2020","Y","Y","North Slope Borough",185,"Northwest Region",6,4,248,4,256,0,9,0,0
"10/29/2020","Y","Y","North Slope Borough",185,"Northwest Region",6,1,249,5,261,0,9,0,0
"10/30/2020","Y","Y","North Slope Borough",185,"Northwest Region",6,2,251,10,271,0,9,0,0
"10/31/2020","Y","Y","North Slope Borough",185,"Northwest Region",6,6,257,2,273,0,9,0,0
"11/01/2020","Y","Y","North Slope Borough",185,"Northwest Region",6,0,257,5,278,0,9,0,0
"11/02/2020","Y","Y","North Slope Borough",185,"Northwest Region",6,5,262,1,279,0,9,0,0
"11/03/2020","Y","Y","North Slope Borough",185,"Northwest Region",6,1,263,5,284,0,9,0,0
"11/04/2020","Y","Y","North Slope Borough",185,"Northwest Region",6,8,271,13,297,0,9,0,0
"11/05/2020","Y","Y","North Slope Borough",185,"Northwest Region",6,8,279,12,309,0,9,0,0
"11/06/2020","Y","Y","North Slope Borough",185,"Northwest Region",6,7,286,9,318,0,9,0,0
"11/07/2020","Y","Y","North Slope Borough",185,"Northwest Region",6,5,291,2,320,1,10,0,0
"11/08/2020","Y","Y","North Slope Borough",185,"Northwest Region",6,5,296,5,325,0,10,0,0
"11/09/2020","Y","Y","North Slope Borough",185,"Northwest Region",6,14,310,7,332,0,10,1,1
"11/10/2020","Y","Y","North Slope Borough",185,"Northwest Region",6,14,324,10,342,0,10,0,1
"11/11/2020","Y","Y","North Slope Borough",185,"Northwest Region",6,5,329,4,346,0,10,0,1
"11/12/2020","Y","Y","North Slope Borough",185,"Northwest Region",6,8,337,4,350,0,10,0,1
"11/13/2020","Y","Y","North Slope Borough",185,"Northwest Region",6,4,341,5,355,0,10,0,1
"11/14/2020","Y","Y","North Slope Borough",185,"Northwest Region",6,4,345,5,360,0,10,0,1
"11/16/2020","Y","Y","North Slope Borough",185,"Northwest Region",6,5,350,5,365,0,10,0,1
"11/17/2020","Y","Y","North Slope Borough",185,"Northwest Region",6,8,358,8,373,0,10,0,1
"11/18/2020","Y","Y","North Slope Borough",185,"Northwest Region",6,7,365,5,378,0,10,0,1
"11/19/2020","Y","Y","North Slope Borough",185,"Northwest Region",6,5,370,7,385,0,10,0,1
"11/20/2020","Y","Y","North Slope Borough",185,"Northwest Region",6,2,372,17,402,0,10,0,1
"11/21/2020","Y","Y","North Slope Borough",185,"Northwest Region",6,1,373,5,407,0,10,0,1
"11/22/2020","Y","Y","North Slope Borough",185,"Northwest Region",6,1,374,5,412,0,10,0,1
"11/23/2020","Y","Y","North Slope Borough",185,"Northwest Region",6,12,386,4,416,0,10,0,1
"11/24/2020","Y","Y","North Slope Borough",185,"Northwest Region",6,15,401,4,420,0,10,0,1
"11/25/2020","Y","Y","North Slope Borough",185,"Northwest Region",6,5,406,12,432,0,10,0,1
"11/26/2020","Y","Y","North Slope Borough",185,"Northwest Region",6,5,411,5,437,0,10,0,1
"11/27/2020","Y","Y","North Slope Borough",185,"Northwest Region",6,9,420,6,443,0,10,0,1
"11/28/2020","Y","Y","North Slope Borough",185,"Northwest Region",6,3,423,12,455,0,10,0,1
"11/29/2020","Y","Y","North Slope Borough",185,"Northwest Region",6,13,436,8,463,0,10,0,1
"11/30/2020","Y","Y","North Slope Borough",185,"Northwest Region",6,8,444,15,478,0,10,0,1
"12/01/2020","Y","Y","North Slope Borough",185,"Northwest Region",6,30,474,16,494,0,10,0,1
"12/02/2020","Y","Y","North Slope Borough",185,"Northwest Region",6,10,484,25,519,0,10,0,1
"12/03/2020","Y","Y","North Slope Borough",185,"Northwest Region",6,19,503,31,550,0,10,0,1
"12/04/2020","Y","Y","North Slope Borough",185,"Northwest Region",6,4,507,17,567,0,10,0,1
"12/05/2020","Y","Y","North Slope Borough",185,"Northwest Region",6,22,529,7,574,0,10,0,1
"12/06/2020","Y","Y","North Slope Borough",185,"Northwest Region",6,2,531,12,586,0,10,0,1
"12/07/2020","Y","Y","North Slope Borough",185,"Northwest Region",6,10,541,10,596,0,10,0,1
"12/08/2020","Y","Y","North Slope Borough",185,"Northwest Region",6,32,573,20,616,1,11,1,2
"12/09/2020","Y","Y","North Slope Borough",185,"Northwest Region",6,12,585,8,624,0,11,0,2
"12/10/2020","Y","Y","North Slope Borough",185,"Northwest Region",6,10,595,16,640,0,11,1,3
"12/11/2020","Y","Y","North Slope Borough",185,"Northwest Region",6,12,607,17,657,0,11,0,3
"12/12/2020","Y","Y","North Slope Borough",185,"Northwest Region",6,17,624,9,666,0,11,0,3
"12/13/2020","Y","Y","North Slope Borough",185,"Northwest Region",6,22,646,7,673,0,11,0,3
"12/14/2020","Y","Y","North Slope Borough",185,"Northwest Region",6,10,656,10,683,0,11,0,3
"12/15/2020","Y","Y","North Slope Borough",185,"Northwest Region",6,14,670,9,692,0,11,0,3
"12/16/2020","Y","Y","North Slope Borough",185,"Northwest Region",6,14,684,16,708,1,12,0,3
"12/17/2020","Y","Y","North Slope Borough",185,"Northwest Region",6,16,700,6,714,0,12,0,3
"12/18/2020","Y","Y","North Slope Borough",185,"Northwest Region",6,10,710,9,723,0,12,0,3
"12/19/2020","Y","Y","North Slope Borough",185,"Northwest Region",6,6,716,6,729,0,12,0,3
"12/20/2020","Y","Y","North Slope Borough",185,"Northwest Region",6,1,717,2,731,0,12,0,3
"12/21/2020","Y","Y","North Slope Borough",185,"Northwest Region",6,3,720,5,736,0,12,0,3
"12/22/2020","Y","Y","North Slope Borough",185,"Northwest Region",6,8,728,5,741,1,13,0,3
"12/23/2020","Y","Y","North Slope Borough",185,"Northwest Region",6,8,736,2,743,0,13,0,3
"12/24/2020","Y","Y","North Slope Borough",185,"Northwest Region",6,2,738,2,745,0,13,0,3
"12/25/2020","Y","Y","North Slope Borough",185,"Northwest Region",6,5,743,1,746,1,14,0,3
"12/26/2020","Y","Y","North Slope Borough",185,"Northwest Region",6,2,745,5,751,0,14,0,3
"12/27/2020","Y","Y","North Slope Borough",185,"Northwest Region",6,3,748,3,754,0,14,0,3
"12/28/2020","Y","Y","North Slope Borough",185,"Northwest Region",6,2,750,11,765,0,14,0,3
"12/29/2020","Y","Y","North Slope Borough",185,"Northwest Region",6,12,762,10,775,1,15,0,3
"12/30/2020","Y","Y","North Slope Borough",185,"Northwest Region",6,4,766,9,784,0,15,0,3
"12/31/2020","Y","Y","North Slope Borough",185,"Northwest Region",6,6,772,4,788,0,15,0,3
"01/01/2021","Y","Y","North Slope Borough",185,"Northwest Region",6,6,778,0,788,0,15,0,3
"01/02/2021","Y","Y","North Slope Borough",185,"Northwest Region",6,3,781,8,796,0,15,0,3
"01/03/2021","Y","Y","North Slope Borough",185,"Northwest Region",6,3,784,3,799,0,15,0,3
"01/04/2021","Y","Y","North Slope Borough",185,"Northwest Region",6,7,791,15,814,0,15,0,3
"01/05/2021","Y","Y","North Slope Borough",185,"Northwest Region",6,10,801,36,850,0,15,0,3
"01/06/2021","Y","Y","North Slope Borough",185,"Northwest Region",6,1,802,7,857,0,15,0,3
"01/07/2021","Y","Y","North Slope Borough",185,"Northwest Region",6,4,806,13,870,0,15,0,3
"01/08/2021","Y","Y","North Slope Borough",185,"Northwest Region",6,8,814,3,873,0,15,0,3
"01/09/2021","Y","Y","North Slope Borough",185,"Northwest Region",6,14,828,2,875,0,15,1,4
"01/10/2021","Y","Y","North Slope Borough",185,"Northwest Region",6,8,836,19,894,0,15,0,4
"01/11/2021","Y","Y","North Slope Borough",185,"Northwest Region",6,15,851,2,896,0,15,0,4
"01/12/2021","Y","Y","North Slope Borough",185,"Northwest Region",6,9,860,9,905,0,15,0,4
"01/13/2021","Y","Y","North Slope Borough",185,"Northwest Region",6,23,883,9,914,0,15,0,4
"01/14/2021","Y","Y","North Slope Borough",185,"Northwest Region",6,16,899,2,916,0,15,0,4
"01/15/2021","Y","Y","North Slope Borough",185,"Northwest Region",6,13,912,8,924,0,15,0,4
"01/16/2021","Y","Y","North Slope Borough",185,"Northwest Region",6,6,918,3,927,0,15,0,4
"01/17/2021","Y","Y","North Slope Borough",185,"Northwest Region",6,5,923,0,927,0,15,0,4
"01/18/2021","Y","Y","North Slope Borough",185,"Northwest Region",6,1,924,1,928,0,15,0,4
"01/19/2021","Y","Y","North Slope Borough",185,"Northwest Region",6,3,927,2,930,0,15,0,4
"01/20/2021","Y","Y","North Slope Borough",185,"Northwest Region",6,0,927,1,931,0,15,0,4
"01/21/2021","Y","Y","North Slope Borough",185,"Northwest Region",6,1,928,0,931,0,15,0,4
"01/22/2021","Y","Y","North Slope Borough",185,"Northwest Region",6,0,928,1,932,0,15,0,4
"01/23/2021","Y","Y","North Slope Borough",185,"Northwest Region",6,3,931,0,932,0,15,0,4
"01/24/2021","Y","Y","North Slope Borough",185,"Northwest Region",6,0,931,1,933,0,15,0,4
"01/25/2021","Y","Y","North Slope Borough",185,"Northwest Region",6,0,931,1,934,0,15,0,4
"01/26/2021","Y","Y","North Slope Borough",185,"Northwest Region",6,3,934,1,935,0,15,0,4
"01/27/2021","Y","Y","North Slope Borough",185,"Northwest Region",6,1,935,0,935,0,15,0,4
"01/28/2021","Y","Y","North Slope Borough",185,"Northwest Region",6,1,936,2,937,0,15,0,4
"01/29/2021","Y","Y","North Slope Borough",185,"Northwest Region",6,1,937,0,937,0,15,0,4
"02/01/2021","Y","Y","North Slope Borough",185,"Northwest Region",6,0,937,2,939,0,15,0,4
"02/02/2021","Y","Y","North Slope Borough",185,"Northwest Region",6,1,938,0,939,0,15,0,4
"02/03/2021","Y","Y","North Slope Borough",185,"Northwest Region",6,1,939,0,939,0,15,0,4
"02/09/2021","Y","Y","North Slope Borough",185,"Northwest Region",6,1,940,2,941,0,15,0,4
"02/10/2021","Y","Y","North Slope Borough",185,"Northwest Region",6,0,940,3,944,0,15,0,4
"02/11/2021","Y","Y","North Slope Borough",185,"Northwest Region",6,1,941,0,944,0,15,0,4
"02/12/2021","Y","Y","North Slope Borough",185,"Northwest Region",6,1,942,0,944,0,15,0,4
"02/14/2021","Y","Y","North Slope Borough",185,"Northwest Region",6,0,942,1,945,0,15,0,4
"02/15/2021","Y","Y","North Slope Borough",185,"Northwest Region",6,2,944,2,947,0,15,0,4
"02/16/2021","Y","Y","North Slope Borough",185,"Northwest Region",6,1,945,0,947,0,15,0,4
"02/17/2021","Y","Y","North Slope Borough",185,"Northwest Region",6,1,946,1,948,0,15,0,4
"02/18/2021","Y","Y","North Slope Borough",185,"Northwest Region",6,2,948,1,949,0,15,0,4
"02/19/2021","Y","Y","North Slope Borough",185,"Northwest Region",6,1,949,0,949,0,15,0,4
"02/26/2021","Y","Y","North Slope Borough",185,"Northwest Region",6,0,949,1,950,0,15,0,4
"03/01/2021","Y","Y","North Slope Borough",185,"Northwest Region",6,1,950,0,950,0,15,0,4
"03/03/2021","Y","Y","North Slope Borough",185,"Northwest Region",6,0,950,3,953,1,16,0,4
"03/04/2021","Y","Y","North Slope Borough",185,"Northwest Region",6,1,951,0,953,0,16,0,4
"03/05/2021","Y","Y","North Slope Borough",185,"Northwest Region",6,2,953,0,953,0,16,0,4
"03/08/2021","Y","Y","North Slope Borough",185,"Northwest Region",6,1,954,1,954,0,16,0,4
"03/10/2021","Y","Y","North Slope Borough",185,"Northwest Region",6,0,954,1,955,0,16,0,4
"03/11/2021","Y","Y","North Slope Borough",185,"Northwest Region",6,1,955,1,956,0,16,0,4
"03/12/2021","Y","Y","North Slope Borough",185,"Northwest Region",6,0,955,1,957,0,16,0,4
"03/13/2021","Y","Y","North Slope Borough",185,"Northwest Region",6,1,956,1,958,0,16,0,4
"03/14/2021","Y","Y","North Slope Borough",185,"Northwest Region",6,1,957,1,959,0,16,0,4
"03/15/2021","Y","Y","North Slope Borough",185,"Northwest Region",6,1,958,2,961,0,16,0,4
"03/16/2021","Y","Y","North Slope Borough",185,"Northwest Region",6,1,959,1,962,0,16,0,4
"03/18/2021","Y","Y","North Slope Borough",185,"Northwest Region",6,2,961,1,963,0,16,0,4
"03/19/2021","Y","Y","North Slope Borough",185,"Northwest Region",6,1,962,1,964,0,16,0,4
"03/20/2021","Y","Y","North Slope Borough",185,"Northwest Region",6,1,963,0,964,0,16,0,4
"03/22/2021","Y","Y","North Slope Borough",185,"Northwest Region",6,1,964,0,964,0,16,0,4
"03/25/2021","Y","Y","North Slope Borough",185,"Northwest Region",6,0,964,3,967,0,16,0,4
"03/26/2021","Y","Y","North Slope Borough",185,"Northwest Region",6,2,966,0,967,0,16,0,4
"03/27/2021","Y","Y","North Slope Borough",185,"Northwest Region",6,1,967,0,967,0,16,0,4
"03/28/2021","Y","Y","North Slope Borough",185,"Northwest Region",6,0,967,1,968,0,16,0,4
"03/29/2021","Y","Y","North Slope Borough",185,"Northwest Region",6,1,968,0,968,0,16,0,4
"04/05/2021","Y","Y","North Slope Borough",185,"Northwest Region",6,0,968,1,969,0,16,0,4
"04/08/2021","Y","Y","North Slope Borough",185,"Northwest Region",6,1,969,0,969,0,16,0,4
"04/13/2021","Y","Y","North Slope Borough",185,"Northwest Region",6,1,970,1,970,0,16,0,4
"04/16/2021","Y","Y","North Slope Borough",185,"Northwest Region",6,0,970,2,972,0,16,0,4
"04/17/2021","Y","Y","North Slope Borough",185,"Northwest Region",6,1,971,0,972,0,16,0,4
"04/18/2021","Y","Y","North Slope Borough",185,"Northwest Region",6,1,972,0,972,0,16,0,4
"04/19/2021","Y","Y","North Slope Borough",185,"Northwest Region",6,0,972,2,974,0,16,0,4
"04/20/2021","Y","Y","North Slope Borough",185,"Northwest Region",6,2,974,0,974,0,16,0,4
"04/22/2021","Y","Y","North Slope Borough",185,"Northwest Region",6,0,974,3,977,0,16,0,4
"04/23/2021","Y","Y","North Slope Borough",185,"Northwest Region",6,2,976,2,979,0,16,0,4
"04/24/2021","Y","Y","North Slope Borough",185,"Northwest Region",6,2,978,1,980,0,16,0,4
"04/25/2021","Y","Y","North Slope Borough",185,"Northwest Region",6,1,979,0,980,0,16,0,4
"04/26/2021","Y","Y","North Slope Borough",185,"Northwest Region",6,1,980,2,982,0,16,0,4
"04/28/2021","Y","Y","North Slope Borough",185,"Northwest Region",6,1,981,0,982,0,16,0,4
"04/29/2021","Y","Y","North Slope Borough",185,"Northwest Region",6,2,983,1,983,0,16,0,4
"04/30/2021","Y","Y","North Slope Borough",185,"Northwest Region",6,0,983,1,984,0,16,0,4
"05/01/2021","Y","Y","North Slope Borough",185,"Northwest Region",6,0,983,1,985,0,16,0,4
"05/02/2021","Y","Y","North Slope Borough",185,"Northwest Region",6,2,985,1,986,0,16,0,4
"05/03/2021","Y","Y","North Slope Borough",185,"Northwest Region",6,0,985,2,988,0,16,0,4
"05/04/2021","Y","Y","North Slope Borough",185,"Northwest Region",6,2,987,0,988,0,16,0,4
"05/05/2021","Y","Y","North Slope Borough",185,"Northwest Region",6,0,987,1,989,0,16,0,4
"05/06/2021","Y","Y","North Slope Borough",185,"Northwest Region",6,1,988,1,990,0,16,0,4
"05/07/2021","Y","Y","North Slope Borough",185,"Northwest Region",6,1,989,0,990,0,16,0,4
"05/11/2021","Y","Y","North Slope Borough",185,"Northwest Region",6,2,991,1,991,1,17,0,4
"05/27/2021","Y","Y","North Slope Borough",185,"Northwest Region",6,1,992,1,992,0,17,0,4
"06/08/2021","Y","Y","North Slope Borough",185,"Northwest Region",6,0,992,1,993,0,17,0,4
"06/09/2021","Y","Y","North Slope Borough",185,"Northwest Region",6,0,992,1,994,0,17,0,4
"06/11/2021","Y","Y","North Slope Borough",185,"Northwest Region",6,1,993,0,994,0,17,0,4
"06/12/2021","Y","Y","North Slope Borough",185,"Northwest Region",6,1,994,0,994,0,17,0,4
"06/23/2021","Y","Y","North Slope Borough",185,"Northwest Region",6,0,994,1,995,0,17,0,4
"06/27/2021","Y","Y","North Slope Borough",185,"Northwest Region",6,1,995,1,996,0,17,0,4
"06/28/2021","Y","Y","North Slope Borough",185,"Northwest Region",6,1,996,0,996,0,17,0,4
"07/05/2021","Y","Y","North Slope Borough",185,"Northwest Region",6,0,996,1,997,0,17,0,4
"07/06/2021","Y","Y","North Slope Borough",185,"Northwest Region",6,1,997,0,997,0,17,0,4
"07/14/2021","Y","Y","North Slope Borough",185,"Northwest Region",6,0,997,1,998,0,17,0,4
"07/15/2021","Y","Y","North Slope Borough",185,"Northwest Region",6,0,997,3,1001,0,17,0,4
"07/16/2021","Y","Y","North Slope Borough",185,"Northwest Region",6,1,998,0,1001,0,17,0,4
"07/17/2021","Y","Y","North Slope Borough",185,"Northwest Region",6,1,999,0,1001,0,17,0,4
"07/19/2021","Y","Y","North Slope Borough",185,"Northwest Region",6,2,1001,1,1002,0,17,0,4
"07/20/2021","Y","Y","North Slope Borough",185,"Northwest Region",6,0,1001,1,1003,0,17,0,4
"07/22/2021","Y","Y","North Slope Borough",185,"Northwest Region",6,0,1001,1,1004,0,17,0,4
"07/23/2021","Y","Y","North Slope Borough",185,"Northwest Region",6,2,1003,1,1005,0,17,0,4
"07/24/2021","Y","Y","North Slope Borough",185,"Northwest Region",6,2,1005,2,1007,0,17,0,4
"07/26/2021","Y","Y","North Slope Borough",185,"Northwest Region",6,2,1007,1,1008,0,17,0,4
"07/27/2021","Y","Y","North Slope Borough",185,"Northwest Region",6,1,1008,4,1012,0,17,0,4
"07/28/2021","Y","Y","North Slope Borough",185,"Northwest Region",6,2,1010,0,1012,0,17,0,4
"07/29/2021","Y","Y","North Slope Borough",185,"Northwest Region",6,1,1011,1,1013,0,17,0,4
"07/30/2021","Y","Y","North Slope Borough",185,"Northwest Region",6,1,1012,2,1015,0,17,0,4
"07/31/2021","Y","Y","North Slope Borough",185,"Northwest Region",6,1,1013,0,1015,0,17,0,4
"08/01/2021","Y","Y","North Slope Borough",185,"Northwest Region",6,0,1013,1,1016,0,17,0,4
"08/02/2021","Y","Y","North Slope Borough",185,"Northwest Region",6,2,1015,4,1020,0,17,0,4
"08/03/2021","Y","Y","North Slope Borough",185,"Northwest Region",6,3,1018,5,1025,0,17,0,4
"08/04/2021","Y","Y","North Slope Borough",185,"Northwest Region",6,3,1021,3,1028,0,17,0,4
"08/05/2021","Y","Y","North Slope Borough",185,"Northwest Region",6,2,1023,6,1034,0,17,0,4
"08/06/2021","Y","Y","North Slope Borough",185,"Northwest Region",6,6,1029,7,1041,0,17,0,4
"08/07/2021","Y","Y","North Slope Borough",185,"Northwest Region",6,3,1032,0,1041,0,17,0,4
"08/08/2021","Y","Y","North Slope Borough",185,"Northwest Region",6,0,1032,1,1042,0,17,0,4
"08/09/2021","Y","Y","North Slope Borough",185,"Northwest Region",6,8,1040,13,1055,1,18,0,4
"08/10/2021","Y","Y","North Slope Borough",185,"Northwest Region",6,6,1046,2,1057,0,18,0,4
"08/11/2021","Y","Y","North Slope Borough",185,"Northwest Region",6,4,1050,6,1063,0,18,0,4
"08/12/2021","Y","Y","North Slope Borough",185,"Northwest Region",6,3,1053,4,1067,0,18,0,4
"08/13/2021","Y","Y","North Slope Borough",185,"Northwest Region",6,6,1059,7,1074,0,18,0,4
"08/14/2021","Y","Y","North Slope Borough",185,"Northwest Region",6,1,1060,3,1077,0,18,0,4
"08/15/2021","Y","Y","North Slope Borough",185,"Northwest Region",6,1,1061,3,1080,0,18,0,4
"08/16/2021","Y","Y","North Slope Borough",185,"Northwest Region",6,7,1068,16,1096,0,18,0,4
"08/17/2021","Y","Y","North Slope Borough",185,"Northwest Region",6,6,1074,7,1103,0,18,0,4
"08/18/2021","Y","Y","North Slope Borough",185,"Northwest Region",6,15,1089,11,1114,0,18,0,4
"08/19/2021","Y","Y","North Slope Borough",185,"Northwest Region",6,4,1093,14,1128,0,18,0,4
"08/20/2021","Y","Y","North Slope Borough",185,"Northwest Region",6,11,1104,7,1135,0,18,0,4
"08/21/2021","Y","Y","North Slope Borough",185,"Northwest Region",6,3,1107,3,1138,0,18,0,4
"08/22/2021","Y","Y","North Slope Borough",185,"Northwest Region",6,12,1119,10,1148,0,18,0,4
"08/23/2021","Y","Y","North Slope Borough",185,"Northwest Region",6,13,1132,26,1174,0,18,0,4
"08/24/2021","Y","Y","North Slope Borough",185,"Northwest Region",6,4,1136,15,1189,0,18,0,4
"08/25/2021","Y","Y","North Slope Borough",185,"Northwest Region",6,28,1164,9,1198,0,18,0,4
"08/26/2021","Y","Y","North Slope Borough",185,"Northwest Region",6,12,1176,14,1212,0,18,0,4
"08/27/2021","Y","Y","North Slope Borough",185,"Northwest Region",6,6,1182,26,1238,1,19,0,4
"08/28/2021","Y","Y","North Slope Borough",185,"Northwest Region",6,5,1187,12,1250,0,19,0,4
"08/29/2021","Y","Y","North Slope Borough",185,"Northwest Region",6,0,1187,16,1266,0,19,0,4
"08/30/2021","Y","Y","North Slope Borough",185,"Northwest Region",6,11,1198,39,1305,0,19,0,4
"08/31/2021","Y","Y","North Slope Borough",185,"Northwest Region",6,25,1223,58,1363,0,19,0,4
"09/01/2021","Y","Y","North Slope Borough",185,"Northwest Region",6,34,1257,38,1401,0,19,0,4
"09/02/2021","Y","Y","North Slope Borough",185,"Northwest Region",6,25,1282,18,1419,0,19,0,4
"09/03/2021","Y","Y","North Slope Borough",185,"Northwest Region",6,13,1295,30,1449,0,19,0,4
"09/04/2021","Y","Y","North Slope Borough",185,"Northwest Region",6,6,1301,20,1469,0,19,0,4
"09/05/2021","Y","Y","North Slope Borough",185,"Northwest Region",6,27,1328,18,1487,0,19,0,4
"09/06/2021","Y","Y","North Slope Borough",185,"Northwest Region",6,68,1396,27,1514,0,19,0,4
"09/07/2021","Y","Y","North Slope Borough",185,"Northwest Region",6,43,1439,30,1544,0,19,0,4
"09/08/2021","Y","Y","North Slope Borough",185,"Northwest Region",6,29,1468,46,1590,0,19,0,4
"09/09/2021","Y","Y","North Slope Borough",185,"Northwest Region",6,19,1487,54,1644,0,19,0,4
"09/10/2021","Y","Y","North Slope Borough",185,"Northwest Region",6,30,1517,41,1685,0,19,0,4
"09/11/2021","Y","Y","North Slope Borough",185,"Northwest Region",6,42,1559,39,1724,0,19,0,4
"09/12/2021","Y","Y","North Slope Borough",185,"Northwest Region",6,10,1569,23,1747,0,19,0,4
"09/13/2021","Y","Y","North Slope Borough",185,"Northwest Region",6,48,1617,46,1793,0,19,0,4
"09/14/2021","Y","Y","North Slope Borough",185,"Northwest Region",6,8,1625,61,1854,1,20,0,4
"09/15/2021","Y","Y","North Slope Borough",185,"Northwest Region",6,21,1646,35,1889,1,21,0,4
"09/16/2021","Y","Y","North Slope Borough",185,"Northwest Region",6,31,1677,46,1935,2,23,1,5
"09/17/2021","Y","Y","North Slope Borough",185,"Northwest Region",6,58,1735,25,1960,0,23,0,5
"09/18/2021","Y","Y","North Slope Borough",185,"Northwest Region",6,41,1776,12,1972,0,23,0,5
"09/19/2021","Y","Y","North Slope Borough",185,"Northwest Region",6,48,1824,9,1981,0,23,0,5
"09/20/2021","Y","Y","North Slope Borough",185,"Northwest Region",6,44,1868,23,2004,0,23,0,5
"09/21/2021","Y","Y","North Slope Borough",185,"Northwest Region",6,24,1892,25,2029,0,23,0,5
"09/22/2021","Y","Y","North Slope Borough",185,"Northwest Region",6,46,1938,14,2043,0,23,0,5
"09/23/2021","Y","Y","North Slope Borough",185,"Northwest Region",6,42,1980,45,2088,0,23,0,5
"09/24/2021","Y","Y","North Slope Borough",185,"Northwest Region",6,20,2000,20,2108,1,24,0,5
"09/25/2021","Y","Y","North Slope Borough",185,"Northwest Region",6,28,2028,4,2112,0,24,0,5
"09/26/2021","Y","Y","North Slope Borough",185,"Northwest Region",6,15,2043,5,2117,0,24,0,5
"09/27/2021","Y","Y","North Slope Borough",185,"Northwest Region",6,38,2081,28,2145,0,24,0,5
"09/28/2021","Y","Y","North Slope Borough",185,"Northwest Region",6,6,2087,29,2174,0,24,0,5
"09/29/2021","Y","Y","North Slope Borough",185,"Northwest Region",6,18,2105,12,2186,0,24,1,6
"09/30/2021","Y","Y","North Slope Borough",185,"Northwest Region",6,20,2125,8,2194,0,24,0,6
"10/01/2021","Y","Y","North Slope Borough",185,"Northwest Region",6,22,2147,17,2211,0,24,0,6
"10/02/2021","Y","Y","North Slope Borough",185,"Northwest Region",6,31,2178,2,2213,0,24,0,6
"10/03/2021","Y","Y","North Slope Borough",185,"Northwest Region",6,15,2193,2,2215,0,24,0,6
"10/04/2021","Y","Y","North Slope Borough",185,"Northwest Region",6,4,2197,17,2232,0,24,1,7
"10/05/2021","Y","Y","North Slope Borough",185,"Northwest Region",6,7,2204,10,2242,0,24,0,7
"10/06/2021","Y","Y","North Slope Borough",185,"Northwest Region",6,7,2211,9,2251,0,24,0,7
"10/07/2021","Y","Y","North Slope Borough",185,"Northwest Region",6,2,2213,4,2255,0,24,0,7
"10/08/2021","Y","Y","North Slope Borough",185,"Northwest Region",6,5,2218,11,2266,0,24,0,7
"10/09/2021","Y","Y","North Slope Borough",185,"Northwest Region",6,21,2239,0,2266,0,24,0,7
"10/10/2021","Y","Y","North Slope Borough",185,"Northwest Region",6,10,2249,9,2275,0,24,0,7
"10/11/2021","Y","Y","North Slope Borough",185,"Northwest Region",6,6,2255,5,2280,0,24,0,7
"10/12/2021","Y","Y","North Slope Borough",185,"Northwest Region",6,5,2260,12,2292,0,24,0,7
"10/13/2021","Y","Y","North Slope Borough",185,"Northwest Region",6,3,2263,9,2301,0,24,0,7
"10/14/2021","Y","Y","North Slope Borough",185,"Northwest Region",6,9,2272,12,2313,0,24,0,7
"10/15/2021","Y","Y","North Slope Borough",185,"Northwest Region",6,21,2293,8,2321,0,24,0,7
"10/16/2021","Y","Y","North Slope Borough",185,"Northwest Region",6,13,2306,6,2327,0,24,0,7
"10/17/2021","Y","Y","North Slope Borough",185,"Northwest Region",6,6,2312,4,2331,0,24,0,7
"10/18/2021","Y","Y","North Slope Borough",185,"Northwest Region",6,9,2321,7,2338,0,24,0,7
"10/19/2021","Y","Y","North Slope Borough",185,"Northwest Region",6,8,2329,24,2362,0,24,0,7
"10/20/2021","Y","Y","North Slope Borough",185,"Northwest Region",6,12,2341,6,2368,0,24,0,7
"10/21/2021","Y","Y","North Slope Borough",185,"Northwest Region",6,7,2348,19,2387,0,24,0,7
"10/22/2021","Y","Y","North Slope Borough",185,"Northwest Region",6,15,2363,5,2392,0,24,0,7
"10/23/2021","Y","Y","North Slope Borough",185,"Northwest Region",6,8,2371,7,2399,0,24,0,7
"10/24/2021","Y","Y","North Slope Borough",185,"Northwest Region",6,11,2382,5,2404,0,24,0,7
"10/25/2021","Y","Y","North Slope Borough",185,"Northwest Region",6,8,2390,14,2418,0,24,0,7
"10/26/2021","Y","Y","North Slope Borough",185,"Northwest Region",6,4,2394,19,2437,0,24,0,7
"10/27/2021","Y","Y","North Slope Borough",185,"Northwest Region",6,21,2415,10,2447,0,24,0,7
"10/28/2021","Y","Y","North Slope Borough",185,"Northwest Region",6,7,2422,17,2464,0,24,0,7
"10/29/2021","Y","Y","North Slope Borough",185,"Northwest Region",6,6,2428,6,2470,0,24,0,7
"10/30/2021","Y","Y","North Slope Borough",185,"Northwest Region",6,17,2445,2,2472,0,24,0,7
"10/31/2021","Y","Y","North Slope Borough",185,"Northwest Region",6,11,2456,10,2482,0,24,0,7
"11/01/2021","Y","Y","North Slope Borough",185,"Northwest Region",6,13,2469,9,2491,0,24,0,7
"11/02/2021","Y","Y","North Slope Borough",185,"Northwest Region",6,12,2481,2,2493,0,24,0,7
"11/03/2021","Y","Y","North Slope Borough",185,"Northwest Region",6,5,2486,7,2500,0,24,0,7
"11/04/2021","Y","Y","North Slope Borough",185,"Northwest Region",6,6,2492,7,2507,0,24,0,7
"11/05/2021","Y","Y","North Slope Borough",185,"Northwest Region",6,3,2495,0,2507,0,24,0,7
"11/06/2021","Y","Y","North Slope Borough",185,"Northwest Region",6,5,2500,1,2508,0,24,0,7
"11/07/2021","Y","Y","North Slope Borough",185,"Northwest Region",6,7,2507,4,2512,0,24,0,7
"11/08/2021","Y","Y","North Slope Borough",185,"Northwest Region",6,1,2508,1,2513,0,24,0,7
"11/09/2021","Y","Y","North Slope Borough",185,"Northwest Region",6,4,2512,2,2515,0,24,0,7
"11/10/2021","Y","Y","North Slope Borough",185,"Northwest Region",6,3,2515,7,2522,0,24,0,7
"11/11/2021","Y","Y","North Slope Borough",185,"Northwest Region",6,0,2515,15,2537,0,24,0,7
"11/12/2021","Y","Y","North Slope Borough",185,"Northwest Region",6,2,2517,3,2540,0,24,0,7
"11/13/2021","Y","Y","North Slope Borough",185,"Northwest Region",6,11,2528,1,2541,0,24,0,7
"11/14/2021","Y","Y","North Slope Borough",185,"Northwest Region",6,11,2539,3,2544,0,24,0,7
"11/15/2021","Y","Y","North Slope Borough",185,"Northwest Region",6,4,2543,5,2549,0,24,0,7
"11/16/2021","Y","Y","North Slope Borough",185,"Northwest Region",6,2,2545,5,2554,0,24,0,7
"11/17/2021","Y","Y","North Slope Borough",185,"Northwest Region",6,2,2547,9,2563,0,24,0,7
"11/18/2021","Y","Y","North Slope Borough",185,"Northwest Region",6,5,2552,26,2589,0,24,0,7
"11/19/2021","Y","Y","North Slope Borough",185,"Northwest Region",6,15,2567,12,2601,0,24,0,7
"11/20/2021","Y","Y","North Slope Borough",185,"Northwest Region",6,15,2582,1,2602,0,24,0,7
"11/21/2021","Y","Y","North Slope Borough",185,"Northwest Region",6,10,2592,6,2608,0,24,0,7
"11/22/2021","Y","Y","North Slope Borough",185,"Northwest Region",6,1,2593,6,2614,0,24,0,7
"11/23/2021","Y","Y","North Slope Borough",185,"Northwest Region",6,1,2594,6,2620,0,24,0,7
"11/24/2021","Y","Y","North Slope Borough",185,"Northwest Region",6,8,2602,3,2623,0,24,0,7
"11/25/2021","Y","Y","North Slope Borough",185,"Northwest Region",6,0,2602,1,2624,0,24,0,7
"11/26/2021","Y","Y","North Slope Borough",185,"Northwest Region",6,6,2608,7,2631,0,24,0,7
"11/27/2021","Y","Y","North Slope Borough",185,"Northwest Region",6,17,2625,0,2631,0,24,0,7
"11/28/2021","Y","Y","North Slope Borough",185,"Northwest Region",6,2,2627,1,2632,0,24,0,7
"11/29/2021","Y","Y","North Slope Borough",185,"Northwest Region",6,2,2629,5,2637,0,24,0,7
"11/30/2021","Y","Y","North Slope Borough",185,"Northwest Region",6,2,2631,1,2638,0,24,1,8
"12/01/2021","Y","Y","North Slope Borough",185,"Northwest Region",6,5,2636,0,2638,0,24,0,8
"12/02/2021","Y","Y","North Slope Borough",185,"Northwest Region",6,2,2638,0,2638,0,24,0,8
"12/03/2021","Y","Y","North Slope Borough",185,"Northwest Region",6,2,2640,2,2640,0,24,0,8
"12/06/2021","Y","Y","North Slope Borough",185,"Northwest Region",6,1,2641,4,2644,0,24,0,8
"12/07/2021","Y","Y","North Slope Borough",185,"Northwest Region",6,1,2642,0,2644,0,24,0,8
"12/08/2021","Y","Y","North Slope Borough",185,"Northwest Region",6,2,2644,1,2645,0,24,0,8
"12/09/2021","Y","Y","North Slope Borough",185,"Northwest Region",6,1,2645,3,2648,0,24,0,8
"12/10/2021","Y","Y","North Slope Borough",185,"Northwest Region",6,2,2647,0,2648,0,24,0,8
"12/12/2021","Y","Y","North Slope Borough",185,"Northwest Region",6,1,2648,1,2649,0,24,0,8
"12/13/2021","Y","Y","North Slope Borough",185,"Northwest Region",6,0,2648,3,2652,0,24,0,8
"12/14/2021","Y","Y","North Slope Borough",185,"Northwest Region",6,1,2649,0,2652,0,24,0,8
"12/15/2021","Y","Y","North Slope Borough",185,"Northwest Region",6,2,2651,4,2656,0,24,0,8
"12/19/2021","Y","Y","North Slope Borough",185,"Northwest Region",6,1,2652,0,2656,0,24,0,8
"12/20/2021","Y","Y","North Slope Borough",185,"Northwest Region",6,1,2653,1,2657,0,24,0,8
"12/21/2021","Y","Y","North Slope Borough",185,"Northwest Region",6,1,2654,1,2658,0,24,0,8
"12/22/2021","Y","Y","North Slope Borough",185,"Northwest Region",6,1,2655,0,2658,0,24,0,8
"12/23/2021","Y","Y","North Slope Borough",185,"Northwest Region",6,0,2655,2,2660,0,24,0,8
"12/25/2021","Y","Y","North Slope Borough",185,"Northwest Region",6,1,2656,1,2661,0,24,0,8
"12/26/2021","Y","Y","North Slope Borough",185,"Northwest Region",6,2,2658,1,2662,0,24,0,8
"12/27/2021","Y","Y","North Slope Borough",185,"Northwest Region",6,1,2659,5,2667,0,24,0,8
"12/28/2021","Y","Y","North Slope Borough",185,"Northwest Region",6,3,2662,9,2676,0,24,0,8
"12/29/2021","Y","Y","North Slope Borough",185,"Northwest Region",6,7,2669,2,2678,0,24,0,8
"12/30/2021","Y","Y","North Slope Borough",185,"Northwest Region",6,7,2676,10,2688,0,24,0,8
"12/31/2021","Y","Y","North Slope Borough",185,"Northwest Region",6,0,2676,6,2694,0,24,0,8
"01/01/2022","Y","Y","North Slope Borough",185,"Northwest Region",6,6,2682,2,2696,0,24,0,8
"01/02/2022","Y","Y","North Slope Borough",185,"Northwest Region",6,11,2693,9,2705,0,24,0,8
"01/03/2022","Y","Y","North Slope Borough",185,"Northwest Region",6,1,2694,12,2717,0,24,0,8
"01/04/2022","Y","Y","North Slope Borough",185,"Northwest Region",6,12,2706,19,2736,0,24,0,8
"01/05/2022","Y","Y","North Slope Borough",185,"Northwest Region",6,18,2724,22,2758,0,24,0,8
"01/06/2022","Y","Y","North Slope Borough",185,"Northwest Region",6,7,2731,11,2769,0,24,0,8
"01/07/2022","Y","Y","North Slope Borough",185,"Northwest Region",6,25,2756,25,2794,0,24,0,8
"01/08/2022","Y","Y","North Slope Borough",185,"Northwest Region",6,10,2766,15,2809,0,24,0,8
"01/09/2022","Y","Y","North Slope Borough",185,"Northwest Region",6,10,2776,21,2830,0,24,0,8
"01/10/2022","Y","Y","North Slope Borough",185,"Northwest Region",6,16,2792,29,2859,0,24,0,8
"01/11/2022","Y","Y","North Slope Borough",185,"Northwest Region",6,20,2812,20,2879,0,24,0,8
"01/12/2022","Y","Y","North Slope Borough",185,"Northwest Region",6,8,2820,34,2913,0,24,0,8
"01/13/2022","Y","Y","North Slope Borough",185,"Northwest Region",6,14,2834,37,2950,0,24,0,8
"01/14/2022","Y","Y","North Slope Borough",185,"Northwest Region",6,7,2841,32,2982,0,24,0,8
"01/15/2022","Y","Y","North Slope Borough",185,"Northwest Region",6,29,2870,15,2997,0,24,0,8
"01/16/2022","Y","Y","North Slope Borough",185,"Northwest Region",6,7,2877,38,3035,0,24,0,8
"01/17/2022","Y","Y","North Slope Borough",185,"Northwest Region",6,10,2887,34,3069,1,25,0,8
"01/18/2022","Y","Y","North Slope Borough",185,"Northwest Region",6,27,2914,40,3109,0,25,0,8
"01/19/2022","Y","Y","North Slope Borough",185,"Northwest Region",6,63,2977,32,3141,0,25,0,8
"01/20/2022","Y","Y","North Slope Borough",185,"Northwest Region",6,71,3048,37,3178,0,25,0,8
"01/21/2022","Y","Y","North Slope Borough",185,"Northwest Region",6,16,3064,29,3207,0,25,0,8
"01/22/2022","Y","Y","North Slope Borough",185,"Northwest Region",6,3,3067,23,3230,0,25,0,8
"01/23/2022","Y","Y","North Slope Borough",185,"Northwest Region",6,8,3075,23,3253,0,25,0,8
"01/24/2022","Y","Y","North Slope Borough",185,"Northwest Region",6,52,3127,61,3314,0,25,0,8
"01/25/2022","Y","Y","North Slope Borough",185,"Northwest Region",6,32,3159,11,3325,1,26,0,8
"01/26/2022","Y","Y","North Slope Borough",185,"Northwest Region",6,30,3189,34,3359,1,27,0,8
"01/27/2022","Y","Y","North Slope Borough",185,"Northwest Region",6,20,3209,27,3386,1,28,0,8
"01/28/2022","Y","Y","North Slope Borough",185,"Northwest Region",6,69,3278,25,3411,0,28,0,8
"01/29/2022","Y","Y","North Slope Borough",185,"Northwest Region",6,17,3295,29,3440,0,28,0,8
"01/30/2022","Y","Y","North Slope Borough",185,"Northwest Region",6,14,3309,21,3461,0,28,0,8
"01/31/2022","Y","Y","North Slope Borough",185,"Northwest Region",6,88,3397,38,3499,0,28,0,8
"02/01/2022","Y","Y","North Slope Borough",185,"Northwest Region",6,40,3437,47,3546,0,28,0,8
"02/02/2022","Y","Y","North Slope Borough",185,"Northwest Region",6,49,3486,59,3605,0,28,0,8
"02/03/2022","Y","Y","North Slope Borough",185,"Northwest Region",6,23,3509,14,3619,0,28,0,8
"02/04/2022","Y","Y","North Slope Borough",185,"Northwest Region",6,52,3561,37,3656,0,28,0,8
"02/05/2022","Y","Y","North Slope Borough",185,"Northwest Region",6,30,3591,16,3672,0,28,0,8
"02/06/2022","Y","Y","North Slope Borough",185,"Northwest Region",6,10,3601,14,3686,0,28,0,8
"02/07/2022","Y","Y","North Slope Borough",185,"Northwest Region",6,8,3609,23,3709,0,28,0,8
"02/08/2022","Y","Y","North Slope Borough",185,"Northwest Region",6,77,3686,16,3725,0,28,0,8
"02/09/2022","Y","Y","North Slope Borough",185,"Northwest Region",6,19,3705,14,3739,0,28,0,8
"02/10/2022","Y","Y","North Slope Borough",185,"Northwest Region",6,6,3711,32,3771,0,28,0,8
"02/11/2022","Y","Y","North Slope Borough",185,"Northwest Region",6,18,3729,18,3789,1,29,0,8
"02/12/2022","Y","Y","North Slope Borough",185,"Northwest Region",6,23,3752,4,3793,0,29,0,8
"02/13/2022","Y","Y","North Slope Borough",185,"Northwest Region",6,8,3760,5,3798,0,29,0,8
"02/14/2022","Y","Y","North Slope Borough",185,"Northwest Region",6,5,3765,20,3818,0,29,0,8
"02/15/2022","Y","Y","North Slope Borough",185,"Northwest Region",6,34,3799,17,3835,0,29,0,8
"02/16/2022","Y","Y","North Slope Borough",185,"Northwest Region",6,0,3799,9,3844,0,29,1,9
"02/17/2022","Y","Y","North Slope Borough",185,"Northwest Region",6,17,3816,8,3852,1,30,0,9
"02/18/2022","Y","Y","North Slope Borough",185,"Northwest Region",6,13,3829,14,3866,0,30,0,9
"02/19/2022","Y","Y","North Slope Borough",185,"Northwest Region",6,22,3851,4,3870,0,30,0,9
"02/20/2022","Y","Y","North Slope Borough",185,"Northwest Region",6,2,3853,4,3874,0,30,0,9
"02/21/2022","Y","Y","North Slope Borough",185,"Northwest Region",6,5,3858,4,3878,0,30,0,9
"02/22/2022","Y","Y","North Slope Borough",185,"Northwest Region",6,0,3858,10,3888,0,30,0,9
"02/23/2022","Y","Y","North Slope Borough",185,"Northwest Region",6,8,3866,2,3890,0,30,0,9
"02/24/2022","Y","Y","North Slope Borough",185,"Northwest Region",6,22,3888,8,3898,0,30,0,9
"02/25/2022","Y","Y","North Slope Borough",185,"Northwest Region",6,7,3895,8,3906,0,30,0,9
"02/26/2022","Y","Y","North Slope Borough",185,"Northwest Region",6,3,3898,3,3909,1,31,0,9
"02/27/2022","Y","Y","North Slope Borough",185,"Northwest Region",6,5,3903,5,3914,0,31,0,9
"02/28/2022","Y","Y","North Slope Borough",185,"Northwest Region",6,10,3913,5,3919,0,31,0,9
"03/01/2022","Y","Y","North Slope Borough",185,"Northwest Region",6,2,3915,2,3921,0,31,0,9
"03/02/2022","Y","Y","North Slope Borough",185,"Northwest Region",6,4,3919,2,3923,0,31,0,9
"03/03/2022","Y","Y","North Slope Borough",185,"Northwest Region",6,1,3920,1,3924,0,31,0,9
"03/04/2022","Y","Y","North Slope Borough",185,"Northwest Region",6,1,3921,1,3925,0,31,0,9
"03/05/2022","Y","Y","North Slope Borough",185,"Northwest Region",6,2,3923,0,3925,0,31,0,9
"03/06/2022","Y","Y","North Slope Borough",185,"Northwest Region",6,1,3924,0,3925,0,31,0,9
"03/07/2022","Y","Y","North Slope Borough",185,"Northwest Region",6,0,3924,8,3933,0,31,0,9
"03/08/2022","Y","Y","North Slope Borough",185,"Northwest Region",6,2,3926,3,3936,0,31,0,9
"03/09/2022","Y","Y","North Slope Borough",185,"Northwest Region",6,3,3929,3,3939,0,31,0,9
"03/10/2022","Y","Y","North Slope Borough",185,"Northwest Region",6,0,3929,1,3940,0,31,0,9
"03/11/2022","Y","Y","North Slope Borough",185,"Northwest Region",6,8,3937,4,3944,0,31,0,9
"03/12/2022","Y","Y","North Slope Borough",185,"Northwest Region",6,0,3937,1,3945,0,31,0,9
"03/13/2022","Y","Y","North Slope Borough",185,"Northwest Region",6,0,3937,1,3946,0,31,0,9
"03/14/2022","Y","Y","North Slope Borough",185,"Northwest Region",6,9,3946,0,3946,0,31,0,9
"03/15/2022","Y","Y","North Slope Borough",185,"Northwest Region",6,0,3946,1,3947,0,31,0,9
"03/16/2022","Y","Y","North Slope Borough",185,"Northwest Region",6,2,3948,1,3948,0,31,0,9
"03/17/2022","Y","Y","North Slope Borough",185,"Northwest Region",6,0,3948,1,3949,0,31,0,9
"03/18/2022","Y","Y","North Slope Borough",185,"Northwest Region",6,3,3951,4,3953,0,31,0,9
"03/19/2022","Y","Y","North Slope Borough",185,"Northwest Region",6,0,3951,1,3954,1,32,0,9
"03/20/2022","Y","Y","North Slope Borough",185,"Northwest Region",6,5,3956,4,3958,0,32,0,9
"03/21/2022","Y","Y","North Slope Borough",185,"Northwest Region",6,9,3965,9,3967,0,32,0,9
"03/22/2022","Y","Y","North Slope Borough",185,"Northwest Region",6,7,3972,8,3975,0,32,0,9
"03/23/2022","Y","Y","North Slope Borough",185,"Northwest Region",6,3,3975,4,3979,0,32,0,9
"03/24/2022","Y","Y","North Slope Borough",185,"Northwest Region",6,10,3985,8,3987,0,32,0,9
"03/25/2022","Y","Y","North Slope Borough",185,"Northwest Region",6,5,3990,4,3991,0,32,0,9
"03/26/2022","Y","Y","North Slope Borough",185,"Northwest Region",6,8,3998,8,3999,0,32,0,9
"03/27/2022","Y","Y","North Slope Borough",185,"Northwest Region",6,2,4000,5,4004,0,32,0,9
"03/28/2022","Y","Y","North Slope Borough",185,"Northwest Region",6,2,4002,4,4008,0,32,0,9
"03/29/2022","Y","Y","North Slope Borough",185,"Northwest Region",6,1,4003,2,4010,0,32,0,9
"03/30/2022","Y","Y","North Slope Borough",185,"Northwest Region",6,9,4012,6,4016,0,32,0,9
"03/31/2022","Y","Y","North Slope Borough",185,"Northwest Region",6,12,4024,11,4027,0,32,0,9
"04/01/2022","Y","Y","North Slope Borough",185,"Northwest Region",6,3,4027,3,4030,0,32,0,9
"04/02/2022","Y","Y","North Slope Borough",185,"Northwest Region",6,6,4033,3,4033,0,32,0,9
"04/03/2022","Y","Y","North Slope Borough",185,"Northwest Region",6,1,4034,6,4039,0,32,0,9
"04/04/2022","Y","Y","North Slope Borough",185,"Northwest Region",6,5,4039,1,4040,0,32,0,9
"04/05/2022","Y","Y","North Slope Borough",185,"Northwest Region",6,1,4040,1,4041,0,32,0,9
"04/06/2022","Y","Y","North Slope Borough",185,"Northwest Region",6,2,4042,1,4042,0,32,0,9
"04/07/2022","Y","Y","North Slope Borough",185,"Northwest Region",6,1,4043,1,4043,0,32,0,9
"04/08/2022","Y","Y","North Slope Borough",185,"Northwest Region",6,1,4044,1,4044,0,32,0,9
"04/09/2022","Y","Y","North Slope Borough",185,"Northwest Region",6,0,4044,1,4045,0,32,0,9
"04/10/2022","Y","Y","North Slope Borough",185,"Northwest Region",6,1,4045,1,4046,0,32,0,9
"04/11/2022","Y","Y","North Slope Borough",185,"Northwest Region",6,1,4046,1,4047,0,32,0,9
"04/12/2022","Y","Y","North Slope Borough",185,"Northwest Region",6,2,4048,3,4050,0,32,0,9
"04/13/2022","Y","Y","North Slope Borough",185,"Northwest Region",6,1,4049,0,4050,0,32,0,9
"04/14/2022","Y","Y","North Slope Borough",185,"Northwest Region",6,1,4050,1,4051,0,32,0,9
"04/15/2022","Y","Y","North Slope Borough",185,"Northwest Region",6,3,4053,3,4054,0,32,0,9
"04/16/2022","Y","Y","North Slope Borough",185,"Northwest Region",6,4,4057,3,4057,0,32,0,9
"04/19/2022","Y","Y","North Slope Borough",185,"Northwest Region",6,3,4060,5,4062,0,32,0,9
"04/21/2022","Y","Y","North Slope Borough",185,"Northwest Region",6,1,4061,0,4062,0,32,0,9
"04/22/2022","Y","Y","North Slope Borough",185,"Northwest Region",6,0,4061,2,4064,0,32,0,9
"04/23/2022","Y","Y","North Slope Borough",185,"Northwest Region",6,1,4062,0,4064,0,32,0,9
"04/24/2022","Y","Y","North Slope Borough",185,"Northwest Region",6,2,4064,0,4064,0,32,0,9
"05/19/2020","Y","Y","Northwest Arctic Borough",188,"Northwest Region",6,1,1,1,1,0,0,0,0
"05/21/2020","Y","Y","Northwest Arctic Borough",188,"Northwest Region",6,0,1,1,2,0,0,0,0
"05/22/2020","Y","Y","Northwest Arctic Borough",188,"Northwest Region",6,1,2,0,2,0,0,0,0
"06/03/2020","Y","Y","Northwest Arctic Borough",188,"Northwest Region",6,0,2,1,3,0,0,0,0
"06/05/2020","Y","Y","Northwest Arctic Borough",188,"Northwest Region",6,0,2,1,4,0,0,0,0
"06/08/2020","Y","Y","Northwest Arctic Borough",188,"Northwest Region",6,1,3,0,4,0,0,0,0
"06/10/2020","Y","Y","Northwest Arctic Borough",188,"Northwest Region",6,1,4,0,4,0,0,0,0
"06/26/2020","Y","Y","Northwest Arctic Borough",188,"Northwest Region",6,0,4,1,5,0,0,0,0
"06/30/2020","Y","Y","Northwest Arctic Borough",188,"Northwest Region",6,1,5,0,5,0,0,0,0
"07/06/2020","Y","Y","Northwest Arctic Borough",188,"Northwest Region",6,0,5,1,6,0,0,0,0
"07/07/2020","Y","Y","Northwest Arctic Borough",188,"Northwest Region",6,1,6,0,6,0,0,0,0
"07/11/2020","Y","Y","Northwest Arctic Borough",188,"Northwest Region",6,0,6,1,7,0,0,0,0
"07/12/2020","Y","Y","Northwest Arctic Borough",188,"Northwest Region",6,1,7,0,7,0,0,0,0
"07/15/2020","Y","Y","Northwest Arctic Borough",188,"Northwest Region",6,1,8,1,8,0,0,0,0
"07/17/2020","Y","Y","Northwest Arctic Borough",188,"Northwest Region",6,0,8,1,9,0,0,0,0
"07/19/2020","Y","Y","Northwest Arctic Borough",188,"Northwest Region",6,0,8,1,10,0,0,0,0
"07/20/2020","Y","Y","Northwest Arctic Borough",188,"Northwest Region",6,1,9,2,12,0,0,0,0
"07/21/2020","Y","Y","Northwest Arctic Borough",188,"Northwest Region",6,0,9,4,16,0,0,0,0
"07/22/2020","Y","Y","Northwest Arctic Borough",188,"Northwest Region",6,1,10,1,17,0,0,0,0
"07/23/2020","Y","Y","Northwest Arctic Borough",188,"Northwest Region",6,0,10,3,20,0,0,0,0
"07/24/2020","Y","Y","Northwest Arctic Borough",188,"Northwest Region",6,4,14,3,23,2,2,0,0
"07/25/2020","Y","Y","Northwest Arctic Borough",188,"Northwest Region",6,0,14,5,28,0,2,0,0
"07/26/2020","Y","Y","Northwest Arctic Borough",188,"Northwest Region",6,5,19,0,28,0,2,0,0
"07/27/2020","Y","Y","Northwest Arctic Borough",188,"Northwest Region",6,0,19,1,29,0,2,0,0
"07/28/2020","Y","Y","Northwest Arctic Borough",188,"Northwest Region",6,0,19,3,32,0,2,0,0
"07/29/2020","Y","Y","Northwest Arctic Borough",188,"Northwest Region",6,9,28,1,33,0,2,0,0
"07/31/2020","Y","Y","Northwest Arctic Borough",188,"Northwest Region",6,0,28,2,35,0,2,0,0
"08/01/2020","Y","Y","Northwest Arctic Borough",188,"Northwest Region",6,3,31,0,35,0,2,0,0
"08/02/2020","Y","Y","Northwest Arctic Borough",188,"Northwest Region",6,2,33,0,35,0,2,0,0
"08/03/2020","Y","Y","Northwest Arctic Borough",188,"Northwest Region",6,0,33,3,38,0,2,0,0
"08/04/2020","Y","Y","Northwest Arctic Borough",188,"Northwest Region",6,3,36,2,40,1,3,0,0
"08/05/2020","Y","Y","Northwest Arctic Borough",188,"Northwest Region",6,1,37,1,41,0,3,0,0
"08/06/2020","Y","Y","Northwest Arctic Borough",188,"Northwest Region",6,1,38,1,42,0,3,0,0
"08/08/2020","Y","Y","Northwest Arctic Borough",188,"Northwest Region",6,0,38,2,44,0,3,0,0
"08/09/2020","Y","Y","Northwest Arctic Borough",188,"Northwest Region",6,2,40,0,44,0,3,0,0
"08/10/2020","Y","Y","Northwest Arctic Borough",188,"Northwest Region",6,1,41,2,46,0,3,0,0
"08/12/2020","Y","Y","Northwest Arctic Borough",188,"Northwest Region",6,2,43,3,49,0,3,0,0
"08/13/2020","Y","Y","Northwest Arctic Borough",188,"Northwest Region",6,1,44,1,50,0,3,0,0
"08/14/2020","Y","Y","Northwest Arctic Borough",188,"Northwest Region",6,0,44,2,52,0,3,0,0
"08/15/2020","Y","Y","Northwest Arctic Borough",188,"Northwest Region",6,1,45,1,53,1,4,0,0
"08/16/2020","Y","Y","Northwest Arctic Borough",188,"Northwest Region",6,0,45,1,54,1,5,0,0
"08/17/2020","Y","Y","Northwest Arctic Borough",188,"Northwest Region",6,3,48,3,57,1,6,0,0
"08/18/2020","Y","Y","Northwest Arctic Borough",188,"Northwest Region",6,3,51,5,62,0,6,0,0
"08/19/2020","Y","Y","Northwest Arctic Borough",188,"Northwest Region",6,3,54,0,62,0,6,0,0
"08/20/2020","Y","Y","Northwest Arctic Borough",188,"Northwest Region",6,7,61,2,64,0,6,0,0
"08/21/2020","Y","Y","Northwest Arctic Borough",188,"Northwest Region",6,1,62,0,64,0,6,0,0
"08/22/2020","Y","Y","Northwest Arctic Borough",188,"Northwest Region",6,0,62,1,65,0,6,0,0
"08/24/2020","Y","Y","Northwest Arctic Borough",188,"Northwest Region",6,1,63,0,65,0,6,0,0
"08/25/2020","Y","Y","Northwest Arctic Borough",188,"Northwest Region",6,2,65,0,65,0,6,0,0
"08/27/2020","Y","Y","Northwest Arctic Borough",188,"Northwest Region",6,0,65,1,66,0,6,0,0
"08/28/2020","Y","Y","Northwest Arctic Borough",188,"Northwest Region",6,0,65,1,67,0,6,0,0
"08/29/2020","Y","Y","Northwest Arctic Borough",188,"Northwest Region",6,1,66,0,67,0,6,0,0
"08/30/2020","Y","Y","Northwest Arctic Borough",188,"Northwest Region",6,0,66,1,68,0,6,0,0
"08/31/2020","Y","Y","Northwest Arctic Borough",188,"Northwest Region",6,0,66,1,69,0,6,0,0
"09/02/2020","Y","Y","Northwest Arctic Borough",188,"Northwest Region",6,3,69,0,69,0,6,0,0
"09/03/2020","Y","Y","Northwest Arctic Borough",188,"Northwest Region",6,0,69,1,70,0,6,0,0
"09/04/2020","Y","Y","Northwest Arctic Borough",188,"Northwest Region",6,1,70,1,71,0,6,0,0
"09/05/2020","Y","Y","Northwest Arctic Borough",188,"Northwest Region",6,0,70,1,72,0,6,0,0
"09/07/2020","Y","Y","Northwest Arctic Borough",188,"Northwest Region",6,2,72,1,73,0,6,0,0
"09/08/2020","Y","Y","Northwest Arctic Borough",188,"Northwest Region",6,0,72,1,74,0,6,0,0
"09/09/2020","Y","Y","Northwest Arctic Borough",188,"Northwest Region",6,1,73,1,75,0,6,0,0
"09/12/2020","Y","Y","Northwest Arctic Borough",188,"Northwest Region",6,1,74,1,76,0,6,0,0
"09/15/2020","Y","Y","Northwest Arctic Borough",188,"Northwest Region",6,1,75,3,79,1,7,0,0
"09/16/2020","Y","Y","Northwest Arctic Borough",188,"Northwest Region",6,5,80,2,81,0,7,0,0
"09/17/2020","Y","Y","Northwest Arctic Borough",188,"Northwest Region",6,0,80,11,92,0,7,0,0
"09/18/2020","Y","Y","Northwest Arctic Borough",188,"Northwest Region",6,2,82,5,97,0,7,0,0
"09/19/2020","Y","Y","Northwest Arctic Borough",188,"Northwest Region",6,9,91,0,97,0,7,0,0
"09/20/2020","Y","Y","Northwest Arctic Borough",188,"Northwest Region",6,2,93,3,100,0,7,0,0
"09/21/2020","Y","Y","Northwest Arctic Borough",188,"Northwest Region",6,5,98,4,104,0,7,0,0
"09/22/2020","Y","Y","Northwest Arctic Borough",188,"Northwest Region",6,0,98,1,105,0,7,0,0
"09/23/2020","Y","Y","Northwest Arctic Borough",188,"Northwest Region",6,5,103,2,107,0,7,0,0
"09/24/2020","Y","Y","Northwest Arctic Borough",188,"Northwest Region",6,1,104,4,111,0,7,0,0
"09/25/2020","Y","Y","Northwest Arctic Borough",188,"Northwest Region",6,1,105,3,114,0,7,0,0
"09/26/2020","Y","Y","Northwest Arctic Borough",188,"Northwest Region",6,1,106,2,116,0,7,0,0
"09/27/2020","Y","Y","Northwest Arctic Borough",188,"Northwest Region",6,1,107,4,120,0,7,0,0
"09/28/2020","Y","Y","Northwest Arctic Borough",188,"Northwest Region",6,4,111,3,123,0,7,0,0
"09/29/2020","Y","Y","Northwest Arctic Borough",188,"Northwest Region",6,5,116,3,126,0,7,0,0
"09/30/2020","Y","Y","Northwest Arctic Borough",188,"Northwest Region",6,8,124,10,136,0,7,0,0
"10/01/2020","Y","Y","Northwest Arctic Borough",188,"Northwest Region",6,5,129,12,148,0,7,0,0
"10/02/2020","Y","Y","Northwest Arctic Borough",188,"Northwest Region",6,0,129,7,155,0,7,0,0
"10/03/2020","Y","Y","Northwest Arctic Borough",188,"Northwest Region",6,2,131,2,157,0,7,0,0
"10/04/2020","Y","Y","Northwest Arctic Borough",188,"Northwest Region",6,1,132,2,159,0,7,0,0
"10/05/2020","Y","Y","Northwest Arctic Borough",188,"Northwest Region",6,6,138,4,163,0,7,0,0
"10/06/2020","Y","Y","Northwest Arctic Borough",188,"Northwest Region",6,3,141,4,167,0,7,0,0
"10/07/2020","Y","Y","Northwest Arctic Borough",188,"Northwest Region",6,2,143,3,170,1,8,0,0
"10/08/2020","Y","Y","Northwest Arctic Borough",188,"Northwest Region",6,9,152,3,173,0,8,0,0
"10/09/2020","Y","Y","Northwest Arctic Borough",188,"Northwest Region",6,6,158,9,182,2,10,0,0
"10/10/2020","Y","Y","Northwest Arctic Borough",188,"Northwest Region",6,13,171,5,187,0,10,0,0
"10/11/2020","Y","Y","Northwest Arctic Borough",188,"Northwest Region",6,7,178,2,189,0,10,0,0
"10/12/2020","Y","Y","Northwest Arctic Borough",188,"Northwest Region",6,4,182,4,193,0,10,0,0
"10/13/2020","Y","Y","Northwest Arctic Borough",188,"Northwest Region",6,5,187,11,204,0,10,0,0
"10/14/2020","Y","Y","Northwest Arctic Borough",188,"Northwest Region",6,3,190,2,206,0,10,0,0
"10/15/2020","Y","Y","Northwest Arctic Borough",188,"Northwest Region",6,4,194,4,210,0,10,0,0
"10/16/2020","Y","Y","Northwest Arctic Borough",188,"Northwest Region",6,0,194,2,212,0,10,0,0
"10/17/2020","Y","Y","Northwest Arctic Borough",188,"Northwest Region",6,8,202,3,215,0,10,0,0
"10/18/2020","Y","Y","Northwest Arctic Borough",188,"Northwest Region",6,0,202,1,216,0,10,0,0
"10/19/2020","Y","Y","Northwest Arctic Borough",188,"Northwest Region",6,3,205,3,219,0,10,0,0
"10/20/2020","Y","Y","Northwest Arctic Borough",188,"Northwest Region",6,1,206,1,220,0,10,0,0
"10/21/2020","Y","Y","Northwest Arctic Borough",188,"Northwest Region",6,1,207,1,221,0,10,0,0
"10/22/2020","Y","Y","Northwest Arctic Borough",188,"Northwest Region",6,2,209,3,224,0,10,0,0
"10/23/2020","Y","Y","Northwest Arctic Borough",188,"Northwest Region",6,4,213,4,228,0,10,0,0
"10/24/2020","Y","Y","Northwest Arctic Borough",188,"Northwest Region",6,9,222,2,230,0,10,0,0
"10/25/2020","Y","Y","Northwest Arctic Borough",188,"Northwest Region",6,1,223,5,235,0,10,0,0
"10/26/2020","Y","Y","Northwest Arctic Borough",188,"Northwest Region",6,4,227,6,241,0,10,0,0
"10/27/2020","Y","Y","Northwest Arctic Borough",188,"Northwest Region",6,6,233,9,250,0,10,0,0
"10/28/2020","Y","Y","Northwest Arctic Borough",188,"Northwest Region",6,0,233,6,256,0,10,0,0
"10/29/2020","Y","Y","Northwest Arctic Borough",188,"Northwest Region",6,5,238,3,259,0,10,0,0
"10/30/2020","Y","Y","Northwest Arctic Borough",188,"Northwest Region",6,7,245,1,260,0,10,0,0
"10/31/2020","Y","Y","Northwest Arctic Borough",188,"Northwest Region",6,1,246,6,266,0,10,0,0
"11/01/2020","Y","Y","Northwest Arctic Borough",188,"Northwest Region",6,3,249,0,266,0,10,0,0
"11/02/2020","Y","Y","Northwest Arctic Borough",188,"Northwest Region",6,12,261,0,266,0,10,0,0
"11/03/2020","Y","Y","Northwest Arctic Borough",188,"Northwest Region",6,5,266,1,267,0,10,0,0
"11/04/2020","Y","Y","Northwest Arctic Borough",188,"Northwest Region",6,0,266,5,272,0,10,0,0
"11/05/2020","Y","Y","Northwest Arctic Borough",188,"Northwest Region",6,1,267,0,272,0,10,0,0
"11/06/2020","Y","Y","Northwest Arctic Borough",188,"Northwest Region",6,3,270,6,278,0,10,0,0
"11/07/2020","Y","Y","Northwest Arctic Borough",188,"Northwest Region",6,2,272,1,279,0,10,0,0
"11/08/2020","Y","Y","Northwest Arctic Borough",188,"Northwest Region",6,1,273,2,281,0,10,0,0
"11/09/2020","Y","Y","Northwest Arctic Borough",188,"Northwest Region",6,5,278,5,286,0,10,0,0
"11/10/2020","Y","Y","Northwest Arctic Borough",188,"Northwest Region",6,3,281,2,288,0,10,0,0
"11/11/2020","Y","Y","Northwest Arctic Borough",188,"Northwest Region",6,3,284,2,290,0,10,0,0
"11/12/2020","Y","Y","Northwest Arctic Borough",188,"Northwest Region",6,2,286,0,290,0,10,0,0
"11/13/2020","Y","Y","Northwest Arctic Borough",188,"Northwest Region",6,1,287,3,293,0,10,0,0
"11/14/2020","Y","Y","Northwest Arctic Borough",188,"Northwest Region",6,2,289,3,296,1,11,0,0
"11/15/2020","Y","Y","Northwest Arctic Borough",188,"Northwest Region",6,3,292,3,299,0,11,0,0
"11/16/2020","Y","Y","Northwest Arctic Borough",188,"Northwest Region",6,1,293,6,305,0,11,0,0
"11/17/2020","Y","Y","Northwest Arctic Borough",188,"Northwest Region",6,3,296,7,312,0,11,0,0
"11/18/2020","Y","Y","Northwest Arctic Borough",188,"Northwest Region",6,4,300,9,321,0,11,0,0
"11/19/2020","Y","Y","Northwest Arctic Borough",188,"Northwest Region",6,9,309,8,329,0,11,0,0
"11/20/2020","Y","Y","Northwest Arctic Borough",188,"Northwest Region",6,11,320,2,331,0,11,0,0
"11/21/2020","Y","Y","Northwest Arctic Borough",188,"Northwest Region",6,1,321,2,333,0,11,0,0
"11/22/2020","Y","Y","Northwest Arctic Borough",188,"Northwest Region",6,7,328,1,334,0,11,0,0
"11/23/2020","Y","Y","Northwest Arctic Borough",188,"Northwest Region",6,4,332,0,334,0,11,0,0
"11/24/2020","Y","Y","Northwest Arctic Borough",188,"Northwest Region",6,0,332,2,336,0,11,0,0
"11/25/2020","Y","Y","Northwest Arctic Borough",188,"Northwest Region",6,0,332,5,341,0,11,0,0
"11/26/2020","Y","Y","Northwest Arctic Borough",188,"Northwest Region",6,1,333,0,341,0,11,0,0
"11/27/2020","Y","Y","Northwest Arctic Borough",188,"Northwest Region",6,5,338,2,343,0,11,0,0
"11/28/2020","Y","Y","Northwest Arctic Borough",188,"Northwest Region",6,3,341,0,343,0,11,0,0
"11/29/2020","Y","Y","Northwest Arctic Borough",188,"Northwest Region",6,0,341,1,344,0,11,0,0
"11/30/2020","Y","Y","Northwest Arctic Borough",188,"Northwest Region",6,2,343,5,349,0,11,0,0
"12/01/2020","Y","Y","Northwest Arctic Borough",188,"Northwest Region",6,0,343,3,352,0,11,0,0
"12/02/2020","Y","Y","Northwest Arctic Borough",188,"Northwest Region",6,4,347,3,355,0,11,0,0
"12/03/2020","Y","Y","Northwest Arctic Borough",188,"Northwest Region",6,4,351,0,355,0,11,0,0
"12/04/2020","Y","Y","Northwest Arctic Borough",188,"Northwest Region",6,1,352,1,356,0,11,0,0
"12/05/2020","Y","Y","Northwest Arctic Borough",188,"Northwest Region",6,2,354,3,359,0,11,0,0
"12/06/2020","Y","Y","Northwest Arctic Borough",188,"Northwest Region",6,0,354,2,361,0,11,0,0
"12/07/2020","Y","Y","Northwest Arctic Borough",188,"Northwest Region",6,3,357,2,363,0,11,0,0
"12/08/2020","Y","Y","Northwest Arctic Borough",188,"Northwest Region",6,2,359,1,364,0,11,0,0
"12/09/2020","Y","Y","Northwest Arctic Borough",188,"Northwest Region",6,4,363,2,366,0,11,0,0
"12/11/2020","Y","Y","Northwest Arctic Borough",188,"Northwest Region",6,2,365,2,368,0,11,0,0
"12/12/2020","Y","Y","Northwest Arctic Borough",188,"Northwest Region",6,1,366,0,368,0,11,0,0
"12/13/2020","Y","Y","Northwest Arctic Borough",188,"Northwest Region",6,1,367,0,368,0,11,0,0
"12/14/2020","Y","Y","Northwest Arctic Borough",188,"Northwest Region",6,0,367,2,370,0,11,0,0
"12/15/2020","Y","Y","Northwest Arctic Borough",188,"Northwest Region",6,0,367,1,371,0,11,0,0
"12/16/2020","Y","Y","Northwest Arctic Borough",188,"Northwest Region",6,2,369,0,371,0,11,0,0
"12/18/2020","Y","Y","Northwest Arctic Borough",188,"Northwest Region",6,0,369,3,374,0,11,0,0
"12/19/2020","Y","Y","Northwest Arctic Borough",188,"Northwest Region",6,2,371,0,374,0,11,0,0
"12/21/2020","Y","Y","Northwest Arctic Borough",188,"Northwest Region",6,1,372,1,375,0,11,0,0
"12/22/2020","Y","Y","Northwest Arctic Borough",188,"Northwest Region",6,2,374,0,375,0,11,0,0
"12/24/2020","Y","Y","Northwest Arctic Borough",188,"Northwest Region",6,1,375,1,376,0,11,0,0
"12/25/2020","Y","Y","Northwest Arctic Borough",188,"Northwest Region",6,0,375,1,377,0,11,0,0
"12/27/2020","Y","Y","Northwest Arctic Borough",188,"Northwest Region",6,1,376,0,377,0,11,0,0
"12/28/2020","Y","Y","Northwest Arctic Borough",188,"Northwest Region",6,0,376,2,379,0,11,0,0
"12/30/2020","Y","Y","Northwest Arctic Borough",188,"Northwest Region",6,0,376,2,381,0,11,0,0
"12/31/2020","Y","Y","Northwest Arctic Borough",188,"Northwest Region",6,3,379,0,381,0,11,0,0
"01/01/2021","Y","Y","Northwest Arctic Borough",188,"Northwest Region",6,2,381,0,381,0,11,0,0
"01/02/2021","Y","Y","Northwest Arctic Borough",188,"Northwest Region",6,0,381,3,384,0,11,0,0
"01/03/2021","Y","Y","Northwest Arctic Borough",188,"Northwest Region",6,0,381,4,388,0,11,0,0
"01/04/2021","Y","Y","Northwest Arctic Borough",188,"Northwest Region",6,4,385,36,424,0,11,0,0
"01/05/2021","Y","Y","Northwest Arctic Borough",188,"Northwest Region",6,8,393,19,443,0,11,0,0
"01/06/2021","Y","Y","Northwest Arctic Borough",188,"Northwest Region",6,30,423,15,458,1,12,0,0
"01/07/2021","Y","Y","Northwest Arctic Borough",188,"Northwest Region",6,17,440,8,466,0,12,0,0
"01/08/2021","Y","Y","Northwest Arctic Borough",188,"Northwest Region",6,15,455,8,474,0,12,0,0
"01/09/2021","Y","Y","Northwest Arctic Borough",188,"Northwest Region",6,4,459,5,479,0,12,0,0
"01/10/2021","Y","Y","Northwest Arctic Borough",188,"Northwest Region",6,9,468,5,484,1,13,0,0
"01/11/2021","Y","Y","Northwest Arctic Borough",188,"Northwest Region",6,1,469,1,485,0,13,0,0
"01/12/2021","Y","Y","Northwest Arctic Borough",188,"Northwest Region",6,10,479,11,496,2,15,0,0
"01/13/2021","Y","Y","Northwest Arctic Borough",188,"Northwest Region",6,2,481,4,500,0,15,0,0
"01/14/2021","Y","Y","Northwest Arctic Borough",188,"Northwest Region",6,13,494,8,508,1,16,0,0
"01/15/2021","Y","Y","Northwest Arctic Borough",188,"Northwest Region",6,1,495,7,515,0,16,0,0
"01/16/2021","Y","Y","Northwest Arctic Borough",188,"Northwest Region",6,4,499,2,517,0,16,0,0
"01/17/2021","Y","Y","Northwest Arctic Borough",188,"Northwest Region",6,12,511,0,517,0,16,0,0
"01/18/2021","Y","Y","Northwest Arctic Borough",188,"Northwest Region",6,5,516,2,519,0,16,0,0
"01/19/2021","Y","Y","Northwest Arctic Borough",188,"Northwest Region",6,0,516,17,536,0,16,0,0
"01/20/2021","Y","Y","Northwest Arctic Borough",188,"Northwest Region",6,1,517,3,539,0,16,0,0
"01/21/2021","Y","Y","Northwest Arctic Borough",188,"Northwest Region",6,18,535,2,541,0,16,0,0
"01/22/2021","Y","Y","Northwest Arctic Borough",188,"Northwest Region",6,1,536,5,546,0,16,0,0
"01/23/2021","Y","Y","Northwest Arctic Borough",188,"Northwest Region",6,3,539,2,548,0,16,0,0
"01/24/2021","Y","Y","Northwest Arctic Borough",188,"Northwest Region",6,7,546,0,548,0,16,1,1
"01/25/2021","Y","Y","Northwest Arctic Borough",188,"Northwest Region",6,1,547,0,548,0,16,0,1
"01/27/2021","Y","Y","Northwest Arctic Borough",188,"Northwest Region",6,0,547,1,549,0,16,0,1
"01/28/2021","Y","Y","Northwest Arctic Borough",188,"Northwest Region",6,0,547,2,551,0,16,0,1
"01/29/2021","Y","Y","Northwest Arctic Borough",188,"Northwest Region",6,1,548,1,552,0,16,0,1
"01/30/2021","Y","Y","Northwest Arctic Borough",188,"Northwest Region",6,2,550,0,552,0,16,0,1
"01/31/2021","Y","Y","Northwest Arctic Borough",188,"Northwest Region",6,1,551,0,552,0,16,0,1
"02/02/2021","Y","Y","Northwest Arctic Borough",188,"Northwest Region",6,0,551,1,553,0,16,0,1
"02/05/2021","Y","Y","Northwest Arctic Borough",188,"Northwest Region",6,1,552,1,554,0,16,0,1
"02/07/2021","Y","Y","Northwest Arctic Borough",188,"Northwest Region",6,1,553,1,555,0,16,0,1
"02/08/2021","Y","Y","Northwest Arctic Borough",188,"Northwest Region",6,1,554,1,556,0,16,0,1
"02/09/2021","Y","Y","Northwest Arctic Borough",188,"Northwest Region",6,0,554,0,556,0,16,1,2
"02/10/2021","Y","Y","Northwest Arctic Borough",188,"Northwest Region",6,1,555,0,556,0,16,0,2
"02/11/2021","Y","Y","Northwest Arctic Borough",188,"Northwest Region",6,0,555,2,558,0,16,0,2
"02/12/2021","Y","Y","Northwest Arctic Borough",188,"Northwest Region",6,1,556,0,558,0,16,0,2
"02/13/2021","Y","Y","Northwest Arctic Borough",188,"Northwest Region",6,2,558,0,558,0,16,0,2
"02/18/2021","Y","Y","Northwest Arctic Borough",188,"Northwest Region",6,0,558,1,559,0,16,0,2
"02/19/2021","Y","Y","Northwest Arctic Borough",188,"Northwest Region",6,0,558,1,560,0,16,0,2
"02/20/2021","Y","Y","Northwest Arctic Borough",188,"Northwest Region",6,2,560,0,560,0,16,0,2
"02/21/2021","Y","Y","Northwest Arctic Borough",188,"Northwest Region",6,0,560,1,561,0,16,0,2
"02/23/2021","Y","Y","Northwest Arctic Borough",188,"Northwest Region",6,1,561,0,561,0,16,0,2
"03/04/2021","Y","Y","Northwest Arctic Borough",188,"Northwest Region",6,0,561,1,562,0,16,0,2
"03/05/2021","Y","Y","Northwest Arctic Borough",188,"Northwest Region",6,0,561,2,564,0,16,0,2
"03/06/2021","Y","Y","Northwest Arctic Borough",188,"Northwest Region",6,1,562,0,564,0,16,0,2
"03/07/2021","Y","Y","Northwest Arctic Borough",188,"Northwest Region",6,2,564,0,564,0,16,0,2
"03/10/2021","Y","Y","Northwest Arctic Borough",188,"Northwest Region",6,0,564,2,566,0,16,0,2
"03/12/2021","Y","Y","Northwest Arctic Borough",188,"Northwest Region",6,2,566,1,567,0,16,0,2
"03/14/2021","Y","Y","Northwest Arctic Borough",188,"Northwest Region",6,1,567,0,567,0,16,0,2
"03/19/2021","Y","Y","Northwest Arctic Borough",188,"Northwest Region",6,0,567,1,568,0,16,0,2
"03/20/2021","Y","Y","Northwest Arctic Borough",188,"Northwest Region",6,1,568,0,568,0,16,0,2
"04/03/2021","Y","Y","Northwest Arctic Borough",188,"Northwest Region",6,0,568,1,569,0,16,0,2
"04/05/2021","Y","Y","Northwest Arctic Borough",188,"Northwest Region",6,0,568,2,571,0,16,0,2
"04/06/2021","Y","Y","Northwest Arctic Borough",188,"Northwest Region",6,0,568,1,572,0,16,0,2
"04/07/2021","Y","Y","Northwest Arctic Borough",188,"Northwest Region",6,2,570,0,572,0,16,0,2
"04/08/2021","Y","Y","Northwest Arctic Borough",188,"Northwest Region",6,2,572,0,572,0,16,0,2
"04/12/2021","Y","Y","Northwest Arctic Borough",188,"Northwest Region",6,0,572,1,573,0,16,0,2
"04/13/2021","Y","Y","Northwest Arctic Borough",188,"Northwest Region",6,0,572,2,575,0,16,0,2
"04/15/2021","Y","Y","Northwest Arctic Borough",188,"Northwest Region",6,1,573,0,575,0,16,0,2
"04/16/2021","Y","Y","Northwest Arctic Borough",188,"Northwest Region",6,1,574,0,575,0,16,0,2
"04/19/2021","Y","Y","Northwest Arctic Borough",188,"Northwest Region",6,0,574,1,576,0,16,0,2
"04/20/2021","Y","Y","Northwest Arctic Borough",188,"Northwest Region",6,0,574,1,577,0,16,0,2
"04/21/2021","Y","Y","Northwest Arctic Borough",188,"Northwest Region",6,2,576,1,578,0,16,0,2
"04/23/2021","Y","Y","Northwest Arctic Borough",188,"Northwest Region",6,2,578,5,583,0,16,0,2
"04/25/2021","Y","Y","Northwest Arctic Borough",188,"Northwest Region",6,5,583,0,583,0,16,0,2
"04/27/2021","Y","Y","Northwest Arctic Borough",188,"Northwest Region",6,0,583,1,584,0,16,0,2
"04/28/2021","Y","Y","Northwest Arctic Borough",188,"Northwest Region",6,0,583,1,585,0,16,0,2
"04/29/2021","Y","Y","Northwest Arctic Borough",188,"Northwest Region",6,1,584,0,585,0,16,0,2
"04/30/2021","Y","Y","Northwest Arctic Borough",188,"Northwest Region",6,0,584,2,587,0,16,0,2
"05/01/2021","Y","Y","Northwest Arctic Borough",188,"Northwest Region",6,1,585,0,587,0,16,0,2
"05/02/2021","Y","Y","Northwest Arctic Borough",188,"Northwest Region",6,2,587,0,587,0,16,0,2
"05/04/2021","Y","Y","Northwest Arctic Borough",188,"Northwest Region",6,0,587,1,588,0,16,0,2
"05/06/2021","Y","Y","Northwest Arctic Borough",188,"Northwest Region",6,1,588,0,588,0,16,0,2
"05/11/2021","Y","Y","Northwest Arctic Borough",188,"Northwest Region",6,0,588,1,589,0,16,0,2
"05/13/2021","Y","Y","Northwest Arctic Borough",188,"Northwest Region",6,1,589,0,589,0,16,0,2
"05/19/2021","Y","Y","Northwest Arctic Borough",188,"Northwest Region",6,0,589,1,590,0,16,0,2
"05/21/2021","Y","Y","Northwest Arctic Borough",188,"Northwest Region",6,1,590,0,590,0,16,0,2
"06/01/2021","Y","Y","Northwest Arctic Borough",188,"Northwest Region",6,0,590,2,592,0,16,0,2
"06/03/2021","Y","Y","Northwest Arctic Borough",188,"Northwest Region",6,2,592,0,592,0,16,0,2
"06/07/2021","Y","Y","Northwest Arctic Borough",188,"Northwest Region",6,0,592,1,593,0,16,0,2
"06/11/2021","Y","Y","Northwest Arctic Borough",188,"Northwest Region",6,0,592,1,594,0,16,0,2
"06/13/2021","Y","Y","Northwest Arctic Borough",188,"Northwest Region",6,1,593,0,594,0,16,0,2
"06/20/2021","Y","Y","Northwest Arctic Borough",188,"Northwest Region",6,1,594,0,594,0,16,0,2
"06/23/2021","Y","Y","Northwest Arctic Borough",188,"Northwest Region",6,0,594,1,595,1,17,0,2
"06/24/2021","Y","Y","Northwest Arctic Borough",188,"Northwest Region",6,1,595,0,595,0,17,0,2
"06/25/2021","Y","Y","Northwest Arctic Borough",188,"Northwest Region",6,0,595,1,596,0,17,0,2
"06/27/2021","Y","Y","Northwest Arctic Borough",188,"Northwest Region",6,1,596,0,596,0,17,0,2
"07/08/2021","Y","Y","Northwest Arctic Borough",188,"Northwest Region",6,0,596,1,597,0,17,0,2
"07/10/2021","Y","Y","Northwest Arctic Borough",188,"Northwest Region",6,1,597,0,597,0,17,0,2
"07/12/2021","Y","Y","Northwest Arctic Borough",188,"Northwest Region",6,0,597,1,598,0,17,0,2
"07/13/2021","Y","Y","Northwest Arctic Borough",188,"Northwest Region",6,0,597,1,599,0,17,0,2
"07/14/2021","Y","Y","Northwest Arctic Borough",188,"Northwest Region",6,1,598,0,599,0,17,0,2
"07/15/2021","Y","Y","Northwest Arctic Borough",188,"Northwest Region",6,1,599,2,601,0,17,0,2
"07/16/2021","Y","Y","Northwest Arctic Borough",188,"Northwest Region",6,1,600,1,602,0,17,0,2
"07/17/2021","Y","Y","Northwest Arctic Borough",188,"Northwest Region",6,1,601,0,602,0,17,0,2
"07/21/2021","Y","Y","Northwest Arctic Borough",188,"Northwest Region",6,1,602,0,602,0,17,0,2
"07/25/2021","Y","Y","Northwest Arctic Borough",188,"Northwest Region",6,0,602,1,603,1,18,0,2
"07/26/2021","Y","Y","Northwest Arctic Borough",188,"Northwest Region",6,0,602,3,606,0,18,0,2
"07/27/2021","Y","Y","Northwest Arctic Borough",188,"Northwest Region",6,2,604,2,608,0,18,0,2
"07/28/2021","Y","Y","Northwest Arctic Borough",188,"Northwest Region",6,1,605,8,616,0,18,0,2
"07/29/2021","Y","Y","Northwest Arctic Borough",188,"Northwest Region",6,0,605,12,628,0,18,0,2
"07/30/2021","Y","Y","Northwest Arctic Borough",188,"Northwest Region",6,6,611,8,636,0,18,0,2
"07/31/2021","Y","Y","Northwest Arctic Borough",188,"Northwest Region",6,4,615,1,637,0,18,0,2
"08/01/2021","Y","Y","Northwest Arctic Borough",188,"Northwest Region",6,13,628,2,639,0,18,0,2
"08/02/2021","Y","Y","Northwest Arctic Borough",188,"Northwest Region",6,10,638,8,647,0,18,0,2
"08/03/2021","Y","Y","Northwest Arctic Borough",188,"Northwest Region",6,2,640,3,650,0,18,0,2
"08/04/2021","Y","Y","Northwest Arctic Borough",188,"Northwest Region",6,1,641,5,655,0,18,0,2
"08/05/2021","Y","Y","Northwest Arctic Borough",188,"Northwest Region",6,6,647,4,659,0,18,0,2
"08/06/2021","Y","Y","Northwest Arctic Borough",188,"Northwest Region",6,2,649,1,660,0,18,0,2
"08/07/2021","Y","Y","Northwest Arctic Borough",188,"Northwest Region",6,7,656,0,660,0,18,0,2
"08/08/2021","Y","Y","Northwest Arctic Borough",188,"Northwest Region",6,1,657,1,661,0,18,0,2
"08/09/2021","Y","Y","Northwest Arctic Borough",188,"Northwest Region",6,0,657,15,676,0,18,0,2
"08/10/2021","Y","Y","Northwest Arctic Borough",188,"Northwest Region",6,2,659,17,693,0,18,0,2
"08/11/2021","Y","Y","Northwest Arctic Borough",188,"Northwest Region",6,3,662,15,708,1,19,0,2
"08/12/2021","Y","Y","Northwest Arctic Borough",188,"Northwest Region",6,0,662,10,718,0,19,0,2
"08/13/2021","Y","Y","Northwest Arctic Borough",188,"Northwest Region",6,3,665,7,725,0,19,0,2
"08/14/2021","Y","Y","Northwest Arctic Borough",188,"Northwest Region",6,7,672,2,727,0,19,0,2
"08/15/2021","Y","Y","Northwest Arctic Borough",188,"Northwest Region",6,18,690,2,729,0,19,0,2
"08/16/2021","Y","Y","Northwest Arctic Borough",188,"Northwest Region",6,17,707,10,739,0,19,1,3
"08/17/2021","Y","Y","Northwest Arctic Borough",188,"Northwest Region",6,19,726,4,743,1,20,0,3
"08/18/2021","Y","Y","Northwest Arctic Borough",188,"Northwest Region",6,6,732,14,757,0,20,0,3
"08/19/2021","Y","Y","Northwest Arctic Borough",188,"Northwest Region",6,1,733,3,760,0,20,1,4
"08/20/2021","Y","Y","Northwest Arctic Borough",188,"Northwest Region",6,10,743,11,771,0,20,0,4
"08/21/2021","Y","Y","Northwest Arctic Borough",188,"Northwest Region",6,0,743,1,772,0,20,0,4
"08/22/2021","Y","Y","Northwest Arctic Borough",188,"Northwest Region",6,3,746,7,779,1,21,0,4
"08/23/2021","Y","Y","Northwest Arctic Borough",188,"Northwest Region",6,12,758,12,791,0,21,0,4
"08/24/2021","Y","Y","Northwest Arctic Borough",188,"Northwest Region",6,6,764,18,809,0,21,0,4
"08/25/2021","Y","Y","Northwest Arctic Borough",188,"Northwest Region",6,16,780,2,811,0,21,0,4
"08/26/2021","Y","Y","Northwest Arctic Borough",188,"Northwest Region",6,1,781,14,825,0,21,0,4
"08/27/2021","Y","Y","Northwest Arctic Borough",188,"Northwest Region",6,1,782,5,830,0,21,0,4
"08/28/2021","Y","Y","Northwest Arctic Borough",188,"Northwest Region",6,13,795,4,834,0,21,0,4
"08/29/2021","Y","Y","Northwest Arctic Borough",188,"Northwest Region",6,5,800,2,836,0,21,0,4
"08/30/2021","Y","Y","Northwest Arctic Borough",188,"Northwest Region",6,11,811,7,843,0,21,0,4
"08/31/2021","Y","Y","Northwest Arctic Borough",188,"Northwest Region",6,20,831,13,856,1,22,0,4
"09/01/2021","Y","Y","Northwest Arctic Borough",188,"Northwest Region",6,9,840,6,862,0,22,0,4
"09/02/2021","Y","Y","Northwest Arctic Borough",188,"Northwest Region",6,9,849,11,873,1,23,0,4
"09/03/2021","Y","Y","Northwest Arctic Borough",188,"Northwest Region",6,6,855,9,882,0,23,0,4
"09/04/2021","Y","Y","Northwest Arctic Borough",188,"Northwest Region",6,8,863,1,883,0,23,0,4
"09/05/2021","Y","Y","Northwest Arctic Borough",188,"Northwest Region",6,5,868,0,883,0,23,0,4
"09/06/2021","Y","Y","Northwest Arctic Borough",188,"Northwest Region",6,1,869,2,885,0,23,0,4
"09/07/2021","Y","Y","Northwest Arctic Borough",188,"Northwest Region",6,7,876,3,888,0,23,0,4
"09/08/2021","Y","Y","Northwest Arctic Borough",188,"Northwest Region",6,4,880,1,889,0,23,0,4
"09/09/2021","Y","Y","Northwest Arctic Borough",188,"Northwest Region",6,4,884,2,891,0,23,0,4
"09/10/2021","Y","Y","Northwest Arctic Borough",188,"Northwest Region",6,2,886,10,901,0,23,0,4
"09/11/2021","Y","Y","Northwest Arctic Borough",188,"Northwest Region",6,2,888,2,903,0,23,0,4
"09/12/2021","Y","Y","Northwest Arctic Borough",188,"Northwest Region",6,9,897,3,906,0,23,0,4
"09/13/2021","Y","Y","Northwest Arctic Borough",188,"Northwest Region",6,2,899,6,912,0,23,0,4
"09/14/2021","Y","Y","Northwest Arctic Borough",188,"Northwest Region",6,3,902,7,919,0,23,0,4
"09/15/2021","Y","Y","Northwest Arctic Borough",188,"Northwest Region",6,7,909,18,937,0,23,0,4
"09/16/2021","Y","Y","Northwest Arctic Borough",188,"Northwest Region",6,4,913,15,952,0,23,0,4
"09/17/2021","Y","Y","Northwest Arctic Borough",188,"Northwest Region",6,12,925,13,965,0,23,0,4
"09/18/2021","Y","Y","Northwest Arctic Borough",188,"Northwest Region",6,15,940,15,980,0,23,1,5
"09/19/2021","Y","Y","Northwest Arctic Borough",188,"Northwest Region",6,12,952,9,989,0,23,0,5
"09/20/2021","Y","Y","Northwest Arctic Borough",188,"Northwest Region",6,16,968,24,1013,0,23,0,5
"09/21/2021","Y","Y","Northwest Arctic Borough",188,"Northwest Region",6,12,980,46,1059,0,23,0,5
"09/22/2021","Y","Y","Northwest Arctic Borough",188,"Northwest Region",6,28,1008,44,1103,0,23,0,5
"09/23/2021","Y","Y","Northwest Arctic Borough",188,"Northwest Region",6,46,1054,30,1133,0,23,0,5
"09/24/2021","Y","Y","Northwest Arctic Borough",188,"Northwest Region",6,45,1099,23,1156,0,23,0,5
"09/25/2021","Y","Y","Northwest Arctic Borough",188,"Northwest Region",6,28,1127,6,1162,0,23,0,5
"09/26/2021","Y","Y","Northwest Arctic Borough",188,"Northwest Region",6,26,1153,6,1168,0,23,1,6
"09/27/2021","Y","Y","Northwest Arctic Borough",188,"Northwest Region",6,8,1161,40,1208,0,23,0,6
"09/28/2021","Y","Y","Northwest Arctic Borough",188,"Northwest Region",6,6,1167,23,1231,0,23,0,6
"09/29/2021","Y","Y","Northwest Arctic Borough",188,"Northwest Region",6,41,1208,11,1242,0,23,1,7
"09/30/2021","Y","Y","Northwest Arctic Borough",188,"Northwest Region",6,23,1231,41,1283,1,24,0,7
"10/01/2021","Y","Y","Northwest Arctic Borough",188,"Northwest Region",6,11,1242,23,1306,0,24,0,7
"10/02/2021","Y","Y","Northwest Arctic Borough",188,"Northwest Region",6,40,1282,5,1311,0,24,1,8
"10/03/2021","Y","Y","Northwest Arctic Borough",188,"Northwest Region",6,22,1304,3,1314,0,24,0,8
"10/04/2021","Y","Y","Northwest Arctic Borough",188,"Northwest Region",6,5,1309,50,1364,0,24,0,8
"10/05/2021","Y","Y","Northwest Arctic Borough",188,"Northwest Region",6,5,1314,28,1392,0,24,0,8
"10/06/2021","Y","Y","Northwest Arctic Borough",188,"Northwest Region",6,50,1364,13,1405,0,24,0,8
"10/07/2021","Y","Y","Northwest Arctic Borough",188,"Northwest Region",6,28,1392,7,1412,0,24,0,8
"10/08/2021","Y","Y","Northwest Arctic Borough",188,"Northwest Region",6,13,1405,55,1467,0,24,0,8
"10/09/2021","Y","Y","Northwest Arctic Borough",188,"Northwest Region",6,7,1412,3,1470,0,24,0,8
"10/10/2021","Y","Y","Northwest Arctic Borough",188,"Northwest Region",6,55,1467,6,1476,0,24,0,8
"10/11/2021","Y","Y","Northwest Arctic Borough",188,"Northwest Region",6,3,1470,2,1478,0,24,0,8
"10/12/2021","Y","Y","Northwest Arctic Borough",188,"Northwest Region",6,6,1476,54,1532,0,24,0,8
"10/13/2021","Y","Y","Northwest Arctic Borough",188,"Northwest Region",6,5,1481,16,1548,0,24,0,8
"10/14/2021","Y","Y","Northwest Arctic Borough",188,"Northwest Region",6,51,1532,16,1564,0,24,0,8
"10/15/2021","Y","Y","Northwest Arctic Borough",188,"Northwest Region",6,16,1548,15,1579,0,24,0,8
"10/16/2021","Y","Y","Northwest Arctic Borough",188,"Northwest Region",6,16,1564,7,1586,0,24,0,8
"10/17/2021","Y","Y","Northwest Arctic Borough",188,"Northwest Region",6,15,1579,0,1586,0,24,0,8
"10/18/2021","Y","Y","Northwest Arctic Borough",188,"Northwest Region",6,7,1586,19,1605,0,24,0,8
"10/19/2021","Y","Y","Northwest Arctic Borough",188,"Northwest Region",6,1,1587,17,1622,0,24,0,8
"10/20/2021","Y","Y","Northwest Arctic Borough",188,"Northwest Region",6,19,1606,10,1632,0,24,0,8
"10/21/2021","Y","Y","Northwest Arctic Borough",188,"Northwest Region",6,17,1623,19,1651,0,24,0,8
"10/22/2021","Y","Y","Northwest Arctic Borough",188,"Northwest Region",6,10,1633,20,1671,0,24,0,8
"10/23/2021","Y","Y","Northwest Arctic Borough",188,"Northwest Region",6,18,1651,4,1675,0,24,0,8
"10/24/2021","Y","Y","Northwest Arctic Borough",188,"Northwest Region",6,19,1670,5,1680,0,24,1,9
"10/25/2021","Y","Y","Northwest Arctic Borough",188,"Northwest Region",6,5,1675,50,1730,0,24,0,9
"10/26/2021","Y","Y","Northwest Arctic Borough",188,"Northwest Region",6,6,1681,26,1756,0,24,0,9
"10/27/2021","Y","Y","Northwest Arctic Borough",188,"Northwest Region",6,47,1728,13,1769,0,24,0,9
"10/28/2021","Y","Y","Northwest Arctic Borough",188,"Northwest Region",6,25,1753,16,1785,0,24,0,9
"10/29/2021","Y","Y","Northwest Arctic Borough",188,"Northwest Region",6,18,1771,19,1804,0,24,0,9
"10/30/2021","Y","Y","Northwest Arctic Borough",188,"Northwest Region",6,16,1787,4,1808,0,24,0,9
"10/31/2021","Y","Y","Northwest Arctic Borough",188,"Northwest Region",6,16,1803,6,1814,0,24,1,10
"11/01/2021","Y","Y","Northwest Arctic Borough",188,"Northwest Region",6,5,1808,16,1830,0,24,0,10
"11/02/2021","Y","Y","Northwest Arctic Borough",188,"Northwest Region",6,4,1812,30,1860,0,24,0,10
"11/03/2021","Y","Y","Northwest Arctic Borough",188,"Northwest Region",6,18,1830,20,1880,0,24,0,10
"11/04/2021","Y","Y","Northwest Arctic Borough",188,"Northwest Region",6,31,1861,18,1898,0,24,0,10
"11/05/2021","Y","Y","Northwest Arctic Borough",188,"Northwest Region",6,19,1880,19,1917,0,24,0,10
"11/06/2021","Y","Y","Northwest Arctic Borough",188,"Northwest Region",6,17,1897,8,1925,0,24,0,10
"11/07/2021","Y","Y","Northwest Arctic Borough",188,"Northwest Region",6,19,1916,7,1932,0,24,0,10
"11/08/2021","Y","Y","Northwest Arctic Borough",188,"Northwest Region",6,9,1925,19,1951,0,24,0,10
"11/09/2021","Y","Y","Northwest Arctic Borough",188,"Northwest Region",6,7,1932,25,1976,0,24,0,10
"11/10/2021","Y","Y","Northwest Arctic Borough",188,"Northwest Region",6,3,1935,29,2005,0,24,0,10
"11/11/2021","Y","Y","Northwest Arctic Borough",188,"Northwest Region",6,41,1976,11,2016,0,24,0,10
"11/12/2021","Y","Y","Northwest Arctic Borough",188,"Northwest Region",6,26,2002,20,2036,0,24,0,10
"11/13/2021","Y","Y","Northwest Arctic Borough",188,"Northwest Region",6,11,2013,9,2045,0,24,0,10
"11/14/2021","Y","Y","Northwest Arctic Borough",188,"Northwest Region",6,19,2032,7,2052,0,24,0,10
"11/15/2021","Y","Y","Northwest Arctic Borough",188,"Northwest Region",6,9,2041,27,2079,0,24,0,10
"11/16/2021","Y","Y","Northwest Arctic Borough",188,"Northwest Region",6,12,2053,22,2101,0,24,0,10
"11/17/2021","Y","Y","Northwest Arctic Borough",188,"Northwest Region",6,28,2081,13,2114,0,24,0,10
"11/18/2021","Y","Y","Northwest Arctic Borough",188,"Northwest Region",6,21,2102,10,2124,0,24,0,10
"11/19/2021","Y","Y","Northwest Arctic Borough",188,"Northwest Region",6,12,2114,10,2134,0,24,0,10
"11/20/2021","Y","Y","Northwest Arctic Borough",188,"Northwest Region",6,10,2124,5,2139,0,24,0,10
"11/21/2021","Y","Y","Northwest Arctic Borough",188,"Northwest Region",6,11,2135,7,2146,0,24,0,10
"11/22/2021","Y","Y","Northwest Arctic Borough",188,"Northwest Region",6,5,2140,29,2175,1,25,0,10
"11/23/2021","Y","Y","Northwest Arctic Borough",188,"Northwest Region",6,7,2147,22,2197,0,25,0,10
"11/24/2021","Y","Y","Northwest Arctic Borough",188,"Northwest Region",6,30,2177,5,2202,0,25,0,10
"11/25/2021","Y","Y","Northwest Arctic Borough",188,"Northwest Region",6,20,2197,0,2202,0,25,0,10
"11/26/2021","Y","Y","Northwest Arctic Borough",188,"Northwest Region",6,5,2202,11,2213,0,25,0,10
"11/27/2021","Y","Y","Northwest Arctic Borough",188,"Northwest Region",6,0,2202,7,2220,0,25,0,10
"11/28/2021","Y","Y","Northwest Arctic Borough",188,"Northwest Region",6,3,2205,3,2223,1,26,0,10
"11/29/2021","Y","Y","Northwest Arctic Borough",188,"Northwest Region",6,7,2212,8,2231,0,26,0,10
"11/30/2021","Y","Y","Northwest Arctic Borough",188,"Northwest Region",6,4,2216,16,2247,0,26,0,10
"12/01/2021","Y","Y","Northwest Arctic Borough",188,"Northwest Region",6,15,2231,7,2254,0,26,0,10
"12/02/2021","Y","Y","Northwest Arctic Borough",188,"Northwest Region",6,15,2246,10,2264,0,26,0,10
"12/03/2021","Y","Y","Northwest Arctic Borough",188,"Northwest Region",6,11,2257,10,2274,0,26,0,10
"12/04/2021","Y","Y","Northwest Arctic Borough",188,"Northwest Region",6,0,2257,3,2277,0,26,0,10
"12/05/2021","Y","Y","Northwest Arctic Borough",188,"Northwest Region",6,22,2279,6,2283,0,26,0,10
"12/06/2021","Y","Y","Northwest Arctic Borough",188,"Northwest Region",6,3,2282,9,2292,0,26,0,10
"12/07/2021","Y","Y","Northwest Arctic Borough",188,"Northwest Region",6,1,2283,1,2293,0,26,0,10
"12/08/2021","Y","Y","Northwest Arctic Borough",188,"Northwest Region",6,17,2300,7,2300,0,26,0,10
"12/09/2021","Y","Y","Northwest Arctic Borough",188,"Northwest Region",6,5,2305,7,2307,0,26,0,10
"12/10/2021","Y","Y","Northwest Arctic Borough",188,"Northwest Region",6,2,2307,7,2314,0,26,0,10
"12/11/2021","Y","Y","Northwest Arctic Borough",188,"Northwest Region",6,7,2314,0,2314,0,26,0,10
"12/12/2021","Y","Y","Northwest Arctic Borough",188,"Northwest Region",6,0,2314,2,2316,0,26,0,10
"12/13/2021","Y","Y","Northwest Arctic Borough",188,"Northwest Region",6,1,2315,2,2318,0,26,0,10
"12/14/2021","Y","Y","Northwest Arctic Borough",188,"Northwest Region",6,2,2317,0,2318,0,26,0,10
"12/15/2021","Y","Y","Northwest Arctic Borough",188,"Northwest Region",6,8,2325,8,2326,0,26,0,10
"12/17/2021","Y","Y","Northwest Arctic Borough",188,"Northwest Region",6,2,2327,2,2328,0,26,0,10
"12/19/2021","Y","Y","Northwest Arctic Borough",188,"Northwest Region",6,4,2331,4,2332,0,26,0,10
"12/20/2021","Y","Y","Northwest Arctic Borough",188,"Northwest Region",6,1,2332,3,2335,0,26,0,10
"12/21/2021","Y","Y","Northwest Arctic Borough",188,"Northwest Region",6,2,2334,0,2335,0,26,0,10
"12/22/2021","Y","Y","Northwest Arctic Borough",188,"Northwest Region",6,2,2336,1,2336,0,26,0,10
"12/23/2021","Y","Y","Northwest Arctic Borough",188,"Northwest Region",6,2,2338,6,2342,0,26,0,10
"12/24/2021","Y","Y","Northwest Arctic Borough",188,"Northwest Region",6,4,2342,3,2345,0,26,0,10
"12/25/2021","Y","Y","Northwest Arctic Borough",188,"Northwest Region",6,1,2343,0,2345,0,26,0,10
"12/26/2021","Y","Y","Northwest Arctic Borough",188,"Northwest Region",6,3,2346,2,2347,0,26,0,10
"12/27/2021","Y","Y","Northwest Arctic Borough",188,"Northwest Region",6,2,2348,4,2351,0,26,0,10
"12/28/2021","Y","Y","Northwest Arctic Borough",188,"Northwest Region",6,2,2350,1,2352,0,26,0,10
"12/29/2021","Y","Y","Northwest Arctic Borough",188,"Northwest Region",6,3,2353,6,2358,0,26,0,10
"12/30/2021","Y","Y","Northwest Arctic Borough",188,"Northwest Region",6,9,2362,12,2370,0,26,0,10
"12/31/2021","Y","Y","Northwest Arctic Borough",188,"Northwest Region",6,11,2373,10,2380,0,26,0,10
"01/01/2022","Y","Y","Northwest Arctic Borough",188,"Northwest Region",6,5,2378,3,2383,0,26,0,10
"01/02/2022","Y","Y","Northwest Arctic Borough",188,"Northwest Region",6,12,2390,10,2393,0,26,0,10
"01/03/2022","Y","Y","Northwest Arctic Borough",188,"Northwest Region",6,2,2392,5,2398,1,27,0,10
"01/04/2022","Y","Y","Northwest Arctic Borough",188,"Northwest Region",6,14,2406,16,2414,0,27,0,10
"01/05/2022","Y","Y","Northwest Arctic Borough",188,"Northwest Region",6,15,2421,17,2431,0,27,0,10
"01/06/2022","Y","Y","Northwest Arctic Borough",188,"Northwest Region",6,20,2441,16,2447,0,27,0,10
"01/07/2022","Y","Y","Northwest Arctic Borough",188,"Northwest Region",6,17,2458,16,2463,0,27,0,10
"01/08/2022","Y","Y","Northwest Arctic Borough",188,"Northwest Region",6,11,2469,12,2475,0,27,0,10
"01/09/2022","Y","Y","Northwest Arctic Borough",188,"Northwest Region",6,6,2475,13,2488,0,27,0,10
"01/10/2022","Y","Y","Northwest Arctic Borough",188,"Northwest Region",6,17,2492,20,2508,0,27,0,10
"01/11/2022","Y","Y","Northwest Arctic Borough",188,"Northwest Region",6,28,2520,24,2532,0,27,0,10
"01/12/2022","Y","Y","Northwest Arctic Borough",188,"Northwest Region",6,34,2554,32,2564,0,27,0,10
"01/13/2022","Y","Y","Northwest Arctic Borough",188,"Northwest Region",6,33,2587,35,2599,0,27,0,10
"01/14/2022","Y","Y","Northwest Arctic Borough",188,"Northwest Region",6,42,2629,41,2640,0,27,0,10
"01/15/2022","Y","Y","Northwest Arctic Borough",188,"Northwest Region",6,31,2660,29,2669,0,27,0,10
"01/16/2022","Y","Y","Northwest Arctic Borough",188,"Northwest Region",6,29,2689,29,2698,0,27,0,10
"01/17/2022","Y","Y","Northwest Arctic Borough",188,"Northwest Region",6,8,2697,11,2709,0,27,0,10
"01/18/2022","Y","Y","Northwest Arctic Borough",188,"Northwest Region",6,14,2711,21,2730,0,27,0,10
"01/19/2022","Y","Y","Northwest Arctic Borough",188,"Northwest Region",6,38,2749,44,2774,0,27,0,10
"01/20/2022","Y","Y","Northwest Arctic Borough",188,"Northwest Region",6,59,2808,61,2835,0,27,1,11
"01/21/2022","Y","Y","Northwest Arctic Borough",188,"Northwest Region",6,60,2868,63,2898,0,27,0,11
"01/22/2022","Y","Y","Northwest Arctic Borough",188,"Northwest Region",6,81,2949,73,2971,0,27,0,11
"01/23/2022","Y","Y","Northwest Arctic Borough",188,"Northwest Region",6,66,3015,55,3026,0,27,0,11
"01/24/2022","Y","Y","Northwest Arctic Borough",188,"Northwest Region",6,31,3046,32,3058,0,27,0,11
"01/25/2022","Y","Y","Northwest Arctic Borough",188,"Northwest Region",6,33,3079,37,3095,0,27,0,11
"01/26/2022","Y","Y","Northwest Arctic Borough",188,"Northwest Region",6,59,3138,58,3153,0,27,0,11
"01/27/2022","Y","Y","Northwest Arctic Borough",188,"Northwest Region",6,38,3176,38,3191,0,27,0,11
"01/28/2022","Y","Y","Northwest Arctic Borough",188,"Northwest Region",6,42,3218,41,3232,0,27,0,11
"01/29/2022","Y","Y","Northwest Arctic Borough",188,"Northwest Region",6,41,3259,39,3271,0,27,0,11
"01/30/2022","Y","Y","Northwest Arctic Borough",188,"Northwest Region",6,39,3298,40,3311,0,27,0,11
"01/31/2022","Y","Y","Northwest Arctic Borough",188,"Northwest Region",6,9,3307,16,3327,1,28,0,11
"02/01/2022","Y","Y","Northwest Arctic Borough",188,"Northwest Region",6,28,3335,25,3352,0,28,0,11
"02/02/2022","Y","Y","Northwest Arctic Borough",188,"Northwest Region",6,56,3391,51,3403,0,28,0,11
"02/03/2022","Y","Y","Northwest Arctic Borough",188,"Northwest Region",6,31,3422,31,3434,0,28,0,11
"02/04/2022","Y","Y","Northwest Arctic Borough",188,"Northwest Region",6,46,3468,49,3483,1,29,1,12
"02/05/2022","Y","Y","Northwest Arctic Borough",188,"Northwest Region",6,46,3514,49,3532,0,29,0,12
"02/06/2022","Y","Y","Northwest Arctic Borough",188,"Northwest Region",6,52,3566,44,3576,0,29,0,12
"02/07/2022","Y","Y","Northwest Arctic Borough",188,"Northwest Region",6,22,3588,16,3592,0,29,0,12
"02/08/2022","Y","Y","Northwest Arctic Borough",188,"Northwest Region",6,22,3610,24,3616,1,30,0,12
"02/09/2022","Y","Y","Northwest Arctic Borough",188,"Northwest Region",6,62,3672,65,3681,0,30,0,12
"02/10/2022","Y","Y","Northwest Arctic Borough",188,"Northwest Region",6,49,3721,47,3728,0,30,0,12
"02/11/2022","Y","Y","Northwest Arctic Borough",188,"Northwest Region",6,28,3749,30,3758,0,30,0,12
"02/12/2022","Y","Y","Northwest Arctic Borough",188,"Northwest Region",6,29,3778,23,3781,0,30,0,12
"02/13/2022","Y","Y","Northwest Arctic Borough",188,"Northwest Region",6,21,3799,21,3802,0,30,0,12
"02/14/2022","Y","Y","Northwest Arctic Borough",188,"Northwest Region",6,10,3809,9,3811,0,30,0,12
"02/15/2022","Y","Y","Northwest Arctic Borough",188,"Northwest Region",6,17,3826,15,3826,0,30,0,12
"02/16/2022","Y","Y","Northwest Arctic Borough",188,"Northwest Region",6,39,3865,40,3866,0,30,0,12
"02/17/2022","Y","Y","Northwest Arctic Borough",188,"Northwest Region",6,39,3904,40,3906,0,30,0,12
"02/18/2022","Y","Y","Northwest Arctic Borough",188,"Northwest Region",6,21,3925,22,3928,0,30,0,12
"02/19/2022","Y","Y","Northwest Arctic Borough",188,"Northwest Region",6,15,3940,14,3942,0,30,0,12
"02/20/2022","Y","Y","Northwest Arctic Borough",188,"Northwest Region",6,28,3968,27,3969,0,30,0,12
"02/21/2022","Y","Y","Northwest Arctic Borough",188,"Northwest Region",6,5,3973,5,3974,0,30,0,12
"02/22/2022","Y","Y","Northwest Arctic Borough",188,"Northwest Region",6,4,3977,5,3979,0,30,1,13
"02/23/2022","Y","Y","Northwest Arctic Borough",188,"Northwest Region",6,2,3979,2,3981,0,30,0,13
"02/24/2022","Y","Y","Northwest Arctic Borough",188,"Northwest Region",6,17,3996,18,3999,0,30,0,13
"02/25/2022","Y","Y","Northwest Arctic Borough",188,"Northwest Region",6,9,4005,11,4010,0,30,0,13
"02/26/2022","Y","Y","Northwest Arctic Borough",188,"Northwest Region",6,14,4019,12,4022,1,31,0,13
"02/27/2022","Y","Y","Northwest Arctic Borough",188,"Northwest Region",6,10,4029,9,4031,0,31,0,13
"02/28/2022","Y","Y","Northwest Arctic Borough",188,"Northwest Region",6,7,4036,10,4041,0,31,0,13
"03/01/2022","Y","Y","Northwest Arctic Borough",188,"Northwest Region",6,8,4044,9,4050,0,31,0,13
"03/02/2022","Y","Y","Northwest Arctic Borough",188,"Northwest Region",6,37,4081,38,4088,0,31,0,13
"03/03/2022","Y","Y","Northwest Arctic Borough",188,"Northwest Region",6,50,4131,49,4137,0,31,0,13
"03/04/2022","Y","Y","Northwest Arctic Borough",188,"Northwest Region",6,18,4149,25,4162,0,31,0,13
"03/05/2022","Y","Y","Northwest Arctic Borough",188,"Northwest Region",6,25,4174,23,4185,0,31,0,13
"03/06/2022","Y","Y","Northwest Arctic Borough",188,"Northwest Region",6,22,4196,14,4199,0,31,0,13
"03/07/2022","Y","Y","Northwest Arctic Borough",188,"Northwest Region",6,8,4204,12,4211,0,31,0,13
"03/08/2022","Y","Y","Northwest Arctic Borough",188,"Northwest Region",6,14,4218,13,4224,0,31,0,13
"03/09/2022","Y","Y","Northwest Arctic Borough",188,"Northwest Region",6,23,4241,19,4243,0,31,0,13
"03/10/2022","Y","Y","Northwest Arctic Borough",188,"Northwest Region",6,14,4255,15,4258,0,31,0,13
"03/11/2022","Y","Y","Northwest Arctic Borough",188,"Northwest Region",6,9,4264,23,4281,0,31,0,13
"03/12/2022","Y","Y","Northwest Arctic Borough",188,"Northwest Region",6,15,4279,14,4295,0,31,0,13
"03/13/2022","Y","Y","Northwest Arctic Borough",188,"Northwest Region",6,16,4295,1,4296,0,31,0,13
"03/14/2022","Y","Y","Northwest Arctic Borough",188,"Northwest Region",6,4,4299,3,4299,0,31,0,13
"03/16/2022","Y","Y","Northwest Arctic Borough",188,"Northwest Region",6,17,4316,17,4316,0,31,0,13
"03/17/2022","Y","Y","Northwest Arctic Borough",188,"Northwest Region",6,9,4325,9,4325,0,31,0,13
"03/18/2022","Y","Y","Northwest Arctic Borough",188,"Northwest Region",6,14,4339,14,4339,0,31,0,13
"03/19/2022","Y","Y","Northwest Arctic Borough",188,"Northwest Region",6,2,4341,2,4341,0,31,0,13
"03/20/2022","Y","Y","Northwest Arctic Borough",188,"Northwest Region",6,5,4346,5,4346,0,31,0,13
"03/21/2022","Y","Y","Northwest Arctic Borough",188,"Northwest Region",6,7,4353,11,4357,0,31,0,13
"03/22/2022","Y","Y","Northwest Arctic Borough",188,"Northwest Region",6,6,4359,8,4365,0,31,0,13
"03/23/2022","Y","Y","Northwest Arctic Borough",188,"Northwest Region",6,24,4383,19,4384,0,31,0,13
"03/24/2022","Y","Y","Northwest Arctic Borough",188,"Northwest Region",6,7,4390,8,4392,0,31,0,13
"03/25/2022","Y","Y","Northwest Arctic Borough",188,"Northwest Region",6,12,4402,12,4404,0,31,0,13
"03/26/2022","Y","Y","Northwest Arctic Borough",188,"Northwest Region",6,11,4413,10,4414,0,31,0,13
"03/27/2022","Y","Y","Northwest Arctic Borough",188,"Northwest Region",6,15,4428,15,4429,0,31,0,13
"03/28/2022","Y","Y","Northwest Arctic Borough",188,"Northwest Region",6,9,4437,11,4440,0,31,0,13
"03/29/2022","Y","Y","Northwest Arctic Borough",188,"Northwest Region",6,4,4441,2,4442,0,31,0,13
"03/30/2022","Y","Y","Northwest Arctic Borough",188,"Northwest Region",6,19,4460,19,4461,0,31,0,13
"03/31/2022","Y","Y","Northwest Arctic Borough",188,"Northwest Region",6,12,4472,12,4473,0,31,0,13
"04/01/2022","Y","Y","Northwest Arctic Borough",188,"Northwest Region",6,18,4490,20,4493,0,31,0,13
"04/02/2022","Y","Y","Northwest Arctic Borough",188,"Northwest Region",6,9,4499,8,4501,0,31,0,13
"04/03/2022","Y","Y","Northwest Arctic Borough",188,"Northwest Region",6,8,4507,6,4507,0,31,0,13
"04/04/2022","Y","Y","Northwest Arctic Borough",188,"Northwest Region",6,11,4518,11,4518,0,31,0,13
"04/05/2022","Y","Y","Northwest Arctic Borough",188,"Northwest Region",6,2,4520,2,4520,0,31,0,13
"04/06/2022","Y","Y","Northwest Arctic Borough",188,"Northwest Region",6,8,4528,8,4528,0,31,0,13
"04/07/2022","Y","Y","Northwest Arctic Borough",188,"Northwest Region",6,7,4535,7,4535,0,31,0,13
"04/08/2022","Y","Y","Northwest Arctic Borough",188,"Northwest Region",6,7,4542,7,4542,0,31,0,13
"04/09/2022","Y","Y","Northwest Arctic Borough",188,"Northwest Region",6,6,4548,6,4548,0,31,0,13
"04/10/2022","Y","Y","Northwest Arctic Borough",188,"Northwest Region",6,2,4550,2,4550,0,31,0,13
"04/11/2022","Y","Y","Northwest Arctic Borough",188,"Northwest Region",6,1,4551,1,4551,0,31,0,13
"04/12/2022","Y","Y","Northwest Arctic Borough",188,"Northwest Region",6,2,4553,2,4553,0,31,0,13
"04/13/2022","Y","Y","Northwest Arctic Borough",188,"Northwest Region",6,12,4565,12,4565,0,31,0,13
"04/14/2022","Y","Y","Northwest Arctic Borough",188,"Northwest Region",6,6,4571,6,4571,0,31,0,13
"04/15/2022","Y","Y","Northwest Arctic Borough",188,"Northwest Region",6,12,4583,15,4586,0,31,0,13
"04/16/2022","Y","Y","Northwest Arctic Borough",188,"Northwest Region",6,8,4591,8,4594,0,31,0,13
"04/17/2022","Y","Y","Northwest Arctic Borough",188,"Northwest Region",6,8,4599,5,4599,0,31,0,13
"04/18/2022","Y","Y","Northwest Arctic Borough",188,"Northwest Region",6,2,4601,12,4611,0,31,0,13
"04/19/2022","Y","Y","Northwest Arctic Borough",188,"Northwest Region",6,0,4601,4,4615,0,31,0,13
"04/20/2022","Y","Y","Northwest Arctic Borough",188,"Northwest Region",6,11,4612,3,4618,0,31,0,13
"04/21/2022","Y","Y","Northwest Arctic Borough",188,"Northwest Region",6,15,4627,9,4627,0,31,0,13
"04/22/2022","Y","Y","Northwest Arctic Borough",188,"Northwest Region",6,4,4631,4,4631,0,31,0,13
"04/23/2022","Y","Y","Northwest Arctic Borough",188,"Northwest Region",6,14,4645,14,4645,0,31,0,13
"04/24/2022","Y","Y","Northwest Arctic Borough",188,"Northwest Region",6,9,4654,9,4654,0,31,0,13
"04/26/2022","Y","Y","Northwest Arctic Borough",188,"Northwest Region",6,3,4657,3,4657,0,31,0,13
"03/20/2020","Y","Y","Petersburg Borough",195,"Other Southeast Region - Northern",8,0,0,1,1,0,0,0,0
"04/05/2020","Y","Y","Petersburg Borough",195,"Other Southeast Region - Northern",8,1,1,0,1,0,0,0,0
"04/09/2020","Y","Y","Petersburg Borough",195,"Other Southeast Region - Northern",8,0,1,1,2,0,0,0,0
"04/17/2020","Y","Y","Petersburg Borough",195,"Other Southeast Region - Northern",8,0,1,1,3,0,0,0,0
"04/18/2020","Y","Y","Petersburg Borough",195,"Other Southeast Region - Northern",8,1,2,0,3,0,0,0,0
"04/27/2020","Y","Y","Petersburg Borough",195,"Other Southeast Region - Northern",8,1,3,0,3,0,0,0,0
"07/01/2020","Y","Y","Petersburg Borough",195,"Other Southeast Region - Northern",8,0,3,1,4,0,0,0,0
"07/03/2020","Y","Y","Petersburg Borough",195,"Other Southeast Region - Northern",8,1,4,0,4,0,0,0,0
"07/26/2020","Y","Y","Petersburg Borough",195,"Other Southeast Region - Northern",8,0,4,1,5,0,0,0,0
"08/12/2020","Y","Y","Petersburg Borough",195,"Other Southeast Region - Northern",8,1,5,0,5,0,0,0,0
"09/29/2020","Y","Y","Petersburg Borough",195,"Other Southeast Region - Northern",8,0,5,1,6,0,0,0,0
"10/01/2020","Y","Y","Petersburg Borough",195,"Other Southeast Region - Northern",8,1,6,0,6,0,0,0,0
"10/11/2020","Y","Y","Petersburg Borough",195,"Other Southeast Region - Northern",8,0,6,1,7,0,0,0,0
"10/12/2020","Y","Y","Petersburg Borough",195,"Other Southeast Region - Northern",8,0,6,2,9,0,0,0,0
"10/16/2020","Y","Y","Petersburg Borough",195,"Other Southeast Region - Northern",8,3,9,0,9,0,0,0,0
"10/20/2020","Y","Y","Petersburg Borough",195,"Other Southeast Region - Northern",8,0,9,2,11,0,0,0,0
"10/22/2020","Y","Y","Petersburg Borough",195,"Other Southeast Region - Northern",8,0,9,1,12,0,0,0,0
"10/24/2020","Y","Y","Petersburg Borough",195,"Other Southeast Region - Northern",8,0,9,1,13,0,0,0,0
"10/25/2020","Y","Y","Petersburg Borough",195,"Other Southeast Region - Northern",8,1,10,0,13,0,0,0,0
"10/26/2020","Y","Y","Petersburg Borough",195,"Other Southeast Region - Northern",8,0,10,1,14,0,0,0,0
"10/27/2020","Y","Y","Petersburg Borough",195,"Other Southeast Region - Northern",8,0,10,1,15,0,0,0,0
"10/28/2020","Y","Y","Petersburg Borough",195,"Other Southeast Region - Northern",8,2,12,0,15,0,0,0,0
"10/30/2020","Y","Y","Petersburg Borough",195,"Other Southeast Region - Northern",8,1,13,0,15,0,0,0,0
"11/03/2020","Y","Y","Petersburg Borough",195,"Other Southeast Region - Northern",8,0,13,1,16,0,0,0,0
"11/05/2020","Y","Y","Petersburg Borough",195,"Other Southeast Region - Northern",8,0,13,1,17,0,0,0,0
"11/06/2020","Y","Y","Petersburg Borough",195,"Other Southeast Region - Northern",8,1,14,0,17,0,0,0,0
"11/07/2020","Y","Y","Petersburg Borough",195,"Other Southeast Region - Northern",8,0,14,1,18,0,0,0,0
"11/12/2020","Y","Y","Petersburg Borough",195,"Other Southeast Region - Northern",8,0,14,1,19,0,0,0,0
"11/13/2020","Y","Y","Petersburg Borough",195,"Other Southeast Region - Northern",8,1,15,0,19,0,0,0,0
"11/25/2020","Y","Y","Petersburg Borough",195,"Other Southeast Region - Northern",8,0,15,1,20,0,0,0,0
"11/27/2020","Y","Y","Petersburg Borough",195,"Other Southeast Region - Northern",8,1,16,0,20,0,0,0,0
"11/28/2020","Y","Y","Petersburg Borough",195,"Other Southeast Region - Northern",8,1,17,0,20,0,0,0,0
"12/02/2020","Y","Y","Petersburg Borough",195,"Other Southeast Region - Northern",8,1,18,0,20,0,0,0,0
"12/04/2020","Y","Y","Petersburg Borough",195,"Other Southeast Region - Northern",8,2,20,0,20,0,0,0,0
"12/25/2020","Y","Y","Petersburg Borough",195,"Other Southeast Region - Northern",8,0,20,1,21,0,0,0,0
"12/29/2020","Y","Y","Petersburg Borough",195,"Other Southeast Region - Northern",8,0,20,1,22,0,0,0,0
"12/30/2020","Y","Y","Petersburg Borough",195,"Other Southeast Region - Northern",8,2,22,2,24,0,0,0,0
"12/31/2020","Y","Y","Petersburg Borough",195,"Other Southeast Region - Northern",8,0,22,1,25,0,0,0,0
"01/01/2021","Y","Y","Petersburg Borough",195,"Other Southeast Region - Northern",8,0,22,2,27,0,0,0,0
"01/03/2021","Y","Y","Petersburg Borough",195,"Other Southeast Region - Northern",8,1,23,0,27,0,0,0,0
"01/04/2021","Y","Y","Petersburg Borough",195,"Other Southeast Region - Northern",8,1,24,1,28,0,0,0,0
"01/05/2021","Y","Y","Petersburg Borough",195,"Other Southeast Region - Northern",8,3,27,2,30,0,0,0,0
"01/06/2021","Y","Y","Petersburg Borough",195,"Other Southeast Region - Northern",8,2,29,1,31,0,0,0,0
"01/09/2021","Y","Y","Petersburg Borough",195,"Other Southeast Region - Northern",8,0,29,1,32,0,0,0,0
"01/11/2021","Y","Y","Petersburg Borough",195,"Other Southeast Region - Northern",8,0,29,6,38,0,0,0,0
"01/12/2021","Y","Y","Petersburg Borough",195,"Other Southeast Region - Northern",8,7,36,0,38,0,0,0,0
"01/13/2021","Y","Y","Petersburg Borough",195,"Other Southeast Region - Northern",8,1,37,0,38,0,0,0,0
"01/15/2021","Y","Y","Petersburg Borough",195,"Other Southeast Region - Northern",8,0,37,0,38,1,1,0,0
"01/17/2021","Y","Y","Petersburg Borough",195,"Other Southeast Region - Northern",8,1,38,0,38,0,1,0,0
"01/24/2021","Y","Y","Petersburg Borough",195,"Other Southeast Region - Northern",8,0,38,1,39,0,1,0,0
"01/30/2021","Y","Y","Petersburg Borough",195,"Other Southeast Region - Northern",8,0,38,1,40,0,1,0,0
"02/03/2021","Y","Y","Petersburg Borough",195,"Other Southeast Region - Northern",8,1,39,0,40,0,1,0,0
"02/06/2021","Y","Y","Petersburg Borough",195,"Other Southeast Region - Northern",8,0,39,0,40,1,2,0,0
"02/08/2021","Y","Y","Petersburg Borough",195,"Other Southeast Region - Northern",8,0,39,2,42,0,2,0,0
"02/10/2021","Y","Y","Petersburg Borough",195,"Other Southeast Region - Northern",8,1,40,0,42,0,2,0,0
"02/12/2021","Y","Y","Petersburg Borough",195,"Other Southeast Region - Northern",8,0,40,1,43,0,2,0,0
"02/14/2021","Y","Y","Petersburg Borough",195,"Other Southeast Region - Northern",8,0,40,2,45,0,2,0,0
"02/15/2021","Y","Y","Petersburg Borough",195,"Other Southeast Region - Northern",8,0,40,2,47,0,2,0,0
"02/16/2021","Y","Y","Petersburg Borough",195,"Other Southeast Region - Northern",8,0,40,1,48,0,2,0,0
"02/17/2021","Y","Y","Petersburg Borough",195,"Other Southeast Region - Northern",8,2,42,6,54,0,2,0,0
"02/18/2021","Y","Y","Petersburg Borough",195,"Other Southeast Region - Northern",8,1,43,2,56,0,2,0,0
"02/19/2021","Y","Y","Petersburg Borough",195,"Other Southeast Region - Northern",8,0,43,6,62,0,2,0,0
"02/20/2021","Y","Y","Petersburg Borough",195,"Other Southeast Region - Northern",8,5,48,6,68,1,3,0,0
"02/21/2021","Y","Y","Petersburg Borough",195,"Other Southeast Region - Northern",8,2,50,4,72,1,4,0,0
"02/22/2021","Y","Y","Petersburg Borough",195,"Other Southeast Region - Northern",8,4,54,9,81,1,5,0,0
"02/23/2021","Y","Y","Petersburg Borough",195,"Other Southeast Region - Northern",8,10,64,15,96,0,5,0,0
"02/24/2021","Y","Y","Petersburg Borough",195,"Other Southeast Region - Northern",8,10,74,9,105,0,5,0,0
"02/25/2021","Y","Y","Petersburg Borough",195,"Other Southeast Region - Northern",8,0,74,7,112,1,6,0,0
"02/26/2021","Y","Y","Petersburg Borough",195,"Other Southeast Region - Northern",8,16,90,5,117,0,6,0,0
"02/27/2021","Y","Y","Petersburg Borough",195,"Other Southeast Region - Northern",8,11,101,4,121,0,6,0,0
"02/28/2021","Y","Y","Petersburg Borough",195,"Other Southeast Region - Northern",8,0,101,4,125,0,6,0,0
"03/01/2021","Y","Y","Petersburg Borough",195,"Other Southeast Region - Northern",8,6,107,3,128,1,7,0,0
"03/02/2021","Y","Y","Petersburg Borough",195,"Other Southeast Region - Northern",8,13,120,2,130,0,7,0,0
"03/03/2021","Y","Y","Petersburg Borough",195,"Other Southeast Region - Northern",8,3,123,1,131,0,7,0,0
"03/04/2021","Y","Y","Petersburg Borough",195,"Other Southeast Region - Northern",8,5,128,2,133,0,7,0,0
"03/05/2021","Y","Y","Petersburg Borough",195,"Other Southeast Region - Northern",8,0,128,2,135,0,7,0,0
"03/06/2021","Y","Y","Petersburg Borough",195,"Other Southeast Region - Northern",8,1,129,0,135,0,7,0,0
"03/08/2021","Y","Y","Petersburg Borough",195,"Other Southeast Region - Northern",8,2,131,2,137,0,7,0,0
"03/10/2021","Y","Y","Petersburg Borough",195,"Other Southeast Region - Northern",8,3,134,1,138,0,7,0,0
"03/12/2021","Y","Y","Petersburg Borough",195,"Other Southeast Region - Northern",8,2,136,0,138,0,7,0,0
"03/13/2021","Y","Y","Petersburg Borough",195,"Other Southeast Region - Northern",8,1,137,0,138,0,7,0,0
"03/14/2021","Y","Y","Petersburg Borough",195,"Other Southeast Region - Northern",8,1,138,1,139,0,7,0,0
"03/16/2021","Y","Y","Petersburg Borough",195,"Other Southeast Region - Northern",8,1,139,0,139,0,7,0,0
"03/17/2021","Y","Y","Petersburg Borough",195,"Other Southeast Region - Northern",8,0,139,1,140,0,7,0,0
"03/19/2021","Y","Y","Petersburg Borough",195,"Other Southeast Region - Northern",8,1,140,0,140,0,7,0,0
"03/27/2021","Y","Y","Petersburg Borough",195,"Other Southeast Region - Northern",8,0,140,5,145,0,7,0,0
"03/28/2021","Y","Y","Petersburg Borough",195,"Other Southeast Region - Northern",8,0,140,1,146,0,7,0,0
"03/29/2021","Y","Y","Petersburg Borough",195,"Other Southeast Region - Northern",8,0,140,2,148,0,7,0,0
"03/30/2021","Y","Y","Petersburg Borough",195,"Other Southeast Region - Northern",8,5,145,1,149,0,7,0,0
"03/31/2021","Y","Y","Petersburg Borough",195,"Other Southeast Region - Northern",8,1,146,0,149,0,7,0,0
"04/02/2021","Y","Y","Petersburg Borough",195,"Other Southeast Region - Northern",8,2,148,0,149,0,7,0,0
"04/09/2021","Y","Y","Petersburg Borough",195,"Other Southeast Region - Northern",8,0,148,1,150,0,7,0,0
"04/11/2021","Y","Y","Petersburg Borough",195,"Other Southeast Region - Northern",8,0,148,1,151,0,7,0,0
"04/12/2021","Y","Y","Petersburg Borough",195,"Other Southeast Region - Northern",8,0,148,1,152,0,7,0,0
"04/14/2021","Y","Y","Petersburg Borough",195,"Other Southeast Region - Northern",8,0,148,1,153,0,7,0,0
"04/15/2021","Y","Y","Petersburg Borough",195,"Other Southeast Region - Northern",8,0,148,1,154,0,7,0,0
"04/16/2021","Y","Y","Petersburg Borough",195,"Other Southeast Region - Northern",8,4,152,0,154,0,7,0,0
"04/18/2021","Y","Y","Petersburg Borough",195,"Other Southeast Region - Northern",8,1,153,0,154,0,7,0,0
"04/21/2021","Y","Y","Petersburg Borough",195,"Other Southeast Region - Northern",8,0,153,0,154,1,8,0,0
"05/02/2021","Y","Y","Petersburg Borough",195,"Other Southeast Region - Northern",8,0,153,1,155,0,8,0,0
"05/03/2021","Y","Y","Petersburg Borough",195,"Other Southeast Region - Northern",8,0,153,2,157,0,8,0,0
"05/05/2021","Y","Y","Petersburg Borough",195,"Other Southeast Region - Northern",8,2,155,0,157,0,8,0,0
"05/06/2021","Y","Y","Petersburg Borough",195,"Other Southeast Region - Northern",8,1,156,0,157,0,8,0,0
"05/07/2021","Y","Y","Petersburg Borough",195,"Other Southeast Region - Northern",8,0,156,1,158,0,8,0,0
"05/11/2021","Y","Y","Petersburg Borough",195,"Other Southeast Region - Northern",8,0,156,1,159,0,8,0,0
"05/12/2021","Y","Y","Petersburg Borough",195,"Other Southeast Region - Northern",8,1,157,0,159,0,8,0,0
"05/18/2021","Y","Y","Petersburg Borough",195,"Other Southeast Region - Northern",8,1,158,0,159,0,8,0,0
"05/19/2021","Y","Y","Petersburg Borough",195,"Other Southeast Region - Northern",8,0,158,1,160,0,8,0,0
"05/25/2021","Y","Y","Petersburg Borough",195,"Other Southeast Region - Northern",8,1,159,0,160,0,8,0,0
"06/29/2021","Y","Y","Petersburg Borough",195,"Other Southeast Region - Northern",8,0,159,1,161,0,8,0,0
"07/07/2021","Y","Y","Petersburg Borough",195,"Other Southeast Region - Northern",8,1,160,0,161,0,8,0,0
"07/09/2021","Y","Y","Petersburg Borough",195,"Other Southeast Region - Northern",8,0,160,1,162,0,8,0,0
"07/10/2021","Y","Y","Petersburg Borough",195,"Other Southeast Region - Northern",8,1,161,0,162,1,9,0,0
"07/12/2021","Y","Y","Petersburg Borough",195,"Other Southeast Region - Northern",8,0,161,1,163,0,9,0,0
"07/13/2021","Y","Y","Petersburg Borough",195,"Other Southeast Region - Northern",8,1,162,1,164,0,9,0,0
"07/14/2021","Y","Y","Petersburg Borough",195,"Other Southeast Region - Northern",8,1,163,2,166,1,10,0,0
"07/15/2021","Y","Y","Petersburg Borough",195,"Other Southeast Region - Northern",8,2,165,0,166,0,10,0,0
"07/16/2021","Y","Y","Petersburg Borough",195,"Other Southeast Region - Northern",8,0,165,2,168,0,10,0,0
"07/17/2021","Y","Y","Petersburg Borough",195,"Other Southeast Region - Northern",8,2,167,2,170,0,10,0,0
"07/18/2021","Y","Y","Petersburg Borough",195,"Other Southeast Region - Northern",8,2,169,0,170,0,10,0,0
"07/19/2021","Y","Y","Petersburg Borough",195,"Other Southeast Region - Northern",8,0,169,0,170,0,10,1,1
"08/01/2021","Y","Y","Petersburg Borough",195,"Other Southeast Region - Northern",8,0,169,1,171,0,10,0,1
"08/02/2021","Y","Y","Petersburg Borough",195,"Other Southeast Region - Northern",8,1,170,0,171,0,10,0,1
"08/06/2021","Y","Y","Petersburg Borough",195,"Other Southeast Region - Northern",8,0,170,0,171,0,10,1,2
"08/08/2021","Y","Y","Petersburg Borough",195,"Other Southeast Region - Northern",8,1,171,1,172,0,10,0,2
"08/18/2021","Y","Y","Petersburg Borough",195,"Other Southeast Region - Northern",8,0,171,1,173,0,10,0,2
"08/21/2021","Y","Y","Petersburg Borough",195,"Other Southeast Region - Northern",8,1,172,0,173,0,10,0,2
"08/23/2021","Y","Y","Petersburg Borough",195,"Other Southeast Region - Northern",8,0,172,2,175,0,10,0,2
"08/25/2021","Y","Y","Petersburg Borough",195,"Other Southeast Region - Northern",8,1,173,1,176,0,10,0,2
"08/26/2021","Y","Y","Petersburg Borough",195,"Other Southeast Region - Northern",8,1,174,1,177,0,10,0,2
"08/27/2021","Y","Y","Petersburg Borough",195,"Other Southeast Region - Northern",8,0,174,2,179,0,10,0,2
"08/28/2021","Y","Y","Petersburg Borough",195,"Other Southeast Region - Northern",8,0,174,2,181,0,10,0,2
"08/29/2021","Y","Y","Petersburg Borough",195,"Other Southeast Region - Northern",8,2,176,0,181,0,10,0,2
"08/31/2021","Y","Y","Petersburg Borough",195,"Other Southeast Region - Northern",8,1,177,0,181,0,10,0,2
"09/02/2021","Y","Y","Petersburg Borough",195,"Other Southeast Region - Northern",8,3,180,0,181,0,10,0,2
"09/07/2021","Y","Y","Petersburg Borough",195,"Other Southeast Region - Northern",8,0,180,2,183,0,10,0,2
"09/14/2021","Y","Y","Petersburg Borough",195,"Other Southeast Region - Northern",8,2,182,0,183,0,10,0,2
"09/20/2021","Y","Y","Petersburg Borough",195,"Other Southeast Region - Northern",8,0,182,8,191,0,10,0,2
"09/21/2021","Y","Y","Petersburg Borough",195,"Other Southeast Region - Northern",8,0,182,4,195,0,10,0,2
"09/22/2021","Y","Y","Petersburg Borough",195,"Other Southeast Region - Northern",8,0,182,4,199,0,10,0,2
"09/23/2021","Y","Y","Petersburg Borough",195,"Other Southeast Region - Northern",8,0,182,3,202,0,10,0,2
"09/24/2021","Y","Y","Petersburg Borough",195,"Other Southeast Region - Northern",8,0,182,2,204,0,10,0,2
"09/25/2021","Y","Y","Petersburg Borough",195,"Other Southeast Region - Northern",8,0,182,1,205,0,10,0,2
"09/26/2021","Y","Y","Petersburg Borough",195,"Other Southeast Region - Northern",8,0,182,1,206,0,10,0,2
"09/27/2021","Y","Y","Petersburg Borough",195,"Other Southeast Region - Northern",8,0,182,7,213,0,10,0,2
"09/28/2021","Y","Y","Petersburg Borough",195,"Other Southeast Region - Northern",8,2,184,2,215,0,10,0,2
"09/29/2021","Y","Y","Petersburg Borough",195,"Other Southeast Region - Northern",8,30,214,7,222,0,10,0,2
"09/30/2021","Y","Y","Petersburg Borough",195,"Other Southeast Region - Northern",8,0,214,7,229,0,10,0,2
"10/01/2021","Y","Y","Petersburg Borough",195,"Other Southeast Region - Northern",8,3,217,2,231,0,10,0,2
"10/02/2021","Y","Y","Petersburg Borough",195,"Other Southeast Region - Northern",8,11,228,2,233,0,10,0,2
"10/04/2021","Y","Y","Petersburg Borough",195,"Other Southeast Region - Northern",8,4,232,5,238,0,10,0,2
"10/05/2021","Y","Y","Petersburg Borough",195,"Other Southeast Region - Northern",8,4,236,2,240,0,10,0,2
"10/07/2021","Y","Y","Petersburg Borough",195,"Other Southeast Region - Northern",8,1,237,1,241,0,10,0,2
"10/08/2021","Y","Y","Petersburg Borough",195,"Other Southeast Region - Northern",8,0,237,7,248,0,10,0,2
"10/09/2021","Y","Y","Petersburg Borough",195,"Other Southeast Region - Northern",8,7,244,0,248,0,10,0,2
"10/10/2021","Y","Y","Petersburg Borough",195,"Other Southeast Region - Northern",8,0,244,1,249,0,10,0,2
"10/11/2021","Y","Y","Petersburg Borough",195,"Other Southeast Region - Northern",8,5,249,1,250,0,10,0,2
"10/13/2021","Y","Y","Petersburg Borough",195,"Other Southeast Region - Northern",8,0,249,2,252,0,10,0,2
"10/14/2021","Y","Y","Petersburg Borough",195,"Other Southeast Region - Northern",8,0,249,1,253,0,10,0,2
"10/15/2021","Y","Y","Petersburg Borough",195,"Other Southeast Region - Northern",8,2,251,0,253,0,10,0,2
"10/16/2021","Y","Y","Petersburg Borough",195,"Other Southeast Region - Northern",8,1,252,1,254,0,10,0,2
"10/18/2021","Y","Y","Petersburg Borough",195,"Other Southeast Region - Northern",8,0,252,1,255,0,10,0,2
"10/19/2021","Y","Y","Petersburg Borough",195,"Other Southeast Region - Northern",8,0,252,1,256,0,10,0,2
"10/20/2021","Y","Y","Petersburg Borough",195,"Other Southeast Region - Northern",8,1,253,2,258,0,10,0,2
"10/21/2021","Y","Y","Petersburg Borough",195,"Other Southeast Region - Northern",8,2,255,0,258,0,10,0,2
"10/22/2021","Y","Y","Petersburg Borough",195,"Other Southeast Region - Northern",8,2,257,0,258,0,10,0,2
"10/25/2021","Y","Y","Petersburg Borough",195,"Other Southeast Region - Northern",8,0,257,1,259,0,10,0,2
"10/26/2021","Y","Y","Petersburg Borough",195,"Other Southeast Region - Northern",8,0,257,3,262,0,10,0,2
"10/27/2021","Y","Y","Petersburg Borough",195,"Other Southeast Region - Northern",8,1,258,1,263,0,10,0,2
"10/28/2021","Y","Y","Petersburg Borough",195,"Other Southeast Region - Northern",8,3,261,1,264,0,10,0,2
"10/29/2021","Y","Y","Petersburg Borough",195,"Other Southeast Region - Northern",8,1,262,4,268,0,10,0,2
"10/30/2021","Y","Y","Petersburg Borough",195,"Other Southeast Region - Northern",8,0,262,1,269,0,10,0,2
"10/31/2021","Y","Y","Petersburg Borough",195,"Other Southeast Region - Northern",8,1,263,0,269,0,10,0,2
"11/01/2021","Y","Y","Petersburg Borough",195,"Other Southeast Region - Northern",8,6,269,16,285,0,10,0,2
"11/02/2021","Y","Y","Petersburg Borough",195,"Other Southeast Region - Northern",8,16,285,10,295,0,10,0,2
"11/03/2021","Y","Y","Petersburg Borough",195,"Other Southeast Region - Northern",8,4,289,14,309,0,10,0,2
"11/04/2021","Y","Y","Petersburg Borough",195,"Other Southeast Region - Northern",8,5,294,6,315,0,10,0,2
"11/05/2021","Y","Y","Petersburg Borough",195,"Other Southeast Region - Northern",8,0,294,2,317,0,10,0,2
"11/06/2021","Y","Y","Petersburg Borough",195,"Other Southeast Region - Northern",8,6,300,11,328,0,10,0,2
"11/07/2021","Y","Y","Petersburg Borough",195,"Other Southeast Region - Northern",8,12,312,1,329,0,10,0,2
"11/08/2021","Y","Y","Petersburg Borough",195,"Other Southeast Region - Northern",8,0,312,13,342,0,10,0,2
"11/09/2021","Y","Y","Petersburg Borough",195,"Other Southeast Region - Northern",8,7,319,11,353,0,10,0,2
"11/10/2021","Y","Y","Petersburg Borough",195,"Other Southeast Region - Northern",8,1,320,17,370,0,10,0,2
"11/11/2021","Y","Y","Petersburg Borough",195,"Other Southeast Region - Northern",8,26,346,2,372,0,10,0,2
"11/12/2021","Y","Y","Petersburg Borough",195,"Other Southeast Region - Northern",8,4,350,12,384,0,10,0,2
"11/13/2021","Y","Y","Petersburg Borough",195,"Other Southeast Region - Northern",8,0,350,10,394,0,10,0,2
"11/14/2021","Y","Y","Petersburg Borough",195,"Other Southeast Region - Northern",8,9,359,1,395,0,10,0,2
"11/15/2021","Y","Y","Petersburg Borough",195,"Other Southeast Region - Northern",8,20,379,18,413,0,10,0,2
"11/16/2021","Y","Y","Petersburg Borough",195,"Other Southeast Region - Northern",8,15,394,12,425,0,10,0,2
"11/17/2021","Y","Y","Petersburg Borough",195,"Other Southeast Region - Northern",8,11,405,6,431,0,10,0,2
"11/18/2021","Y","Y","Petersburg Borough",195,"Other Southeast Region - Northern",8,13,418,7,438,0,10,0,2
"11/19/2021","Y","Y","Petersburg Borough",195,"Other Southeast Region - Northern",8,1,419,5,443,1,11,0,2
"11/20/2021","Y","Y","Petersburg Borough",195,"Other Southeast Region - Northern",8,4,423,1,444,0,11,0,2
"11/21/2021","Y","Y","Petersburg Borough",195,"Other Southeast Region - Northern",8,10,433,1,445,0,11,0,2
"11/22/2021","Y","Y","Petersburg Borough",195,"Other Southeast Region - Northern",8,1,434,11,456,1,12,0,2
"11/23/2021","Y","Y","Petersburg Borough",195,"Other Southeast Region - Northern",8,1,435,10,466,0,12,0,2
"11/24/2021","Y","Y","Petersburg Borough",195,"Other Southeast Region - Northern",8,12,447,1,467,0,12,0,2
"11/26/2021","Y","Y","Petersburg Borough",195,"Other Southeast Region - Northern",8,10,457,7,474,0,12,0,2
"11/27/2021","Y","Y","Petersburg Borough",195,"Other Southeast Region - Northern",8,14,471,0,474,0,12,0,2
"11/29/2021","Y","Y","Petersburg Borough",195,"Other Southeast Region - Northern",8,2,473,7,481,0,12,0,2
"11/30/2021","Y","Y","Petersburg Borough",195,"Other Southeast Region - Northern",8,2,475,0,481,0,12,0,2
"12/01/2021","Y","Y","Petersburg Borough",195,"Other Southeast Region - Northern",8,2,477,2,483,0,12,0,2
"12/02/2021","Y","Y","Petersburg Borough",195,"Other Southeast Region - Northern",8,5,482,2,485,0,12,0,2
"12/03/2021","Y","Y","Petersburg Borough",195,"Other Southeast Region - Northern",8,2,484,0,485,0,12,0,2
"12/04/2021","Y","Y","Petersburg Borough",195,"Other Southeast Region - Northern",8,0,484,1,486,0,12,0,2
"12/07/2021","Y","Y","Petersburg Borough",195,"Other Southeast Region - Northern",8,1,485,1,487,0,12,0,2
"12/10/2021","Y","Y","Petersburg Borough",195,"Other Southeast Region - Northern",8,1,486,0,487,0,12,0,2
"12/11/2021","Y","Y","Petersburg Borough",195,"Other Southeast Region - Northern",8,0,486,2,489,0,12,0,2
"12/12/2021","Y","Y","Petersburg Borough",195,"Other Southeast Region - Northern",8,1,487,0,489,0,12,0,2
"12/13/2021","Y","Y","Petersburg Borough",195,"Other Southeast Region - Northern",8,0,487,1,490,0,12,0,2
"12/14/2021","Y","Y","Petersburg Borough",195,"Other Southeast Region - Northern",8,0,487,2,492,0,12,0,2
"12/15/2021","Y","Y","Petersburg Borough",195,"Other Southeast Region - Northern",8,3,490,2,494,0,12,0,2
"12/16/2021","Y","Y","Petersburg Borough",195,"Other Southeast Region - Northern",8,3,493,0,494,0,12,0,2
"12/17/2021","Y","Y","Petersburg Borough",195,"Other Southeast Region - Northern",8,0,493,1,495,0,12,0,2
"12/21/2021","Y","Y","Petersburg Borough",195,"Other Southeast Region - Northern",8,0,493,2,497,0,12,0,2
"12/22/2021","Y","Y","Petersburg Borough",195,"Other Southeast Region - Northern",8,3,496,0,497,0,12,0,2
"12/23/2021","Y","Y","Petersburg Borough",195,"Other Southeast Region - Northern",8,0,496,4,501,1,13,0,2
"12/24/2021","Y","Y","Petersburg Borough",195,"Other Southeast Region - Northern",8,3,499,0,501,0,13,0,2
"12/27/2021","Y","Y","Petersburg Borough",195,"Other Southeast Region - Northern",8,1,500,2,503,0,13,0,2
"12/28/2021","Y","Y","Petersburg Borough",195,"Other Southeast Region - Northern",8,2,502,1,504,0,13,0,2
"12/29/2021","Y","Y","Petersburg Borough",195,"Other Southeast Region - Northern",8,1,503,0,504,0,13,0,2
"12/30/2021","Y","Y","Petersburg Borough",195,"Other Southeast Region - Northern",8,1,504,3,507,0,13,0,2
"01/02/2022","Y","Y","Petersburg Borough",195,"Other Southeast Region - Northern",8,0,504,2,509,0,13,0,2
"01/03/2022","Y","Y","Petersburg Borough",195,"Other Southeast Region - Northern",8,3,507,1,510,0,13,0,2
"01/04/2022","Y","Y","Petersburg Borough",195,"Other Southeast Region - Northern",8,1,508,1,511,0,13,0,2
"01/05/2022","Y","Y","Petersburg Borough",195,"Other Southeast Region - Northern",8,1,509,2,513,0,13,0,2
"01/06/2022","Y","Y","Petersburg Borough",195,"Other Southeast Region - Northern",8,1,510,6,519,0,13,0,2
"01/07/2022","Y","Y","Petersburg Borough",195,"Other Southeast Region - Northern",8,0,510,10,529,0,13,0,2
"01/10/2022","Y","Y","Petersburg Borough",195,"Other Southeast Region - Northern",8,5,515,4,533,0,13,0,2
"01/11/2022","Y","Y","Petersburg Borough",195,"Other Southeast Region - Northern",8,14,529,5,538,0,13,0,2
"01/12/2022","Y","Y","Petersburg Borough",195,"Other Southeast Region - Northern",8,3,532,4,542,0,13,0,2
"01/13/2022","Y","Y","Petersburg Borough",195,"Other Southeast Region - Northern",8,1,533,3,545,0,13,0,2
"01/15/2022","Y","Y","Petersburg Borough",195,"Other Southeast Region - Northern",8,10,543,1,546,0,13,0,2
"01/16/2022","Y","Y","Petersburg Borough",195,"Other Southeast Region - Northern",8,0,543,1,547,0,13,0,2
"01/17/2022","Y","Y","Petersburg Borough",195,"Other Southeast Region - Northern",8,0,543,8,555,0,13,0,2
"01/18/2022","Y","Y","Petersburg Borough",195,"Other Southeast Region - Northern",8,1,544,2,557,0,13,0,2
"01/19/2022","Y","Y","Petersburg Borough",195,"Other Southeast Region - Northern",8,10,554,4,561,0,13,0,2
"01/20/2022","Y","Y","Petersburg Borough",195,"Other Southeast Region - Northern",8,0,554,8,569,0,13,0,2
"01/21/2022","Y","Y","Petersburg Borough",195,"Other Southeast Region - Northern",8,0,554,2,571,0,13,0,2
"01/23/2022","Y","Y","Petersburg Borough",195,"Other Southeast Region - Northern",8,1,555,0,571,0,13,0,2
"01/24/2022","Y","Y","Petersburg Borough",195,"Other Southeast Region - Northern",8,1,556,3,574,0,13,0,2
"01/25/2022","Y","Y","Petersburg Borough",195,"Other Southeast Region - Northern",8,5,561,2,576,0,13,0,2
"01/26/2022","Y","Y","Petersburg Borough",195,"Other Southeast Region - Northern",8,7,568,1,577,0,13,0,2
"01/27/2022","Y","Y","Petersburg Borough",195,"Other Southeast Region - Northern",8,8,576,5,582,0,13,0,2
"01/28/2022","Y","Y","Petersburg Borough",195,"Other Southeast Region - Northern",8,1,577,4,586,0,13,0,2
"01/31/2022","Y","Y","Petersburg Borough",195,"Other Southeast Region - Northern",8,0,577,5,591,0,13,0,2
"02/01/2022","Y","Y","Petersburg Borough",195,"Other Southeast Region - Northern",8,0,577,2,593,0,13,0,2
"02/02/2022","Y","Y","Petersburg Borough",195,"Other Southeast Region - Northern",8,12,589,6,599,0,13,0,2
"02/03/2022","Y","Y","Petersburg Borough",195,"Other Southeast Region - Northern",8,9,598,2,601,0,13,0,2
"02/04/2022","Y","Y","Petersburg Borough",195,"Other Southeast Region - Northern",8,0,598,4,605,0,13,0,2
"02/05/2022","Y","Y","Petersburg Borough",195,"Other Southeast Region - Northern",8,4,602,1,606,0,13,0,2
"02/06/2022","Y","Y","Petersburg Borough",195,"Other Southeast Region - Northern",8,1,603,0,606,0,13,0,2
"02/07/2022","Y","Y","Petersburg Borough",195,"Other Southeast Region - Northern",8,1,604,2,608,0,13,0,2
"02/08/2022","Y","Y","Petersburg Borough",195,"Other Southeast Region - Northern",8,0,604,1,609,0,13,0,2
"02/09/2022","Y","Y","Petersburg Borough",195,"Other Southeast Region - Northern",8,4,608,4,613,0,13,0,2
"02/10/2022","Y","Y","Petersburg Borough",195,"Other Southeast Region - Northern",8,3,611,3,616,0,13,0,2
"02/11/2022","Y","Y","Petersburg Borough",195,"Other Southeast Region - Northern",8,0,611,2,618,0,13,0,2
"02/12/2022","Y","Y","Petersburg Borough",195,"Other Southeast Region - Northern",8,5,616,0,618,0,13,0,2
"02/13/2022","Y","Y","Petersburg Borough",195,"Other Southeast Region - Northern",8,0,616,2,620,0,13,0,2
"02/14/2022","Y","Y","Petersburg Borough",195,"Other Southeast Region - Northern",8,2,618,8,628,0,13,1,3
"02/15/2022","Y","Y","Petersburg Borough",195,"Other Southeast Region - Northern",8,9,627,2,630,0,13,0,3
"02/16/2022","Y","Y","Petersburg Borough",195,"Other Southeast Region - Northern",8,0,627,4,634,0,13,0,3
"02/17/2022","Y","Y","Petersburg Borough",195,"Other Southeast Region - Northern",8,5,632,2,636,0,13,0,3
"02/18/2022","Y","Y","Petersburg Borough",195,"Other Southeast Region - Northern",8,2,634,0,636,0,13,0,3
"02/19/2022","Y","Y","Petersburg Borough",195,"Other Southeast Region - Northern",8,1,635,1,637,0,13,0,3
"02/20/2022","Y","Y","Petersburg Borough",195,"Other Southeast Region - Northern",8,1,636,0,637,0,13,0,3
"02/21/2022","Y","Y","Petersburg Borough",195,"Other Southeast Region - Northern",8,0,636,2,639,1,14,0,3
"02/22/2022","Y","Y","Petersburg Borough",195,"Other Southeast Region - Northern",8,1,637,0,639,0,14,0,3
"02/24/2022","Y","Y","Petersburg Borough",195,"Other Southeast Region - Northern",8,0,637,2,641,0,14,0,3
"02/25/2022","Y","Y","Petersburg Borough",195,"Other Southeast Region - Northern",8,4,641,5,646,0,14,0,3
"02/26/2022","Y","Y","Petersburg Borough",195,"Other Southeast Region - Northern",8,4,645,0,646,0,14,0,3
"02/28/2022","Y","Y","Petersburg Borough",195,"Other Southeast Region - Northern",8,2,647,2,648,0,14,0,3
"03/04/2022","Y","Y","Petersburg Borough",195,"Other Southeast Region - Northern",8,0,647,1,649,0,14,0,3
"03/05/2022","Y","Y","Petersburg Borough",195,"Other Southeast Region - Northern",8,1,648,1,650,0,14,0,3
"03/06/2022","Y","Y","Petersburg Borough",195,"Other Southeast Region - Northern",8,1,649,0,650,0,14,0,3
"03/07/2022","Y","Y","Petersburg Borough",195,"Other Southeast Region - Northern",8,0,649,2,652,0,14,1,4
"03/09/2022","Y","Y","Petersburg Borough",195,"Other Southeast Region - Northern",8,1,650,0,652,0,14,0,4
"03/10/2022","Y","Y","Petersburg Borough",195,"Other Southeast Region - Northern",8,1,651,0,652,0,14,0,4
"03/17/2022","Y","Y","Petersburg Borough",195,"Other Southeast Region - Northern",8,1,652,2,654,0,14,0,4
"03/18/2022","Y","Y","Petersburg Borough",195,"Other Southeast Region - Northern",8,1,653,0,654,0,14,0,4
"03/21/2022","Y","Y","Petersburg Borough",195,"Other Southeast Region - Northern",8,0,653,1,655,0,14,0,4
"03/22/2022","Y","Y","Petersburg Borough",195,"Other Southeast Region - Northern",8,0,653,1,656,0,14,0,4
"03/23/2022","Y","Y","Petersburg Borough",195,"Other Southeast Region - Northern",8,2,655,1,657,0,14,0,4
"03/25/2022","Y","Y","Petersburg Borough",195,"Other Southeast Region - Northern",8,1,656,0,657,0,14,0,4
"03/26/2022","Y","Y","Petersburg Borough",195,"Other Southeast Region - Northern",8,0,656,1,658,0,14,0,4
"03/28/2022","Y","Y","Petersburg Borough",195,"Other Southeast Region - Northern",8,0,656,4,662,0,14,0,4
"03/29/2022","Y","Y","Petersburg Borough",195,"Other Southeast Region - Northern",8,6,662,4,666,0,14,0,4
"03/30/2022","Y","Y","Petersburg Borough",195,"Other Southeast Region - Northern",8,4,666,0,666,0,14,0,4
"03/31/2022","Y","Y","Petersburg Borough",195,"Other Southeast Region - Northern",8,0,666,3,669,0,14,0,4
"04/01/2022","Y","Y","Petersburg Borough",195,"Other Southeast Region - Northern",8,3,669,4,673,0,14,0,4
"04/02/2022","Y","Y","Petersburg Borough",195,"Other Southeast Region - Northern",8,4,673,0,673,0,14,0,4
"04/05/2022","Y","Y","Petersburg Borough",195,"Other Southeast Region - Northern",8,0,673,1,674,0,14,0,4
"04/06/2022","Y","Y","Petersburg Borough",195,"Other Southeast Region - Northern",8,1,674,0,674,0,14,0,4
"04/08/2022","Y","Y","Petersburg Borough",195,"Other Southeast Region - Northern",8,0,674,3,677,0,14,0,4
"04/09/2022","Y","Y","Petersburg Borough",195,"Other Southeast Region - Northern",8,3,677,0,677,0,14,0,4
"04/11/2022","Y","Y","Petersburg Borough",195,"Other Southeast Region - Northern",8,2,679,5,682,0,14,0,4
"04/12/2022","Y","Y","Petersburg Borough",195,"Other Southeast Region - Northern",8,3,682,2,684,0,14,0,4
"04/13/2022","Y","Y","Petersburg Borough",195,"Other Southeast Region - Northern",8,1,683,0,684,0,14,0,4
"04/14/2022","Y","Y","Petersburg Borough",195,"Other Southeast Region - Northern",8,0,683,4,688,0,14,0,4
"04/15/2022","Y","Y","Petersburg Borough",195,"Other Southeast Region - Northern",8,1,684,2,690,0,14,0,4
"04/16/2022","Y","Y","Petersburg Borough",195,"Other Southeast Region - Northern",8,6,690,0,690,0,14,0,4
"04/17/2022","Y","Y","Petersburg Borough",195,"Other Southeast Region - Northern",8,0,690,1,691,0,14,0,4
"04/18/2022","Y","Y","Petersburg Borough",195,"Other Southeast Region - Northern",8,0,690,2,693,0,14,0,4
"04/19/2022","Y","Y","Petersburg Borough",195,"Other Southeast Region - Northern",8,6,696,14,707,0,14,0,4
"04/20/2022","Y","Y","Petersburg Borough",195,"Other Southeast Region - Northern",8,12,708,5,712,0,14,0,4
"04/21/2022","Y","Y","Petersburg Borough",195,"Other Southeast Region - Northern",8,9,717,6,718,0,14,0,4
"04/22/2022","Y","Y","Petersburg Borough",195,"Other Southeast Region - Northern",8,3,720,3,721,0,14,0,4
"04/23/2022","Y","Y","Petersburg Borough",195,"Other Southeast Region - Northern",8,2,722,2,723,0,14,0,4
"04/24/2022","Y","Y","Petersburg Borough",195,"Other Southeast Region - Northern",8,2,724,2,725,0,14,0,4
"04/26/2022","Y","Y","Petersburg Borough",195,"Other Southeast Region - Northern",8,5,729,4,729,0,14,0,4
"03/24/2020","Y","Y","Prince of Wales-Hyder Census Area",198,"Other Southeast Region - Southern",9,0,0,1,1,0,0,0,0
"03/25/2020","Y","Y","Prince of Wales-Hyder Census Area",198,"Other Southeast Region - Southern",9,0,0,1,2,0,0,0,0
"04/10/2020","Y","Y","Prince of Wales-Hyder Census Area",198,"Other Southeast Region - Southern",9,1,1,0,2,0,0,0,0
"04/13/2020","Y","Y","Prince of Wales-Hyder Census Area",198,"Other Southeast Region - Southern",9,1,2,0,2,0,0,0,0
"07/22/2020","Y","Y","Prince of Wales-Hyder Census Area",198,"Other Southeast Region - Southern",9,0,2,2,4,0,0,0,0
"07/23/2020","Y","Y","Prince of Wales-Hyder Census Area",198,"Other Southeast Region - Southern",9,0,2,1,5,0,0,0,0
"07/25/2020","Y","Y","Prince of Wales-Hyder Census Area",198,"Other Southeast Region - Southern",9,1,3,0,5,0,0,0,0
"07/26/2020","Y","Y","Prince of Wales-Hyder Census Area",198,"Other Southeast Region - Southern",9,1,4,0,5,0,0,0,0
"07/27/2020","Y","Y","Prince of Wales-Hyder Census Area",198,"Other Southeast Region - Southern",9,1,5,0,5,0,0,0,0
"07/29/2020","Y","Y","Prince of Wales-Hyder Census Area",198,"Other Southeast Region - Southern",9,0,5,1,6,0,0,0,0
"08/01/2020","Y","Y","Prince of Wales-Hyder Census Area",198,"Other Southeast Region - Southern",9,2,7,1,7,0,0,0,0
"08/02/2020","Y","Y","Prince of Wales-Hyder Census Area",198,"Other Southeast Region - Southern",9,1,8,0,7,0,0,0,0
"08/07/2020","Y","Y","Prince of Wales-Hyder Census Area",198,"Other Southeast Region - Southern",9,0,8,2,9,0,0,0,0
"08/10/2020","Y","Y","Prince of Wales-Hyder Census Area",198,"Other Southeast Region - Southern",9,0,8,2,11,1,1,0,0
"08/11/2020","Y","Y","Prince of Wales-Hyder Census Area",198,"Other Southeast Region - Southern",9,1,9,0,11,0,1,0,0
"08/12/2020","Y","Y","Prince of Wales-Hyder Census Area",198,"Other Southeast Region - Southern",9,1,10,2,13,0,1,0,0
"08/13/2020","Y","Y","Prince of Wales-Hyder Census Area",198,"Other Southeast Region - Southern",9,1,11,1,14,0,1,0,0
"08/14/2020","Y","Y","Prince of Wales-Hyder Census Area",198,"Other Southeast Region - Southern",9,1,12,2,16,1,2,0,0
"08/15/2020","Y","Y","Prince of Wales-Hyder Census Area",198,"Other Southeast Region - Southern",9,2,14,0,16,0,2,0,0
"08/16/2020","Y","Y","Prince of Wales-Hyder Census Area",198,"Other Southeast Region - Southern",9,0,14,4,20,0,2,0,0
"08/17/2020","Y","Y","Prince of Wales-Hyder Census Area",198,"Other Southeast Region - Southern",9,1,15,0,20,0,2,0,0
"08/21/2020","Y","Y","Prince of Wales-Hyder Census Area",198,"Other Southeast Region - Southern",9,4,19,0,20,0,2,0,0
"08/22/2020","Y","Y","Prince of Wales-Hyder Census Area",198,"Other Southeast Region - Southern",9,0,19,2,22,0,2,0,0
"08/23/2020","Y","Y","Prince of Wales-Hyder Census Area",198,"Other Southeast Region - Southern",9,0,19,1,23,0,2,0,0
"08/25/2020","Y","Y","Prince of Wales-Hyder Census Area",198,"Other Southeast Region - Southern",9,0,19,1,24,0,2,0,0
"08/26/2020","Y","Y","Prince of Wales-Hyder Census Area",198,"Other Southeast Region - Southern",9,1,20,0,24,0,2,0,0
"08/27/2020","Y","Y","Prince of Wales-Hyder Census Area",198,"Other Southeast Region - Southern",9,2,22,0,24,0,2,0,0
"08/29/2020","Y","Y","Prince of Wales-Hyder Census Area",198,"Other Southeast Region - Southern",9,2,24,0,24,0,2,0,0
"09/01/2020","Y","Y","Prince of Wales-Hyder Census Area",198,"Other Southeast Region - Southern",9,0,24,1,25,0,2,0,0
"09/02/2020","Y","Y","Prince of Wales-Hyder Census Area",198,"Other Southeast Region - Southern",9,0,24,0,25,1,3,0,0
"09/03/2020","Y","Y","Prince of Wales-Hyder Census Area",198,"Other Southeast Region - Southern",9,1,25,0,25,0,3,0,0
"09/06/2020","Y","Y","Prince of Wales-Hyder Census Area",198,"Other Southeast Region - Southern",9,1,26,2,27,0,3,0,0
"09/08/2020","Y","Y","Prince of Wales-Hyder Census Area",198,"Other Southeast Region - Southern",9,1,27,0,27,0,3,0,0
"09/11/2020","Y","Y","Prince of Wales-Hyder Census Area",198,"Other Southeast Region - Southern",9,0,27,1,28,0,3,0,0
"09/12/2020","Y","Y","Prince of Wales-Hyder Census Area",198,"Other Southeast Region - Southern",9,1,28,0,28,0,3,0,0
"09/19/2020","Y","Y","Prince of Wales-Hyder Census Area",198,"Other Southeast Region - Southern",9,0,28,0,28,1,4,0,0
"09/23/2020","Y","Y","Prince of Wales-Hyder Census Area",198,"Other Southeast Region - Southern",9,1,29,1,29,0,4,0,0
"10/08/2020","Y","Y","Prince of Wales-Hyder Census Area",198,"Other Southeast Region - Southern",9,0,29,0,29,0,4,1,1
"10/10/2020","Y","Y","Prince of Wales-Hyder Census Area",198,"Other Southeast Region - Southern",9,0,29,1,30,0,4,0,1
"10/15/2020","Y","Y","Prince of Wales-Hyder Census Area",198,"Other Southeast Region - Southern",9,2,31,2,32,0,4,0,1
"10/24/2020","Y","Y","Prince of Wales-Hyder Census Area",198,"Other Southeast Region - Southern",9,0,31,1,33,0,4,0,1
"11/02/2020","Y","Y","Prince of Wales-Hyder Census Area",198,"Other Southeast Region - Southern",9,0,31,1,34,0,4,0,1
"11/03/2020","Y","Y","Prince of Wales-Hyder Census Area",198,"Other Southeast Region - Southern",9,1,32,1,35,0,4,0,1
"11/06/2020","Y","Y","Prince of Wales-Hyder Census Area",198,"Other Southeast Region - Southern",9,1,33,1,36,0,4,0,1
"11/07/2020","Y","Y","Prince of Wales-Hyder Census Area",198,"Other Southeast Region - Southern",9,1,34,1,37,0,4,0,1
"11/10/2020","Y","Y","Prince of Wales-Hyder Census Area",198,"Other Southeast Region - Southern",9,1,35,0,37,0,4,0,1
"11/11/2020","Y","Y","Prince of Wales-Hyder Census Area",198,"Other Southeast Region - Southern",9,1,36,1,38,0,4,0,1
"11/13/2020","Y","Y","Prince of Wales-Hyder Census Area",198,"Other Southeast Region - Southern",9,1,37,1,39,0,4,0,1
"11/14/2020","Y","Y","Prince of Wales-Hyder Census Area",198,"Other Southeast Region - Southern",9,1,38,0,39,0,4,0,1
"11/15/2020","Y","Y","Prince of Wales-Hyder Census Area",198,"Other Southeast Region - Southern",9,0,38,2,41,0,4,0,1
"11/18/2020","Y","Y","Prince of Wales-Hyder Census Area",198,"Other Southeast Region - Southern",9,0,38,1,42,0,4,0,1
"11/23/2020","Y","Y","Prince of Wales-Hyder Census Area",198,"Other Southeast Region - Southern",9,1,39,1,43,0,4,0,1
"11/25/2020","Y","Y","Prince of Wales-Hyder Census Area",198,"Other Southeast Region - Southern",9,1,40,3,46,0,4,0,1
"11/26/2020","Y","Y","Prince of Wales-Hyder Census Area",198,"Other Southeast Region - Southern",9,2,42,0,46,0,4,0,1
"11/27/2020","Y","Y","Prince of Wales-Hyder Census Area",198,"Other Southeast Region - Southern",9,1,43,3,49,0,4,0,1
"11/29/2020","Y","Y","Prince of Wales-Hyder Census Area",198,"Other Southeast Region - Southern",9,1,44,5,54,0,4,0,1
"11/30/2020","Y","Y","Prince of Wales-Hyder Census Area",198,"Other Southeast Region - Southern",9,3,47,1,55,0,4,0,1
"12/01/2020","Y","Y","Prince of Wales-Hyder Census Area",198,"Other Southeast Region - Southern",9,2,49,0,55,0,4,0,1
"12/02/2020","Y","Y","Prince of Wales-Hyder Census Area",198,"Other Southeast Region - Southern",9,2,51,2,57,0,4,0,1
"12/03/2020","Y","Y","Prince of Wales-Hyder Census Area",198,"Other Southeast Region - Southern",9,0,51,1,58,0,4,0,1
"12/04/2020","Y","Y","Prince of Wales-Hyder Census Area",198,"Other Southeast Region - Southern",9,3,54,0,58,0,4,0,1
"12/06/2020","Y","Y","Prince of Wales-Hyder Census Area",198,"Other Southeast Region - Southern",9,1,55,0,58,0,4,0,1
"12/08/2020","Y","Y","Prince of Wales-Hyder Census Area",198,"Other Southeast Region - Southern",9,0,55,1,59,0,4,0,1
"12/09/2020","Y","Y","Prince of Wales-Hyder Census Area",198,"Other Southeast Region - Southern",9,3,58,0,59,0,4,0,1
"12/10/2020","Y","Y","Prince of Wales-Hyder Census Area",198,"Other Southeast Region - Southern",9,0,58,1,60,0,4,0,1
"12/11/2020","Y","Y","Prince of Wales-Hyder Census Area",198,"Other Southeast Region - Southern",9,1,59,0,60,0,4,0,1
"12/12/2020","Y","Y","Prince of Wales-Hyder Census Area",198,"Other Southeast Region - Southern",9,0,59,1,61,0,4,0,1
"12/13/2020","Y","Y","Prince of Wales-Hyder Census Area",198,"Other Southeast Region - Southern",9,0,59,2,63,0,4,0,1
"12/16/2020","Y","Y","Prince of Wales-Hyder Census Area",198,"Other Southeast Region - Southern",9,1,60,2,65,0,4,0,1
"12/17/2020","Y","Y","Prince of Wales-Hyder Census Area",198,"Other Southeast Region - Southern",9,2,62,0,65,0,4,0,1
"12/18/2020","Y","Y","Prince of Wales-Hyder Census Area",198,"Other Southeast Region - Southern",9,0,62,1,66,0,4,0,1
"12/19/2020","Y","Y","Prince of Wales-Hyder Census Area",198,"Other Southeast Region - Southern",9,1,63,0,66,0,4,0,1
"12/22/2020","Y","Y","Prince of Wales-Hyder Census Area",198,"Other Southeast Region - Southern",9,1,64,1,67,0,4,0,1
"12/25/2020","Y","Y","Prince of Wales-Hyder Census Area",198,"Other Southeast Region - Southern",9,1,65,0,67,0,4,0,1
"12/28/2020","Y","Y","Prince of Wales-Hyder Census Area",198,"Other Southeast Region - Southern",9,1,66,0,67,0,4,0,1
"12/29/2020","Y","Y","Prince of Wales-Hyder Census Area",198,"Other Southeast Region - Southern",9,0,66,1,68,0,4,0,1
"01/05/2021","Y","Y","Prince of Wales-Hyder Census Area",198,"Other Southeast Region - Southern",9,2,68,0,68,0,4,0,1
"02/02/2021","Y","Y","Prince of Wales-Hyder Census Area",198,"Other Southeast Region - Southern",9,0,68,1,69,0,4,0,1
"02/06/2021","Y","Y","Prince of Wales-Hyder Census Area",198,"Other Southeast Region - Southern",9,1,69,0,69,0,4,0,1
"02/22/2021","Y","Y","Prince of Wales-Hyder Census Area",198,"Other Southeast Region - Southern",9,0,69,1,70,0,4,0,1
"02/24/2021","Y","Y","Prince of Wales-Hyder Census Area",198,"Other Southeast Region - Southern",9,1,70,0,70,0,4,0,1
"02/26/2021","Y","Y","Prince of Wales-Hyder Census Area",198,"Other Southeast Region - Southern",9,0,70,1,71,0,4,0,1
"02/27/2021","Y","Y","Prince of Wales-Hyder Census Area",198,"Other Southeast Region - Southern",9,0,70,1,72,0,4,0,1
"03/01/2021","Y","Y","Prince of Wales-Hyder Census Area",198,"Other Southeast Region - Southern",9,1,71,0,72,0,4,0,1
"03/02/2021","Y","Y","Prince of Wales-Hyder Census Area",198,"Other Southeast Region - Southern",9,1,72,0,72,0,4,0,1
"03/03/2021","Y","Y","Prince of Wales-Hyder Census Area",198,"Other Southeast Region - Southern",9,0,72,1,73,0,4,0,1
"03/08/2021","Y","Y","Prince of Wales-Hyder Census Area",198,"Other Southeast Region - Southern",9,2,74,1,74,0,4,0,1
"03/16/2021","Y","Y","Prince of Wales-Hyder Census Area",198,"Other Southeast Region - Southern",9,0,74,1,75,0,4,0,1
"03/17/2021","Y","Y","Prince of Wales-Hyder Census Area",198,"Other Southeast Region - Southern",9,1,75,0,75,0,4,0,1
"03/25/2021","Y","Y","Prince of Wales-Hyder Census Area",198,"Other Southeast Region - Southern",9,0,75,1,76,0,4,0,1
"03/26/2021","Y","Y","Prince of Wales-Hyder Census Area",198,"Other Southeast Region - Southern",9,1,76,0,76,0,4,0,1
"04/17/2021","Y","Y","Prince of Wales-Hyder Census Area",198,"Other Southeast Region - Southern",9,0,76,1,77,0,4,0,1
"04/18/2021","Y","Y","Prince of Wales-Hyder Census Area",198,"Other Southeast Region - Southern",9,0,76,2,79,0,4,0,1
"04/19/2021","Y","Y","Prince of Wales-Hyder Census Area",198,"Other Southeast Region - Southern",9,0,76,8,87,0,4,0,1
"04/20/2021","Y","Y","Prince of Wales-Hyder Census Area",198,"Other Southeast Region - Southern",9,3,79,2,89,0,4,0,1
"04/21/2021","Y","Y","Prince of Wales-Hyder Census Area",198,"Other Southeast Region - Southern",9,4,83,2,91,1,5,0,1
"04/22/2021","Y","Y","Prince of Wales-Hyder Census Area",198,"Other Southeast Region - Southern",9,0,83,2,93,0,5,0,1
"04/23/2021","Y","Y","Prince of Wales-Hyder Census Area",198,"Other Southeast Region - Southern",9,0,83,1,94,0,5,0,1
"04/24/2021","Y","Y","Prince of Wales-Hyder Census Area",198,"Other Southeast Region - Southern",9,2,85,0,94,0,5,0,1
"04/25/2021","Y","Y","Prince of Wales-Hyder Census Area",198,"Other Southeast Region - Southern",9,5,90,1,95,0,5,0,1
"04/26/2021","Y","Y","Prince of Wales-Hyder Census Area",198,"Other Southeast Region - Southern",9,0,90,2,97,0,5,0,1
"04/27/2021","Y","Y","Prince of Wales-Hyder Census Area",198,"Other Southeast Region - Southern",9,1,91,1,98,0,5,0,1
"04/28/2021","Y","Y","Prince of Wales-Hyder Census Area",198,"Other Southeast Region - Southern",9,1,92,1,99,0,5,0,1
"04/29/2021","Y","Y","Prince of Wales-Hyder Census Area",198,"Other Southeast Region - Southern",9,2,94,2,101,0,5,0,1
"04/30/2021","Y","Y","Prince of Wales-Hyder Census Area",198,"Other Southeast Region - Southern",9,3,97,2,103,0,5,0,1
"05/02/2021","Y","Y","Prince of Wales-Hyder Census Area",198,"Other Southeast Region - Southern",9,0,97,1,104,0,5,0,1
"05/03/2021","Y","Y","Prince of Wales-Hyder Census Area",198,"Other Southeast Region - Southern",9,2,99,0,104,0,5,0,1
"05/04/2021","Y","Y","Prince of Wales-Hyder Census Area",198,"Other Southeast Region - Southern",9,0,99,1,105,0,5,0,1
"05/05/2021","Y","Y","Prince of Wales-Hyder Census Area",198,"Other Southeast Region - Southern",9,2,101,1,106,0,5,0,1
"05/06/2021","Y","Y","Prince of Wales-Hyder Census Area",198,"Other Southeast Region - Southern",9,2,103,0,106,0,5,0,1
"05/07/2021","Y","Y","Prince of Wales-Hyder Census Area",198,"Other Southeast Region - Southern",9,0,103,2,108,0,5,0,1
"05/09/2021","Y","Y","Prince of Wales-Hyder Census Area",198,"Other Southeast Region - Southern",9,0,103,1,109,0,5,0,1
"05/10/2021","Y","Y","Prince of Wales-Hyder Census Area",198,"Other Southeast Region - Southern",9,1,104,6,115,0,5,0,1
"05/11/2021","Y","Y","Prince of Wales-Hyder Census Area",198,"Other Southeast Region - Southern",9,0,104,3,118,0,5,0,1
"05/12/2021","Y","Y","Prince of Wales-Hyder Census Area",198,"Other Southeast Region - Southern",9,6,110,2,120,0,5,0,1
"05/13/2021","Y","Y","Prince of Wales-Hyder Census Area",198,"Other Southeast Region - Southern",9,1,111,3,123,0,5,0,1
"05/14/2021","Y","Y","Prince of Wales-Hyder Census Area",198,"Other Southeast Region - Southern",9,1,112,3,126,1,6,0,1
"05/15/2021","Y","Y","Prince of Wales-Hyder Census Area",198,"Other Southeast Region - Southern",9,1,113,1,127,1,7,0,1
"05/16/2021","Y","Y","Prince of Wales-Hyder Census Area",198,"Other Southeast Region - Southern",9,4,117,0,127,0,7,0,1
"05/17/2021","Y","Y","Prince of Wales-Hyder Census Area",198,"Other Southeast Region - Southern",9,0,117,2,129,0,7,0,1
"05/18/2021","Y","Y","Prince of Wales-Hyder Census Area",198,"Other Southeast Region - Southern",9,4,121,3,132,0,7,0,1
"05/19/2021","Y","Y","Prince of Wales-Hyder Census Area",198,"Other Southeast Region - Southern",9,3,124,2,134,1,8,0,1
"05/20/2021","Y","Y","Prince of Wales-Hyder Census Area",198,"Other Southeast Region - Southern",9,8,132,1,135,0,8,0,1
"05/21/2021","Y","Y","Prince of Wales-Hyder Census Area",198,"Other Southeast Region - Southern",9,0,132,2,137,0,8,0,1
"05/22/2021","Y","Y","Prince of Wales-Hyder Census Area",198,"Other Southeast Region - Southern",9,4,136,1,138,0,8,1,2
"05/23/2021","Y","Y","Prince of Wales-Hyder Census Area",198,"Other Southeast Region - Southern",9,1,137,3,141,0,8,0,2
"05/24/2021","Y","Y","Prince of Wales-Hyder Census Area",198,"Other Southeast Region - Southern",9,0,137,0,141,1,9,0,2
"05/25/2021","Y","Y","Prince of Wales-Hyder Census Area",198,"Other Southeast Region - Southern",9,1,138,2,143,0,9,0,2
"05/26/2021","Y","Y","Prince of Wales-Hyder Census Area",198,"Other Southeast Region - Southern",9,1,139,4,147,0,9,0,2
"05/27/2021","Y","Y","Prince of Wales-Hyder Census Area",198,"Other Southeast Region - Southern",9,2,141,2,149,0,9,0,2
"05/28/2021","Y","Y","Prince of Wales-Hyder Census Area",198,"Other Southeast Region - Southern",9,5,146,1,150,0,9,0,2
"05/29/2021","Y","Y","Prince of Wales-Hyder Census Area",198,"Other Southeast Region - Southern",9,0,146,2,152,0,9,0,2
"05/30/2021","Y","Y","Prince of Wales-Hyder Census Area",198,"Other Southeast Region - Southern",9,0,146,1,153,0,9,0,2
"05/31/2021","Y","Y","Prince of Wales-Hyder Census Area",198,"Other Southeast Region - Southern",9,0,146,2,155,0,9,1,3
"06/01/2021","Y","Y","Prince of Wales-Hyder Census Area",198,"Other Southeast Region - Southern",9,2,148,2,157,1,10,0,3
"06/02/2021","Y","Y","Prince of Wales-Hyder Census Area",198,"Other Southeast Region - Southern",9,3,151,3,160,1,11,0,3
"06/03/2021","Y","Y","Prince of Wales-Hyder Census Area",198,"Other Southeast Region - Southern",9,7,158,2,162,0,11,0,3
"06/05/2021","Y","Y","Prince of Wales-Hyder Census Area",198,"Other Southeast Region - Southern",9,2,160,1,163,0,11,0,3
"06/06/2021","Y","Y","Prince of Wales-Hyder Census Area",198,"Other Southeast Region - Southern",9,0,160,1,164,0,11,1,4
"06/07/2021","Y","Y","Prince of Wales-Hyder Census Area",198,"Other Southeast Region - Southern",9,1,161,1,165,0,11,0,4
"06/08/2021","Y","Y","Prince of Wales-Hyder Census Area",198,"Other Southeast Region - Southern",9,1,162,2,167,0,11,0,4
"06/09/2021","Y","Y","Prince of Wales-Hyder Census Area",198,"Other Southeast Region - Southern",9,2,164,1,168,0,11,0,4
"06/10/2021","Y","Y","Prince of Wales-Hyder Census Area",198,"Other Southeast Region - Southern",9,2,166,0,168,0,11,0,4
"06/11/2021","Y","Y","Prince of Wales-Hyder Census Area",198,"Other Southeast Region - Southern",9,0,166,1,169,0,11,0,4
"06/12/2021","Y","Y","Prince of Wales-Hyder Census Area",198,"Other Southeast Region - Southern",9,0,166,2,171,0,11,0,4
"06/14/2021","Y","Y","Prince of Wales-Hyder Census Area",198,"Other Southeast Region - Southern",9,0,166,0,171,1,12,0,4
"06/15/2021","Y","Y","Prince of Wales-Hyder Census Area",198,"Other Southeast Region - Southern",9,3,169,0,171,0,12,0,4
"06/16/2021","Y","Y","Prince of Wales-Hyder Census Area",198,"Other Southeast Region - Southern",9,2,171,2,173,0,12,0,4
"06/18/2021","Y","Y","Prince of Wales-Hyder Census Area",198,"Other Southeast Region - Southern",9,1,172,0,173,0,12,0,4
"06/19/2021","Y","Y","Prince of Wales-Hyder Census Area",198,"Other Southeast Region - Southern",9,1,173,0,173,0,12,0,4
"06/21/2021","Y","Y","Prince of Wales-Hyder Census Area",198,"Other Southeast Region - Southern",9,0,173,1,174,0,12,1,5
"06/24/2021","Y","Y","Prince of Wales-Hyder Census Area",198,"Other Southeast Region - Southern",9,1,174,0,174,0,12,0,5
"06/29/2021","Y","Y","Prince of Wales-Hyder Census Area",198,"Other Southeast Region - Southern",9,0,174,1,175,0,12,0,5
"06/30/2021","Y","Y","Prince of Wales-Hyder Census Area",198,"Other Southeast Region - Southern",9,1,175,0,175,0,12,0,5
"07/01/2021","Y","Y","Prince of Wales-Hyder Census Area",198,"Other Southeast Region - Southern",9,1,176,2,177,0,12,0,5
"07/03/2021","Y","Y","Prince of Wales-Hyder Census Area",198,"Other Southeast Region - Southern",9,1,177,0,177,0,12,0,5
"07/07/2021","Y","Y","Prince of Wales-Hyder Census Area",198,"Other Southeast Region - Southern",9,0,177,1,178,0,12,0,5
"07/08/2021","Y","Y","Prince of Wales-Hyder Census Area",198,"Other Southeast Region - Southern",9,1,178,0,178,0,12,0,5
"07/21/2021","Y","Y","Prince of Wales-Hyder Census Area",198,"Other Southeast Region - Southern",9,0,178,1,179,0,12,0,5
"07/22/2021","Y","Y","Prince of Wales-Hyder Census Area",198,"Other Southeast Region - Southern",9,1,179,0,179,0,12,0,5
"07/23/2021","Y","Y","Prince of Wales-Hyder Census Area",198,"Other Southeast Region - Southern",9,0,179,1,180,0,12,0,5
"07/26/2021","Y","Y","Prince of Wales-Hyder Census Area",198,"Other Southeast Region - Southern",9,2,181,7,187,0,12,0,5
"07/27/2021","Y","Y","Prince of Wales-Hyder Census Area",198,"Other Southeast Region - Southern",9,7,188,6,193,0,12,0,5
"07/28/2021","Y","Y","Prince of Wales-Hyder Census Area",198,"Other Southeast Region - Southern",9,5,193,4,197,0,12,0,5
"07/29/2021","Y","Y","Prince of Wales-Hyder Census Area",198,"Other Southeast Region - Southern",9,3,196,6,203,0,12,0,5
"07/30/2021","Y","Y","Prince of Wales-Hyder Census Area",198,"Other Southeast Region - Southern",9,5,201,14,217,0,12,0,5
"07/31/2021","Y","Y","Prince of Wales-Hyder Census Area",198,"Other Southeast Region - Southern",9,13,214,2,219,0,12,0,5
"08/01/2021","Y","Y","Prince of Wales-Hyder Census Area",198,"Other Southeast Region - Southern",9,2,216,2,221,0,12,0,5
"08/02/2021","Y","Y","Prince of Wales-Hyder Census Area",198,"Other Southeast Region - Southern",9,4,220,3,224,0,12,0,5
"08/03/2021","Y","Y","Prince of Wales-Hyder Census Area",198,"Other Southeast Region - Southern",9,4,224,3,227,0,12,0,5
"08/04/2021","Y","Y","Prince of Wales-Hyder Census Area",198,"Other Southeast Region - Southern",9,0,224,4,231,0,12,0,5
"08/05/2021","Y","Y","Prince of Wales-Hyder Census Area",198,"Other Southeast Region - Southern",9,0,224,3,234,0,12,0,5
"08/06/2021","Y","Y","Prince of Wales-Hyder Census Area",198,"Other Southeast Region - Southern",9,4,228,1,235,0,12,0,5
"08/07/2021","Y","Y","Prince of Wales-Hyder Census Area",198,"Other Southeast Region - Southern",9,0,228,1,236,0,12,0,5
"08/08/2021","Y","Y","Prince of Wales-Hyder Census Area",198,"Other Southeast Region - Southern",9,4,232,1,237,0,12,0,5
"08/09/2021","Y","Y","Prince of Wales-Hyder Census Area",198,"Other Southeast Region - Southern",9,6,238,12,249,0,12,0,5
"08/10/2021","Y","Y","Prince of Wales-Hyder Census Area",198,"Other Southeast Region - Southern",9,6,244,2,251,1,13,0,5
"08/11/2021","Y","Y","Prince of Wales-Hyder Census Area",198,"Other Southeast Region - Southern",9,7,251,7,258,0,13,0,5
"08/12/2021","Y","Y","Prince of Wales-Hyder Census Area",198,"Other Southeast Region - Southern",9,0,251,9,267,0,13,0,5
"08/13/2021","Y","Y","Prince of Wales-Hyder Census Area",198,"Other Southeast Region - Southern",9,2,253,0,267,0,13,0,5
"08/14/2021","Y","Y","Prince of Wales-Hyder Census Area",198,"Other Southeast Region - Southern",9,2,255,0,267,0,13,0,5
"08/15/2021","Y","Y","Prince of Wales-Hyder Census Area",198,"Other Southeast Region - Southern",9,1,256,2,269,0,13,0,5
"08/16/2021","Y","Y","Prince of Wales-Hyder Census Area",198,"Other Southeast Region - Southern",9,0,256,6,275,0,13,1,6
"08/17/2021","Y","Y","Prince of Wales-Hyder Census Area",198,"Other Southeast Region - Southern",9,10,266,10,285,0,13,0,6
"08/18/2021","Y","Y","Prince of Wales-Hyder Census Area",198,"Other Southeast Region - Southern",9,8,274,6,291,0,13,0,6
"08/19/2021","Y","Y","Prince of Wales-Hyder Census Area",198,"Other Southeast Region - Southern",9,2,276,4,295,1,14,0,6
"08/20/2021","Y","Y","Prince of Wales-Hyder Census Area",198,"Other Southeast Region - Southern",9,5,281,10,305,0,14,0,6
"08/21/2021","Y","Y","Prince of Wales-Hyder Census Area",198,"Other Southeast Region - Southern",9,9,290,0,305,0,14,0,6
"08/22/2021","Y","Y","Prince of Wales-Hyder Census Area",198,"Other Southeast Region - Southern",9,1,291,2,307,0,14,0,6
"08/23/2021","Y","Y","Prince of Wales-Hyder Census Area",198,"Other Southeast Region - Southern",9,6,297,2,309,0,14,0,6
"08/24/2021","Y","Y","Prince of Wales-Hyder Census Area",198,"Other Southeast Region - Southern",9,1,298,7,316,0,14,0,6
"08/25/2021","Y","Y","Prince of Wales-Hyder Census Area",198,"Other Southeast Region - Southern",9,1,299,5,321,0,14,0,6
"08/26/2021","Y","Y","Prince of Wales-Hyder Census Area",198,"Other Southeast Region - Southern",9,9,308,2,323,0,14,0,6
"08/27/2021","Y","Y","Prince of Wales-Hyder Census Area",198,"Other Southeast Region - Southern",9,4,312,12,335,0,14,0,6
"08/28/2021","Y","Y","Prince of Wales-Hyder Census Area",198,"Other Southeast Region - Southern",9,0,312,1,336,0,14,0,6
"08/29/2021","Y","Y","Prince of Wales-Hyder Census Area",198,"Other Southeast Region - Southern",9,0,312,1,337,0,14,0,6
"08/30/2021","Y","Y","Prince of Wales-Hyder Census Area",198,"Other Southeast Region - Southern",9,1,313,3,340,0,14,0,6
"08/31/2021","Y","Y","Prince of Wales-Hyder Census Area",198,"Other Southeast Region - Southern",9,8,321,7,347,0,14,0,6
"09/01/2021","Y","Y","Prince of Wales-Hyder Census Area",198,"Other Southeast Region - Southern",9,4,325,2,349,0,14,0,6
"09/02/2021","Y","Y","Prince of Wales-Hyder Census Area",198,"Other Southeast Region - Southern",9,12,337,7,356,0,14,0,6
"09/03/2021","Y","Y","Prince of Wales-Hyder Census Area",198,"Other Southeast Region - Southern",9,4,341,2,358,1,15,0,6
"09/05/2021","Y","Y","Prince of Wales-Hyder Census Area",198,"Other Southeast Region - Southern",9,2,343,2,360,0,15,0,6
"09/06/2021","Y","Y","Prince of Wales-Hyder Census Area",198,"Other Southeast Region - Southern",9,8,351,1,361,0,15,0,6
"09/07/2021","Y","Y","Prince of Wales-Hyder Census Area",198,"Other Southeast Region - Southern",9,3,354,10,371,0,15,0,6
"09/08/2021","Y","Y","Prince of Wales-Hyder Census Area",198,"Other Southeast Region - Southern",9,1,355,5,376,0,15,0,6
"09/09/2021","Y","Y","Prince of Wales-Hyder Census Area",198,"Other Southeast Region - Southern",9,3,358,11,387,0,15,0,6
"09/10/2021","Y","Y","Prince of Wales-Hyder Census Area",198,"Other Southeast Region - Southern",9,3,361,12,399,0,15,0,6
"09/11/2021","Y","Y","Prince of Wales-Hyder Census Area",198,"Other Southeast Region - Southern",9,5,366,1,400,0,15,0,6
"09/13/2021","Y","Y","Prince of Wales-Hyder Census Area",198,"Other Southeast Region - Southern",9,0,366,5,405,0,15,0,6
"09/14/2021","Y","Y","Prince of Wales-Hyder Census Area",198,"Other Southeast Region - Southern",9,2,368,7,412,0,15,0,6
"09/15/2021","Y","Y","Prince of Wales-Hyder Census Area",198,"Other Southeast Region - Southern",9,5,373,6,418,0,15,0,6
"09/16/2021","Y","Y","Prince of Wales-Hyder Census Area",198,"Other Southeast Region - Southern",9,4,377,2,420,0,15,0,6
"09/17/2021","Y","Y","Prince of Wales-Hyder Census Area",198,"Other Southeast Region - Southern",9,11,388,3,423,0,15,0,6
"09/18/2021","Y","Y","Prince of Wales-Hyder Census Area",198,"Other Southeast Region - Southern",9,6,394,2,425,0,15,0,6
"09/19/2021","Y","Y","Prince of Wales-Hyder Census Area",198,"Other Southeast Region - Southern",9,0,394,1,426,0,15,0,6
"09/20/2021","Y","Y","Prince of Wales-Hyder Census Area",198,"Other Southeast Region - Southern",9,14,408,7,433,0,15,0,6
"09/21/2021","Y","Y","Prince of Wales-Hyder Census Area",198,"Other Southeast Region - Southern",9,7,415,4,437,0,15,0,6
"09/22/2021","Y","Y","Prince of Wales-Hyder Census Area",198,"Other Southeast Region - Southern",9,9,424,0,437,0,15,0,6
"09/23/2021","Y","Y","Prince of Wales-Hyder Census Area",198,"Other Southeast Region - Southern",9,3,427,0,437,0,15,0,6
"09/24/2021","Y","Y","Prince of Wales-Hyder Census Area",198,"Other Southeast Region - Southern",9,6,433,0,437,0,15,0,6
"09/26/2021","Y","Y","Prince of Wales-Hyder Census Area",198,"Other Southeast Region - Southern",9,0,433,1,438,0,15,0,6
"09/27/2021","Y","Y","Prince of Wales-Hyder Census Area",198,"Other Southeast Region - Southern",9,0,433,4,442,0,15,0,6
"09/28/2021","Y","Y","Prince of Wales-Hyder Census Area",198,"Other Southeast Region - Southern",9,7,440,0,442,0,15,0,6
"09/29/2021","Y","Y","Prince of Wales-Hyder Census Area",198,"Other Southeast Region - Southern",9,2,442,0,442,0,15,0,6
"09/30/2021","Y","Y","Prince of Wales-Hyder Census Area",198,"Other Southeast Region - Southern",9,0,442,3,445,0,15,0,6
"10/01/2021","Y","Y","Prince of Wales-Hyder Census Area",198,"Other Southeast Region - Southern",9,1,443,1,446,0,15,0,6
"10/02/2021","Y","Y","Prince of Wales-Hyder Census Area",198,"Other Southeast Region - Southern",9,3,446,0,446,0,15,0,6
"10/04/2021","Y","Y","Prince of Wales-Hyder Census Area",198,"Other Southeast Region - Southern",9,0,446,2,448,0,15,0,6
"10/05/2021","Y","Y","Prince of Wales-Hyder Census Area",198,"Other Southeast Region - Southern",9,1,447,0,448,0,15,0,6
"10/07/2021","Y","Y","Prince of Wales-Hyder Census Area",198,"Other Southeast Region - Southern",9,1,448,3,451,0,15,0,6
"10/09/2021","Y","Y","Prince of Wales-Hyder Census Area",198,"Other Southeast Region - Southern",9,0,448,2,453,0,15,0,6
"10/10/2021","Y","Y","Prince of Wales-Hyder Census Area",198,"Other Southeast Region - Southern",9,1,449,1,454,0,15,0,6
"10/11/2021","Y","Y","Prince of Wales-Hyder Census Area",198,"Other Southeast Region - Southern",9,5,454,2,456,0,15,0,6
"10/12/2021","Y","Y","Prince of Wales-Hyder Census Area",198,"Other Southeast Region - Southern",9,1,455,1,457,0,15,0,6
"10/13/2021","Y","Y","Prince of Wales-Hyder Census Area",198,"Other Southeast Region - Southern",9,2,457,2,459,0,15,0,6
"10/14/2021","Y","Y","Prince of Wales-Hyder Census Area",198,"Other Southeast Region - Southern",9,2,459,0,459,0,15,0,6
"10/15/2021","Y","Y","Prince of Wales-Hyder Census Area",198,"Other Southeast Region - Southern",9,0,459,1,460,0,15,0,6
"10/16/2021","Y","Y","Prince of Wales-Hyder Census Area",198,"Other Southeast Region - Southern",9,0,459,1,461,0,15,0,6
"10/17/2021","Y","Y","Prince of Wales-Hyder Census Area",198,"Other Southeast Region - Southern",9,1,460,2,463,0,15,0,6
"10/18/2021","Y","Y","Prince of Wales-Hyder Census Area",198,"Other Southeast Region - Southern",9,1,461,2,465,0,15,0,6
"10/19/2021","Y","Y","Prince of Wales-Hyder Census Area",198,"Other Southeast Region - Southern",9,1,462,5,470,0,15,0,6
"10/20/2021","Y","Y","Prince of Wales-Hyder Census Area",198,"Other Southeast Region - Southern",9,3,465,0,470,0,15,0,6
"10/21/2021","Y","Y","Prince of Wales-Hyder Census Area",198,"Other Southeast Region - Southern",9,5,470,3,473,0,15,0,6
"10/22/2021","Y","Y","Prince of Wales-Hyder Census Area",198,"Other Southeast Region - Southern",9,2,472,4,477,0,15,0,6
"10/23/2021","Y","Y","Prince of Wales-Hyder Census Area",198,"Other Southeast Region - Southern",9,2,474,1,478,0,15,0,6
"10/24/2021","Y","Y","Prince of Wales-Hyder Census Area",198,"Other Southeast Region - Southern",9,2,476,0,478,0,15,0,6
"10/25/2021","Y","Y","Prince of Wales-Hyder Census Area",198,"Other Southeast Region - Southern",9,1,477,2,480,0,15,0,6
"10/26/2021","Y","Y","Prince of Wales-Hyder Census Area",198,"Other Southeast Region - Southern",9,0,477,1,481,0,15,0,6
"10/27/2021","Y","Y","Prince of Wales-Hyder Census Area",198,"Other Southeast Region - Southern",9,2,479,0,481,0,15,0,6
"10/28/2021","Y","Y","Prince of Wales-Hyder Census Area",198,"Other Southeast Region - Southern",9,1,480,4,485,0,15,0,6
"10/29/2021","Y","Y","Prince of Wales-Hyder Census Area",198,"Other Southeast Region - Southern",9,1,481,2,487,0,15,0,6
"10/31/2021","Y","Y","Prince of Wales-Hyder Census Area",198,"Other Southeast Region - Southern",9,2,483,0,487,0,15,0,6
"11/01/2021","Y","Y","Prince of Wales-Hyder Census Area",198,"Other Southeast Region - Southern",9,4,487,4,491,0,15,0,6
"11/02/2021","Y","Y","Prince of Wales-Hyder Census Area",198,"Other Southeast Region - Southern",9,2,489,4,495,0,15,0,6
"11/03/2021","Y","Y","Prince of Wales-Hyder Census Area",198,"Other Southeast Region - Southern",9,1,490,8,503,0,15,0,6
"11/04/2021","Y","Y","Prince of Wales-Hyder Census Area",198,"Other Southeast Region - Southern",9,6,496,9,512,0,15,0,6
"11/05/2021","Y","Y","Prince of Wales-Hyder Census Area",198,"Other Southeast Region - Southern",9,9,505,0,512,0,15,0,6
"11/06/2021","Y","Y","Prince of Wales-Hyder Census Area",198,"Other Southeast Region - Southern",9,7,512,1,513,0,15,0,6
"11/08/2021","Y","Y","Prince of Wales-Hyder Census Area",198,"Other Southeast Region - Southern",9,0,512,13,526,0,15,0,6
"11/09/2021","Y","Y","Prince of Wales-Hyder Census Area",198,"Other Southeast Region - Southern",9,4,516,6,532,0,15,0,6
"11/10/2021","Y","Y","Prince of Wales-Hyder Census Area",198,"Other Southeast Region - Southern",9,1,517,3,535,0,15,0,6
"11/11/2021","Y","Y","Prince of Wales-Hyder Census Area",198,"Other Southeast Region - Southern",9,14,531,3,538,0,15,0,6
"11/12/2021","Y","Y","Prince of Wales-Hyder Census Area",198,"Other Southeast Region - Southern",9,2,533,6,544,0,15,0,6
"11/13/2021","Y","Y","Prince of Wales-Hyder Census Area",198,"Other Southeast Region - Southern",9,8,541,0,544,0,15,0,6
"11/14/2021","Y","Y","Prince of Wales-Hyder Census Area",198,"Other Southeast Region - Southern",9,1,542,1,545,0,15,0,6
"11/15/2021","Y","Y","Prince of Wales-Hyder Census Area",198,"Other Southeast Region - Southern",9,5,547,7,552,0,15,0,6
"11/16/2021","Y","Y","Prince of Wales-Hyder Census Area",198,"Other Southeast Region - Southern",9,1,548,1,553,0,15,0,6
"11/17/2021","Y","Y","Prince of Wales-Hyder Census Area",198,"Other Southeast Region - Southern",9,4,552,2,555,0,15,0,6
"11/18/2021","Y","Y","Prince of Wales-Hyder Census Area",198,"Other Southeast Region - Southern",9,2,554,4,559,0,15,0,6
"11/19/2021","Y","Y","Prince of Wales-Hyder Census Area",198,"Other Southeast Region - Southern",9,1,555,1,560,0,15,0,6
"11/20/2021","Y","Y","Prince of Wales-Hyder Census Area",198,"Other Southeast Region - Southern",9,5,560,2,562,0,15,0,6
"11/21/2021","Y","Y","Prince of Wales-Hyder Census Area",198,"Other Southeast Region - Southern",9,2,562,0,562,0,15,0,6
"11/22/2021","Y","Y","Prince of Wales-Hyder Census Area",198,"Other Southeast Region - Southern",9,0,562,2,564,0,15,0,6
"11/24/2021","Y","Y","Prince of Wales-Hyder Census Area",198,"Other Southeast Region - Southern",9,3,565,1,565,0,15,0,6
"11/28/2021","Y","Y","Prince of Wales-Hyder Census Area",198,"Other Southeast Region - Southern",9,0,565,4,569,0,15,0,6
"11/29/2021","Y","Y","Prince of Wales-Hyder Census Area",198,"Other Southeast Region - Southern",9,0,565,11,580,0,15,0,6
"11/30/2021","Y","Y","Prince of Wales-Hyder Census Area",198,"Other Southeast Region - Southern",9,6,571,1,581,0,15,0,6
"12/01/2021","Y","Y","Prince of Wales-Hyder Census Area",198,"Other Southeast Region - Southern",9,7,578,3,584,0,15,0,6
"12/02/2021","Y","Y","Prince of Wales-Hyder Census Area",198,"Other Southeast Region - Southern",9,5,583,6,590,0,15,0,6
"12/03/2021","Y","Y","Prince of Wales-Hyder Census Area",198,"Other Southeast Region - Southern",9,2,585,2,592,0,15,0,6
"12/04/2021","Y","Y","Prince of Wales-Hyder Census Area",198,"Other Southeast Region - Southern",9,1,586,0,592,0,15,0,6
"12/05/2021","Y","Y","Prince of Wales-Hyder Census Area",198,"Other Southeast Region - Southern",9,2,588,0,592,0,15,0,6
"12/06/2021","Y","Y","Prince of Wales-Hyder Census Area",198,"Other Southeast Region - Southern",9,0,588,3,595,0,15,0,6
"12/07/2021","Y","Y","Prince of Wales-Hyder Census Area",198,"Other Southeast Region - Southern",9,4,592,0,595,0,15,0,6
"12/08/2021","Y","Y","Prince of Wales-Hyder Census Area",198,"Other Southeast Region - Southern",9,4,596,2,597,0,15,0,6
"12/09/2021","Y","Y","Prince of Wales-Hyder Census Area",198,"Other Southeast Region - Southern",9,4,600,4,601,0,15,0,6
"12/11/2021","Y","Y","Prince of Wales-Hyder Census Area",198,"Other Southeast Region - Southern",9,1,601,0,601,0,15,0,6
"12/13/2021","Y","Y","Prince of Wales-Hyder Census Area",198,"Other Southeast Region - Southern",9,1,602,1,602,0,15,0,6
"12/16/2021","Y","Y","Prince of Wales-Hyder Census Area",198,"Other Southeast Region - Southern",9,1,603,2,604,0,15,0,6
"12/17/2021","Y","Y","Prince of Wales-Hyder Census Area",198,"Other Southeast Region - Southern",9,4,607,4,608,0,15,0,6
"12/18/2021","Y","Y","Prince of Wales-Hyder Census Area",198,"Other Southeast Region - Southern",9,1,608,0,608,0,15,0,6
"12/20/2021","Y","Y","Prince of Wales-Hyder Census Area",198,"Other Southeast Region - Southern",9,2,610,2,610,0,15,0,6
"12/22/2021","Y","Y","Prince of Wales-Hyder Census Area",198,"Other Southeast Region - Southern",9,2,612,2,612,0,15,0,6
"12/23/2021","Y","Y","Prince of Wales-Hyder Census Area",198,"Other Southeast Region - Southern",9,2,614,4,616,0,15,0,6
"12/26/2021","Y","Y","Prince of Wales-Hyder Census Area",198,"Other Southeast Region - Southern",9,1,615,1,617,0,15,0,6
"12/27/2021","Y","Y","Prince of Wales-Hyder Census Area",198,"Other Southeast Region - Southern",9,0,615,1,618,0,15,0,6
"12/28/2021","Y","Y","Prince of Wales-Hyder Census Area",198,"Other Southeast Region - Southern",9,2,617,0,618,0,15,0,6
"12/29/2021","Y","Y","Prince of Wales-Hyder Census Area",198,"Other Southeast Region - Southern",9,0,617,2,620,0,15,0,6
"12/30/2021","Y","Y","Prince of Wales-Hyder Census Area",198,"Other Southeast Region - Southern",9,2,619,2,622,0,15,0,6
"12/31/2021","Y","Y","Prince of Wales-Hyder Census Area",198,"Other Southeast Region - Southern",9,1,620,0,622,0,15,0,6
"01/01/2022","Y","Y","Prince of Wales-Hyder Census Area",198,"Other Southeast Region - Southern",9,0,620,3,625,0,15,0,6
"01/02/2022","Y","Y","Prince of Wales-Hyder Census Area",198,"Other Southeast Region - Southern",9,0,620,1,626,0,15,0,6
"01/03/2022","Y","Y","Prince of Wales-Hyder Census Area",198,"Other Southeast Region - Southern",9,7,627,19,645,0,15,0,6
"01/04/2022","Y","Y","Prince of Wales-Hyder Census Area",198,"Other Southeast Region - Southern",9,8,635,24,669,0,15,0,6
"01/05/2022","Y","Y","Prince of Wales-Hyder Census Area",198,"Other Southeast Region - Southern",9,3,638,9,678,0,15,0,6
"01/06/2022","Y","Y","Prince of Wales-Hyder Census Area",198,"Other Southeast Region - Southern",9,39,677,23,701,0,15,0,6
"01/07/2022","Y","Y","Prince of Wales-Hyder Census Area",198,"Other Southeast Region - Southern",9,2,679,9,710,0,15,0,6
"01/08/2022","Y","Y","Prince of Wales-Hyder Census Area",198,"Other Southeast Region - Southern",9,18,697,18,728,0,15,0,6
"01/09/2022","Y","Y","Prince of Wales-Hyder Census Area",198,"Other Southeast Region - Southern",9,19,716,18,746,0,15,0,6
"01/10/2022","Y","Y","Prince of Wales-Hyder Census Area",198,"Other Southeast Region - Southern",9,10,726,23,769,0,15,0,6
"01/11/2022","Y","Y","Prince of Wales-Hyder Census Area",198,"Other Southeast Region - Southern",9,26,752,16,785,0,15,0,6
"01/12/2022","Y","Y","Prince of Wales-Hyder Census Area",198,"Other Southeast Region - Southern",9,1,753,11,796,0,15,0,6
"01/13/2022","Y","Y","Prince of Wales-Hyder Census Area",198,"Other Southeast Region - Southern",9,24,777,30,826,0,15,0,6
"01/14/2022","Y","Y","Prince of Wales-Hyder Census Area",198,"Other Southeast Region - Southern",9,31,808,10,836,0,15,0,6
"01/15/2022","Y","Y","Prince of Wales-Hyder Census Area",198,"Other Southeast Region - Southern",9,8,816,7,843,0,15,0,6
"01/16/2022","Y","Y","Prince of Wales-Hyder Census Area",198,"Other Southeast Region - Southern",9,1,817,2,845,0,15,0,6
"01/17/2022","Y","Y","Prince of Wales-Hyder Census Area",198,"Other Southeast Region - Southern",9,14,831,23,868,0,15,0,6
"01/18/2022","Y","Y","Prince of Wales-Hyder Census Area",198,"Other Southeast Region - Southern",9,4,835,12,880,0,15,0,6
"01/19/2022","Y","Y","Prince of Wales-Hyder Census Area",198,"Other Southeast Region - Southern",9,22,857,6,886,0,15,0,6
"01/20/2022","Y","Y","Prince of Wales-Hyder Census Area",198,"Other Southeast Region - Southern",9,4,861,10,896,0,15,0,6
"01/21/2022","Y","Y","Prince of Wales-Hyder Census Area",198,"Other Southeast Region - Southern",9,22,883,13,909,0,15,0,6
"01/22/2022","Y","Y","Prince of Wales-Hyder Census Area",198,"Other Southeast Region - Southern",9,32,915,28,937,0,15,0,6
"01/23/2022","Y","Y","Prince of Wales-Hyder Census Area",198,"Other Southeast Region - Southern",9,11,926,9,946,0,15,0,6
"01/24/2022","Y","Y","Prince of Wales-Hyder Census Area",198,"Other Southeast Region - Southern",9,6,932,18,964,0,15,0,6
"01/25/2022","Y","Y","Prince of Wales-Hyder Census Area",198,"Other Southeast Region - Southern",9,7,939,12,976,0,15,0,6
"01/26/2022","Y","Y","Prince of Wales-Hyder Census Area",198,"Other Southeast Region - Southern",9,22,961,17,993,0,15,0,6
"01/27/2022","Y","Y","Prince of Wales-Hyder Census Area",198,"Other Southeast Region - Southern",9,38,999,25,1018,0,15,0,6
"01/28/2022","Y","Y","Prince of Wales-Hyder Census Area",198,"Other Southeast Region - Southern",9,27,1026,21,1039,0,15,0,6
"01/29/2022","Y","Y","Prince of Wales-Hyder Census Area",198,"Other Southeast Region - Southern",9,3,1029,4,1043,0,15,0,6
"01/30/2022","Y","Y","Prince of Wales-Hyder Census Area",198,"Other Southeast Region - Southern",9,15,1044,12,1055,0,15,0,6
"01/31/2022","Y","Y","Prince of Wales-Hyder Census Area",198,"Other Southeast Region - Southern",9,6,1050,11,1066,0,15,0,6
"02/01/2022","Y","Y","Prince of Wales-Hyder Census Area",198,"Other Southeast Region - Southern",9,2,1052,3,1069,0,15,0,6
"02/02/2022","Y","Y","Prince of Wales-Hyder Census Area",198,"Other Southeast Region - Southern",9,29,1081,22,1091,0,15,0,6
"02/03/2022","Y","Y","Prince of Wales-Hyder Census Area",198,"Other Southeast Region - Southern",9,13,1094,18,1109,0,15,0,6
"02/04/2022","Y","Y","Prince of Wales-Hyder Census Area",198,"Other Southeast Region - Southern",9,4,1098,12,1121,1,16,0,6
"02/05/2022","Y","Y","Prince of Wales-Hyder Census Area",198,"Other Southeast Region - Southern",9,28,1126,17,1138,0,16,0,6
"02/06/2022","Y","Y","Prince of Wales-Hyder Census Area",198,"Other Southeast Region - Southern",9,10,1136,3,1141,0,16,0,6
"02/07/2022","Y","Y","Prince of Wales-Hyder Census Area",198,"Other Southeast Region - Southern",9,2,1138,9,1150,1,17,0,6
"02/08/2022","Y","Y","Prince of Wales-Hyder Census Area",198,"Other Southeast Region - Southern",9,23,1161,18,1168,0,17,0,6
"02/09/2022","Y","Y","Prince of Wales-Hyder Census Area",198,"Other Southeast Region - Southern",9,25,1186,29,1197,0,17,0,6
"02/10/2022","Y","Y","Prince of Wales-Hyder Census Area",198,"Other Southeast Region - Southern",9,19,1205,21,1218,0,17,0,6
"02/11/2022","Y","Y","Prince of Wales-Hyder Census Area",198,"Other Southeast Region - Southern",9,9,1214,10,1228,0,17,1,7
"02/12/2022","Y","Y","Prince of Wales-Hyder Census Area",198,"Other Southeast Region - Southern",9,18,1232,8,1236,0,17,0,7
"02/13/2022","Y","Y","Prince of Wales-Hyder Census Area",198,"Other Southeast Region - Southern",9,3,1235,3,1239,1,18,0,7
"02/14/2022","Y","Y","Prince of Wales-Hyder Census Area",198,"Other Southeast Region - Southern",9,9,1244,10,1249,0,18,0,7
"02/15/2022","Y","Y","Prince of Wales-Hyder Census Area",198,"Other Southeast Region - Southern",9,17,1261,14,1263,1,19,0,7
"02/16/2022","Y","Y","Prince of Wales-Hyder Census Area",198,"Other Southeast Region - Southern",9,21,1282,23,1286,0,19,0,7
"02/17/2022","Y","Y","Prince of Wales-Hyder Census Area",198,"Other Southeast Region - Southern",9,5,1287,8,1294,0,19,0,7
"02/18/2022","Y","Y","Prince of Wales-Hyder Census Area",198,"Other Southeast Region - Southern",9,1,1288,4,1298,1,20,1,8
"02/19/2022","Y","Y","Prince of Wales-Hyder Census Area",198,"Other Southeast Region - Southern",9,15,1303,5,1303,0,20,0,8
"02/21/2022","Y","Y","Prince of Wales-Hyder Census Area",198,"Other Southeast Region - Southern",9,1,1304,2,1305,0,20,0,8
"02/22/2022","Y","Y","Prince of Wales-Hyder Census Area",198,"Other Southeast Region - Southern",9,1,1305,0,1305,0,20,0,8
"02/23/2022","Y","Y","Prince of Wales-Hyder Census Area",198,"Other Southeast Region - Southern",9,14,1319,14,1319,0,20,0,8
"02/24/2022","Y","Y","Prince of Wales-Hyder Census Area",198,"Other Southeast Region - Southern",9,1,1320,3,1322,0,20,0,8
"02/25/2022","Y","Y","Prince of Wales-Hyder Census Area",198,"Other Southeast Region - Southern",9,7,1327,5,1327,0,20,0,8
"02/26/2022","Y","Y","Prince of Wales-Hyder Census Area",198,"Other Southeast Region - Southern",9,1,1328,1,1328,0,20,0,8
"02/27/2022","Y","Y","Prince of Wales-Hyder Census Area",198,"Other Southeast Region - Southern",9,0,1328,1,1329,0,20,0,8
"02/28/2022","Y","Y","Prince of Wales-Hyder Census Area",198,"Other Southeast Region - Southern",9,1,1329,5,1334,0,20,0,8
"03/01/2022","Y","Y","Prince of Wales-Hyder Census Area",198,"Other Southeast Region - Southern",9,5,1334,0,1334,0,20,0,8
"03/02/2022","Y","Y","Prince of Wales-Hyder Census Area",198,"Other Southeast Region - Southern",9,2,1336,3,1337,0,20,0,8
"03/03/2022","Y","Y","Prince of Wales-Hyder Census Area",198,"Other Southeast Region - Southern",9,2,1338,4,1341,0,20,0,8
"03/04/2022","Y","Y","Prince of Wales-Hyder Census Area",198,"Other Southeast Region - Southern",9,4,1342,7,1348,0,20,0,8
"03/05/2022","Y","Y","Prince of Wales-Hyder Census Area",198,"Other Southeast Region - Southern",9,7,1349,2,1350,0,20,0,8
"03/06/2022","Y","Y","Prince of Wales-Hyder Census Area",198,"Other Southeast Region - Southern",9,1,1350,1,1351,0,20,0,8
"03/07/2022","Y","Y","Prince of Wales-Hyder Census Area",198,"Other Southeast Region - Southern",9,0,1350,1,1352,0,20,0,8
"03/08/2022","Y","Y","Prince of Wales-Hyder Census Area",198,"Other Southeast Region - Southern",9,2,1352,2,1354,0,20,0,8
"03/09/2022","Y","Y","Prince of Wales-Hyder Census Area",198,"Other Southeast Region - Southern",9,3,1355,2,1356,0,20,0,8
"03/10/2022","Y","Y","Prince of Wales-Hyder Census Area",198,"Other Southeast Region - Southern",9,6,1361,7,1363,0,20,0,8
"03/11/2022","Y","Y","Prince of Wales-Hyder Census Area",198,"Other Southeast Region - Southern",9,0,1361,2,1365,0,20,0,8
"03/12/2022","Y","Y","Prince of Wales-Hyder Census Area",198,"Other Southeast Region - Southern",9,3,1364,1,1366,0,20,0,8
"03/13/2022","Y","Y","Prince of Wales-Hyder Census Area",198,"Other Southeast Region - Southern",9,2,1366,1,1367,0,20,0,8
"03/14/2022","Y","Y","Prince of Wales-Hyder Census Area",198,"Other Southeast Region - Southern",9,3,1369,2,1369,0,20,0,8
"03/15/2022","Y","Y","Prince of Wales-Hyder Census Area",198,"Other Southeast Region - Southern",9,4,1373,4,1373,0,20,0,8
"03/17/2022","Y","Y","Prince of Wales-Hyder Census Area",198,"Other Southeast Region - Southern",9,5,1378,5,1378,0,20,0,8
"03/18/2022","Y","Y","Prince of Wales-Hyder Census Area",198,"Other Southeast Region - Southern",9,2,1380,2,1380,0,20,0,8
"03/20/2022","Y","Y","Prince of Wales-Hyder Census Area",198,"Other Southeast Region - Southern",9,4,1384,4,1384,0,20,0,8
"03/21/2022","Y","Y","Prince of Wales-Hyder Census Area",198,"Other Southeast Region - Southern",9,5,1389,5,1389,0,20,0,8
"03/23/2022","Y","Y","Prince of Wales-Hyder Census Area",198,"Other Southeast Region - Southern",9,1,1390,1,1390,0,20,0,8
"03/25/2022","Y","Y","Prince of Wales-Hyder Census Area",198,"Other Southeast Region - Southern",9,1,1391,1,1391,0,20,0,8
"03/29/2022","Y","Y","Prince of Wales-Hyder Census Area",198,"Other Southeast Region - Southern",9,1,1392,1,1392,0,20,0,8
"03/30/2022","Y","Y","Prince of Wales-Hyder Census Area",198,"Other Southeast Region - Southern",9,1,1393,1,1393,0,20,0,8
"03/31/2022","Y","Y","Prince of Wales-Hyder Census Area",198,"Other Southeast Region - Southern",9,1,1394,1,1394,0,20,0,8
"04/03/2022","Y","Y","Prince of Wales-Hyder Census Area",198,"Other Southeast Region - Southern",9,0,1394,1,1395,0,20,0,8
"04/04/2022","Y","Y","Prince of Wales-Hyder Census Area",198,"Other Southeast Region - Southern",9,0,1394,3,1398,0,20,0,8
"04/05/2022","Y","Y","Prince of Wales-Hyder Census Area",198,"Other Southeast Region - Southern",9,4,1398,1,1399,0,20,0,8
"04/06/2022","Y","Y","Prince of Wales-Hyder Census Area",198,"Other Southeast Region - Southern",9,1,1399,0,1399,0,20,0,8
"04/10/2022","Y","Y","Prince of Wales-Hyder Census Area",198,"Other Southeast Region - Southern",9,0,1399,1,1400,0,20,0,8
"04/13/2022","Y","Y","Prince of Wales-Hyder Census Area",198,"Other Southeast Region - Southern",9,1,1400,0,1400,0,20,0,8
"04/14/2022","Y","Y","Prince of Wales-Hyder Census Area",198,"Other Southeast Region - Southern",9,1,1401,1,1401,0,20,0,8
"04/19/2022","Y","Y","Prince of Wales-Hyder Census Area",198,"Other Southeast Region - Southern",9,1,1402,1,1402,0,20,0,8
"04/20/2022","Y","Y","Prince of Wales-Hyder Census Area",198,"Other Southeast Region - Southern",9,2,1404,2,1404,0,20,0,8
"04/22/2022","Y","Y","Prince of Wales-Hyder Census Area",198,"Other Southeast Region - Southern",9,1,1405,1,1405,0,20,0,8
"04/21/2020","Y","Y","Sitka City and Borough",220,"Other Southeast Region - Northern",8,0,0,1,1,0,0,0,0
"04/25/2020","Y","Y","Sitka City and Borough",220,"Other Southeast Region - Northern",8,1,1,0,1,0,0,0,0
"05/22/2020","Y","Y","Sitka City and Borough",220,"Other Southeast Region - Northern",8,0,1,1,2,0,0,0,0
"05/25/2020","Y","Y","Sitka City and Borough",220,"Other Southeast Region - Northern",8,1,2,0,2,0,0,0,0
"06/04/2020","Y","Y","Sitka City and Borough",220,"Other Southeast Region - Northern",8,0,2,1,3,0,0,0,0
"06/07/2020","Y","Y","Sitka City and Borough",220,"Other Southeast Region - Northern",8,0,2,2,5,0,0,0,0
"06/08/2020","Y","Y","Sitka City and Borough",220,"Other Southeast Region - Northern",8,0,2,2,7,0,0,0,0
"06/09/2020","Y","Y","Sitka City and Borough",220,"Other Southeast Region - Northern",8,1,3,1,8,0,0,0,0
"06/10/2020","Y","Y","Sitka City and Borough",220,"Other Southeast Region - Northern",8,3,6,0,8,0,0,0,0
"06/11/2020","Y","Y","Sitka City and Borough",220,"Other Southeast Region - Northern",8,0,6,1,9,0,0,0,0
"06/12/2020","Y","Y","Sitka City and Borough",220,"Other Southeast Region - Northern",8,2,8,1,10,0,0,0,0
"06/13/2020","Y","Y","Sitka City and Borough",220,"Other Southeast Region - Northern",8,0,8,1,11,0,0,0,0
"06/16/2020","Y","Y","Sitka City and Borough",220,"Other Southeast Region - Northern",8,1,9,0,11,0,0,0,0
"06/19/2020","Y","Y","Sitka City and Borough",220,"Other Southeast Region - Northern",8,2,11,0,11,0,0,0,0
"06/25/2020","Y","Y","Sitka City and Borough",220,"Other Southeast Region - Northern",8,1,12,1,12,0,0,0,0
"06/28/2020","Y","Y","Sitka City and Borough",220,"Other Southeast Region - Northern",8,0,12,1,13,0,0,0,0
"07/01/2020","Y","Y","Sitka City and Borough",220,"Other Southeast Region - Northern",8,1,13,0,13,0,0,0,0
"07/14/2020","Y","Y","Sitka City and Borough",220,"Other Southeast Region - Northern",8,0,13,1,14,0,0,0,0
"07/15/2020","Y","Y","Sitka City and Borough",220,"Other Southeast Region - Northern",8,0,13,1,15,0,0,0,0
"07/16/2020","Y","Y","Sitka City and Borough",220,"Other Southeast Region - Northern",8,2,15,2,17,0,0,0,0
"07/20/2020","Y","Y","Sitka City and Borough",220,"Other Southeast Region - Northern",8,1,16,2,19,0,0,0,0
"07/21/2020","Y","Y","Sitka City and Borough",220,"Other Southeast Region - Northern",8,2,18,0,19,0,0,0,0
"07/23/2020","Y","Y","Sitka City and Borough",220,"Other Southeast Region - Northern",8,0,18,1,20,0,0,0,0
"07/25/2020","Y","Y","Sitka City and Borough",220,"Other Southeast Region - Northern",8,1,19,2,22,0,0,0,0
"07/26/2020","Y","Y","Sitka City and Borough",220,"Other Southeast Region - Northern",8,2,21,0,22,0,0,0,0
"07/30/2020","Y","Y","Sitka City and Borough",220,"Other Southeast Region - Northern",8,0,21,1,23,0,0,0,0
"07/31/2020","Y","Y","Sitka City and Borough",220,"Other Southeast Region - Northern",8,1,22,1,24,0,0,0,0
"08/01/2020","Y","Y","Sitka City and Borough",220,"Other Southeast Region - Northern",8,1,23,0,24,0,0,0,0
"08/03/2020","Y","Y","Sitka City and Borough",220,"Other Southeast Region - Northern",8,0,23,1,25,0,0,0,0
"08/04/2020","Y","Y","Sitka City and Borough",220,"Other Southeast Region - Northern",8,2,25,1,26,0,0,0,0
"08/06/2020","Y","Y","Sitka City and Borough",220,"Other Southeast Region - Northern",8,0,25,1,27,0,0,0,0
"08/07/2020","Y","Y","Sitka City and Borough",220,"Other Southeast Region - Northern",8,1,26,0,27,0,0,0,0
"08/08/2020","Y","Y","Sitka City and Borough",220,"Other Southeast Region - Northern",8,0,26,2,29,0,0,0,0
"08/09/2020","Y","Y","Sitka City and Borough",220,"Other Southeast Region - Northern",8,1,27,0,29,0,0,0,0
"08/10/2020","Y","Y","Sitka City and Borough",220,"Other Southeast Region - Northern",8,0,27,1,30,0,0,0,0
"08/11/2020","Y","Y","Sitka City and Borough",220,"Other Southeast Region - Northern",8,1,28,0,30,0,0,0,0
"08/13/2020","Y","Y","Sitka City and Borough",220,"Other Southeast Region - Northern",8,1,29,1,31,0,0,0,0
"08/14/2020","Y","Y","Sitka City and Borough",220,"Other Southeast Region - Northern",8,2,31,0,31,0,0,0,0
"08/15/2020","Y","Y","Sitka City and Borough",220,"Other Southeast Region - Northern",8,0,31,1,32,0,0,0,0
"08/17/2020","Y","Y","Sitka City and Borough",220,"Other Southeast Region - Northern",8,2,33,2,34,0,0,0,0
"08/20/2020","Y","Y","Sitka City and Borough",220,"Other Southeast Region - Northern",8,1,34,0,34,0,0,0,0
"08/21/2020","Y","Y","Sitka City and Borough",220,"Other Southeast Region - Northern",8,0,34,1,35,0,0,0,0
"08/23/2020","Y","Y","Sitka City and Borough",220,"Other Southeast Region - Northern",8,0,34,1,36,0,0,0,0
"08/24/2020","Y","Y","Sitka City and Borough",220,"Other Southeast Region - Northern",8,0,34,1,37,0,0,0,0
"08/26/2020","Y","Y","Sitka City and Borough",220,"Other Southeast Region - Northern",8,1,35,0,37,0,0,0,0
"08/27/2020","Y","Y","Sitka City and Borough",220,"Other Southeast Region - Northern",8,1,36,0,37,0,0,0,0
"08/28/2020","Y","Y","Sitka City and Borough",220,"Other Southeast Region - Northern",8,1,37,0,37,0,0,0,0
"09/03/2020","Y","Y","Sitka City and Borough",220,"Other Southeast Region - Northern",8,0,37,1,38,0,0,0,0
"09/06/2020","Y","Y","Sitka City and Borough",220,"Other Southeast Region - Northern",8,0,37,1,39,0,0,0,0
"09/07/2020","Y","Y","Sitka City and Borough",220,"Other Southeast Region - Northern",8,1,38,0,39,0,0,0,0
"09/09/2020","Y","Y","Sitka City and Borough",220,"Other Southeast Region - Northern",8,1,39,0,39,0,0,0,0
"09/12/2020","Y","Y","Sitka City and Borough",220,"Other Southeast Region - Northern",8,0,39,1,40,0,0,0,0
"09/16/2020","Y","Y","Sitka City and Borough",220,"Other Southeast Region - Northern",8,0,39,1,41,0,0,0,0
"09/17/2020","Y","Y","Sitka City and Borough",220,"Other Southeast Region - Northern",8,2,41,0,41,0,0,0,0
"09/18/2020","Y","Y","Sitka City and Borough",220,"Other Southeast Region - Northern",8,0,41,2,43,0,0,0,0
"09/19/2020","Y","Y","Sitka City and Borough",220,"Other Southeast Region - Northern",8,2,43,0,43,0,0,0,0
"09/22/2020","Y","Y","Sitka City and Borough",220,"Other Southeast Region - Northern",8,0,43,1,44,0,0,0,0
"09/23/2020","Y","Y","Sitka City and Borough",220,"Other Southeast Region - Northern",8,1,44,0,44,0,0,0,0
"09/24/2020","Y","Y","Sitka City and Borough",220,"Other Southeast Region - Northern",8,0,44,1,45,0,0,0,0
"09/25/2020","Y","Y","Sitka City and Borough",220,"Other Southeast Region - Northern",8,0,44,1,46,0,0,0,0
"09/26/2020","Y","Y","Sitka City and Borough",220,"Other Southeast Region - Northern",8,1,45,3,49,1,1,0,0
"09/27/2020","Y","Y","Sitka City and Borough",220,"Other Southeast Region - Northern",8,2,47,1,50,0,1,0,0
"09/28/2020","Y","Y","Sitka City and Borough",220,"Other Southeast Region - Northern",8,2,49,2,52,0,1,0,0
"09/29/2020","Y","Y","Sitka City and Borough",220,"Other Southeast Region - Northern",8,3,52,0,52,0,1,0,0
"10/08/2020","Y","Y","Sitka City and Borough",220,"Other Southeast Region - Northern",8,0,52,1,53,0,1,0,0
"10/13/2020","Y","Y","Sitka City and Borough",220,"Other Southeast Region - Northern",8,1,53,0,53,0,1,0,0
"10/17/2020","Y","Y","Sitka City and Borough",220,"Other Southeast Region - Northern",8,0,53,1,54,0,1,0,0
"10/20/2020","Y","Y","Sitka City and Borough",220,"Other Southeast Region - Northern",8,1,54,1,55,0,1,0,0
"10/21/2020","Y","Y","Sitka City and Borough",220,"Other Southeast Region - Northern",8,0,54,2,57,0,1,0,0
"10/22/2020","Y","Y","Sitka City and Borough",220,"Other Southeast Region - Northern",8,0,54,2,59,0,1,0,0
"10/24/2020","Y","Y","Sitka City and Borough",220,"Other Southeast Region - Northern",8,2,56,0,59,0,1,0,0
"10/25/2020","Y","Y","Sitka City and Borough",220,"Other Southeast Region - Northern",8,0,56,1,60,0,1,0,0
"10/26/2020","Y","Y","Sitka City and Borough",220,"Other Southeast Region - Northern",8,0,56,1,61,0,1,0,0
"10/27/2020","Y","Y","Sitka City and Borough",220,"Other Southeast Region - Northern",8,0,56,1,62,0,1,0,0
"10/28/2020","Y","Y","Sitka City and Borough",220,"Other Southeast Region - Northern",8,2,58,1,63,0,1,0,0
"10/29/2020","Y","Y","Sitka City and Borough",220,"Other Southeast Region - Northern",8,2,60,1,64,1,2,0,0
"10/30/2020","Y","Y","Sitka City and Borough",220,"Other Southeast Region - Northern",8,3,63,3,67,0,2,0,0
"10/31/2020","Y","Y","Sitka City and Borough",220,"Other Southeast Region - Northern",8,0,63,1,68,0,2,0,0
"11/01/2020","Y","Y","Sitka City and Borough",220,"Other Southeast Region - Northern",8,1,64,5,73,0,2,0,0
"11/02/2020","Y","Y","Sitka City and Borough",220,"Other Southeast Region - Northern",8,1,65,3,76,0,2,0,0
"11/03/2020","Y","Y","Sitka City and Borough",220,"Other Southeast Region - Northern",8,5,70,0,76,0,2,0,0
"11/04/2020","Y","Y","Sitka City and Borough",220,"Other Southeast Region - Northern",8,1,71,3,79,0,2,0,0
"11/05/2020","Y","Y","Sitka City and Borough",220,"Other Southeast Region - Northern",8,4,75,3,82,0,2,0,0
"11/06/2020","Y","Y","Sitka City and Borough",220,"Other Southeast Region - Northern",8,3,78,5,87,0,2,0,0
"11/07/2020","Y","Y","Sitka City and Borough",220,"Other Southeast Region - Northern",8,1,79,3,90,0,2,0,0
"11/08/2020","Y","Y","Sitka City and Borough",220,"Other Southeast Region - Northern",8,6,85,1,91,0,2,0,0
"11/09/2020","Y","Y","Sitka City and Borough",220,"Other Southeast Region - Northern",8,0,85,10,101,0,2,0,0
"11/10/2020","Y","Y","Sitka City and Borough",220,"Other Southeast Region - Northern",8,3,88,5,106,0,2,0,0
"11/11/2020","Y","Y","Sitka City and Borough",220,"Other Southeast Region - Northern",8,3,91,5,111,0,2,0,0
"11/12/2020","Y","Y","Sitka City and Borough",220,"Other Southeast Region - Northern",8,8,99,3,114,0,2,0,0
"11/13/2020","Y","Y","Sitka City and Borough",220,"Other Southeast Region - Northern",8,1,100,2,116,0,2,0,0
"11/14/2020","Y","Y","Sitka City and Borough",220,"Other Southeast Region - Northern",8,13,113,0,116,0,2,0,0
"11/15/2020","Y","Y","Sitka City and Borough",220,"Other Southeast Region - Northern",8,1,114,3,119,0,2,0,0
"11/16/2020","Y","Y","Sitka City and Borough",220,"Other Southeast Region - Northern",8,2,116,5,124,0,2,0,0
"11/17/2020","Y","Y","Sitka City and Borough",220,"Other Southeast Region - Northern",8,0,116,6,130,0,2,0,0
"11/18/2020","Y","Y","Sitka City and Borough",220,"Other Southeast Region - Northern",8,6,122,4,134,0,2,0,0
"11/19/2020","Y","Y","Sitka City and Borough",220,"Other Southeast Region - Northern",8,3,125,7,141,0,2,0,0
"11/20/2020","Y","Y","Sitka City and Borough",220,"Other Southeast Region - Northern",8,8,133,3,144,0,2,0,0
"11/21/2020","Y","Y","Sitka City and Borough",220,"Other Southeast Region - Northern",8,4,137,8,152,0,2,0,0
"11/22/2020","Y","Y","Sitka City and Borough",220,"Other Southeast Region - Northern",8,5,142,2,154,0,2,0,0
"11/23/2020","Y","Y","Sitka City and Borough",220,"Other Southeast Region - Northern",8,2,144,2,156,0,2,0,0
"11/24/2020","Y","Y","Sitka City and Borough",220,"Other Southeast Region - Northern",8,9,153,9,165,0,2,0,0
"11/25/2020","Y","Y","Sitka City and Borough",220,"Other Southeast Region - Northern",8,1,154,9,174,0,2,0,0
"11/26/2020","Y","Y","Sitka City and Borough",220,"Other Southeast Region - Northern",8,2,156,1,175,0,2,0,0
"11/27/2020","Y","Y","Sitka City and Borough",220,"Other Southeast Region - Northern",8,6,162,7,182,0,2,0,0
"11/28/2020","Y","Y","Sitka City and Borough",220,"Other Southeast Region - Northern",8,6,168,3,185,0,2,0,0
"11/29/2020","Y","Y","Sitka City and Borough",220,"Other Southeast Region - Northern",8,7,175,3,188,0,2,0,0
"11/30/2020","Y","Y","Sitka City and Borough",220,"Other Southeast Region - Northern",8,4,179,6,194,0,2,0,0
"12/01/2020","Y","Y","Sitka City and Borough",220,"Other Southeast Region - Northern",8,7,186,5,199,0,2,0,0
"12/02/2020","Y","Y","Sitka City and Borough",220,"Other Southeast Region - Northern",8,7,193,2,201,0,2,0,0
"12/03/2020","Y","Y","Sitka City and Borough",220,"Other Southeast Region - Northern",8,3,196,3,204,0,2,0,0
"12/04/2020","Y","Y","Sitka City and Borough",220,"Other Southeast Region - Northern",8,5,201,1,205,0,2,0,0
"12/05/2020","Y","Y","Sitka City and Borough",220,"Other Southeast Region - Northern",8,1,202,2,207,0,2,0,0
"12/06/2020","Y","Y","Sitka City and Borough",220,"Other Southeast Region - Northern",8,1,203,0,207,0,2,0,0
"12/07/2020","Y","Y","Sitka City and Borough",220,"Other Southeast Region - Northern",8,3,206,1,208,0,2,0,0
"12/08/2020","Y","Y","Sitka City and Borough",220,"Other Southeast Region - Northern",8,0,206,3,211,0,2,0,0
"12/09/2020","Y","Y","Sitka City and Borough",220,"Other Southeast Region - Northern",8,1,207,6,217,0,2,0,0
"12/10/2020","Y","Y","Sitka City and Borough",220,"Other Southeast Region - Northern",8,0,207,3,220,0,2,0,0
"12/11/2020","Y","Y","Sitka City and Borough",220,"Other Southeast Region - Northern",8,3,210,3,223,0,2,0,0
"12/12/2020","Y","Y","Sitka City and Borough",220,"Other Southeast Region - Northern",8,4,214,1,224,0,2,0,0
"12/13/2020","Y","Y","Sitka City and Borough",220,"Other Southeast Region - Northern",8,2,216,0,224,0,2,0,0
"12/14/2020","Y","Y","Sitka City and Borough",220,"Other Southeast Region - Northern",8,5,221,6,230,0,2,0,0
"12/15/2020","Y","Y","Sitka City and Borough",220,"Other Southeast Region - Northern",8,2,223,3,233,0,2,0,0
"12/16/2020","Y","Y","Sitka City and Borough",220,"Other Southeast Region - Northern",8,2,225,0,233,1,3,0,0
"12/17/2020","Y","Y","Sitka City and Borough",220,"Other Southeast Region - Northern",8,6,231,2,235,0,3,0,0
"12/18/2020","Y","Y","Sitka City and Borough",220,"Other Southeast Region - Northern",8,1,232,4,239,0,3,0,0
"12/19/2020","Y","Y","Sitka City and Borough",220,"Other Southeast Region - Northern",8,1,233,1,240,0,3,0,0
"12/21/2020","Y","Y","Sitka City and Borough",220,"Other Southeast Region - Northern",8,0,233,1,241,0,3,0,0
"12/22/2020","Y","Y","Sitka City and Borough",220,"Other Southeast Region - Northern",8,4,237,0,241,0,3,0,0
"12/23/2020","Y","Y","Sitka City and Borough",220,"Other Southeast Region - Northern",8,3,240,2,243,0,3,0,0
"12/25/2020","Y","Y","Sitka City and Borough",220,"Other Southeast Region - Northern",8,3,243,0,243,0,3,0,0
"12/26/2020","Y","Y","Sitka City and Borough",220,"Other Southeast Region - Northern",8,1,244,1,244,0,3,0,0
"12/30/2020","Y","Y","Sitka City and Borough",220,"Other Southeast Region - Northern",8,0,244,1,245,0,3,0,0
"01/02/2021","Y","Y","Sitka City and Borough",220,"Other Southeast Region - Northern",8,1,245,2,247,0,3,0,0
"01/04/2021","Y","Y","Sitka City and Borough",220,"Other Southeast Region - Northern",8,2,247,3,250,0,3,0,0
"01/05/2021","Y","Y","Sitka City and Borough",220,"Other Southeast Region - Northern",8,1,248,1,251,0,3,0,0
"01/06/2021","Y","Y","Sitka City and Borough",220,"Other Southeast Region - Northern",8,0,248,2,253,0,3,0,0
"01/07/2021","Y","Y","Sitka City and Borough",220,"Other Southeast Region - Northern",8,4,252,3,256,0,3,0,0
"01/08/2021","Y","Y","Sitka City and Borough",220,"Other Southeast Region - Northern",8,1,253,4,260,0,3,0,0
"01/09/2021","Y","Y","Sitka City and Borough",220,"Other Southeast Region - Northern",8,1,254,1,261,0,3,0,0
"01/10/2021","Y","Y","Sitka City and Borough",220,"Other Southeast Region - Northern",8,2,256,1,262,0,3,0,0
"01/11/2021","Y","Y","Sitka City and Borough",220,"Other Southeast Region - Northern",8,5,261,5,267,0,3,0,0
"01/12/2021","Y","Y","Sitka City and Borough",220,"Other Southeast Region - Northern",8,1,262,0,267,0,3,0,0
"01/13/2021","Y","Y","Sitka City and Borough",220,"Other Southeast Region - Northern",8,0,262,1,268,0,3,0,0
"01/14/2021","Y","Y","Sitka City and Borough",220,"Other Southeast Region - Northern",8,4,266,1,269,0,3,0,0
"01/15/2021","Y","Y","Sitka City and Borough",220,"Other Southeast Region - Northern",8,1,267,1,270,0,3,0,0
"01/17/2021","Y","Y","Sitka City and Borough",220,"Other Southeast Region - Northern",8,1,268,0,270,0,3,0,0
"01/18/2021","Y","Y","Sitka City and Borough",220,"Other Southeast Region - Northern",8,1,269,0,270,0,3,0,0
"01/21/2021","Y","Y","Sitka City and Borough",220,"Other Southeast Region - Northern",8,0,269,1,271,0,3,0,0
"01/23/2021","Y","Y","Sitka City and Borough",220,"Other Southeast Region - Northern",8,1,270,0,271,0,3,0,0
"01/26/2021","Y","Y","Sitka City and Borough",220,"Other Southeast Region - Northern",8,0,270,1,272,0,3,0,0
"01/27/2021","Y","Y","Sitka City and Borough",220,"Other Southeast Region - Northern",8,1,271,2,274,0,3,0,0
"01/28/2021","Y","Y","Sitka City and Borough",220,"Other Southeast Region - Northern",8,1,272,1,275,0,3,0,0
"01/29/2021","Y","Y","Sitka City and Borough",220,"Other Southeast Region - Northern",8,1,273,1,276,0,3,0,0
"01/30/2021","Y","Y","Sitka City and Borough",220,"Other Southeast Region - Northern",8,1,274,0,276,0,3,0,0
"01/31/2021","Y","Y","Sitka City and Borough",220,"Other Southeast Region - Northern",8,0,274,1,277,0,3,0,0
"02/02/2021","Y","Y","Sitka City and Borough",220,"Other Southeast Region - Northern",8,3,277,0,277,0,3,0,0
"02/03/2021","Y","Y","Sitka City and Borough",220,"Other Southeast Region - Northern",8,1,278,1,278,0,3,0,0
"02/04/2021","Y","Y","Sitka City and Borough",220,"Other Southeast Region - Northern",8,0,278,1,279,0,3,0,0
"02/10/2021","Y","Y","Sitka City and Borough",220,"Other Southeast Region - Northern",8,0,278,1,280,0,3,0,0
"02/12/2021","Y","Y","Sitka City and Borough",220,"Other Southeast Region - Northern",8,1,279,0,280,0,3,0,0
"02/13/2021","Y","Y","Sitka City and Borough",220,"Other Southeast Region - Northern",8,0,279,1,281,0,3,0,0
"02/15/2021","Y","Y","Sitka City and Borough",220,"Other Southeast Region - Northern",8,0,279,3,284,0,3,0,0
"02/17/2021","Y","Y","Sitka City and Borough",220,"Other Southeast Region - Northern",8,1,280,1,285,0,3,0,0
"02/18/2021","Y","Y","Sitka City and Borough",220,"Other Southeast Region - Northern",8,2,282,1,286,0,3,0,0
"02/19/2021","Y","Y","Sitka City and Borough",220,"Other Southeast Region - Northern",8,1,283,1,287,0,3,0,0
"02/22/2021","Y","Y","Sitka City and Borough",220,"Other Southeast Region - Northern",8,1,284,0,287,0,3,0,0
"02/23/2021","Y","Y","Sitka City and Borough",220,"Other Southeast Region - Northern",8,0,284,1,288,0,3,0,0
"02/25/2021","Y","Y","Sitka City and Borough",220,"Other Southeast Region - Northern",8,1,285,0,288,0,3,0,0
"02/26/2021","Y","Y","Sitka City and Borough",220,"Other Southeast Region - Northern",8,0,285,1,289,0,3,0,0
"02/28/2021","Y","Y","Sitka City and Borough",220,"Other Southeast Region - Northern",8,1,286,0,289,0,3,0,0
"03/01/2021","Y","Y","Sitka City and Borough",220,"Other Southeast Region - Northern",8,3,289,1,290,0,3,0,0
"03/02/2021","Y","Y","Sitka City and Borough",220,"Other Southeast Region - Northern",8,1,290,1,291,0,3,0,0
"03/04/2021","Y","Y","Sitka City and Borough",220,"Other Southeast Region - Northern",8,1,291,1,292,0,3,0,0
"03/05/2021","Y","Y","Sitka City and Borough",220,"Other Southeast Region - Northern",8,1,292,1,293,0,3,0,0
"03/06/2021","Y","Y","Sitka City and Borough",220,"Other Southeast Region - Northern",8,0,292,1,294,0,3,0,0
"03/10/2021","Y","Y","Sitka City and Borough",220,"Other Southeast Region - Northern",8,2,294,1,295,0,3,0,0
"03/18/2021","Y","Y","Sitka City and Borough",220,"Other Southeast Region - Northern",8,1,295,0,295,0,3,0,0
"03/21/2021","Y","Y","Sitka City and Borough",220,"Other Southeast Region - Northern",8,0,295,1,296,0,3,0,0
"03/22/2021","Y","Y","Sitka City and Borough",220,"Other Southeast Region - Northern",8,0,295,3,299,0,3,0,0
"03/24/2021","Y","Y","Sitka City and Borough",220,"Other Southeast Region - Northern",8,1,296,0,299,0,3,0,0
"03/25/2021","Y","Y","Sitka City and Borough",220,"Other Southeast Region - Northern",8,2,298,2,301,0,3,0,0
"03/27/2021","Y","Y","Sitka City and Borough",220,"Other Southeast Region - Northern",8,3,301,1,302,0,3,0,0
"03/28/2021","Y","Y","Sitka City and Borough",220,"Other Southeast Region - Northern",8,1,302,0,302,0,3,0,0
"03/31/2021","Y","Y","Sitka City and Borough",220,"Other Southeast Region - Northern",8,0,302,1,303,0,3,0,0
"04/02/2021","Y","Y","Sitka City and Borough",220,"Other Southeast Region - Northern",8,0,302,1,304,0,3,0,0
"04/05/2021","Y","Y","Sitka City and Borough",220,"Other Southeast Region - Northern",8,0,302,4,308,0,3,0,0
"04/06/2021","Y","Y","Sitka City and Borough",220,"Other Southeast Region - Northern",8,2,304,1,309,0,3,1,1
"04/07/2021","Y","Y","Sitka City and Borough",220,"Other Southeast Region - Northern",8,2,306,0,309,0,3,0,1
"04/08/2021","Y","Y","Sitka City and Borough",220,"Other Southeast Region - Northern",8,0,306,2,311,0,3,0,1
"04/09/2021","Y","Y","Sitka City and Borough",220,"Other Southeast Region - Northern",8,2,308,1,312,0,3,0,1
"04/10/2021","Y","Y","Sitka City and Borough",220,"Other Southeast Region - Northern",8,1,309,1,313,0,3,0,1
"04/12/2021","Y","Y","Sitka City and Borough",220,"Other Southeast Region - Northern",8,1,310,1,314,0,3,0,1
"04/14/2021","Y","Y","Sitka City and Borough",220,"Other Southeast Region - Northern",8,1,311,0,314,0,3,0,1
"04/16/2021","Y","Y","Sitka City and Borough",220,"Other Southeast Region - Northern",8,2,313,0,314,0,3,0,1
"04/19/2021","Y","Y","Sitka City and Borough",220,"Other Southeast Region - Northern",8,0,313,1,315,0,3,0,1
"04/21/2021","Y","Y","Sitka City and Borough",220,"Other Southeast Region - Northern",8,0,313,1,316,0,3,0,1
"04/22/2021","Y","Y","Sitka City and Borough",220,"Other Southeast Region - Northern",8,1,314,0,316,0,3,0,1
"04/24/2021","Y","Y","Sitka City and Borough",220,"Other Southeast Region - Northern",8,1,315,0,316,0,3,0,1
"04/25/2021","Y","Y","Sitka City and Borough",220,"Other Southeast Region - Northern",8,0,315,1,317,0,3,0,1
"04/29/2021","Y","Y","Sitka City and Borough",220,"Other Southeast Region - Northern",8,0,315,1,318,0,3,0,1
"05/01/2021","Y","Y","Sitka City and Borough",220,"Other Southeast Region - Northern",8,1,316,0,318,0,3,0,1
"05/03/2021","Y","Y","Sitka City and Borough",220,"Other Southeast Region - Northern",8,1,317,0,318,0,3,0,1
"05/05/2021","Y","Y","Sitka City and Borough",220,"Other Southeast Region - Northern",8,0,317,2,320,0,3,0,1
"05/06/2021","Y","Y","Sitka City and Borough",220,"Other Southeast Region - Northern",8,0,317,1,321,0,3,0,1
"05/07/2021","Y","Y","Sitka City and Borough",220,"Other Southeast Region - Northern",8,1,318,0,321,0,3,0,1
"05/08/2021","Y","Y","Sitka City and Borough",220,"Other Southeast Region - Northern",8,1,319,0,321,0,3,0,1
"05/09/2021","Y","Y","Sitka City and Borough",220,"Other Southeast Region - Northern",8,1,320,0,321,0,3,0,1
"05/10/2021","Y","Y","Sitka City and Borough",220,"Other Southeast Region - Northern",8,0,320,1,322,0,3,0,1
"05/11/2021","Y","Y","Sitka City and Borough",220,"Other Southeast Region - Northern",8,0,320,1,323,0,3,0,1
"05/14/2021","Y","Y","Sitka City and Borough",220,"Other Southeast Region - Northern",8,1,321,1,324,0,3,0,1
"05/15/2021","Y","Y","Sitka City and Borough",220,"Other Southeast Region - Northern",8,1,322,0,324,0,3,0,1
"05/17/2021","Y","Y","Sitka City and Borough",220,"Other Southeast Region - Northern",8,0,322,1,325,0,3,0,1
"05/18/2021","Y","Y","Sitka City and Borough",220,"Other Southeast Region - Northern",8,1,323,1,326,0,3,0,1
"05/19/2021","Y","Y","Sitka City and Borough",220,"Other Southeast Region - Northern",8,0,323,1,327,0,3,0,1
"05/20/2021","Y","Y","Sitka City and Borough",220,"Other Southeast Region - Northern",8,1,324,0,327,0,3,0,1
"05/21/2021","Y","Y","Sitka City and Borough",220,"Other Southeast Region - Northern",8,1,325,0,327,0,3,0,1
"05/22/2021","Y","Y","Sitka City and Borough",220,"Other Southeast Region - Northern",8,0,325,1,328,0,3,0,1
"05/24/2021","Y","Y","Sitka City and Borough",220,"Other Southeast Region - Northern",8,0,325,2,330,1,4,0,1
"05/25/2021","Y","Y","Sitka City and Borough",220,"Other Southeast Region - Northern",8,3,328,1,331,0,4,0,1
"05/26/2021","Y","Y","Sitka City and Borough",220,"Other Southeast Region - Northern",8,1,329,0,331,0,4,0,1
"05/27/2021","Y","Y","Sitka City and Borough",220,"Other Southeast Region - Northern",8,0,329,1,332,0,4,0,1
"05/29/2021","Y","Y","Sitka City and Borough",220,"Other Southeast Region - Northern",8,0,329,1,333,0,4,0,1
"06/01/2021","Y","Y","Sitka City and Borough",220,"Other Southeast Region - Northern",8,1,330,0,333,0,4,0,1
"06/02/2021","Y","Y","Sitka City and Borough",220,"Other Southeast Region - Northern",8,0,330,2,335,0,4,0,1
"06/04/2021","Y","Y","Sitka City and Borough",220,"Other Southeast Region - Northern",8,2,332,1,336,0,4,0,1
"06/09/2021","Y","Y","Sitka City and Borough",220,"Other Southeast Region - Northern",8,1,333,0,336,0,4,0,1
"06/11/2021","Y","Y","Sitka City and Borough",220,"Other Southeast Region - Northern",8,0,333,1,337,0,4,0,1
"06/18/2021","Y","Y","Sitka City and Borough",220,"Other Southeast Region - Northern",8,1,334,0,337,0,4,0,1
"06/19/2021","Y","Y","Sitka City and Borough",220,"Other Southeast Region - Northern",8,1,335,0,337,0,4,0,1
"06/20/2021","Y","Y","Sitka City and Borough",220,"Other Southeast Region - Northern",8,0,335,1,338,0,4,0,1
"06/21/2021","Y","Y","Sitka City and Borough",220,"Other Southeast Region - Northern",8,1,336,0,338,0,4,0,1
"06/24/2021","Y","Y","Sitka City and Borough",220,"Other Southeast Region - Northern",8,0,336,2,340,0,4,0,1
"06/25/2021","Y","Y","Sitka City and Borough",220,"Other Southeast Region - Northern",8,0,336,1,341,0,4,0,1
"06/26/2021","Y","Y","Sitka City and Borough",220,"Other Southeast Region - Northern",8,2,338,0,341,0,4,0,1
"06/28/2021","Y","Y","Sitka City and Borough",220,"Other Southeast Region - Northern",8,1,339,0,341,0,4,0,1
"06/29/2021","Y","Y","Sitka City and Borough",220,"Other Southeast Region - Northern",8,0,339,1,342,0,4,0,1
"06/30/2021","Y","Y","Sitka City and Borough",220,"Other Southeast Region - Northern",8,1,340,5,347,0,4,0,1
"07/01/2021","Y","Y","Sitka City and Borough",220,"Other Southeast Region - Northern",8,5,345,1,348,0,4,0,1
"07/02/2021","Y","Y","Sitka City and Borough",220,"Other Southeast Region - Northern",8,0,345,1,349,0,4,0,1
"07/05/2021","Y","Y","Sitka City and Borough",220,"Other Southeast Region - Northern",8,0,345,3,352,0,4,0,1
"07/06/2021","Y","Y","Sitka City and Borough",220,"Other Southeast Region - Northern",8,5,350,4,356,1,5,0,1
"07/07/2021","Y","Y","Sitka City and Borough",220,"Other Southeast Region - Northern",8,4,354,8,364,1,6,0,1
"07/08/2021","Y","Y","Sitka City and Borough",220,"Other Southeast Region - Northern",8,8,362,5,369,1,7,0,1
"07/09/2021","Y","Y","Sitka City and Borough",220,"Other Southeast Region - Northern",8,4,366,6,375,0,7,0,1
"07/10/2021","Y","Y","Sitka City and Borough",220,"Other Southeast Region - Northern",8,7,373,3,378,0,7,0,1
"07/11/2021","Y","Y","Sitka City and Borough",220,"Other Southeast Region - Northern",8,0,373,11,389,0,7,0,1
"07/12/2021","Y","Y","Sitka City and Borough",220,"Other Southeast Region - Northern",8,15,388,18,407,1,8,0,1
"07/13/2021","Y","Y","Sitka City and Borough",220,"Other Southeast Region - Northern",8,14,402,18,425,1,9,0,1
"07/14/2021","Y","Y","Sitka City and Borough",220,"Other Southeast Region - Northern",8,16,418,18,443,0,9,0,1
"07/15/2021","Y","Y","Sitka City and Borough",220,"Other Southeast Region - Northern",8,21,439,18,461,0,9,0,1
"07/16/2021","Y","Y","Sitka City and Borough",220,"Other Southeast Region - Northern",8,14,453,22,483,1,10,0,1
"07/17/2021","Y","Y","Sitka City and Borough",220,"Other Southeast Region - Northern",8,21,474,15,498,1,11,0,1
"07/18/2021","Y","Y","Sitka City and Borough",220,"Other Southeast Region - Northern",8,0,474,22,520,0,11,1,2
"07/19/2021","Y","Y","Sitka City and Borough",220,"Other Southeast Region - Northern",8,35,509,30,550,0,11,0,2
"07/20/2021","Y","Y","Sitka City and Borough",220,"Other Southeast Region - Northern",8,27,536,27,577,0,11,0,2
"07/21/2021","Y","Y","Sitka City and Borough",220,"Other Southeast Region - Northern",8,39,575,37,614,0,11,0,2
"07/22/2021","Y","Y","Sitka City and Borough",220,"Other Southeast Region - Northern",8,25,600,17,631,0,11,0,2
"07/23/2021","Y","Y","Sitka City and Borough",220,"Other Southeast Region - Northern",8,18,618,20,651,3,14,0,2
"07/24/2021","Y","Y","Sitka City and Borough",220,"Other Southeast Region - Northern",8,17,635,6,657,0,14,0,2
"07/25/2021","Y","Y","Sitka City and Borough",220,"Other Southeast Region - Northern",8,5,640,6,663,0,14,0,2
"07/26/2021","Y","Y","Sitka City and Borough",220,"Other Southeast Region - Northern",8,4,644,10,673,0,14,0,2
"07/27/2021","Y","Y","Sitka City and Borough",220,"Other Southeast Region - Northern",8,24,668,16,689,0,14,0,2
"07/28/2021","Y","Y","Sitka City and Borough",220,"Other Southeast Region - Northern",8,21,689,17,706,1,15,0,2
"07/29/2021","Y","Y","Sitka City and Borough",220,"Other Southeast Region - Northern",8,14,703,14,720,0,15,0,2
"07/30/2021","Y","Y","Sitka City and Borough",220,"Other Southeast Region - Northern",8,7,710,21,741,2,17,0,2
"07/31/2021","Y","Y","Sitka City and Borough",220,"Other Southeast Region - Northern",8,20,730,9,750,0,17,0,2
"08/01/2021","Y","Y","Sitka City and Borough",220,"Other Southeast Region - Northern",8,0,730,4,754,0,17,0,2
"08/02/2021","Y","Y","Sitka City and Borough",220,"Other Southeast Region - Northern",8,11,741,8,762,0,17,0,2
"08/03/2021","Y","Y","Sitka City and Borough",220,"Other Southeast Region - Northern",8,11,752,6,768,1,18,0,2
"08/04/2021","Y","Y","Sitka City and Borough",220,"Other Southeast Region - Northern",8,3,755,10,778,0,18,0,2
"08/05/2021","Y","Y","Sitka City and Borough",220,"Other Southeast Region - Northern",8,2,757,7,785,0,18,0,2
"08/06/2021","Y","Y","Sitka City and Borough",220,"Other Southeast Region - Northern",8,11,768,6,791,0,18,0,2
"08/07/2021","Y","Y","Sitka City and Borough",220,"Other Southeast Region - Northern",8,9,777,3,794,0,18,0,2
"08/08/2021","Y","Y","Sitka City and Borough",220,"Other Southeast Region - Northern",8,5,782,1,795,0,18,0,2
"08/09/2021","Y","Y","Sitka City and Borough",220,"Other Southeast Region - Northern",8,9,791,5,800,1,19,0,2
"08/10/2021","Y","Y","Sitka City and Borough",220,"Other Southeast Region - Northern",8,1,792,7,807,0,19,0,2
"08/11/2021","Y","Y","Sitka City and Borough",220,"Other Southeast Region - Northern",8,4,796,5,812,0,19,0,2
"08/12/2021","Y","Y","Sitka City and Borough",220,"Other Southeast Region - Northern",8,2,798,7,819,0,19,0,2
"08/13/2021","Y","Y","Sitka City and Borough",220,"Other Southeast Region - Northern",8,4,802,9,828,0,19,0,2
"08/14/2021","Y","Y","Sitka City and Borough",220,"Other Southeast Region - Northern",8,2,804,8,836,0,19,0,2
"08/15/2021","Y","Y","Sitka City and Borough",220,"Other Southeast Region - Northern",8,8,812,7,843,0,19,1,3
"08/16/2021","Y","Y","Sitka City and Borough",220,"Other Southeast Region - Northern",8,7,819,16,859,0,19,0,3
"08/17/2021","Y","Y","Sitka City and Borough",220,"Other Southeast Region - Northern",8,21,840,3,862,0,19,0,3
"08/18/2021","Y","Y","Sitka City and Borough",220,"Other Southeast Region - Northern",8,7,847,5,867,0,19,0,3
"08/19/2021","Y","Y","Sitka City and Borough",220,"Other Southeast Region - Northern",8,7,854,2,869,0,19,0,3
"08/20/2021","Y","Y","Sitka City and Borough",220,"Other Southeast Region - Northern",8,4,858,12,881,0,19,0,3
"08/21/2021","Y","Y","Sitka City and Borough",220,"Other Southeast Region - Northern",8,5,863,1,882,0,19,0,3
"08/22/2021","Y","Y","Sitka City and Borough",220,"Other Southeast Region - Northern",8,2,865,0,882,0,19,0,3
"08/23/2021","Y","Y","Sitka City and Borough",220,"Other Southeast Region - Northern",8,4,869,9,891,0,19,0,3
"08/24/2021","Y","Y","Sitka City and Borough",220,"Other Southeast Region - Northern",8,6,875,2,893,0,19,0,3
"08/25/2021","Y","Y","Sitka City and Borough",220,"Other Southeast Region - Northern",8,1,876,5,898,0,19,0,3
"08/26/2021","Y","Y","Sitka City and Borough",220,"Other Southeast Region - Northern",8,2,878,4,902,0,19,0,3
"08/27/2021","Y","Y","Sitka City and Borough",220,"Other Southeast Region - Northern",8,13,891,1,903,1,20,0,3
"08/28/2021","Y","Y","Sitka City and Borough",220,"Other Southeast Region - Northern",8,1,892,1,904,0,20,0,3
"08/29/2021","Y","Y","Sitka City and Borough",220,"Other Southeast Region - Northern",8,4,896,1,905,0,20,0,3
"08/30/2021","Y","Y","Sitka City and Borough",220,"Other Southeast Region - Northern",8,0,896,2,907,0,20,0,3
"08/31/2021","Y","Y","Sitka City and Borough",220,"Other Southeast Region - Northern",8,4,900,2,909,0,20,0,3
"09/01/2021","Y","Y","Sitka City and Borough",220,"Other Southeast Region - Northern",8,1,901,1,910,0,20,0,3
"09/02/2021","Y","Y","Sitka City and Borough",220,"Other Southeast Region - Northern",8,1,902,4,914,0,20,0,3
"09/03/2021","Y","Y","Sitka City and Borough",220,"Other Southeast Region - Northern",8,1,903,1,915,0,20,0,3
"09/04/2021","Y","Y","Sitka City and Borough",220,"Other Southeast Region - Northern",8,0,903,1,916,1,21,0,3
"09/05/2021","Y","Y","Sitka City and Borough",220,"Other Southeast Region - Northern",8,3,906,0,916,0,21,0,3
"09/06/2021","Y","Y","Sitka City and Borough",220,"Other Southeast Region - Northern",8,2,908,3,919,0,21,0,3
"09/07/2021","Y","Y","Sitka City and Borough",220,"Other Southeast Region - Northern",8,1,909,0,919,0,21,0,3
"09/08/2021","Y","Y","Sitka City and Borough",220,"Other Southeast Region - Northern",8,2,911,2,921,0,21,0,3
"09/09/2021","Y","Y","Sitka City and Borough",220,"Other Southeast Region - Northern",8,0,911,4,925,0,21,0,3
"09/10/2021","Y","Y","Sitka City and Borough",220,"Other Southeast Region - Northern",8,1,912,2,927,0,21,0,3
"09/11/2021","Y","Y","Sitka City and Borough",220,"Other Southeast Region - Northern",8,0,912,1,928,0,21,0,3
"09/12/2021","Y","Y","Sitka City and Borough",220,"Other Southeast Region - Northern",8,0,912,8,936,0,21,0,3
"09/13/2021","Y","Y","Sitka City and Borough",220,"Other Southeast Region - Northern",8,4,916,10,946,0,21,0,3
"09/14/2021","Y","Y","Sitka City and Borough",220,"Other Southeast Region - Northern",8,2,918,7,953,0,21,0,3
"09/15/2021","Y","Y","Sitka City and Borough",220,"Other Southeast Region - Northern",8,4,922,6,959,0,21,1,4
"09/16/2021","Y","Y","Sitka City and Borough",220,"Other Southeast Region - Northern",8,5,927,10,969,0,21,0,4
"09/17/2021","Y","Y","Sitka City and Borough",220,"Other Southeast Region - Northern",8,5,932,8,977,0,21,0,4
"09/18/2021","Y","Y","Sitka City and Borough",220,"Other Southeast Region - Northern",8,10,942,6,983,0,21,0,4
"09/19/2021","Y","Y","Sitka City and Borough",220,"Other Southeast Region - Northern",8,0,942,4,987,0,21,0,4
"09/20/2021","Y","Y","Sitka City and Borough",220,"Other Southeast Region - Northern",8,10,952,5,992,0,21,0,4
"09/21/2021","Y","Y","Sitka City and Borough",220,"Other Southeast Region - Northern",8,1,953,1,993,0,21,0,4
"09/22/2021","Y","Y","Sitka City and Borough",220,"Other Southeast Region - Northern",8,16,969,2,995,1,22,0,4
"09/23/2021","Y","Y","Sitka City and Borough",220,"Other Southeast Region - Northern",8,4,973,5,1000,0,22,0,4
"09/24/2021","Y","Y","Sitka City and Borough",220,"Other Southeast Region - Northern",8,4,977,4,1004,0,22,0,4
"09/25/2021","Y","Y","Sitka City and Borough",220,"Other Southeast Region - Northern",8,4,981,1,1005,0,22,0,4
"09/26/2021","Y","Y","Sitka City and Borough",220,"Other Southeast Region - Northern",8,2,983,1,1006,0,22,0,4
"09/27/2021","Y","Y","Sitka City and Borough",220,"Other Southeast Region - Northern",8,9,992,3,1009,0,22,0,4
"09/28/2021","Y","Y","Sitka City and Borough",220,"Other Southeast Region - Northern",8,9,1001,0,1009,0,22,0,4
"09/29/2021","Y","Y","Sitka City and Borough",220,"Other Southeast Region - Northern",8,0,1001,1,1010,0,22,0,4
"09/30/2021","Y","Y","Sitka City and Borough",220,"Other Southeast Region - Northern",8,5,1006,3,1013,0,22,0,4
"10/01/2021","Y","Y","Sitka City and Borough",220,"Other Southeast Region - Northern",8,0,1006,1,1014,0,22,0,4
"10/02/2021","Y","Y","Sitka City and Borough",220,"Other Southeast Region - Northern",8,2,1008,0,1014,0,22,0,4
"10/03/2021","Y","Y","Sitka City and Borough",220,"Other Southeast Region - Northern",8,0,1008,1,1015,0,22,0,4
"10/04/2021","Y","Y","Sitka City and Borough",220,"Other Southeast Region - Northern",8,2,1010,7,1022,0,22,0,4
"10/05/2021","Y","Y","Sitka City and Borough",220,"Other Southeast Region - Northern",8,4,1014,7,1029,0,22,0,4
"10/06/2021","Y","Y","Sitka City and Borough",220,"Other Southeast Region - Northern",8,8,1022,1,1030,0,22,0,4
"10/07/2021","Y","Y","Sitka City and Borough",220,"Other Southeast Region - Northern",8,3,1025,2,1032,0,22,0,4
"10/08/2021","Y","Y","Sitka City and Borough",220,"Other Southeast Region - Northern",8,3,1028,3,1035,0,22,0,4
"10/09/2021","Y","Y","Sitka City and Borough",220,"Other Southeast Region - Northern",8,1,1029,2,1037,0,22,0,4
"10/10/2021","Y","Y","Sitka City and Borough",220,"Other Southeast Region - Northern",8,2,1031,0,1037,0,22,0,4
"10/11/2021","Y","Y","Sitka City and Borough",220,"Other Southeast Region - Northern",8,2,1033,0,1037,0,22,0,4
"10/12/2021","Y","Y","Sitka City and Borough",220,"Other Southeast Region - Northern",8,0,1033,2,1039,0,22,0,4
"10/13/2021","Y","Y","Sitka City and Borough",220,"Other Southeast Region - Northern",8,1,1034,5,1044,0,22,0,4
"10/14/2021","Y","Y","Sitka City and Borough",220,"Other Southeast Region - Northern",8,2,1036,2,1046,0,22,0,4
"10/15/2021","Y","Y","Sitka City and Borough",220,"Other Southeast Region - Northern",8,2,1038,0,1046,0,22,0,4
"10/16/2021","Y","Y","Sitka City and Borough",220,"Other Southeast Region - Northern",8,2,1040,3,1049,0,22,0,4
"10/17/2021","Y","Y","Sitka City and Borough",220,"Other Southeast Region - Northern",8,2,1042,1,1050,0,22,0,4
"10/18/2021","Y","Y","Sitka City and Borough",220,"Other Southeast Region - Northern",8,1,1043,2,1052,0,22,0,4
"10/19/2021","Y","Y","Sitka City and Borough",220,"Other Southeast Region - Northern",8,3,1046,8,1060,0,22,0,4
"10/20/2021","Y","Y","Sitka City and Borough",220,"Other Southeast Region - Northern",8,9,1055,7,1067,1,23,0,4
"10/21/2021","Y","Y","Sitka City and Borough",220,"Other Southeast Region - Northern",8,7,1062,2,1069,0,23,0,4
"10/22/2021","Y","Y","Sitka City and Borough",220,"Other Southeast Region - Northern",8,0,1062,8,1077,0,23,0,4
"10/23/2021","Y","Y","Sitka City and Borough",220,"Other Southeast Region - Northern",8,2,1064,0,1077,0,23,0,4
"10/25/2021","Y","Y","Sitka City and Borough",220,"Other Southeast Region - Northern",8,4,1068,1,1078,0,23,0,4
"10/26/2021","Y","Y","Sitka City and Borough",220,"Other Southeast Region - Northern",8,0,1068,2,1080,0,23,0,4
"10/27/2021","Y","Y","Sitka City and Borough",220,"Other Southeast Region - Northern",8,4,1072,2,1082,0,23,0,4
"10/28/2021","Y","Y","Sitka City and Borough",220,"Other Southeast Region - Northern",8,4,1076,2,1084,0,23,1,5
"10/30/2021","Y","Y","Sitka City and Borough",220,"Other Southeast Region - Northern",8,4,1080,1,1085,0,23,0,5
"10/31/2021","Y","Y","Sitka City and Borough",220,"Other Southeast Region - Northern",8,2,1082,1,1086,0,23,0,5
"11/01/2021","Y","Y","Sitka City and Borough",220,"Other Southeast Region - Northern",8,3,1085,3,1089,0,23,0,5
"11/02/2021","Y","Y","Sitka City and Borough",220,"Other Southeast Region - Northern",8,0,1085,1,1090,0,23,0,5
"11/03/2021","Y","Y","Sitka City and Borough",220,"Other Southeast Region - Northern",8,2,1087,0,1090,0,23,0,5
"11/04/2021","Y","Y","Sitka City and Borough",220,"Other Southeast Region - Northern",8,1,1088,0,1090,0,23,0,5
"11/05/2021","Y","Y","Sitka City and Borough",220,"Other Southeast Region - Northern",8,0,1088,1,1091,0,23,0,5
"11/06/2021","Y","Y","Sitka City and Borough",220,"Other Southeast Region - Northern",8,1,1089,1,1092,0,23,0,5
"11/08/2021","Y","Y","Sitka City and Borough",220,"Other Southeast Region - Northern",8,1,1090,3,1095,0,23,0,5
"11/09/2021","Y","Y","Sitka City and Borough",220,"Other Southeast Region - Northern",8,2,1092,0,1095,0,23,0,5
"11/10/2021","Y","Y","Sitka City and Borough",220,"Other Southeast Region - Northern",8,0,1092,2,1097,0,23,0,5
"11/11/2021","Y","Y","Sitka City and Borough",220,"Other Southeast Region - Northern",8,0,1092,1,1098,0,23,0,5
"11/12/2021","Y","Y","Sitka City and Borough",220,"Other Southeast Region - Northern",8,3,1095,1,1099,0,23,0,5
"11/15/2021","Y","Y","Sitka City and Borough",220,"Other Southeast Region - Northern",8,3,1098,3,1102,0,23,0,5
"11/17/2021","Y","Y","Sitka City and Borough",220,"Other Southeast Region - Northern",8,2,1100,2,1104,0,23,0,5
"11/18/2021","Y","Y","Sitka City and Borough",220,"Other Southeast Region - Northern",8,2,1102,1,1105,0,23,0,5
"11/19/2021","Y","Y","Sitka City and Borough",220,"Other Southeast Region - Northern",8,1,1103,1,1106,0,23,0,5
"11/20/2021","Y","Y","Sitka City and Borough",220,"Other Southeast Region - Northern",8,1,1104,0,1106,0,23,0,5
"11/22/2021","Y","Y","Sitka City and Borough",220,"Other Southeast Region - Northern",8,2,1106,2,1108,0,23,0,5
"11/23/2021","Y","Y","Sitka City and Borough",220,"Other Southeast Region - Northern",8,1,1107,2,1110,0,23,0,5
"11/24/2021","Y","Y","Sitka City and Borough",220,"Other Southeast Region - Northern",8,0,1107,3,1113,1,24,0,5
"11/25/2021","Y","Y","Sitka City and Borough",220,"Other Southeast Region - Northern",8,1,1108,0,1113,0,24,0,5
"11/26/2021","Y","Y","Sitka City and Borough",220,"Other Southeast Region - Northern",8,3,1111,1,1114,0,24,0,5
"11/27/2021","Y","Y","Sitka City and Borough",220,"Other Southeast Region - Northern",8,1,1112,1,1115,1,25,0,5
"11/29/2021","Y","Y","Sitka City and Borough",220,"Other Southeast Region - Northern",8,3,1115,3,1118,0,25,0,5
"11/30/2021","Y","Y","Sitka City and Borough",220,"Other Southeast Region - Northern",8,2,1117,3,1121,0,25,0,5
"12/01/2021","Y","Y","Sitka City and Borough",220,"Other Southeast Region - Northern",8,1,1118,1,1122,0,25,0,5
"12/02/2021","Y","Y","Sitka City and Borough",220,"Other Southeast Region - Northern",8,2,1120,0,1122,0,25,0,5
"12/03/2021","Y","Y","Sitka City and Borough",220,"Other Southeast Region - Northern",8,1,1121,1,1123,1,26,0,5
"12/04/2021","Y","Y","Sitka City and Borough",220,"Other Southeast Region - Northern",8,1,1122,2,1125,0,26,0,5
"12/06/2021","Y","Y","Sitka City and Borough",220,"Other Southeast Region - Northern",8,3,1125,5,1130,0,26,0,5
"12/07/2021","Y","Y","Sitka City and Borough",220,"Other Southeast Region - Northern",8,5,1130,3,1133,0,26,0,5
"12/08/2021","Y","Y","Sitka City and Borough",220,"Other Southeast Region - Northern",8,2,1132,2,1135,0,26,0,5
"12/09/2021","Y","Y","Sitka City and Borough",220,"Other Southeast Region - Northern",8,3,1135,3,1138,0,26,0,5
"12/10/2021","Y","Y","Sitka City and Borough",220,"Other Southeast Region - Northern",8,7,1142,10,1148,0,26,0,5
"12/11/2021","Y","Y","Sitka City and Borough",220,"Other Southeast Region - Northern",8,4,1146,1,1149,0,26,0,5
"12/12/2021","Y","Y","Sitka City and Borough",220,"Other Southeast Region - Northern",8,2,1148,1,1150,1,27,0,5
"12/13/2021","Y","Y","Sitka City and Borough",220,"Other Southeast Region - Northern",8,1,1149,5,1155,0,27,0,5
"12/14/2021","Y","Y","Sitka City and Borough",220,"Other Southeast Region - Northern",8,7,1156,6,1161,0,27,0,5
"12/15/2021","Y","Y","Sitka City and Borough",220,"Other Southeast Region - Northern",8,6,1162,5,1166,0,27,0,5
"12/16/2021","Y","Y","Sitka City and Borough",220,"Other Southeast Region - Northern",8,6,1168,4,1170,0,27,0,5
"12/17/2021","Y","Y","Sitka City and Borough",220,"Other Southeast Region - Northern",8,2,1170,2,1172,0,27,0,5
"12/18/2021","Y","Y","Sitka City and Borough",220,"Other Southeast Region - Northern",8,1,1171,2,1174,0,27,0,5
"12/19/2021","Y","Y","Sitka City and Borough",220,"Other Southeast Region - Northern",8,0,1171,1,1175,0,27,0,5
"12/20/2021","Y","Y","Sitka City and Borough",220,"Other Southeast Region - Northern",8,3,1174,1,1176,0,27,0,5
"12/21/2021","Y","Y","Sitka City and Borough",220,"Other Southeast Region - Northern",8,2,1176,5,1181,0,27,0,5
"12/22/2021","Y","Y","Sitka City and Borough",220,"Other Southeast Region - Northern",8,5,1181,2,1183,0,27,0,5
"12/23/2021","Y","Y","Sitka City and Borough",220,"Other Southeast Region - Northern",8,13,1194,12,1195,0,27,0,5
"12/24/2021","Y","Y","Sitka City and Borough",220,"Other Southeast Region - Northern",8,2,1196,6,1201,1,28,0,5
"12/25/2021","Y","Y","Sitka City and Borough",220,"Other Southeast Region - Northern",8,1,1197,1,1202,0,28,0,5
"12/26/2021","Y","Y","Sitka City and Borough",220,"Other Southeast Region - Northern",8,3,1200,1,1203,0,28,0,5
"12/27/2021","Y","Y","Sitka City and Borough",220,"Other Southeast Region - Northern",8,12,1212,17,1220,0,28,0,5
"12/28/2021","Y","Y","Sitka City and Borough",220,"Other Southeast Region - Northern",8,16,1228,13,1233,0,28,0,5
"12/29/2021","Y","Y","Sitka City and Borough",220,"Other Southeast Region - Northern",8,16,1244,18,1251,0,28,0,5
"12/30/2021","Y","Y","Sitka City and Borough",220,"Other Southeast Region - Northern",8,11,1255,11,1262,0,28,0,5
"12/31/2021","Y","Y","Sitka City and Borough",220,"Other Southeast Region - Northern",8,10,1265,6,1268,0,28,0,5
"01/01/2022","Y","Y","Sitka City and Borough",220,"Other Southeast Region - Northern",8,4,1269,4,1272,0,28,0,5
"01/02/2022","Y","Y","Sitka City and Borough",220,"Other Southeast Region - Northern",8,3,1272,4,1276,0,28,0,5
"01/03/2022","Y","Y","Sitka City and Borough",220,"Other Southeast Region - Northern",8,14,1286,33,1309,0,28,0,5
"01/04/2022","Y","Y","Sitka City and Borough",220,"Other Southeast Region - Northern",8,30,1316,28,1337,0,28,0,5
"01/05/2022","Y","Y","Sitka City and Borough",220,"Other Southeast Region - Northern",8,22,1338,26,1363,0,28,0,5
"01/06/2022","Y","Y","Sitka City and Borough",220,"Other Southeast Region - Northern",8,19,1357,29,1392,0,28,0,5
"01/07/2022","Y","Y","Sitka City and Borough",220,"Other Southeast Region - Northern",8,36,1393,23,1415,0,28,0,5
"01/08/2022","Y","Y","Sitka City and Borough",220,"Other Southeast Region - Northern",8,6,1399,18,1433,0,28,0,5
"01/09/2022","Y","Y","Sitka City and Borough",220,"Other Southeast Region - Northern",8,32,1431,7,1440,0,28,0,5
"01/10/2022","Y","Y","Sitka City and Borough",220,"Other Southeast Region - Northern",8,7,1438,38,1478,0,28,0,5
"01/11/2022","Y","Y","Sitka City and Borough",220,"Other Southeast Region - Northern",8,6,1444,24,1502,0,28,0,5
"01/12/2022","Y","Y","Sitka City and Borough",220,"Other Southeast Region - Northern",8,30,1474,17,1519,0,28,0,5
"01/13/2022","Y","Y","Sitka City and Borough",220,"Other Southeast Region - Northern",8,34,1508,45,1564,0,28,0,5
"01/14/2022","Y","Y","Sitka City and Borough",220,"Other Southeast Region - Northern",8,41,1549,18,1582,0,28,0,5
"01/15/2022","Y","Y","Sitka City and Borough",220,"Other Southeast Region - Northern",8,17,1566,17,1599,0,28,0,5
"01/16/2022","Y","Y","Sitka City and Borough",220,"Other Southeast Region - Northern",8,6,1572,8,1607,0,28,0,5
"01/17/2022","Y","Y","Sitka City and Borough",220,"Other Southeast Region - Northern",8,24,1596,26,1633,0,28,0,5
"01/18/2022","Y","Y","Sitka City and Borough",220,"Other Southeast Region - Northern",8,1,1597,17,1650,0,28,0,5
"01/19/2022","Y","Y","Sitka City and Borough",220,"Other Southeast Region - Northern",8,13,1610,21,1671,0,28,0,5
"01/20/2022","Y","Y","Sitka City and Borough",220,"Other Southeast Region - Northern",8,50,1660,32,1703,0,28,0,5
"01/21/2022","Y","Y","Sitka City and Borough",220,"Other Southeast Region - Northern",8,7,1667,20,1723,0,28,0,5
"01/22/2022","Y","Y","Sitka City and Borough",220,"Other Southeast Region - Northern",8,5,1672,14,1737,0,28,0,5
"01/23/2022","Y","Y","Sitka City and Borough",220,"Other Southeast Region - Northern",8,10,1682,13,1750,0,28,0,5
"01/24/2022","Y","Y","Sitka City and Borough",220,"Other Southeast Region - Northern",8,8,1690,42,1792,0,28,0,5
"01/25/2022","Y","Y","Sitka City and Borough",220,"Other Southeast Region - Northern",8,12,1702,14,1806,0,28,0,5
"01/26/2022","Y","Y","Sitka City and Borough",220,"Other Southeast Region - Northern",8,69,1771,29,1835,0,28,0,5
"01/27/2022","Y","Y","Sitka City and Borough",220,"Other Southeast Region - Northern",8,23,1794,14,1849,0,28,0,5
"01/28/2022","Y","Y","Sitka City and Borough",220,"Other Southeast Region - Northern",8,4,1798,9,1858,0,28,0,5
"01/29/2022","Y","Y","Sitka City and Borough",220,"Other Southeast Region - Northern",8,8,1806,13,1871,0,28,0,5
"01/30/2022","Y","Y","Sitka City and Borough",220,"Other Southeast Region - Northern",8,18,1824,4,1875,0,28,0,5
"01/31/2022","Y","Y","Sitka City and Borough",220,"Other Southeast Region - Northern",8,49,1873,15,1890,0,28,0,5
"02/01/2022","Y","Y","Sitka City and Borough",220,"Other Southeast Region - Northern",8,9,1882,13,1903,0,28,0,5
"02/02/2022","Y","Y","Sitka City and Borough",220,"Other Southeast Region - Northern",8,14,1896,14,1917,0,28,0,5
"02/03/2022","Y","Y","Sitka City and Borough",220,"Other Southeast Region - Northern",8,17,1913,15,1932,0,28,0,5
"02/04/2022","Y","Y","Sitka City and Borough",220,"Other Southeast Region - Northern",8,8,1921,12,1944,0,28,0,5
"02/05/2022","Y","Y","Sitka City and Borough",220,"Other Southeast Region - Northern",8,20,1941,4,1948,0,28,0,5
"02/06/2022","Y","Y","Sitka City and Borough",220,"Other Southeast Region - Northern",8,12,1953,12,1960,0,28,0,5
"02/07/2022","Y","Y","Sitka City and Borough",220,"Other Southeast Region - Northern",8,13,1966,14,1974,0,28,0,5
"02/08/2022","Y","Y","Sitka City and Borough",220,"Other Southeast Region - Northern",8,13,1979,14,1988,0,28,0,5
"02/09/2022","Y","Y","Sitka City and Borough",220,"Other Southeast Region - Northern",8,16,1995,15,2003,0,28,0,5
"02/10/2022","Y","Y","Sitka City and Borough",220,"Other Southeast Region - Northern",8,12,2007,5,2008,0,28,0,5
"02/11/2022","Y","Y","Sitka City and Borough",220,"Other Southeast Region - Northern",8,5,2012,6,2014,0,28,0,5
"02/12/2022","Y","Y","Sitka City and Borough",220,"Other Southeast Region - Northern",8,1,2013,2,2016,0,28,0,5
"02/13/2022","Y","Y","Sitka City and Borough",220,"Other Southeast Region - Northern",8,4,2017,3,2019,0,28,0,5
"02/14/2022","Y","Y","Sitka City and Borough",220,"Other Southeast Region - Northern",8,3,2020,5,2024,0,28,0,5
"02/15/2022","Y","Y","Sitka City and Borough",220,"Other Southeast Region - Northern",8,3,2023,6,2030,0,28,0,5
"02/16/2022","Y","Y","Sitka City and Borough",220,"Other Southeast Region - Northern",8,1,2024,3,2033,0,28,0,5
"02/17/2022","Y","Y","Sitka City and Borough",220,"Other Southeast Region - Northern",8,11,2035,5,2038,0,28,0,5
"02/18/2022","Y","Y","Sitka City and Borough",220,"Other Southeast Region - Northern",8,4,2039,2,2040,0,28,0,5
"02/19/2022","Y","Y","Sitka City and Borough",220,"Other Southeast Region - Northern",8,4,2043,5,2045,0,28,0,5
"02/21/2022","Y","Y","Sitka City and Borough",220,"Other Southeast Region - Northern",8,4,2047,5,2050,0,28,0,5
"02/22/2022","Y","Y","Sitka City and Borough",220,"Other Southeast Region - Northern",8,2,2049,1,2051,0,28,0,5
"02/23/2022","Y","Y","Sitka City and Borough",220,"Other Southeast Region - Northern",8,1,2050,1,2052,0,28,0,5
"02/24/2022","Y","Y","Sitka City and Borough",220,"Other Southeast Region - Northern",8,7,2057,6,2058,0,28,0,5
"02/25/2022","Y","Y","Sitka City and Borough",220,"Other Southeast Region - Northern",8,4,2061,5,2063,0,28,0,5
"02/26/2022","Y","Y","Sitka City and Borough",220,"Other Southeast Region - Northern",8,3,2064,5,2068,0,28,0,5
"02/27/2022","Y","Y","Sitka City and Borough",220,"Other Southeast Region - Northern",8,1,2065,8,2076,0,28,0,5
"02/28/2022","Y","Y","Sitka City and Borough",220,"Other Southeast Region - Northern",8,14,2079,5,2081,0,28,0,5
"03/01/2022","Y","Y","Sitka City and Borough",220,"Other Southeast Region - Northern",8,5,2084,4,2085,0,28,0,5
"03/02/2022","Y","Y","Sitka City and Borough",220,"Other Southeast Region - Northern",8,6,2090,6,2091,0,28,0,5
"03/03/2022","Y","Y","Sitka City and Borough",220,"Other Southeast Region - Northern",8,3,2093,3,2094,0,28,0,5
"03/04/2022","Y","Y","Sitka City and Borough",220,"Other Southeast Region - Northern",8,5,2098,5,2099,0,28,0,5
"03/05/2022","Y","Y","Sitka City and Borough",220,"Other Southeast Region - Northern",8,2,2100,2,2101,0,28,0,5
"03/06/2022","Y","Y","Sitka City and Borough",220,"Other Southeast Region - Northern",8,4,2104,4,2105,0,28,0,5
"03/07/2022","Y","Y","Sitka City and Borough",220,"Other Southeast Region - Northern",8,3,2107,3,2108,0,28,0,5
"03/08/2022","Y","Y","Sitka City and Borough",220,"Other Southeast Region - Northern",8,1,2108,1,2109,0,28,0,5
"03/09/2022","Y","Y","Sitka City and Borough",220,"Other Southeast Region - Northern",8,2,2110,3,2112,0,28,0,5
"03/10/2022","Y","Y","Sitka City and Borough",220,"Other Southeast Region - Northern",8,8,2118,7,2119,0,28,0,5
"03/11/2022","Y","Y","Sitka City and Borough",220,"Other Southeast Region - Northern",8,4,2122,7,2126,0,28,0,5
"03/12/2022","Y","Y","Sitka City and Borough",220,"Other Southeast Region - Northern",8,3,2125,3,2129,0,28,0,5
"03/13/2022","Y","Y","Sitka City and Borough",220,"Other Southeast Region - Northern",8,3,2128,0,2129,0,28,0,5
"03/14/2022","Y","Y","Sitka City and Borough",220,"Other Southeast Region - Northern",8,3,2131,3,2132,0,28,0,5
"03/15/2022","Y","Y","Sitka City and Borough",220,"Other Southeast Region - Northern",8,5,2136,5,2137,0,28,0,5
"03/16/2022","Y","Y","Sitka City and Borough",220,"Other Southeast Region - Northern",8,2,2138,2,2139,0,28,0,5
"03/17/2022","Y","Y","Sitka City and Borough",220,"Other Southeast Region - Northern",8,4,2142,5,2144,0,28,0,5
"03/18/2022","Y","Y","Sitka City and Borough",220,"Other Southeast Region - Northern",8,4,2146,3,2147,0,28,0,5
"03/19/2022","Y","Y","Sitka City and Borough",220,"Other Southeast Region - Northern",8,2,2148,2,2149,0,28,0,5
"03/20/2022","Y","Y","Sitka City and Borough",220,"Other Southeast Region - Northern",8,5,2153,5,2154,0,28,0,5
"03/21/2022","Y","Y","Sitka City and Borough",220,"Other Southeast Region - Northern",8,9,2162,9,2163,0,28,0,5
"03/22/2022","Y","Y","Sitka City and Borough",220,"Other Southeast Region - Northern",8,3,2165,4,2167,0,28,0,5
"03/23/2022","Y","Y","Sitka City and Borough",220,"Other Southeast Region - Northern",8,8,2173,8,2175,0,28,0,5
"03/24/2022","Y","Y","Sitka City and Borough",220,"Other Southeast Region - Northern",8,2,2175,2,2177,0,28,0,5
"03/25/2022","Y","Y","Sitka City and Borough",220,"Other Southeast Region - Northern",8,3,2178,4,2181,0,28,0,5
"03/26/2022","Y","Y","Sitka City and Borough",220,"Other Southeast Region - Northern",8,3,2181,2,2183,0,28,0,5
"03/27/2022","Y","Y","Sitka City and Borough",220,"Other Southeast Region - Northern",8,2,2183,1,2184,0,28,0,5
"03/28/2022","Y","Y","Sitka City and Borough",220,"Other Southeast Region - Northern",8,3,2186,3,2187,0,28,0,5
"03/29/2022","Y","Y","Sitka City and Borough",220,"Other Southeast Region - Northern",8,3,2189,4,2191,0,28,0,5
"03/30/2022","Y","Y","Sitka City and Borough",220,"Other Southeast Region - Northern",8,0,2189,1,2192,0,28,0,5
"03/31/2022","Y","Y","Sitka City and Borough",220,"Other Southeast Region - Northern",8,2,2191,3,2195,0,28,0,5
"04/01/2022","Y","Y","Sitka City and Borough",220,"Other Southeast Region - Northern",8,3,2194,0,2195,0,28,0,5
"04/02/2022","Y","Y","Sitka City and Borough",220,"Other Southeast Region - Northern",8,1,2195,1,2196,0,28,0,5
"04/04/2022","Y","Y","Sitka City and Borough",220,"Other Southeast Region - Northern",8,7,2202,7,2203,0,28,0,5
"04/06/2022","Y","Y","Sitka City and Borough",220,"Other Southeast Region - Northern",8,10,2212,10,2213,0,28,0,5
"04/07/2022","Y","Y","Sitka City and Borough",220,"Other Southeast Region - Northern",8,6,2218,6,2219,0,28,0,5
"04/08/2022","Y","Y","Sitka City and Borough",220,"Other Southeast Region - Northern",8,4,2222,4,2223,0,28,0,5
"04/09/2022","Y","Y","Sitka City and Borough",220,"Other Southeast Region - Northern",8,6,2228,8,2231,0,28,0,5
"04/10/2022","Y","Y","Sitka City and Borough",220,"Other Southeast Region - Northern",8,2,2230,0,2231,0,28,0,5
"04/11/2022","Y","Y","Sitka City and Borough",220,"Other Southeast Region - Northern",8,8,2238,10,2241,0,28,0,5
"04/12/2022","Y","Y","Sitka City and Borough",220,"Other Southeast Region - Northern",8,10,2248,8,2249,0,28,0,5
"04/13/2022","Y","Y","Sitka City and Borough",220,"Other Southeast Region - Northern",8,7,2255,10,2259,0,28,0,5
"04/14/2022","Y","Y","Sitka City and Borough",220,"Other Southeast Region - Northern",8,1,2256,7,2266,0,28,0,5
"04/15/2022","Y","Y","Sitka City and Borough",220,"Other Southeast Region - Northern",8,22,2278,13,2279,0,28,0,5
"04/16/2022","Y","Y","Sitka City and Borough",220,"Other Southeast Region - Northern",8,4,2282,7,2286,0,28,0,5
"04/17/2022","Y","Y","Sitka City and Borough",220,"Other Southeast Region - Northern",8,4,2286,5,2291,0,28,0,5
"04/18/2022","Y","Y","Sitka City and Borough",220,"Other Southeast Region - Northern",8,21,2307,25,2316,0,28,0,5
"04/19/2022","Y","Y","Sitka City and Borough",220,"Other Southeast Region - Northern",8,16,2323,15,2331,0,28,0,5
"04/20/2022","Y","Y","Sitka City and Borough",220,"Other Southeast Region - Northern",8,14,2337,10,2341,0,28,0,5
"04/21/2022","Y","Y","Sitka City and Borough",220,"Other Southeast Region - Northern",8,21,2358,18,2359,0,28,0,5
"04/22/2022","Y","Y","Sitka City and Borough",220,"Other Southeast Region - Northern",8,12,2370,11,2370,0,28,0,5
"04/23/2022","Y","Y","Sitka City and Borough",220,"Other Southeast Region - Northern",8,4,2374,4,2374,0,28,0,5
"04/24/2022","Y","Y","Sitka City and Borough",220,"Other Southeast Region - Northern",8,5,2379,5,2379,0,28,0,5
"04/25/2022","Y","Y","Sitka City and Borough",220,"Other Southeast Region - Northern",8,17,2396,17,2396,0,28,0,5
"04/26/2022","Y","Y","Sitka City and Borough",220,"Other Southeast Region - Northern",8,12,2408,12,2408,0,28,0,5
"10/10/2020","Y","Y","Skagway Municipality",230,"Other Southeast Region - Northern",8,0,0,1,1,0,0,0,0
"10/11/2020","Y","Y","Skagway Municipality",230,"Other Southeast Region - Northern",8,0,0,1,2,0,0,0,0
"10/12/2020","Y","Y","Skagway Municipality",230,"Other Southeast Region - Northern",8,0,0,1,3,0,0,0,0
"10/15/2020","Y","Y","Skagway Municipality",230,"Other Southeast Region - Northern",8,1,1,2,5,0,0,0,0
"10/18/2020","Y","Y","Skagway Municipality",230,"Other Southeast Region - Northern",8,0,1,1,6,0,0,0,0
"10/19/2020","Y","Y","Skagway Municipality",230,"Other Southeast Region - Northern",8,2,3,0,6,0,0,0,0
"10/20/2020","Y","Y","Skagway Municipality",230,"Other Southeast Region - Northern",8,1,4,1,7,0,0,0,0
"10/21/2020","Y","Y","Skagway Municipality",230,"Other Southeast Region - Northern",8,1,5,0,7,0,0,0,0
"10/24/2020","Y","Y","Skagway Municipality",230,"Other Southeast Region - Northern",8,2,7,0,7,0,0,0,0
"11/10/2020","Y","Y","Skagway Municipality",230,"Other Southeast Region - Northern",8,0,7,0,7,1,1,0,0
"11/18/2020","Y","Y","Skagway Municipality",230,"Other Southeast Region - Northern",8,1,8,1,8,0,1,0,0
"11/20/2020","Y","Y","Skagway Municipality",230,"Other Southeast Region - Northern",8,1,9,0,8,1,2,0,0
"11/23/2020","Y","Y","Skagway Municipality",230,"Other Southeast Region - Northern",8,0,9,1,9,0,2,0,0
"11/25/2020","Y","Y","Skagway Municipality",230,"Other Southeast Region - Northern",8,0,9,2,11,0,2,0,0
"11/29/2020","Y","Y","Skagway Municipality",230,"Other Southeast Region - Northern",8,1,10,0,11,0,2,0,0
"11/30/2020","Y","Y","Skagway Municipality",230,"Other Southeast Region - Northern",8,1,11,0,11,0,2,0,0
"12/07/2020","Y","Y","Skagway Municipality",230,"Other Southeast Region - Northern",8,0,11,2,13,0,2,0,0
"12/09/2020","Y","Y","Skagway Municipality",230,"Other Southeast Region - Northern",8,0,11,2,15,0,2,0,0
"12/12/2020","Y","Y","Skagway Municipality",230,"Other Southeast Region - Northern",8,3,14,0,15,0,2,0,0
"12/14/2020","Y","Y","Skagway Municipality",230,"Other Southeast Region - Northern",8,1,15,0,15,0,2,0,0
"02/10/2021","Y","Y","Skagway Municipality",230,"Other Southeast Region - Northern",8,0,15,1,16,0,2,0,0
"02/11/2021","Y","Y","Skagway Municipality",230,"Other Southeast Region - Northern",8,1,16,0,16,0,2,0,0
"02/12/2021","Y","Y","Skagway Municipality",230,"Other Southeast Region - Northern",8,0,16,1,17,0,2,0,0
"02/13/2021","Y","Y","Skagway Municipality",230,"Other Southeast Region - Northern",8,2,18,1,18,0,2,0,0
"02/22/2021","Y","Y","Skagway Municipality",230,"Other Southeast Region - Northern",8,0,18,1,19,0,2,0,0
"02/23/2021","Y","Y","Skagway Municipality",230,"Other Southeast Region - Northern",8,1,19,0,19,0,2,0,0
"04/22/2021","Y","Y","Skagway Municipality",230,"Other Southeast Region - Northern",8,0,19,1,20,0,2,0,0
"04/25/2021","Y","Y","Skagway Municipality",230,"Other Southeast Region - Northern",8,1,20,0,20,0,2,0,0
"06/18/2021","Y","Y","Skagway Municipality",230,"Other Southeast Region - Northern",8,0,20,1,21,0,2,0,0
"06/19/2021","Y","Y","Skagway Municipality",230,"Other Southeast Region - Northern",8,1,21,0,21,0,2,0,0
"07/13/2021","Y","Y","Skagway Municipality",230,"Other Southeast Region - Northern",8,0,21,2,23,0,2,0,0
"07/14/2021","Y","Y","Skagway Municipality",230,"Other Southeast Region - Northern",8,1,22,0,23,0,2,0,0
"07/15/2021","Y","Y","Skagway Municipality",230,"Other Southeast Region - Northern",8,1,23,0,23,0,2,0,0
"07/17/2021","Y","Y","Skagway Municipality",230,"Other Southeast Region - Northern",8,0,23,1,24,0,2,0,0
"07/18/2021","Y","Y","Skagway Municipality",230,"Other Southeast Region - Northern",8,1,24,0,24,0,2,0,0
"07/28/2021","Y","Y","Skagway Municipality",230,"Other Southeast Region - Northern",8,1,25,1,25,0,2,0,0
"07/29/2021","Y","Y","Skagway Municipality",230,"Other Southeast Region - Northern",8,0,25,1,26,0,2,0,0
"07/30/2021","Y","Y","Skagway Municipality",230,"Other Southeast Region - Northern",8,1,26,0,26,0,2,0,0
"07/31/2021","Y","Y","Skagway Municipality",230,"Other Southeast Region - Northern",8,1,27,1,27,0,2,0,0
"08/02/2021","Y","Y","Skagway Municipality",230,"Other Southeast Region - Northern",8,0,27,2,29,0,2,0,0
"08/03/2021","Y","Y","Skagway Municipality",230,"Other Southeast Region - Northern",8,2,29,0,29,0,2,0,0
"08/08/2021","Y","Y","Skagway Municipality",230,"Other Southeast Region - Northern",8,0,29,1,30,0,2,0,0
"08/11/2021","Y","Y","Skagway Municipality",230,"Other Southeast Region - Northern",8,1,30,0,30,0,2,0,0
"08/12/2021","Y","Y","Skagway Municipality",230,"Other Southeast Region - Northern",8,0,30,2,32,0,2,0,0
"08/13/2021","Y","Y","Skagway Municipality",230,"Other Southeast Region - Northern",8,0,30,2,34,0,2,0,0
"08/14/2021","Y","Y","Skagway Municipality",230,"Other Southeast Region - Northern",8,3,33,0,34,0,2,0,0
"08/16/2021","Y","Y","Skagway Municipality",230,"Other Southeast Region - Northern",8,1,34,3,37,0,2,0,0
"08/17/2021","Y","Y","Skagway Municipality",230,"Other Southeast Region - Northern",8,2,36,0,37,0,2,0,0
"08/18/2021","Y","Y","Skagway Municipality",230,"Other Southeast Region - Northern",8,1,37,0,37,0,2,0,0
"08/19/2021","Y","Y","Skagway Municipality",230,"Other Southeast Region - Northern",8,0,37,1,38,0,2,0,0
"08/20/2021","Y","Y","Skagway Municipality",230,"Other Southeast Region - Northern",8,1,38,1,39,0,2,0,0
"08/23/2021","Y","Y","Skagway Municipality",230,"Other Southeast Region - Northern",8,0,38,3,42,0,2,0,0
"08/24/2021","Y","Y","Skagway Municipality",230,"Other Southeast Region - Northern",8,2,40,0,42,0,2,0,0
"08/25/2021","Y","Y","Skagway Municipality",230,"Other Southeast Region - Northern",8,1,41,0,42,0,2,0,0
"09/07/2021","Y","Y","Skagway Municipality",230,"Other Southeast Region - Northern",8,1,42,0,42,0,2,0,0
"09/08/2021","Y","Y","Skagway Municipality",230,"Other Southeast Region - Northern",8,0,42,2,44,0,2,0,0
"09/10/2021","Y","Y","Skagway Municipality",230,"Other Southeast Region - Northern",8,0,42,1,45,0,2,0,0
"09/11/2021","Y","Y","Skagway Municipality",230,"Other Southeast Region - Northern",8,1,43,0,45,0,2,0,0
"09/14/2021","Y","Y","Skagway Municipality",230,"Other Southeast Region - Northern",8,1,44,0,45,0,2,0,0
"09/17/2021","Y","Y","Skagway Municipality",230,"Other Southeast Region - Northern",8,0,44,1,46,0,2,0,0
"09/20/2021","Y","Y","Skagway Municipality",230,"Other Southeast Region - Northern",8,1,45,2,48,0,2,0,0
"09/21/2021","Y","Y","Skagway Municipality",230,"Other Southeast Region - Northern",8,0,45,1,49,0,2,0,0
"09/24/2021","Y","Y","Skagway Municipality",230,"Other Southeast Region - Northern",8,1,46,1,50,0,2,0,0
"09/25/2021","Y","Y","Skagway Municipality",230,"Other Southeast Region - Northern",8,1,47,0,50,0,2,0,0
"09/27/2021","Y","Y","Skagway Municipality",230,"Other Southeast Region - Northern",8,2,49,0,50,0,2,0,0
"09/28/2021","Y","Y","Skagway Municipality",230,"Other Southeast Region - Northern",8,1,50,2,52,0,2,0,0
"09/29/2021","Y","Y","Skagway Municipality",230,"Other Southeast Region - Northern",8,2,52,0,52,0,2,0,0
"10/02/2021","Y","Y","Skagway Municipality",230,"Other Southeast Region - Northern",8,0,52,1,53,0,2,0,0
"10/07/2021","Y","Y","Skagway Municipality",230,"Other Southeast Region - Northern",8,1,53,0,53,0,2,0,0
"10/18/2021","Y","Y","Skagway Municipality",230,"Other Southeast Region - Northern",8,0,53,1,54,0,2,0,0
"10/20/2021","Y","Y","Skagway Municipality",230,"Other Southeast Region - Northern",8,0,53,1,55,0,2,0,0
"10/22/2021","Y","Y","Skagway Municipality",230,"Other Southeast Region - Northern",8,2,55,5,60,0,2,0,0
"10/23/2021","Y","Y","Skagway Municipality",230,"Other Southeast Region - Northern",8,3,58,0,60,0,2,0,0
"10/25/2021","Y","Y","Skagway Municipality",230,"Other Southeast Region - Northern",8,2,60,0,60,0,2,0,0
"10/26/2021","Y","Y","Skagway Municipality",230,"Other Southeast Region - Northern",8,0,60,4,64,0,2,0,0
"10/27/2021","Y","Y","Skagway Municipality",230,"Other Southeast Region - Northern",8,1,61,2,66,0,2,0,0
"10/28/2021","Y","Y","Skagway Municipality",230,"Other Southeast Region - Northern",8,0,61,2,68,0,2,0,0
"10/29/2021","Y","Y","Skagway Municipality",230,"Other Southeast Region - Northern",8,7,68,1,69,0,2,0,0
"10/30/2021","Y","Y","Skagway Municipality",230,"Other Southeast Region - Northern",8,1,69,0,69,0,2,0,0
"11/29/2021","Y","Y","Skagway Municipality",230,"Other Southeast Region - Northern",8,0,69,1,70,0,2,0,0
"12/01/2021","Y","Y","Skagway Municipality",230,"Other Southeast Region - Northern",8,1,70,0,70,0,2,0,0
"12/03/2021","Y","Y","Skagway Municipality",230,"Other Southeast Region - Northern",8,1,71,1,71,0,2,0,0
"12/04/2021","Y","Y","Skagway Municipality",230,"Other Southeast Region - Northern",8,0,71,1,72,0,2,0,0
"12/08/2021","Y","Y","Skagway Municipality",230,"Other Southeast Region - Northern",8,1,72,0,72,0,2,0,0
"12/13/2021","Y","Y","Skagway Municipality",230,"Other Southeast Region - Northern",8,0,72,1,73,0,2,0,0
"12/15/2021","Y","Y","Skagway Municipality",230,"Other Southeast Region - Northern",8,1,73,0,73,0,2,0,0
"12/31/2021","Y","Y","Skagway Municipality",230,"Other Southeast Region - Northern",8,0,73,1,74,0,2,0,0
"01/02/2022","Y","Y","Skagway Municipality",230,"Other Southeast Region - Northern",8,1,74,2,76,0,2,0,0
"01/06/2022","Y","Y","Skagway Municipality",230,"Other Southeast Region - Northern",8,1,75,0,76,0,2,0,0
"01/10/2022","Y","Y","Skagway Municipality",230,"Other Southeast Region - Northern",8,0,75,2,78,0,2,0,0
"01/11/2022","Y","Y","Skagway Municipality",230,"Other Southeast Region - Northern",8,3,78,1,79,0,2,0,0
"01/13/2022","Y","Y","Skagway Municipality",230,"Other Southeast Region - Northern",8,0,78,1,80,0,2,0,0
"01/14/2022","Y","Y","Skagway Municipality",230,"Other Southeast Region - Northern",8,1,79,1,81,0,2,0,0
"01/18/2022","Y","Y","Skagway Municipality",230,"Other Southeast Region - Northern",8,1,80,2,83,0,2,0,0
"01/19/2022","Y","Y","Skagway Municipality",230,"Other Southeast Region - Northern",8,1,81,0,83,0,2,0,0
"01/20/2022","Y","Y","Skagway Municipality",230,"Other Southeast Region - Northern",8,0,81,1,84,0,2,0,0
"01/21/2022","Y","Y","Skagway Municipality",230,"Other Southeast Region - Northern",8,2,83,1,85,0,2,0,0
"01/22/2022","Y","Y","Skagway Municipality",230,"Other Southeast Region - Northern",8,2,85,2,87,0,2,0,0
"01/25/2022","Y","Y","Skagway Municipality",230,"Other Southeast Region - Northern",8,1,86,0,87,0,2,0,0
"01/28/2022","Y","Y","Skagway Municipality",230,"Other Southeast Region - Northern",8,0,86,1,88,0,2,0,0
"01/31/2022","Y","Y","Skagway Municipality",230,"Other Southeast Region - Northern",8,3,89,5,93,0,2,0,0
"02/01/2022","Y","Y","Skagway Municipality",230,"Other Southeast Region - Northern",8,3,92,3,96,0,2,0,0
"02/04/2022","Y","Y","Skagway Municipality",230,"Other Southeast Region - Northern",8,0,92,2,98,0,2,0,0
"02/05/2022","Y","Y","Skagway Municipality",230,"Other Southeast Region - Northern",8,2,94,1,99,0,2,0,0
"02/07/2022","Y","Y","Skagway Municipality",230,"Other Southeast Region - Northern",8,4,98,2,101,0,2,0,0
"02/08/2022","Y","Y","Skagway Municipality",230,"Other Southeast Region - Northern",8,1,99,0,101,0,2,0,0
"02/09/2022","Y","Y","Skagway Municipality",230,"Other Southeast Region - Northern",8,2,101,0,101,0,2,0,0
"02/11/2022","Y","Y","Skagway Municipality",230,"Other Southeast Region - Northern",8,2,103,2,103,0,2,0,0
"02/12/2022","Y","Y","Skagway Municipality",230,"Other Southeast Region - Northern",8,0,103,1,104,0,2,0,0
"02/17/2022","Y","Y","Skagway Municipality",230,"Other Southeast Region - Northern",8,1,104,2,106,0,2,0,0
"02/19/2022","Y","Y","Skagway Municipality",230,"Other Southeast Region - Northern",8,2,106,2,108,0,2,0,0
"02/24/2022","Y","Y","Skagway Municipality",230,"Other Southeast Region - Northern",8,2,108,0,108,0,2,0,0
"03/08/2022","Y","Y","Skagway Municipality",230,"Other Southeast Region - Northern",8,0,108,6,114,0,2,0,0
"03/09/2022","Y","Y","Skagway Municipality",230,"Other Southeast Region - Northern",8,2,110,0,114,0,2,0,0
"03/10/2022","Y","Y","Skagway Municipality",230,"Other Southeast Region - Northern",8,3,113,2,116,0,2,0,0
"03/11/2022","Y","Y","Skagway Municipality",230,"Other Southeast Region - Northern",8,2,115,2,118,0,2,0,0
"03/12/2022","Y","Y","Skagway Municipality",230,"Other Southeast Region - Northern",8,2,117,1,119,0,2,0,0
"03/15/2022","Y","Y","Skagway Municipality",230,"Other Southeast Region - Northern",8,1,118,0,119,0,2,0,0
"03/16/2022","Y","Y","Skagway Municipality",230,"Other Southeast Region - Northern",8,1,119,0,119,0,2,0,0
"03/20/2022","Y","Y","Skagway Municipality",230,"Other Southeast Region - Northern",8,0,119,1,120,0,2,0,0
"03/21/2022","Y","Y","Skagway Municipality",230,"Other Southeast Region - Northern",8,0,119,2,122,0,2,0,0
"03/22/2022","Y","Y","Skagway Municipality",230,"Other Southeast Region - Northern",8,3,122,1,123,0,2,0,0
"03/23/2022","Y","Y","Skagway Municipality",230,"Other Southeast Region - Northern",8,1,123,1,124,0,2,0,0
"03/25/2022","Y","Y","Skagway Municipality",230,"Other Southeast Region - Northern",8,0,123,3,127,0,2,0,0
"03/28/2022","Y","Y","Skagway Municipality",230,"Other Southeast Region - Northern",8,0,123,1,128,0,2,0,0
"03/29/2022","Y","Y","Skagway Municipality",230,"Other Southeast Region - Northern",8,1,124,1,129,0,2,0,0
"03/30/2022","Y","Y","Skagway Municipality",230,"Other Southeast Region - Northern",8,4,128,1,130,0,2,0,0
"03/31/2022","Y","Y","Skagway Municipality",230,"Other Southeast Region - Northern",8,0,128,1,131,0,2,0,0
"04/01/2022","Y","Y","Skagway Municipality",230,"Other Southeast Region - Northern",8,3,131,1,132,0,2,0,0
"04/02/2022","Y","Y","Skagway Municipality",230,"Other Southeast Region - Northern",8,1,132,0,132,0,2,0,0
"04/05/2022","Y","Y","Skagway Municipality",230,"Other Southeast Region - Northern",8,0,132,1,133,0,2,0,0
"04/06/2022","Y","Y","Skagway Municipality",230,"Other Southeast Region - Northern",8,1,133,0,133,0,2,0,0
"04/10/2022","Y","Y","Skagway Municipality",230,"Other Southeast Region - Northern",8,0,133,2,135,0,2,0,0
"04/11/2022","Y","Y","Skagway Municipality",230,"Other Southeast Region - Northern",8,0,133,2,137,0,2,0,0
"04/12/2022","Y","Y","Skagway Municipality",230,"Other Southeast Region - Northern",8,2,135,0,137,0,2,0,0
"04/15/2022","Y","Y","Skagway Municipality",230,"Other Southeast Region - Northern",8,2,137,0,137,0,2,0,0
"04/16/2022","Y","Y","Skagway Municipality",230,"Other Southeast Region - Northern",8,0,137,1,138,0,2,0,0
"04/18/2022","Y","Y","Skagway Municipality",230,"Other Southeast Region - Northern",8,0,137,2,140,0,2,0,0
"04/19/2022","Y","Y","Skagway Municipality",230,"Other Southeast Region - Northern",8,0,137,2,142,0,2,0,0
"04/20/2022","Y","Y","Skagway Municipality",230,"Other Southeast Region - Northern",8,4,141,2,144,0,2,0,0
"04/21/2022","Y","Y","Skagway Municipality",230,"Other Southeast Region - Northern",8,1,142,0,144,0,2,0,0
"04/22/2022","Y","Y","Skagway Municipality",230,"Other Southeast Region - Northern",8,3,145,2,146,0,2,0,0
"04/25/2022","Y","Y","Skagway Municipality",230,"Other Southeast Region - Northern",8,0,145,2,148,0,2,0,0
"04/26/2022","Y","Y","Skagway Municipality",230,"Other Southeast Region - Northern",8,3,148,0,148,0,2,0,0
"03/24/2020","Y","Y","Southeast Fairbanks Census Area",240,"Other Interior Region",7,0,0,1,1,0,0,0,0
"04/02/2020","Y","Y","Southeast Fairbanks Census Area",240,"Other Interior Region",7,1,1,0,1,0,0,0,0
"05/03/2020","Y","Y","Southeast Fairbanks Census Area",240,"Other Interior Region",7,0,1,1,2,0,0,0,0
"05/05/2020","Y","Y","Southeast Fairbanks Census Area",240,"Other Interior Region",7,1,2,0,2,0,0,0,0
"05/11/2020","Y","Y","Southeast Fairbanks Census Area",240,"Other Interior Region",7,0,2,1,3,0,0,0,0
"05/13/2020","Y","Y","Southeast Fairbanks Census Area",240,"Other Interior Region",7,1,3,0,3,1,1,0,0
"06/19/2020","Y","Y","Southeast Fairbanks Census Area",240,"Other Interior Region",7,0,3,1,4,0,1,0,0
"06/22/2020","Y","Y","Southeast Fairbanks Census Area",240,"Other Interior Region",7,0,3,1,5,0,1,0,0
"06/27/2020","Y","Y","Southeast Fairbanks Census Area",240,"Other Interior Region",7,2,5,0,5,0,1,0,0
"06/28/2020","Y","Y","Southeast Fairbanks Census Area",240,"Other Interior Region",7,0,5,1,6,0,1,0,0
"06/30/2020","Y","Y","Southeast Fairbanks Census Area",240,"Other Interior Region",7,3,8,2,8,0,1,0,0
"07/01/2020","Y","Y","Southeast Fairbanks Census Area",240,"Other Interior Region",7,2,10,1,9,0,1,0,0
"07/02/2020","Y","Y","Southeast Fairbanks Census Area",240,"Other Interior Region",7,0,10,1,10,0,1,0,0
"07/09/2020","Y","Y","Southeast Fairbanks Census Area",240,"Other Interior Region",7,0,10,1,11,0,1,0,0
"07/14/2020","Y","Y","Southeast Fairbanks Census Area",240,"Other Interior Region",7,0,10,2,13,0,1,0,0
"07/15/2020","Y","Y","Southeast Fairbanks Census Area",240,"Other Interior Region",7,0,10,1,14,0,1,0,0
"07/18/2020","Y","Y","Southeast Fairbanks Census Area",240,"Other Interior Region",7,1,11,0,14,0,1,0,0
"07/20/2020","Y","Y","Southeast Fairbanks Census Area",240,"Other Interior Region",7,1,12,1,15,0,1,0,0
"07/22/2020","Y","Y","Southeast Fairbanks Census Area",240,"Other Interior Region",7,1,13,0,15,0,1,0,0
"07/27/2020","Y","Y","Southeast Fairbanks Census Area",240,"Other Interior Region",7,1,14,0,15,0,1,0,0
"08/04/2020","Y","Y","Southeast Fairbanks Census Area",240,"Other Interior Region",7,1,15,0,15,0,1,0,0
"08/06/2020","Y","Y","Southeast Fairbanks Census Area",240,"Other Interior Region",7,1,16,2,17,0,1,0,0
"08/08/2020","Y","Y","Southeast Fairbanks Census Area",240,"Other Interior Region",7,1,17,0,17,0,1,0,0
"08/11/2020","Y","Y","Southeast Fairbanks Census Area",240,"Other Interior Region",7,0,17,1,18,0,1,0,0
"08/14/2020","Y","Y","Southeast Fairbanks Census Area",240,"Other Interior Region",7,1,18,0,18,0,1,0,0
"09/01/2020","Y","Y","Southeast Fairbanks Census Area",240,"Other Interior Region",7,1,19,1,19,0,1,0,0
"09/08/2020","Y","Y","Southeast Fairbanks Census Area",240,"Other Interior Region",7,0,19,1,20,0,1,0,0
"09/09/2020","Y","Y","Southeast Fairbanks Census Area",240,"Other Interior Region",7,1,20,0,20,0,1,0,0
"09/16/2020","Y","Y","Southeast Fairbanks Census Area",240,"Other Interior Region",7,1,21,1,21,0,1,0,0
"09/21/2020","Y","Y","Southeast Fairbanks Census Area",240,"Other Interior Region",7,0,21,2,23,0,1,0,0
"09/22/2020","Y","Y","Southeast Fairbanks Census Area",240,"Other Interior Region",7,2,23,1,24,0,1,0,0
"09/24/2020","Y","Y","Southeast Fairbanks Census Area",240,"Other Interior Region",7,1,24,0,24,0,1,0,0
"09/25/2020","Y","Y","Southeast Fairbanks Census Area",240,"Other Interior Region",7,0,24,1,25,0,1,0,0
"09/26/2020","Y","Y","Southeast Fairbanks Census Area",240,"Other Interior Region",7,1,25,0,25,0,1,0,0
"09/28/2020","Y","Y","Southeast Fairbanks Census Area",240,"Other Interior Region",7,0,25,1,26,0,1,0,0
"09/29/2020","Y","Y","Southeast Fairbanks Census Area",240,"Other Interior Region",7,1,26,0,26,0,1,0,0
"09/30/2020","Y","Y","Southeast Fairbanks Census Area",240,"Other Interior Region",7,0,26,1,27,0,1,0,0
"10/01/2020","Y","Y","Southeast Fairbanks Census Area",240,"Other Interior Region",7,0,26,1,28,0,1,0,0
"10/02/2020","Y","Y","Southeast Fairbanks Census Area",240,"Other Interior Region",7,1,27,2,30,0,1,0,0
"10/03/2020","Y","Y","Southeast Fairbanks Census Area",240,"Other Interior Region",7,3,30,1,31,1,2,0,0
"10/04/2020","Y","Y","Southeast Fairbanks Census Area",240,"Other Interior Region",7,1,31,0,31,0,2,0,0
"10/08/2020","Y","Y","Southeast Fairbanks Census Area",240,"Other Interior Region",7,0,31,1,32,0,2,0,0
"10/09/2020","Y","Y","Southeast Fairbanks Census Area",240,"Other Interior Region",7,1,32,1,33,0,2,0,0
"10/12/2020","Y","Y","Southeast Fairbanks Census Area",240,"Other Interior Region",7,0,32,1,34,0,2,0,0
"10/13/2020","Y","Y","Southeast Fairbanks Census Area",240,"Other Interior Region",7,0,32,5,39,0,2,0,0
"10/14/2020","Y","Y","Southeast Fairbanks Census Area",240,"Other Interior Region",7,2,34,7,46,0,2,0,0
"10/15/2020","Y","Y","Southeast Fairbanks Census Area",240,"Other Interior Region",7,2,36,1,47,0,2,0,0
"10/16/2020","Y","Y","Southeast Fairbanks Census Area",240,"Other Interior Region",7,8,44,5,52,0,2,0,0
"10/17/2020","Y","Y","Southeast Fairbanks Census Area",240,"Other Interior Region",7,4,48,1,53,0,2,0,0
"10/19/2020","Y","Y","Southeast Fairbanks Census Area",240,"Other Interior Region",7,0,48,3,56,0,2,0,0
"10/20/2020","Y","Y","Southeast Fairbanks Census Area",240,"Other Interior Region",7,3,51,4,60,1,3,0,0
"10/21/2020","Y","Y","Southeast Fairbanks Census Area",240,"Other Interior Region",7,1,52,4,64,0,3,0,0
"10/22/2020","Y","Y","Southeast Fairbanks Census Area",240,"Other Interior Region",7,0,52,1,65,1,4,0,0
"10/23/2020","Y","Y","Southeast Fairbanks Census Area",240,"Other Interior Region",7,0,52,4,69,0,4,0,0
"10/24/2020","Y","Y","Southeast Fairbanks Census Area",240,"Other Interior Region",7,5,57,0,69,0,4,0,0
"10/25/2020","Y","Y","Southeast Fairbanks Census Area",240,"Other Interior Region",7,4,61,2,71,0,4,0,0
"10/26/2020","Y","Y","Southeast Fairbanks Census Area",240,"Other Interior Region",7,1,62,1,72,0,4,0,0
"10/27/2020","Y","Y","Southeast Fairbanks Census Area",240,"Other Interior Region",7,4,66,2,74,0,4,0,0
"10/28/2020","Y","Y","Southeast Fairbanks Census Area",240,"Other Interior Region",7,5,71,1,75,0,4,0,0
"10/29/2020","Y","Y","Southeast Fairbanks Census Area",240,"Other Interior Region",7,2,73,3,78,0,4,1,1
"10/30/2020","Y","Y","Southeast Fairbanks Census Area",240,"Other Interior Region",7,2,75,0,78,0,4,0,1
"10/31/2020","Y","Y","Southeast Fairbanks Census Area",240,"Other Interior Region",7,3,78,1,79,0,4,0,1
"11/02/2020","Y","Y","Southeast Fairbanks Census Area",240,"Other Interior Region",7,2,80,3,82,0,4,0,1
"11/03/2020","Y","Y","Southeast Fairbanks Census Area",240,"Other Interior Region",7,0,80,1,83,1,5,0,1
"11/04/2020","Y","Y","Southeast Fairbanks Census Area",240,"Other Interior Region",7,1,81,3,86,0,5,0,1
"11/05/2020","Y","Y","Southeast Fairbanks Census Area",240,"Other Interior Region",7,2,83,3,89,0,5,0,1
"11/06/2020","Y","Y","Southeast Fairbanks Census Area",240,"Other Interior Region",7,4,87,6,95,0,5,0,1
"11/07/2020","Y","Y","Southeast Fairbanks Census Area",240,"Other Interior Region",7,4,91,2,97,0,5,0,1
"11/08/2020","Y","Y","Southeast Fairbanks Census Area",240,"Other Interior Region",7,4,95,0,97,0,5,0,1
"11/09/2020","Y","Y","Southeast Fairbanks Census Area",240,"Other Interior Region",7,3,98,18,115,0,5,0,1
"11/10/2020","Y","Y","Southeast Fairbanks Census Area",240,"Other Interior Region",7,12,110,14,129,0,5,0,1
"11/11/2020","Y","Y","Southeast Fairbanks Census Area",240,"Other Interior Region",7,2,112,5,134,0,5,0,1
"11/12/2020","Y","Y","Southeast Fairbanks Census Area",240,"Other Interior Region",7,14,126,19,153,0,5,0,1
"11/13/2020","Y","Y","Southeast Fairbanks Census Area",240,"Other Interior Region",7,9,135,15,168,0,5,0,1
"11/14/2020","Y","Y","Southeast Fairbanks Census Area",240,"Other Interior Region",7,5,140,1,169,0,5,0,1
"11/15/2020","Y","Y","Southeast Fairbanks Census Area",240,"Other Interior Region",7,8,148,0,169,0,5,0,1
"11/16/2020","Y","Y","Southeast Fairbanks Census Area",240,"Other Interior Region",7,4,152,18,187,1,6,0,1
"11/17/2020","Y","Y","Southeast Fairbanks Census Area",240,"Other Interior Region",7,10,162,18,205,0,6,0,1
"11/18/2020","Y","Y","Southeast Fairbanks Census Area",240,"Other Interior Region",7,14,176,19,224,0,6,0,1
"11/19/2020","Y","Y","Southeast Fairbanks Census Area",240,"Other Interior Region",7,15,191,10,234,0,6,0,1
"11/20/2020","Y","Y","Southeast Fairbanks Census Area",240,"Other Interior Region",7,15,206,11,245,0,6,0,1
"11/21/2020","Y","Y","Southeast Fairbanks Census Area",240,"Other Interior Region",7,15,221,0,245,0,6,0,1
"11/23/2020","Y","Y","Southeast Fairbanks Census Area",240,"Other Interior Region",7,6,227,16,261,1,7,0,1
"11/24/2020","Y","Y","Southeast Fairbanks Census Area",240,"Other Interior Region",7,11,238,7,268,1,8,1,2
"11/25/2020","Y","Y","Southeast Fairbanks Census Area",240,"Other Interior Region",7,10,248,7,275,0,8,0,2
"11/26/2020","Y","Y","Southeast Fairbanks Census Area",240,"Other Interior Region",7,9,257,0,275,0,8,0,2
"11/27/2020","Y","Y","Southeast Fairbanks Census Area",240,"Other Interior Region",7,3,260,5,280,0,8,1,3
"11/28/2020","Y","Y","Southeast Fairbanks Census Area",240,"Other Interior Region",7,1,261,0,280,0,8,0,3
"11/29/2020","Y","Y","Southeast Fairbanks Census Area",240,"Other Interior Region",7,0,261,2,282,1,9,0,3
"11/30/2020","Y","Y","Southeast Fairbanks Census Area",240,"Other Interior Region",7,8,269,10,292,0,9,0,3
"12/01/2020","Y","Y","Southeast Fairbanks Census Area",240,"Other Interior Region",7,8,277,13,305,0,9,0,3
"12/02/2020","Y","Y","Southeast Fairbanks Census Area",240,"Other Interior Region",7,8,285,13,318,0,9,0,3
"12/03/2020","Y","Y","Southeast Fairbanks Census Area",240,"Other Interior Region",7,9,294,7,325,0,9,0,3
"12/04/2020","Y","Y","Southeast Fairbanks Census Area",240,"Other Interior Region",7,12,306,1,326,0,9,0,3
"12/05/2020","Y","Y","Southeast Fairbanks Census Area",240,"Other Interior Region",7,1,307,3,329,0,9,0,3
"12/06/2020","Y","Y","Southeast Fairbanks Census Area",240,"Other Interior Region",7,4,311,1,330,0,9,0,3
"12/07/2020","Y","Y","Southeast Fairbanks Census Area",240,"Other Interior Region",7,2,313,3,333,0,9,0,3
"12/08/2020","Y","Y","Southeast Fairbanks Census Area",240,"Other Interior Region",7,7,320,1,334,0,9,0,3
"12/09/2020","Y","Y","Southeast Fairbanks Census Area",240,"Other Interior Region",7,4,324,2,336,0,9,0,3
"12/10/2020","Y","Y","Southeast Fairbanks Census Area",240,"Other Interior Region",7,4,328,1,337,0,9,0,3
"12/11/2020","Y","Y","Southeast Fairbanks Census Area",240,"Other Interior Region",7,1,329,0,337,0,9,0,3
"12/12/2020","Y","Y","Southeast Fairbanks Census Area",240,"Other Interior Region",7,1,330,0,337,0,9,0,3
"12/13/2020","Y","Y","Southeast Fairbanks Census Area",240,"Other Interior Region",7,7,337,2,339,0,9,0,3
"12/14/2020","Y","Y","Southeast Fairbanks Census Area",240,"Other Interior Region",7,2,339,2,341,0,9,0,3
"12/15/2020","Y","Y","Southeast Fairbanks Census Area",240,"Other Interior Region",7,3,342,2,343,0,9,0,3
"12/16/2020","Y","Y","Southeast Fairbanks Census Area",240,"Other Interior Region",7,0,342,3,346,0,9,0,3
"12/17/2020","Y","Y","Southeast Fairbanks Census Area",240,"Other Interior Region",7,3,345,6,352,0,9,0,3
"12/18/2020","Y","Y","Southeast Fairbanks Census Area",240,"Other Interior Region",7,4,349,0,352,0,9,0,3
"12/19/2020","Y","Y","Southeast Fairbanks Census Area",240,"Other Interior Region",7,0,349,2,354,1,10,0,3
"12/21/2020","Y","Y","Southeast Fairbanks Census Area",240,"Other Interior Region",7,2,351,7,361,0,10,0,3
"12/22/2020","Y","Y","Southeast Fairbanks Census Area",240,"Other Interior Region",7,11,362,4,365,0,10,0,3
"12/23/2020","Y","Y","Southeast Fairbanks Census Area",240,"Other Interior Region",7,2,364,0,365,0,10,0,3
"12/26/2020","Y","Y","Southeast Fairbanks Census Area",240,"Other Interior Region",7,1,365,0,365,0,10,0,3
"12/28/2020","Y","Y","Southeast Fairbanks Census Area",240,"Other Interior Region",7,3,368,5,370,0,10,0,3
"12/29/2020","Y","Y","Southeast Fairbanks Census Area",240,"Other Interior Region",7,2,370,3,373,0,10,0,3
"12/30/2020","Y","Y","Southeast Fairbanks Census Area",240,"Other Interior Region",7,2,372,2,375,0,10,0,3
"12/31/2020","Y","Y","Southeast Fairbanks Census Area",240,"Other Interior Region",7,1,373,0,375,0,10,0,3
"01/04/2021","Y","Y","Southeast Fairbanks Census Area",240,"Other Interior Region",7,1,374,0,375,2,12,0,3
"01/06/2021","Y","Y","Southeast Fairbanks Census Area",240,"Other Interior Region",7,0,374,1,376,0,12,0,3
"01/07/2021","Y","Y","Southeast Fairbanks Census Area",240,"Other Interior Region",7,1,375,1,377,0,12,0,3
"01/08/2021","Y","Y","Southeast Fairbanks Census Area",240,"Other Interior Region",7,1,376,0,377,0,12,0,3
"01/09/2021","Y","Y","Southeast Fairbanks Census Area",240,"Other Interior Region",7,0,376,1,378,0,12,0,3
"01/12/2021","Y","Y","Southeast Fairbanks Census Area",240,"Other Interior Region",7,2,378,0,378,0,12,0,3
"01/13/2021","Y","Y","Southeast Fairbanks Census Area",240,"Other Interior Region",7,0,378,1,379,0,12,0,3
"01/15/2021","Y","Y","Southeast Fairbanks Census Area",240,"Other Interior Region",7,0,378,1,380,0,12,0,3
"01/16/2021","Y","Y","Southeast Fairbanks Census Area",240,"Other Interior Region",7,1,379,2,382,0,12,0,3
"01/17/2021","Y","Y","Southeast Fairbanks Census Area",240,"Other Interior Region",7,2,381,3,385,0,12,0,3
"01/18/2021","Y","Y","Southeast Fairbanks Census Area",240,"Other Interior Region",7,0,381,2,387,0,12,0,3
"01/19/2021","Y","Y","Southeast Fairbanks Census Area",240,"Other Interior Region",7,3,384,2,389,1,13,0,3
"01/20/2021","Y","Y","Southeast Fairbanks Census Area",240,"Other Interior Region",7,1,385,0,389,0,13,0,3
"01/21/2021","Y","Y","Southeast Fairbanks Census Area",240,"Other Interior Region",7,3,388,0,389,0,13,0,3
"01/22/2021","Y","Y","Southeast Fairbanks Census Area",240,"Other Interior Region",7,2,390,1,390,0,13,0,3
"01/23/2021","Y","Y","Southeast Fairbanks Census Area",240,"Other Interior Region",7,0,390,2,392,0,13,0,3
"01/25/2021","Y","Y","Southeast Fairbanks Census Area",240,"Other Interior Region",7,0,390,3,395,0,13,0,3
"01/26/2021","Y","Y","Southeast Fairbanks Census Area",240,"Other Interior Region",7,3,393,0,395,0,13,0,3
"01/27/2021","Y","Y","Southeast Fairbanks Census Area",240,"Other Interior Region",7,0,393,2,397,0,13,0,3
"01/28/2021","Y","Y","Southeast Fairbanks Census Area",240,"Other Interior Region",7,1,394,5,402,0,13,0,3
"01/29/2021","Y","Y","Southeast Fairbanks Census Area",240,"Other Interior Region",7,4,398,2,404,0,13,0,3
"01/30/2021","Y","Y","Southeast Fairbanks Census Area",240,"Other Interior Region",7,2,400,1,405,0,13,0,3
"01/31/2021","Y","Y","Southeast Fairbanks Census Area",240,"Other Interior Region",7,1,401,1,406,0,13,0,3
"02/01/2021","Y","Y","Southeast Fairbanks Census Area",240,"Other Interior Region",7,0,401,2,408,0,13,0,3
"02/02/2021","Y","Y","Southeast Fairbanks Census Area",240,"Other Interior Region",7,7,408,1,409,0,13,0,3
"02/03/2021","Y","Y","Southeast Fairbanks Census Area",240,"Other Interior Region",7,0,408,1,410,0,13,0,3
"02/05/2021","Y","Y","Southeast Fairbanks Census Area",240,"Other Interior Region",7,1,409,0,410,0,13,0,3
"02/08/2021","Y","Y","Southeast Fairbanks Census Area",240,"Other Interior Region",7,1,410,0,410,0,13,0,3
"02/16/2021","Y","Y","Southeast Fairbanks Census Area",240,"Other Interior Region",7,0,410,1,411,0,13,0,3
"02/17/2021","Y","Y","Southeast Fairbanks Census Area",240,"Other Interior Region",7,1,411,0,411,0,13,0,3
"02/20/2021","Y","Y","Southeast Fairbanks Census Area",240,"Other Interior Region",7,0,411,1,412,0,13,0,3
"02/24/2021","Y","Y","Southeast Fairbanks Census Area",240,"Other Interior Region",7,1,412,5,417,0,13,0,3
"02/25/2021","Y","Y","Southeast Fairbanks Census Area",240,"Other Interior Region",7,2,414,2,419,0,13,0,3
"02/26/2021","Y","Y","Southeast Fairbanks Census Area",240,"Other Interior Region",7,2,416,3,422,0,13,0,3
"02/27/2021","Y","Y","Southeast Fairbanks Census Area",240,"Other Interior Region",7,4,420,2,424,0,13,0,3
"03/01/2021","Y","Y","Southeast Fairbanks Census Area",240,"Other Interior Region",7,1,421,2,426,0,13,0,3
"03/02/2021","Y","Y","Southeast Fairbanks Census Area",240,"Other Interior Region",7,2,423,0,426,0,13,0,3
"03/03/2021","Y","Y","Southeast Fairbanks Census Area",240,"Other Interior Region",7,2,425,4,430,0,13,0,3
"03/04/2021","Y","Y","Southeast Fairbanks Census Area",240,"Other Interior Region",7,3,428,3,433,0,13,0,3
"03/05/2021","Y","Y","Southeast Fairbanks Census Area",240,"Other Interior Region",7,4,432,3,436,0,13,0,3
"03/06/2021","Y","Y","Southeast Fairbanks Census Area",240,"Other Interior Region",7,1,433,1,437,0,13,0,3
"03/08/2021","Y","Y","Southeast Fairbanks Census Area",240,"Other Interior Region",7,1,434,3,440,0,13,0,3
"03/09/2021","Y","Y","Southeast Fairbanks Census Area",240,"Other Interior Region",7,6,440,2,442,0,13,0,3
"03/10/2021","Y","Y","Southeast Fairbanks Census Area",240,"Other Interior Region",7,2,442,12,454,0,13,0,3
"03/11/2021","Y","Y","Southeast Fairbanks Census Area",240,"Other Interior Region",7,7,449,9,463,0,13,0,3
"03/12/2021","Y","Y","Southeast Fairbanks Census Area",240,"Other Interior Region",7,6,455,3,466,0,13,0,3
"03/13/2021","Y","Y","Southeast Fairbanks Census Area",240,"Other Interior Region",7,7,462,9,475,0,13,0,3
"03/14/2021","Y","Y","Southeast Fairbanks Census Area",240,"Other Interior Region",7,9,471,0,475,0,13,0,3
"03/15/2021","Y","Y","Southeast Fairbanks Census Area",240,"Other Interior Region",7,2,473,12,487,0,13,0,3
"03/16/2021","Y","Y","Southeast Fairbanks Census Area",240,"Other Interior Region",7,11,484,6,493,1,14,0,3
"03/17/2021","Y","Y","Southeast Fairbanks Census Area",240,"Other Interior Region",7,10,494,10,503,0,14,0,3
"03/18/2021","Y","Y","Southeast Fairbanks Census Area",240,"Other Interior Region",7,12,506,9,512,1,15,0,3
"03/19/2021","Y","Y","Southeast Fairbanks Census Area",240,"Other Interior Region",7,5,511,7,519,5,20,0,3
"03/20/2021","Y","Y","Southeast Fairbanks Census Area",240,"Other Interior Region",7,5,516,2,521,0,20,0,3
"03/21/2021","Y","Y","Southeast Fairbanks Census Area",240,"Other Interior Region",7,0,516,1,522,0,20,0,3
"03/22/2021","Y","Y","Southeast Fairbanks Census Area",240,"Other Interior Region",7,4,520,12,534,1,21,0,3
"03/23/2021","Y","Y","Southeast Fairbanks Census Area",240,"Other Interior Region",7,3,523,5,539,0,21,0,3
"03/24/2021","Y","Y","Southeast Fairbanks Census Area",240,"Other Interior Region",7,7,530,5,544,0,21,0,3
"03/25/2021","Y","Y","Southeast Fairbanks Census Area",240,"Other Interior Region",7,5,535,5,549,0,21,1,4
"03/26/2021","Y","Y","Southeast Fairbanks Census Area",240,"Other Interior Region",7,3,538,6,555,1,22,0,4
"03/27/2021","Y","Y","Southeast Fairbanks Census Area",240,"Other Interior Region",7,4,542,0,555,0,22,0,4
"03/28/2021","Y","Y","Southeast Fairbanks Census Area",240,"Other Interior Region",7,2,544,2,557,0,22,0,4
"03/29/2021","Y","Y","Southeast Fairbanks Census Area",240,"Other Interior Region",7,4,548,1,558,0,22,0,4
"03/30/2021","Y","Y","Southeast Fairbanks Census Area",240,"Other Interior Region",7,2,550,7,565,0,22,0,4
"03/31/2021","Y","Y","Southeast Fairbanks Census Area",240,"Other Interior Region",7,6,556,1,566,0,22,0,4
"04/01/2021","Y","Y","Southeast Fairbanks Census Area",240,"Other Interior Region",7,3,559,1,567,0,22,0,4
"04/02/2021","Y","Y","Southeast Fairbanks Census Area",240,"Other Interior Region",7,3,562,0,567,0,22,0,4
"04/05/2021","Y","Y","Southeast Fairbanks Census Area",240,"Other Interior Region",7,0,562,3,570,0,22,0,4
"04/06/2021","Y","Y","Southeast Fairbanks Census Area",240,"Other Interior Region",7,2,564,2,572,0,22,0,4
"04/07/2021","Y","Y","Southeast Fairbanks Census Area",240,"Other Interior Region",7,1,565,0,572,0,22,0,4
"04/08/2021","Y","Y","Southeast Fairbanks Census Area",240,"Other Interior Region",7,2,567,1,573,0,22,0,4
"04/09/2021","Y","Y","Southeast Fairbanks Census Area",240,"Other Interior Region",7,0,567,1,574,0,22,0,4
"04/10/2021","Y","Y","Southeast Fairbanks Census Area",240,"Other Interior Region",7,1,568,0,574,0,22,0,4
"04/12/2021","Y","Y","Southeast Fairbanks Census Area",240,"Other Interior Region",7,1,569,2,576,0,22,0,4
"04/13/2021","Y","Y","Southeast Fairbanks Census Area",240,"Other Interior Region",7,2,571,3,579,0,22,0,4
"04/14/2021","Y","Y","Southeast Fairbanks Census Area",240,"Other Interior Region",7,1,572,5,584,0,22,0,4
"04/15/2021","Y","Y","Southeast Fairbanks Census Area",240,"Other Interior Region",7,3,575,5,589,0,22,0,4
"04/16/2021","Y","Y","Southeast Fairbanks Census Area",240,"Other Interior Region",7,5,580,1,590,0,22,0,4
"04/17/2021","Y","Y","Southeast Fairbanks Census Area",240,"Other Interior Region",7,1,581,1,591,0,22,0,4
"04/18/2021","Y","Y","Southeast Fairbanks Census Area",240,"Other Interior Region",7,0,581,1,592,0,22,0,4
"04/19/2021","Y","Y","Southeast Fairbanks Census Area",240,"Other Interior Region",7,0,581,3,595,1,23,0,4
"04/20/2021","Y","Y","Southeast Fairbanks Census Area",240,"Other Interior Region",7,1,582,0,595,0,23,0,4
"04/21/2021","Y","Y","Southeast Fairbanks Census Area",240,"Other Interior Region",7,2,584,1,596,0,23,0,4
"04/22/2021","Y","Y","Southeast Fairbanks Census Area",240,"Other Interior Region",7,0,584,1,597,0,23,0,4
"04/23/2021","Y","Y","Southeast Fairbanks Census Area",240,"Other Interior Region",7,3,587,1,598,1,24,0,4
"04/24/2021","Y","Y","Southeast Fairbanks Census Area",240,"Other Interior Region",7,10,597,0,598,1,25,0,4
"04/26/2021","Y","Y","Southeast Fairbanks Census Area",240,"Other Interior Region",7,1,598,2,600,0,25,0,4
"04/27/2021","Y","Y","Southeast Fairbanks Census Area",240,"Other Interior Region",7,5,603,5,605,0,25,0,4
"04/28/2021","Y","Y","Southeast Fairbanks Census Area",240,"Other Interior Region",7,2,605,3,608,0,25,0,4
"04/29/2021","Y","Y","Southeast Fairbanks Census Area",240,"Other Interior Region",7,1,606,1,609,0,25,0,4
"04/30/2021","Y","Y","Southeast Fairbanks Census Area",240,"Other Interior Region",7,0,606,1,610,0,25,0,4
"05/01/2021","Y","Y","Southeast Fairbanks Census Area",240,"Other Interior Region",7,2,608,1,611,0,25,0,4
"05/03/2021","Y","Y","Southeast Fairbanks Census Area",240,"Other Interior Region",7,1,609,2,613,1,26,0,4
"05/04/2021","Y","Y","Southeast Fairbanks Census Area",240,"Other Interior Region",7,4,613,3,616,0,26,0,4
"05/05/2021","Y","Y","Southeast Fairbanks Census Area",240,"Other Interior Region",7,2,615,3,619,0,26,0,4
"05/06/2021","Y","Y","Southeast Fairbanks Census Area",240,"Other Interior Region",7,4,619,1,620,0,26,0,4
"05/07/2021","Y","Y","Southeast Fairbanks Census Area",240,"Other Interior Region",7,1,620,1,621,0,26,0,4
"05/08/2021","Y","Y","Southeast Fairbanks Census Area",240,"Other Interior Region",7,0,620,1,622,0,26,0,4
"05/09/2021","Y","Y","Southeast Fairbanks Census Area",240,"Other Interior Region",7,0,620,0,622,1,27,0,4
"05/11/2021","Y","Y","Southeast Fairbanks Census Area",240,"Other Interior Region",7,1,621,3,625,0,27,0,4
"05/12/2021","Y","Y","Southeast Fairbanks Census Area",240,"Other Interior Region",7,3,624,0,625,0,27,0,4
"05/13/2021","Y","Y","Southeast Fairbanks Census Area",240,"Other Interior Region",7,0,624,2,627,0,27,0,4
"05/14/2021","Y","Y","Southeast Fairbanks Census Area",240,"Other Interior Region",7,3,627,2,629,0,27,1,5
"05/17/2021","Y","Y","Southeast Fairbanks Census Area",240,"Other Interior Region",7,0,627,2,631,0,27,0,5
"05/18/2021","Y","Y","Southeast Fairbanks Census Area",240,"Other Interior Region",7,2,629,3,634,0,27,0,5
"05/19/2021","Y","Y","Southeast Fairbanks Census Area",240,"Other Interior Region",7,3,632,3,637,0,27,0,5
"05/20/2021","Y","Y","Southeast Fairbanks Census Area",240,"Other Interior Region",7,5,637,4,641,0,27,0,5
"05/21/2021","Y","Y","Southeast Fairbanks Census Area",240,"Other Interior Region",7,2,639,2,643,1,28,0,5
"05/22/2021","Y","Y","Southeast Fairbanks Census Area",240,"Other Interior Region",7,2,641,1,644,0,28,0,5
"05/24/2021","Y","Y","Southeast Fairbanks Census Area",240,"Other Interior Region",7,0,641,11,655,0,28,0,5
"05/25/2021","Y","Y","Southeast Fairbanks Census Area",240,"Other Interior Region",7,10,651,3,658,0,28,0,5
"05/26/2021","Y","Y","Southeast Fairbanks Census Area",240,"Other Interior Region",7,3,654,2,660,0,28,0,5
"05/27/2021","Y","Y","Southeast Fairbanks Census Area",240,"Other Interior Region",7,4,658,8,668,0,28,0,5
"05/28/2021","Y","Y","Southeast Fairbanks Census Area",240,"Other Interior Region",7,7,665,2,670,0,28,0,5
"05/29/2021","Y","Y","Southeast Fairbanks Census Area",240,"Other Interior Region",7,3,668,0,670,0,28,0,5
"05/30/2021","Y","Y","Southeast Fairbanks Census Area",240,"Other Interior Region",7,0,668,1,671,0,28,0,5
"05/31/2021","Y","Y","Southeast Fairbanks Census Area",240,"Other Interior Region",7,1,669,1,672,0,28,0,5
"06/01/2021","Y","Y","Southeast Fairbanks Census Area",240,"Other Interior Region",7,2,671,2,674,1,29,0,5
"06/02/2021","Y","Y","Southeast Fairbanks Census Area",240,"Other Interior Region",7,3,674,9,683,0,29,0,5
"06/03/2021","Y","Y","Southeast Fairbanks Census Area",240,"Other Interior Region",7,7,681,1,684,0,29,0,5
"06/04/2021","Y","Y","Southeast Fairbanks Census Area",240,"Other Interior Region",7,1,682,1,685,0,29,0,5
"06/05/2021","Y","Y","Southeast Fairbanks Census Area",240,"Other Interior Region",7,1,683,0,685,0,29,0,5
"06/07/2021","Y","Y","Southeast Fairbanks Census Area",240,"Other Interior Region",7,0,683,3,688,0,29,0,5
"06/08/2021","Y","Y","Southeast Fairbanks Census Area",240,"Other Interior Region",7,5,688,2,690,0,29,0,5
"06/09/2021","Y","Y","Southeast Fairbanks Census Area",240,"Other Interior Region",7,3,691,1,691,0,29,0,5
"06/15/2021","Y","Y","Southeast Fairbanks Census Area",240,"Other Interior Region",7,0,691,3,694,1,30,0,5
"06/16/2021","Y","Y","Southeast Fairbanks Census Area",240,"Other Interior Region",7,3,694,1,695,0,30,0,5
"06/17/2021","Y","Y","Southeast Fairbanks Census Area",240,"Other Interior Region",7,0,694,2,697,0,30,0,5
"06/18/2021","Y","Y","Southeast Fairbanks Census Area",240,"Other Interior Region",7,3,697,0,697,0,30,0,5
"06/30/2021","Y","Y","Southeast Fairbanks Census Area",240,"Other Interior Region",7,0,697,1,698,0,30,0,5
"07/01/2021","Y","Y","Southeast Fairbanks Census Area",240,"Other Interior Region",7,1,698,0,698,0,30,0,5
"07/07/2021","Y","Y","Southeast Fairbanks Census Area",240,"Other Interior Region",7,0,698,1,699,1,31,0,5
"07/08/2021","Y","Y","Southeast Fairbanks Census Area",240,"Other Interior Region",7,1,699,0,699,0,31,0,5
"07/09/2021","Y","Y","Southeast Fairbanks Census Area",240,"Other Interior Region",7,0,699,0,699,1,32,0,5
"07/12/2021","Y","Y","Southeast Fairbanks Census Area",240,"Other Interior Region",7,0,699,2,701,0,32,0,5
"07/13/2021","Y","Y","Southeast Fairbanks Census Area",240,"Other Interior Region",7,2,701,0,701,0,32,0,5
"07/15/2021","Y","Y","Southeast Fairbanks Census Area",240,"Other Interior Region",7,0,701,2,703,0,32,0,5
"07/16/2021","Y","Y","Southeast Fairbanks Census Area",240,"Other Interior Region",7,1,702,0,703,0,32,0,5
"07/17/2021","Y","Y","Southeast Fairbanks Census Area",240,"Other Interior Region",7,1,703,0,703,0,32,0,5
"07/20/2021","Y","Y","Southeast Fairbanks Census Area",240,"Other Interior Region",7,0,703,1,704,0,32,0,5
"07/21/2021","Y","Y","Southeast Fairbanks Census Area",240,"Other Interior Region",7,1,704,6,710,0,32,0,5
"07/22/2021","Y","Y","Southeast Fairbanks Census Area",240,"Other Interior Region",7,6,710,5,715,0,32,0,5
"07/23/2021","Y","Y","Southeast Fairbanks Census Area",240,"Other Interior Region",7,1,711,5,720,0,32,0,5
"07/24/2021","Y","Y","Southeast Fairbanks Census Area",240,"Other Interior Region",7,2,713,1,721,0,32,0,5
"07/26/2021","Y","Y","Southeast Fairbanks Census Area",240,"Other Interior Region",7,7,720,2,723,0,32,0,5
"07/27/2021","Y","Y","Southeast Fairbanks Census Area",240,"Other Interior Region",7,2,722,2,725,0,32,0,5
"07/28/2021","Y","Y","Southeast Fairbanks Census Area",240,"Other Interior Region",7,1,723,2,727,0,32,0,5
"07/29/2021","Y","Y","Southeast Fairbanks Census Area",240,"Other Interior Region",7,2,725,0,727,0,32,0,5
"07/30/2021","Y","Y","Southeast Fairbanks Census Area",240,"Other Interior Region",7,1,726,1,728,0,32,0,5
"07/31/2021","Y","Y","Southeast Fairbanks Census Area",240,"Other Interior Region",7,1,727,0,728,1,33,0,5
"08/02/2021","Y","Y","Southeast Fairbanks Census Area",240,"Other Interior Region",7,0,727,1,729,0,33,0,5
"08/03/2021","Y","Y","Southeast Fairbanks Census Area",240,"Other Interior Region",7,1,728,0,729,0,33,0,5
"08/04/2021","Y","Y","Southeast Fairbanks Census Area",240,"Other Interior Region",7,0,728,1,730,0,33,0,5
"08/06/2021","Y","Y","Southeast Fairbanks Census Area",240,"Other Interior Region",7,2,730,3,733,0,33,3,8
"08/08/2021","Y","Y","Southeast Fairbanks Census Area",240,"Other Interior Region",7,0,730,1,734,0,33,0,8
"08/09/2021","Y","Y","Southeast Fairbanks Census Area",240,"Other Interior Region",7,4,734,2,736,0,33,0,8
"08/10/2021","Y","Y","Southeast Fairbanks Census Area",240,"Other Interior Region",7,1,735,1,737,0,33,0,8
"08/11/2021","Y","Y","Southeast Fairbanks Census Area",240,"Other Interior Region",7,1,736,0,737,0,33,0,8
"08/13/2021","Y","Y","Southeast Fairbanks Census Area",240,"Other Interior Region",7,0,736,2,739,0,33,0,8
"08/16/2021","Y","Y","Southeast Fairbanks Census Area",240,"Other Interior Region",7,3,739,2,741,0,33,0,8
"08/17/2021","Y","Y","Southeast Fairbanks Census Area",240,"Other Interior Region",7,1,740,0,741,0,33,0,8
"08/18/2021","Y","Y","Southeast Fairbanks Census Area",240,"Other Interior Region",7,1,741,1,742,0,33,0,8
"08/19/2021","Y","Y","Southeast Fairbanks Census Area",240,"Other Interior Region",7,1,742,4,746,0,33,0,8
"08/20/2021","Y","Y","Southeast Fairbanks Census Area",240,"Other Interior Region",7,3,745,3,749,0,33,0,8
"08/21/2021","Y","Y","Southeast Fairbanks Census Area",240,"Other Interior Region",7,1,746,1,750,0,33,0,8
"08/22/2021","Y","Y","Southeast Fairbanks Census Area",240,"Other Interior Region",7,0,746,2,752,0,33,0,8
"08/23/2021","Y","Y","Southeast Fairbanks Census Area",240,"Other Interior Region",7,5,751,7,759,0,33,0,8
"08/24/2021","Y","Y","Southeast Fairbanks Census Area",240,"Other Interior Region",7,4,755,9,768,0,33,0,8
"08/25/2021","Y","Y","Southeast Fairbanks Census Area",240,"Other Interior Region",7,2,757,7,775,3,36,0,8
"08/26/2021","Y","Y","Southeast Fairbanks Census Area",240,"Other Interior Region",7,1,758,5,780,0,36,0,8
"08/27/2021","Y","Y","Southeast Fairbanks Census Area",240,"Other Interior Region",7,3,761,2,782,1,37,0,8
"08/28/2021","Y","Y","Southeast Fairbanks Census Area",240,"Other Interior Region",7,8,769,3,785,0,37,0,8
"08/29/2021","Y","Y","Southeast Fairbanks Census Area",240,"Other Interior Region",7,2,771,0,785,0,37,0,8
"08/30/2021","Y","Y","Southeast Fairbanks Census Area",240,"Other Interior Region",7,6,777,4,789,0,37,0,8
"08/31/2021","Y","Y","Southeast Fairbanks Census Area",240,"Other Interior Region",7,9,786,4,793,0,37,0,8
"09/01/2021","Y","Y","Southeast Fairbanks Census Area",240,"Other Interior Region",7,3,789,3,796,0,37,0,8
"09/02/2021","Y","Y","Southeast Fairbanks Census Area",240,"Other Interior Region",7,1,790,8,804,0,37,0,8
"09/03/2021","Y","Y","Southeast Fairbanks Census Area",240,"Other Interior Region",7,6,796,6,810,1,38,0,8
"09/04/2021","Y","Y","Southeast Fairbanks Census Area",240,"Other Interior Region",7,3,799,2,812,0,38,0,8
"09/05/2021","Y","Y","Southeast Fairbanks Census Area",240,"Other Interior Region",7,0,799,0,812,1,39,0,8
"09/06/2021","Y","Y","Southeast Fairbanks Census Area",240,"Other Interior Region",7,0,799,4,816,0,39,0,8
"09/07/2021","Y","Y","Southeast Fairbanks Census Area",240,"Other Interior Region",7,3,802,16,832,1,40,0,8
"09/08/2021","Y","Y","Southeast Fairbanks Census Area",240,"Other Interior Region",7,11,813,17,849,0,40,0,8
"09/09/2021","Y","Y","Southeast Fairbanks Census Area",240,"Other Interior Region",7,11,824,12,861,0,40,0,8
"09/10/2021","Y","Y","Southeast Fairbanks Census Area",240,"Other Interior Region",7,7,831,9,870,0,40,0,8
"09/11/2021","Y","Y","Southeast Fairbanks Census Area",240,"Other Interior Region",7,2,833,4,874,0,40,0,8
"09/12/2021","Y","Y","Southeast Fairbanks Census Area",240,"Other Interior Region",7,3,836,1,875,1,41,1,9
"09/13/2021","Y","Y","Southeast Fairbanks Census Area",240,"Other Interior Region",7,3,839,16,891,0,41,0,9
"09/14/2021","Y","Y","Southeast Fairbanks Census Area",240,"Other Interior Region",7,11,850,8,899,0,41,0,9
"09/15/2021","Y","Y","Southeast Fairbanks Census Area",240,"Other Interior Region",7,7,857,9,908,0,41,0,9
"09/16/2021","Y","Y","Southeast Fairbanks Census Area",240,"Other Interior Region",7,10,867,3,911,0,41,0,9
"09/17/2021","Y","Y","Southeast Fairbanks Census Area",240,"Other Interior Region",7,2,869,8,919,0,41,0,9
"09/18/2021","Y","Y","Southeast Fairbanks Census Area",240,"Other Interior Region",7,18,887,2,921,0,41,0,9
"09/19/2021","Y","Y","Southeast Fairbanks Census Area",240,"Other Interior Region",7,1,888,1,922,0,41,0,9
"09/20/2021","Y","Y","Southeast Fairbanks Census Area",240,"Other Interior Region",7,7,895,15,937,0,41,0,9
"09/21/2021","Y","Y","Southeast Fairbanks Census Area",240,"Other Interior Region",7,13,908,9,946,0,41,0,9
"09/22/2021","Y","Y","Southeast Fairbanks Census Area",240,"Other Interior Region",7,11,919,8,954,1,42,0,9
"09/23/2021","Y","Y","Southeast Fairbanks Census Area",240,"Other Interior Region",7,3,922,4,958,0,42,1,10
"09/24/2021","Y","Y","Southeast Fairbanks Census Area",240,"Other Interior Region",7,5,927,13,971,0,42,0,10
"09/25/2021","Y","Y","Southeast Fairbanks Census Area",240,"Other Interior Region",7,3,930,3,974,0,42,0,10
"09/26/2021","Y","Y","Southeast Fairbanks Census Area",240,"Other Interior Region",7,8,938,0,974,0,42,0,10
"09/27/2021","Y","Y","Southeast Fairbanks Census Area",240,"Other Interior Region",7,7,945,7,981,0,42,0,10
"09/28/2021","Y","Y","Southeast Fairbanks Census Area",240,"Other Interior Region",7,8,953,3,984,0,42,0,10
"09/29/2021","Y","Y","Southeast Fairbanks Census Area",240,"Other Interior Region",7,6,959,6,990,0,42,0,10
"09/30/2021","Y","Y","Southeast Fairbanks Census Area",240,"Other Interior Region",7,8,967,6,996,0,42,0,10
"10/01/2021","Y","Y","Southeast Fairbanks Census Area",240,"Other Interior Region",7,4,971,5,1001,0,42,0,10
"10/02/2021","Y","Y","Southeast Fairbanks Census Area",240,"Other Interior Region",7,5,976,5,1006,0,42,0,10
"10/03/2021","Y","Y","Southeast Fairbanks Census Area",240,"Other Interior Region",7,7,983,0,1006,0,42,0,10
"10/04/2021","Y","Y","Southeast Fairbanks Census Area",240,"Other Interior Region",7,5,988,9,1015,0,42,0,10
"10/05/2021","Y","Y","Southeast Fairbanks Census Area",240,"Other Interior Region",7,3,991,3,1018,0,42,0,10
"10/06/2021","Y","Y","Southeast Fairbanks Census Area",240,"Other Interior Region",7,2,993,6,1024,0,42,0,10
"10/07/2021","Y","Y","Southeast Fairbanks Census Area",240,"Other Interior Region",7,17,1010,9,1033,0,42,0,10
"10/08/2021","Y","Y","Southeast Fairbanks Census Area",240,"Other Interior Region",7,0,1010,8,1041,0,42,0,10
"10/09/2021","Y","Y","Southeast Fairbanks Census Area",240,"Other Interior Region",7,6,1016,6,1047,1,43,0,10
"10/10/2021","Y","Y","Southeast Fairbanks Census Area",240,"Other Interior Region",7,2,1018,0,1047,0,43,1,11
"10/11/2021","Y","Y","Southeast Fairbanks Census Area",240,"Other Interior Region",7,3,1021,9,1056,0,43,0,11
"10/12/2021","Y","Y","Southeast Fairbanks Census Area",240,"Other Interior Region",7,5,1026,9,1065,0,43,0,11
"10/13/2021","Y","Y","Southeast Fairbanks Census Area",240,"Other Interior Region",7,10,1036,13,1078,0,43,0,11
"10/14/2021","Y","Y","Southeast Fairbanks Census Area",240,"Other Interior Region",7,8,1044,1,1079,1,44,0,11
"10/15/2021","Y","Y","Southeast Fairbanks Census Area",240,"Other Interior Region",7,6,1050,4,1083,0,44,0,11
"10/16/2021","Y","Y","Southeast Fairbanks Census Area",240,"Other Interior Region",7,5,1055,2,1085,0,44,0,11
"10/17/2021","Y","Y","Southeast Fairbanks Census Area",240,"Other Interior Region",7,6,1061,0,1085,0,44,0,11
"10/18/2021","Y","Y","Southeast Fairbanks Census Area",240,"Other Interior Region",7,2,1063,5,1090,0,44,1,12
"10/19/2021","Y","Y","Southeast Fairbanks Census Area",240,"Other Interior Region",7,9,1072,12,1102,1,45,0,12
"10/20/2021","Y","Y","Southeast Fairbanks Census Area",240,"Other Interior Region",7,7,1079,16,1118,1,46,0,12
"10/21/2021","Y","Y","Southeast Fairbanks Census Area",240,"Other Interior Region",7,11,1090,10,1128,0,46,0,12
"10/22/2021","Y","Y","Southeast Fairbanks Census Area",240,"Other Interior Region",7,6,1096,4,1132,0,46,0,12
"10/23/2021","Y","Y","Southeast Fairbanks Census Area",240,"Other Interior Region",7,4,1100,5,1137,0,46,0,12
"10/24/2021","Y","Y","Southeast Fairbanks Census Area",240,"Other Interior Region",7,0,1100,1,1138,1,47,0,12
"10/25/2021","Y","Y","Southeast Fairbanks Census Area",240,"Other Interior Region",7,7,1107,24,1162,0,47,0,12
"10/26/2021","Y","Y","Southeast Fairbanks Census Area",240,"Other Interior Region",7,24,1131,17,1179,0,47,0,12
"10/27/2021","Y","Y","Southeast Fairbanks Census Area",240,"Other Interior Region",7,23,1154,5,1184,1,48,0,12
"10/28/2021","Y","Y","Southeast Fairbanks Census Area",240,"Other Interior Region",7,14,1168,12,1196,1,49,0,12
"10/29/2021","Y","Y","Southeast Fairbanks Census Area",240,"Other Interior Region",7,8,1176,6,1202,0,49,0,12
"10/30/2021","Y","Y","Southeast Fairbanks Census Area",240,"Other Interior Region",7,9,1185,1,1203,0,49,0,12
"10/31/2021","Y","Y","Southeast Fairbanks Census Area",240,"Other Interior Region",7,2,1187,0,1203,0,49,0,12
"11/01/2021","Y","Y","Southeast Fairbanks Census Area",240,"Other Interior Region",7,0,1187,15,1218,0,49,0,12
"11/02/2021","Y","Y","Southeast Fairbanks Census Area",240,"Other Interior Region",7,13,1200,14,1232,3,52,0,12
"11/03/2021","Y","Y","Southeast Fairbanks Census Area",240,"Other Interior Region",7,8,1208,2,1234,2,54,0,12
"11/04/2021","Y","Y","Southeast Fairbanks Census Area",240,"Other Interior Region",7,8,1216,3,1237,0,54,0,12
"11/05/2021","Y","Y","Southeast Fairbanks Census Area",240,"Other Interior Region",7,6,1222,0,1237,1,55,0,12
"11/06/2021","Y","Y","Southeast Fairbanks Census Area",240,"Other Interior Region",7,4,1226,1,1238,0,55,1,13
"11/07/2021","Y","Y","Southeast Fairbanks Census Area",240,"Other Interior Region",7,2,1228,1,1239,0,55,0,13
"11/08/2021","Y","Y","Southeast Fairbanks Census Area",240,"Other Interior Region",7,1,1229,7,1246,1,56,0,13
"11/09/2021","Y","Y","Southeast Fairbanks Census Area",240,"Other Interior Region",7,6,1235,4,1250,0,56,0,13
"11/10/2021","Y","Y","Southeast Fairbanks Census Area",240,"Other Interior Region",7,11,1246,0,1250,0,56,1,14
"11/12/2021","Y","Y","Southeast Fairbanks Census Area",240,"Other Interior Region",7,0,1246,5,1255,0,56,0,14
"11/13/2021","Y","Y","Southeast Fairbanks Census Area",240,"Other Interior Region",7,7,1253,3,1258,1,57,0,14
"11/14/2021","Y","Y","Southeast Fairbanks Census Area",240,"Other Interior Region",7,5,1258,0,1258,0,57,0,14
"11/15/2021","Y","Y","Southeast Fairbanks Census Area",240,"Other Interior Region",7,0,1258,5,1263,0,57,0,14
"11/16/2021","Y","Y","Southeast Fairbanks Census Area",240,"Other Interior Region",7,3,1261,3,1266,0,57,0,14
"11/17/2021","Y","Y","Southeast Fairbanks Census Area",240,"Other Interior Region",7,1,1262,4,1270,0,57,0,14
"11/18/2021","Y","Y","Southeast Fairbanks Census Area",240,"Other Interior Region",7,0,1262,1,1271,0,57,0,14
"11/19/2021","Y","Y","Southeast Fairbanks Census Area",240,"Other Interior Region",7,0,1262,3,1274,1,58,0,14
"11/20/2021","Y","Y","Southeast Fairbanks Census Area",240,"Other Interior Region",7,3,1265,2,1276,1,59,0,14
"11/21/2021","Y","Y","Southeast Fairbanks Census Area",240,"Other Interior Region",7,2,1267,0,1276,0,59,1,15
"11/22/2021","Y","Y","Southeast Fairbanks Census Area",240,"Other Interior Region",7,1,1268,2,1278,2,61,0,15
"11/23/2021","Y","Y","Southeast Fairbanks Census Area",240,"Other Interior Region",7,8,1276,1,1279,0,61,1,16
"11/24/2021","Y","Y","Southeast Fairbanks Census Area",240,"Other Interior Region",7,1,1277,6,1285,0,61,0,16
"11/25/2021","Y","Y","Southeast Fairbanks Census Area",240,"Other Interior Region",7,3,1280,0,1285,1,62,0,16
"11/26/2021","Y","Y","Southeast Fairbanks Census Area",240,"Other Interior Region",7,2,1282,0,1285,0,62,0,16
"11/27/2021","Y","Y","Southeast Fairbanks Census Area",240,"Other Interior Region",7,3,1285,1,1286,1,63,0,16
"11/28/2021","Y","Y","Southeast Fairbanks Census Area",240,"Other Interior Region",7,1,1286,0,1286,0,63,0,16
"11/30/2021","Y","Y","Southeast Fairbanks Census Area",240,"Other Interior Region",7,0,1286,2,1288,1,64,0,16
"12/01/2021","Y","Y","Southeast Fairbanks Census Area",240,"Other Interior Region",7,2,1288,2,1290,0,64,0,16
"12/03/2021","Y","Y","Southeast Fairbanks Census Area",240,"Other Interior Region",7,2,1290,0,1290,0,64,0,16
"12/05/2021","Y","Y","Southeast Fairbanks Census Area",240,"Other Interior Region",7,0,1290,1,1291,0,64,0,16
"12/06/2021","Y","Y","Southeast Fairbanks Census Area",240,"Other Interior Region",7,2,1292,2,1293,0,64,0,16
"12/07/2021","Y","Y","Southeast Fairbanks Census Area",240,"Other Interior Region",7,0,1292,2,1295,0,64,0,16
"12/08/2021","Y","Y","Southeast Fairbanks Census Area",240,"Other Interior Region",7,3,1295,2,1297,0,64,0,16
"12/09/2021","Y","Y","Southeast Fairbanks Census Area",240,"Other Interior Region",7,2,1297,1,1298,0,64,0,16
"12/10/2021","Y","Y","Southeast Fairbanks Census Area",240,"Other Interior Region",7,1,1298,0,1298,0,64,0,16
"12/17/2021","Y","Y","Southeast Fairbanks Census Area",240,"Other Interior Region",7,0,1298,1,1299,1,65,0,16
"12/18/2021","Y","Y","Southeast Fairbanks Census Area",240,"Other Interior Region",7,0,1298,2,1301,0,65,0,16
"12/19/2021","Y","Y","Southeast Fairbanks Census Area",240,"Other Interior Region",7,2,1300,0,1301,0,65,0,16
"12/20/2021","Y","Y","Southeast Fairbanks Census Area",240,"Other Interior Region",7,1,1301,2,1303,0,65,0,16
"12/21/2021","Y","Y","Southeast Fairbanks Census Area",240,"Other Interior Region",7,0,1301,1,1304,0,65,0,16
"12/22/2021","Y","Y","Southeast Fairbanks Census Area",240,"Other Interior Region",7,0,1301,2,1306,0,65,0,16
"12/23/2021","Y","Y","Southeast Fairbanks Census Area",240,"Other Interior Region",7,5,1306,0,1306,0,65,0,16
"12/27/2021","Y","Y","Southeast Fairbanks Census Area",240,"Other Interior Region",7,0,1306,1,1307,0,65,0,16
"12/28/2021","Y","Y","Southeast Fairbanks Census Area",240,"Other Interior Region",7,0,1306,2,1309,0,65,0,16
"12/29/2021","Y","Y","Southeast Fairbanks Census Area",240,"Other Interior Region",7,4,1310,2,1311,0,65,0,16
"12/30/2021","Y","Y","Southeast Fairbanks Census Area",240,"Other Interior Region",7,8,1318,8,1319,0,65,0,16
"12/31/2021","Y","Y","Southeast Fairbanks Census Area",240,"Other Interior Region",7,2,1320,4,1323,0,65,0,16
"01/01/2022","Y","Y","Southeast Fairbanks Census Area",240,"Other Interior Region",7,2,1322,1,1324,0,65,0,16
"01/02/2022","Y","Y","Southeast Fairbanks Census Area",240,"Other Interior Region",7,2,1324,0,1324,0,65,0,16
"01/03/2022","Y","Y","Southeast Fairbanks Census Area",240,"Other Interior Region",7,0,1324,4,1328,0,65,0,16
"01/04/2022","Y","Y","Southeast Fairbanks Census Area",240,"Other Interior Region",7,7,1331,8,1336,0,65,0,16
"01/05/2022","Y","Y","Southeast Fairbanks Census Area",240,"Other Interior Region",7,5,1336,8,1344,0,65,0,16
"01/06/2022","Y","Y","Southeast Fairbanks Census Area",240,"Other Interior Region",7,3,1339,9,1353,0,65,0,16
"01/07/2022","Y","Y","Southeast Fairbanks Census Area",240,"Other Interior Region",7,1,1340,1,1354,0,65,0,16
"01/08/2022","Y","Y","Southeast Fairbanks Census Area",240,"Other Interior Region",7,3,1343,3,1357,0,65,0,16
"01/09/2022","Y","Y","Southeast Fairbanks Census Area",240,"Other Interior Region",7,2,1345,2,1359,0,65,0,16
"01/10/2022","Y","Y","Southeast Fairbanks Census Area",240,"Other Interior Region",7,10,1355,8,1367,1,66,0,16
"01/11/2022","Y","Y","Southeast Fairbanks Census Area",240,"Other Interior Region",7,13,1368,15,1382,0,66,0,16
"01/12/2022","Y","Y","Southeast Fairbanks Census Area",240,"Other Interior Region",7,7,1375,12,1394,0,66,0,16
"01/13/2022","Y","Y","Southeast Fairbanks Census Area",240,"Other Interior Region",7,7,1382,9,1403,0,66,0,16
"01/14/2022","Y","Y","Southeast Fairbanks Census Area",240,"Other Interior Region",7,9,1391,10,1413,0,66,0,16
"01/15/2022","Y","Y","Southeast Fairbanks Census Area",240,"Other Interior Region",7,0,1391,3,1416,0,66,0,16
"01/16/2022","Y","Y","Southeast Fairbanks Census Area",240,"Other Interior Region",7,4,1395,2,1418,0,66,0,16
"01/17/2022","Y","Y","Southeast Fairbanks Census Area",240,"Other Interior Region",7,14,1409,12,1430,0,66,0,16
"01/18/2022","Y","Y","Southeast Fairbanks Census Area",240,"Other Interior Region",7,4,1413,9,1439,0,66,0,16
"01/19/2022","Y","Y","Southeast Fairbanks Census Area",240,"Other Interior Region",7,9,1422,12,1451,1,67,0,16
"01/20/2022","Y","Y","Southeast Fairbanks Census Area",240,"Other Interior Region",7,23,1445,20,1471,0,67,0,16
"01/21/2022","Y","Y","Southeast Fairbanks Census Area",240,"Other Interior Region",7,26,1471,31,1502,0,67,0,16
"01/22/2022","Y","Y","Southeast Fairbanks Census Area",240,"Other Interior Region",7,14,1485,10,1512,0,67,0,16
"01/23/2022","Y","Y","Southeast Fairbanks Census Area",240,"Other Interior Region",7,7,1492,6,1518,0,67,0,16
"01/24/2022","Y","Y","Southeast Fairbanks Census Area",240,"Other Interior Region",7,12,1504,17,1535,0,67,0,16
"01/25/2022","Y","Y","Southeast Fairbanks Census Area",240,"Other Interior Region",7,34,1538,30,1565,0,67,0,16
"01/26/2022","Y","Y","Southeast Fairbanks Census Area",240,"Other Interior Region",7,14,1552,15,1580,1,68,0,16
"01/27/2022","Y","Y","Southeast Fairbanks Census Area",240,"Other Interior Region",7,37,1589,40,1620,0,68,0,16
"01/28/2022","Y","Y","Southeast Fairbanks Census Area",240,"Other Interior Region",7,13,1602,12,1632,0,68,0,16
"01/29/2022","Y","Y","Southeast Fairbanks Census Area",240,"Other Interior Region",7,3,1605,3,1635,0,68,0,16
"01/30/2022","Y","Y","Southeast Fairbanks Census Area",240,"Other Interior Region",7,4,1609,1,1636,0,68,0,16
"01/31/2022","Y","Y","Southeast Fairbanks Census Area",240,"Other Interior Region",7,13,1622,12,1648,0,68,0,16
"02/01/2022","Y","Y","Southeast Fairbanks Census Area",240,"Other Interior Region",7,27,1649,25,1673,0,68,0,16
"02/02/2022","Y","Y","Southeast Fairbanks Census Area",240,"Other Interior Region",7,45,1694,39,1712,0,68,0,16
"02/03/2022","Y","Y","Southeast Fairbanks Census Area",240,"Other Interior Region",7,15,1709,13,1725,0,68,0,16
"02/04/2022","Y","Y","Southeast Fairbanks Census Area",240,"Other Interior Region",7,14,1723,11,1736,0,68,0,16
"02/05/2022","Y","Y","Southeast Fairbanks Census Area",240,"Other Interior Region",7,4,1727,1,1737,0,68,0,16
"02/06/2022","Y","Y","Southeast Fairbanks Census Area",240,"Other Interior Region",7,6,1733,1,1738,0,68,0,16
"02/07/2022","Y","Y","Southeast Fairbanks Census Area",240,"Other Interior Region",7,9,1742,15,1753,1,69,0,16
"02/08/2022","Y","Y","Southeast Fairbanks Census Area",240,"Other Interior Region",7,23,1765,17,1770,0,69,0,16
"02/09/2022","Y","Y","Southeast Fairbanks Census Area",240,"Other Interior Region",7,3,1768,3,1773,0,69,1,17
"02/10/2022","Y","Y","Southeast Fairbanks Census Area",240,"Other Interior Region",7,6,1774,7,1780,0,69,0,17
"02/11/2022","Y","Y","Southeast Fairbanks Census Area",240,"Other Interior Region",7,7,1781,4,1784,0,69,0,17
"02/12/2022","Y","Y","Southeast Fairbanks Census Area",240,"Other Interior Region",7,3,1784,3,1787,1,70,0,17
"02/13/2022","Y","Y","Southeast Fairbanks Census Area",240,"Other Interior Region",7,2,1786,0,1787,0,70,0,17
"02/14/2022","Y","Y","Southeast Fairbanks Census Area",240,"Other Interior Region",7,12,1798,16,1803,0,70,0,17
"02/15/2022","Y","Y","Southeast Fairbanks Census Area",240,"Other Interior Region",7,7,1805,10,1813,1,71,0,17
"02/16/2022","Y","Y","Southeast Fairbanks Census Area",240,"Other Interior Region",7,3,1808,3,1816,0,71,0,17
"02/17/2022","Y","Y","Southeast Fairbanks Census Area",240,"Other Interior Region",7,11,1819,7,1823,0,71,0,17
"02/18/2022","Y","Y","Southeast Fairbanks Census Area",240,"Other Interior Region",7,8,1827,7,1830,0,71,1,18
"02/19/2022","Y","Y","Southeast Fairbanks Census Area",240,"Other Interior Region",7,1,1828,1,1831,0,71,0,18
"02/21/2022","Y","Y","Southeast Fairbanks Census Area",240,"Other Interior Region",7,2,1830,2,1833,0,71,0,18
"02/22/2022","Y","Y","Southeast Fairbanks Census Area",240,"Other Interior Region",7,0,1830,1,1834,0,71,0,18
"02/23/2022","Y","Y","Southeast Fairbanks Census Area",240,"Other Interior Region",7,6,1836,6,1840,0,71,0,18
"02/24/2022","Y","Y","Southeast Fairbanks Census Area",240,"Other Interior Region",7,5,1841,4,1844,0,71,0,18
"02/25/2022","Y","Y","Southeast Fairbanks Census Area",240,"Other Interior Region",7,2,1843,0,1844,0,71,0,18
"02/26/2022","Y","Y","Southeast Fairbanks Census Area",240,"Other Interior Region",7,2,1845,2,1846,0,71,0,18
"02/28/2022","Y","Y","Southeast Fairbanks Census Area",240,"Other Interior Region",7,1,1846,2,1848,0,71,1,19
"03/01/2022","Y","Y","Southeast Fairbanks Census Area",240,"Other Interior Region",7,1,1847,0,1848,0,71,1,20
"03/03/2022","Y","Y","Southeast Fairbanks Census Area",240,"Other Interior Region",7,1,1848,0,1848,0,71,0,20
"03/04/2022","Y","Y","Southeast Fairbanks Census Area",240,"Other Interior Region",7,1,1849,1,1849,0,71,0,20
"03/08/2022","Y","Y","Southeast Fairbanks Census Area",240,"Other Interior Region",7,1,1850,1,1850,0,71,0,20
"03/09/2022","Y","Y","Southeast Fairbanks Census Area",240,"Other Interior Region",7,0,1850,1,1851,0,71,0,20
"03/11/2022","Y","Y","Southeast Fairbanks Census Area",240,"Other Interior Region",7,1,1851,0,1851,0,71,0,20
"03/14/2022","Y","Y","Southeast Fairbanks Census Area",240,"Other Interior Region",7,1,1852,1,1852,0,71,0,20
"03/15/2022","Y","Y","Southeast Fairbanks Census Area",240,"Other Interior Region",7,1,1853,1,1853,0,71,0,20
"03/23/2022","Y","Y","Southeast Fairbanks Census Area",240,"Other Interior Region",7,2,1855,3,1856,0,71,0,20
"03/24/2022","Y","Y","Southeast Fairbanks Census Area",240,"Other Interior Region",7,1,1856,1,1857,0,71,0,20
"03/25/2022","Y","Y","Southeast Fairbanks Census Area",240,"Other Interior Region",7,1,1857,0,1857,0,71,0,20
"03/28/2022","Y","Y","Southeast Fairbanks Census Area",240,"Other Interior Region",7,0,1857,4,1861,0,71,0,20
"03/29/2022","Y","Y","Southeast Fairbanks Census Area",240,"Other Interior Region",7,0,1857,1,1862,0,71,0,20
"03/30/2022","Y","Y","Southeast Fairbanks Census Area",240,"Other Interior Region",7,2,1859,3,1865,0,71,0,20
"03/31/2022","Y","Y","Southeast Fairbanks Census Area",240,"Other Interior Region",7,4,1863,5,1870,0,71,0,20
"04/01/2022","Y","Y","Southeast Fairbanks Census Area",240,"Other Interior Region",7,7,1870,0,1870,0,71,0,20
"04/02/2022","Y","Y","Southeast Fairbanks Census Area",240,"Other Interior Region",7,2,1872,2,1872,0,71,0,20
"04/04/2022","Y","Y","Southeast Fairbanks Census Area",240,"Other Interior Region",7,1,1873,2,1874,0,71,0,20
"04/05/2022","Y","Y","Southeast Fairbanks Census Area",240,"Other Interior Region",7,3,1876,3,1877,0,71,0,20
"04/06/2022","Y","Y","Southeast Fairbanks Census Area",240,"Other Interior Region",7,1,1877,0,1877,0,71,0,20
"04/07/2022","Y","Y","Southeast Fairbanks Census Area",240,"Other Interior Region",7,2,1879,2,1879,0,71,0,20
"04/08/2022","Y","Y","Southeast Fairbanks Census Area",240,"Other Interior Region",7,3,1882,3,1882,0,71,0,20
"04/11/2022","Y","Y","Southeast Fairbanks Census Area",240,"Other Interior Region",7,2,1884,4,1886,0,71,0,20
"04/12/2022","Y","Y","Southeast Fairbanks Census Area",240,"Other Interior Region",7,3,1887,3,1889,0,71,0,20
"04/13/2022","Y","Y","Southeast Fairbanks Census Area",240,"Other Interior Region",7,1,1888,0,1889,0,71,0,20
"04/14/2022","Y","Y","Southeast Fairbanks Census Area",240,"Other Interior Region",7,1,1889,0,1889,0,71,0,20
"04/15/2022","Y","Y","Southeast Fairbanks Census Area",240,"Other Interior Region",7,1,1890,1,1890,0,71,0,20
"04/19/2022","Y","Y","Southeast Fairbanks Census Area",240,"Other Interior Region",7,0,1890,2,1892,0,71,0,20
"04/20/2022","Y","Y","Southeast Fairbanks Census Area",240,"Other Interior Region",7,2,1892,0,1892,0,71,0,20
"04/23/2022","Y","Y","Southeast Fairbanks Census Area",240,"Other Interior Region",7,1,1893,2,1894,0,71,0,20
"04/24/2022","Y","Y","Southeast Fairbanks Census Area",240,"Other Interior Region",7,1,1894,0,1894,0,71,0,20
"04/25/2022","Y","Y","Southeast Fairbanks Census Area",240,"Other Interior Region",7,1,1895,1,1895,0,71,0,20
"09/23/2020","Y","Y","Unknown",999,"Unknown",99,0,0,1,1,0,0,0,0
"10/01/2020","Y","Y","Unknown",999,"Unknown",99,1,1,0,1,0,0,0,0
"11/12/2020","Y","Y","Unknown",999,"Unknown",99,0,1,1,2,0,0,0,0
"11/28/2020","Y","Y","Unknown",999,"Unknown",99,1,2,0,2,0,0,0,0
"12/12/2020","Y","Y","Unknown",999,"Unknown",99,0,2,1,3,0,0,0,0
"12/17/2020","Y","Y","Unknown",999,"Unknown",99,1,3,0,3,0,0,0,0
"01/21/2021","Y","Y","Unknown",999,"Unknown",99,1,4,1,4,0,0,0,0
"03/20/2021","Y","Y","Unknown",999,"Unknown",99,0,4,1,5,0,0,0,0
"03/24/2021","Y","Y","Unknown",999,"Unknown",99,1,5,0,5,0,0,0,0
"08/07/2021","Y","Y","Unknown",999,"Unknown",99,0,5,1,6,0,0,0,0
"08/10/2021","Y","Y","Unknown",999,"Unknown",99,1,6,0,6,0,0,0,0
"04/25/2022","Y","Y","Unknown",999,"Unknown",99,2,8,2,8,0,0,0,0
"04/26/2022","Y","Y","Unknown",999,"Unknown",99,1,9,1,9,0,0,0,0
"06/04/2020","Y","Y","Wrangell City and Borough",275,"Other Southeast Region - Northern",8,0,0,1,1,0,0,0,0
"06/07/2020","Y","Y","Wrangell City and Borough",275,"Other Southeast Region - Northern",8,1,1,0,1,0,0,0,0
"06/12/2020","Y","Y","Wrangell City and Borough",275,"Other Southeast Region - Northern",8,1,2,1,2,0,0,0,0
"06/14/2020","Y","Y","Wrangell City and Borough",275,"Other Southeast Region - Northern",8,0,2,1,3,0,0,0,0
"06/16/2020","Y","Y","Wrangell City and Borough",275,"Other Southeast Region - Northern",8,1,3,0,3,0,0,0,0
"07/16/2020","Y","Y","Wrangell City and Borough",275,"Other Southeast Region - Northern",8,0,3,1,4,0,0,0,0
"07/23/2020","Y","Y","Wrangell City and Borough",275,"Other Southeast Region - Northern",8,0,3,1,5,0,0,0,0
"07/24/2020","Y","Y","Wrangell City and Borough",275,"Other Southeast Region - Northern",8,0,3,0,5,1,1,0,0
"07/25/2020","Y","Y","Wrangell City and Borough",275,"Other Southeast Region - Northern",8,2,5,0,5,0,1,0,0
"07/26/2020","Y","Y","Wrangell City and Borough",275,"Other Southeast Region - Northern",8,0,5,2,7,0,1,0,0
"07/27/2020","Y","Y","Wrangell City and Borough",275,"Other Southeast Region - Northern",8,0,5,1,8,0,1,0,0
"07/28/2020","Y","Y","Wrangell City and Borough",275,"Other Southeast Region - Northern",8,0,5,1,9,0,1,0,0
"08/01/2020","Y","Y","Wrangell City and Borough",275,"Other Southeast Region - Northern",8,2,7,0,9,1,2,0,0
"08/02/2020","Y","Y","Wrangell City and Borough",275,"Other Southeast Region - Northern",8,1,8,0,9,0,2,0,0
"08/18/2020","Y","Y","Wrangell City and Borough",275,"Other Southeast Region - Northern",8,0,8,1,10,0,2,0,0
"08/21/2020","Y","Y","Wrangell City and Borough",275,"Other Southeast Region - Northern",8,1,9,0,10,0,2,0,0
"08/25/2020","Y","Y","Wrangell City and Borough",275,"Other Southeast Region - Northern",8,0,9,1,11,0,2,0,0
"08/26/2020","Y","Y","Wrangell City and Borough",275,"Other Southeast Region - Northern",8,1,10,0,11,0,2,0,0
"08/28/2020","Y","Y","Wrangell City and Borough",275,"Other Southeast Region - Northern",8,1,11,0,11,0,2,0,0
"08/31/2020","Y","Y","Wrangell City and Borough",275,"Other Southeast Region - Northern",8,0,11,1,12,0,2,0,0
"09/02/2020","Y","Y","Wrangell City and Borough",275,"Other Southeast Region - Northern",8,2,13,1,13,0,2,0,0
"09/07/2020","Y","Y","Wrangell City and Borough",275,"Other Southeast Region - Northern",8,1,14,1,14,0,2,0,0
"09/14/2020","Y","Y","Wrangell City and Borough",275,"Other Southeast Region - Northern",8,0,14,1,15,0,2,0,0
"09/16/2020","Y","Y","Wrangell City and Borough",275,"Other Southeast Region - Northern",8,1,15,0,15,0,2,0,0
"11/17/2020","Y","Y","Wrangell City and Borough",275,"Other Southeast Region - Northern",8,0,15,1,16,0,2,0,0
"11/20/2020","Y","Y","Wrangell City and Borough",275,"Other Southeast Region - Northern",8,1,16,0,16,1,3,0,0
"11/27/2020","Y","Y","Wrangell City and Borough",275,"Other Southeast Region - Northern",8,0,16,1,17,0,3,0,0
"11/28/2020","Y","Y","Wrangell City and Borough",275,"Other Southeast Region - Northern",8,0,16,1,18,0,3,0,0
"12/01/2020","Y","Y","Wrangell City and Borough",275,"Other Southeast Region - Northern",8,1,17,0,18,0,3,0,0
"12/06/2020","Y","Y","Wrangell City and Borough",275,"Other Southeast Region - Northern",8,1,18,0,18,0,3,0,0
"12/12/2020","Y","Y","Wrangell City and Borough",275,"Other Southeast Region - Northern",8,0,18,1,19,0,3,0,0
"12/17/2020","Y","Y","Wrangell City and Borough",275,"Other Southeast Region - Northern",8,1,19,0,19,0,3,0,0
"01/26/2021","Y","Y","Wrangell City and Borough",275,"Other Southeast Region - Northern",8,0,19,1,20,0,3,0,0
"01/30/2021","Y","Y","Wrangell City and Borough",275,"Other Southeast Region - Northern",8,1,20,0,20,0,3,0,0
"02/17/2021","Y","Y","Wrangell City and Borough",275,"Other Southeast Region - Northern",8,0,20,1,21,0,3,0,0
"02/18/2021","Y","Y","Wrangell City and Borough",275,"Other Southeast Region - Northern",8,1,21,0,21,0,3,0,0
"02/23/2021","Y","Y","Wrangell City and Borough",275,"Other Southeast Region - Northern",8,0,21,1,22,0,3,0,0
"02/24/2021","Y","Y","Wrangell City and Borough",275,"Other Southeast Region - Northern",8,1,22,1,23,0,3,0,0
"02/27/2021","Y","Y","Wrangell City and Borough",275,"Other Southeast Region - Northern",8,1,23,0,23,0,3,0,0
"03/09/2021","Y","Y","Wrangell City and Borough",275,"Other Southeast Region - Northern",8,0,23,1,24,0,3,0,0
"03/10/2021","Y","Y","Wrangell City and Borough",275,"Other Southeast Region - Northern",8,1,24,0,24,0,3,0,0
"03/19/2021","Y","Y","Wrangell City and Borough",275,"Other Southeast Region - Northern",8,0,24,1,25,0,3,0,0
"03/23/2021","Y","Y","Wrangell City and Borough",275,"Other Southeast Region - Northern",8,1,25,0,25,0,3,0,0
"03/30/2021","Y","Y","Wrangell City and Borough",275,"Other Southeast Region - Northern",8,0,25,1,26,0,3,0,0
"03/31/2021","Y","Y","Wrangell City and Borough",275,"Other Southeast Region - Northern",8,0,25,1,27,0,3,0,0
"04/01/2021","Y","Y","Wrangell City and Borough",275,"Other Southeast Region - Northern",8,0,25,1,28,0,3,0,0
"04/02/2021","Y","Y","Wrangell City and Borough",275,"Other Southeast Region - Northern",8,1,26,1,29,0,3,0,0
"04/03/2021","Y","Y","Wrangell City and Borough",275,"Other Southeast Region - Northern",8,1,27,0,29,0,3,0,0
"04/06/2021","Y","Y","Wrangell City and Borough",275,"Other Southeast Region - Northern",8,0,27,1,30,0,3,0,0
"04/07/2021","Y","Y","Wrangell City and Borough",275,"Other Southeast Region - Northern",8,0,27,3,33,0,3,0,0
"04/08/2021","Y","Y","Wrangell City and Borough",275,"Other Southeast Region - Northern",8,1,28,2,35,0,3,0,0
"04/09/2021","Y","Y","Wrangell City and Borough",275,"Other Southeast Region - Northern",8,2,30,0,35,0,3,0,0
"04/10/2021","Y","Y","Wrangell City and Borough",275,"Other Southeast Region - Northern",8,1,31,1,36,0,3,0,0
"04/11/2021","Y","Y","Wrangell City and Borough",275,"Other Southeast Region - Northern",8,0,31,2,38,0,3,0,0
"04/12/2021","Y","Y","Wrangell City and Borough",275,"Other Southeast Region - Northern",8,2,33,2,40,0,3,0,0
"04/13/2021","Y","Y","Wrangell City and Borough",275,"Other Southeast Region - Northern",8,2,35,1,41,0,3,0,0
"04/14/2021","Y","Y","Wrangell City and Borough",275,"Other Southeast Region - Northern",8,1,36,0,41,0,3,0,0
"04/15/2021","Y","Y","Wrangell City and Borough",275,"Other Southeast Region - Northern",8,3,39,2,43,1,4,0,0
"04/16/2021","Y","Y","Wrangell City and Borough",275,"Other Southeast Region - Northern",8,3,42,0,43,1,5,0,0
"04/17/2021","Y","Y","Wrangell City and Borough",275,"Other Southeast Region - Northern",8,1,43,0,43,0,5,0,0
"04/18/2021","Y","Y","Wrangell City and Borough",275,"Other Southeast Region - Northern",8,0,43,1,44,0,5,0,0
"04/20/2021","Y","Y","Wrangell City and Borough",275,"Other Southeast Region - Northern",8,1,44,0,44,0,5,0,0
"04/26/2021","Y","Y","Wrangell City and Borough",275,"Other Southeast Region - Northern",8,0,44,1,45,0,5,0,0
"04/29/2021","Y","Y","Wrangell City and Borough",275,"Other Southeast Region - Northern",8,0,44,1,46,0,5,0,0
"04/30/2021","Y","Y","Wrangell City and Borough",275,"Other Southeast Region - Northern",8,1,45,0,46,0,5,0,0
"05/03/2021","Y","Y","Wrangell City and Borough",275,"Other Southeast Region - Northern",8,1,46,1,47,0,5,0,0
"05/07/2021","Y","Y","Wrangell City and Borough",275,"Other Southeast Region - Northern",8,1,47,0,47,0,5,0,0
"06/02/2021","Y","Y","Wrangell City and Borough",275,"Other Southeast Region - Northern",8,1,48,1,48,0,5,0,0
"06/03/2021","Y","Y","Wrangell City and Borough",275,"Other Southeast Region - Northern",8,1,49,1,49,0,5,0,0
"06/07/2021","Y","Y","Wrangell City and Borough",275,"Other Southeast Region - Northern",8,0,49,1,50,0,5,0,0
"06/08/2021","Y","Y","Wrangell City and Borough",275,"Other Southeast Region - Northern",8,0,49,1,51,0,5,0,0
"06/10/2021","Y","Y","Wrangell City and Borough",275,"Other Southeast Region - Northern",8,2,51,0,51,0,5,0,0
"06/13/2021","Y","Y","Wrangell City and Borough",275,"Other Southeast Region - Northern",8,0,51,1,52,0,5,0,0
"06/15/2021","Y","Y","Wrangell City and Borough",275,"Other Southeast Region - Northern",8,1,52,0,52,0,5,0,0
"06/16/2021","Y","Y","Wrangell City and Borough",275,"Other Southeast Region - Northern",8,0,52,1,53,0,5,0,0
"06/17/2021","Y","Y","Wrangell City and Borough",275,"Other Southeast Region - Northern",8,0,52,1,54,0,5,0,0
"06/18/2021","Y","Y","Wrangell City and Borough",275,"Other Southeast Region - Northern",8,1,53,0,54,0,5,0,0
"06/19/2021","Y","Y","Wrangell City and Borough",275,"Other Southeast Region - Northern",8,1,54,0,54,0,5,0,0
"07/02/2021","Y","Y","Wrangell City and Borough",275,"Other Southeast Region - Northern",8,0,54,1,55,0,5,0,0
"07/03/2021","Y","Y","Wrangell City and Borough",275,"Other Southeast Region - Northern",8,1,55,0,55,0,5,0,0
"07/12/2021","Y","Y","Wrangell City and Borough",275,"Other Southeast Region - Northern",8,0,55,1,56,0,5,0,0
"07/13/2021","Y","Y","Wrangell City and Borough",275,"Other Southeast Region - Northern",8,1,56,0,56,0,5,0,0
"07/16/2021","Y","Y","Wrangell City and Borough",275,"Other Southeast Region - Northern",8,1,57,1,57,0,5,0,0
"07/21/2021","Y","Y","Wrangell City and Borough",275,"Other Southeast Region - Northern",8,0,57,1,58,0,5,0,0
"07/22/2021","Y","Y","Wrangell City and Borough",275,"Other Southeast Region - Northern",8,1,58,0,58,0,5,0,0
"07/23/2021","Y","Y","Wrangell City and Borough",275,"Other Southeast Region - Northern",8,0,58,1,59,0,5,0,0
"07/24/2021","Y","Y","Wrangell City and Borough",275,"Other Southeast Region - Northern",8,1,59,0,59,0,5,0,0
"07/26/2021","Y","Y","Wrangell City and Borough",275,"Other Southeast Region - Northern",8,0,59,1,60,0,5,0,0
"07/27/2021","Y","Y","Wrangell City and Borough",275,"Other Southeast Region - Northern",8,2,61,1,61,0,5,0,0
"07/30/2021","Y","Y","Wrangell City and Borough",275,"Other Southeast Region - Northern",8,0,61,1,62,0,5,0,0
"07/31/2021","Y","Y","Wrangell City and Borough",275,"Other Southeast Region - Northern",8,1,62,0,62,0,5,0,0
"08/06/2021","Y","Y","Wrangell City and Borough",275,"Other Southeast Region - Northern",8,0,62,4,66,0,5,0,0
"08/07/2021","Y","Y","Wrangell City and Borough",275,"Other Southeast Region - Northern",8,3,65,0,66,0,5,0,0
"08/08/2021","Y","Y","Wrangell City and Borough",275,"Other Southeast Region - Northern",8,1,66,0,66,0,5,0,0
"08/09/2021","Y","Y","Wrangell City and Borough",275,"Other Southeast Region - Northern",8,0,66,1,67,0,5,0,0
"08/10/2021","Y","Y","Wrangell City and Borough",275,"Other Southeast Region - Northern",8,1,67,0,67,0,5,0,0
"08/12/2021","Y","Y","Wrangell City and Borough",275,"Other Southeast Region - Northern",8,0,67,4,71,0,5,0,0
"08/13/2021","Y","Y","Wrangell City and Borough",275,"Other Southeast Region - Northern",8,2,69,0,71,0,5,0,0
"08/15/2021","Y","Y","Wrangell City and Borough",275,"Other Southeast Region - Northern",8,1,70,0,71,0,5,0,0
"08/16/2021","Y","Y","Wrangell City and Borough",275,"Other Southeast Region - Northern",8,1,71,3,74,0,5,0,0
"08/17/2021","Y","Y","Wrangell City and Borough",275,"Other Southeast Region - Northern",8,3,74,5,79,0,5,0,0
"08/18/2021","Y","Y","Wrangell City and Borough",275,"Other Southeast Region - Northern",8,4,78,1,80,0,5,0,0
"08/19/2021","Y","Y","Wrangell City and Borough",275,"Other Southeast Region - Northern",8,0,78,4,84,0,5,0,0
"08/20/2021","Y","Y","Wrangell City and Borough",275,"Other Southeast Region - Northern",8,1,79,4,88,0,5,0,0
"08/21/2021","Y","Y","Wrangell City and Borough",275,"Other Southeast Region - Northern",8,1,80,0,88,0,5,0,0
"08/22/2021","Y","Y","Wrangell City and Borough",275,"Other Southeast Region - Northern",8,4,84,0,88,0,5,0,0
"08/23/2021","Y","Y","Wrangell City and Borough",275,"Other Southeast Region - Northern",8,3,87,4,92,0,5,0,0
"08/24/2021","Y","Y","Wrangell City and Borough",275,"Other Southeast Region - Northern",8,1,88,6,98,0,5,0,0
"08/25/2021","Y","Y","Wrangell City and Borough",275,"Other Southeast Region - Northern",8,0,88,5,103,0,5,0,0
"08/26/2021","Y","Y","Wrangell City and Borough",275,"Other Southeast Region - Northern",8,14,102,4,107,0,5,0,0
"08/29/2021","Y","Y","Wrangell City and Borough",275,"Other Southeast Region - Northern",8,4,106,0,107,0,5,0,0
"08/30/2021","Y","Y","Wrangell City and Borough",275,"Other Southeast Region - Northern",8,0,106,4,111,0,5,0,0
"08/31/2021","Y","Y","Wrangell City and Borough",275,"Other Southeast Region - Northern",8,1,107,1,112,0,5,0,0
"09/01/2021","Y","Y","Wrangell City and Borough",275,"Other Southeast Region - Northern",8,0,107,2,114,0,5,0,0
"09/03/2021","Y","Y","Wrangell City and Borough",275,"Other Southeast Region - Northern",8,0,107,1,115,0,5,0,0
"09/04/2021","Y","Y","Wrangell City and Borough",275,"Other Southeast Region - Northern",8,4,111,0,115,0,5,0,0
"09/06/2021","Y","Y","Wrangell City and Borough",275,"Other Southeast Region - Northern",8,1,112,0,115,0,5,0,0
"09/07/2021","Y","Y","Wrangell City and Borough",275,"Other Southeast Region - Northern",8,2,114,0,115,0,5,0,0
"09/08/2021","Y","Y","Wrangell City and Borough",275,"Other Southeast Region - Northern",8,0,114,1,116,0,5,0,0
"09/10/2021","Y","Y","Wrangell City and Borough",275,"Other Southeast Region - Northern",8,1,115,0,116,0,5,0,0
"09/16/2021","Y","Y","Wrangell City and Borough",275,"Other Southeast Region - Northern",8,1,116,0,116,0,5,0,0
"09/20/2021","Y","Y","Wrangell City and Borough",275,"Other Southeast Region - Northern",8,0,116,1,117,0,5,0,0
"09/22/2021","Y","Y","Wrangell City and Borough",275,"Other Southeast Region - Northern",8,1,117,1,118,0,5,0,0
"09/23/2021","Y","Y","Wrangell City and Borough",275,"Other Southeast Region - Northern",8,0,117,1,119,0,5,0,0
"09/24/2021","Y","Y","Wrangell City and Borough",275,"Other Southeast Region - Northern",8,0,117,4,123,0,5,0,0
"09/25/2021","Y","Y","Wrangell City and Borough",275,"Other Southeast Region - Northern",8,0,117,1,124,0,5,0,0
"09/28/2021","Y","Y","Wrangell City and Borough",275,"Other Southeast Region - Northern",8,3,120,0,124,0,5,0,0
"09/30/2021","Y","Y","Wrangell City and Borough",275,"Other Southeast Region - Northern",8,4,124,0,124,0,5,0,0
"10/01/2021","Y","Y","Wrangell City and Borough",275,"Other Southeast Region - Northern",8,0,124,1,125,0,5,0,0
"10/04/2021","Y","Y","Wrangell City and Borough",275,"Other Southeast Region - Northern",8,0,124,1,126,0,5,0,0
"10/05/2021","Y","Y","Wrangell City and Borough",275,"Other Southeast Region - Northern",8,1,125,0,126,0,5,0,0
"10/08/2021","Y","Y","Wrangell City and Borough",275,"Other Southeast Region - Northern",8,1,126,0,126,0,5,0,0
"10/13/2021","Y","Y","Wrangell City and Borough",275,"Other Southeast Region - Northern",8,0,126,1,127,0,5,0,0
"10/16/2021","Y","Y","Wrangell City and Borough",275,"Other Southeast Region - Northern",8,1,127,0,127,0,5,0,0
"10/18/2021","Y","Y","Wrangell City and Borough",275,"Other Southeast Region - Northern",8,0,127,1,128,0,5,0,0
"10/22/2021","Y","Y","Wrangell City and Borough",275,"Other Southeast Region - Northern",8,0,127,1,129,0,5,0,0
"10/23/2021","Y","Y","Wrangell City and Borough",275,"Other Southeast Region - Northern",8,1,128,5,134,0,5,0,0
"10/24/2021","Y","Y","Wrangell City and Borough",275,"Other Southeast Region - Northern",8,3,131,1,135,0,5,0,0
"10/25/2021","Y","Y","Wrangell City and Borough",275,"Other Southeast Region - Northern",8,3,134,1,136,0,5,0,0
"10/26/2021","Y","Y","Wrangell City and Borough",275,"Other Southeast Region - Northern",8,2,136,1,137,0,5,0,0
"10/28/2021","Y","Y","Wrangell City and Borough",275,"Other Southeast Region - Northern",8,1,137,1,138,0,5,0,0
"10/29/2021","Y","Y","Wrangell City and Borough",275,"Other Southeast Region - Northern",8,1,138,1,139,0,5,0,0
"10/30/2021","Y","Y","Wrangell City and Borough",275,"Other Southeast Region - Northern",8,1,139,0,139,0,5,0,0
"11/02/2021","Y","Y","Wrangell City and Borough",275,"Other Southeast Region - Northern",8,0,139,4,143,0,5,0,0
"11/03/2021","Y","Y","Wrangell City and Borough",275,"Other Southeast Region - Northern",8,3,142,2,145,0,5,0,0
"11/04/2021","Y","Y","Wrangell City and Borough",275,"Other Southeast Region - Northern",8,2,144,0,145,0,5,0,0
"11/05/2021","Y","Y","Wrangell City and Borough",275,"Other Southeast Region - Northern",8,0,144,1,146,0,5,0,0
"11/06/2021","Y","Y","Wrangell City and Borough",275,"Other Southeast Region - Northern",8,2,146,0,146,0,5,0,0
"11/07/2021","Y","Y","Wrangell City and Borough",275,"Other Southeast Region - Northern",8,0,146,1,147,0,5,0,0
"11/08/2021","Y","Y","Wrangell City and Borough",275,"Other Southeast Region - Northern",8,2,148,5,152,0,5,0,0
"11/09/2021","Y","Y","Wrangell City and Borough",275,"Other Southeast Region - Northern",8,5,153,3,155,1,6,0,0
"11/10/2021","Y","Y","Wrangell City and Borough",275,"Other Southeast Region - Northern",8,3,156,4,159,0,6,0,0
"11/11/2021","Y","Y","Wrangell City and Borough",275,"Other Southeast Region - Northern",8,3,159,3,162,0,6,0,0
"11/12/2021","Y","Y","Wrangell City and Borough",275,"Other Southeast Region - Northern",8,2,161,11,173,0,6,0,0
"11/13/2021","Y","Y","Wrangell City and Borough",275,"Other Southeast Region - Northern",8,11,172,1,174,0,6,0,0
"11/14/2021","Y","Y","Wrangell City and Borough",275,"Other Southeast Region - Northern",8,1,173,1,175,0,6,0,0
"11/15/2021","Y","Y","Wrangell City and Borough",275,"Other Southeast Region - Northern",8,7,180,6,181,0,6,0,0
"11/16/2021","Y","Y","Wrangell City and Borough",275,"Other Southeast Region - Northern",8,7,187,6,187,0,6,0,0
"11/17/2021","Y","Y","Wrangell City and Borough",275,"Other Southeast Region - Northern",8,0,187,1,188,0,6,0,0
"11/18/2021","Y","Y","Wrangell City and Borough",275,"Other Southeast Region - Northern",8,2,189,2,190,0,6,0,0
"11/19/2021","Y","Y","Wrangell City and Borough",275,"Other Southeast Region - Northern",8,0,189,3,193,0,6,0,0
"11/20/2021","Y","Y","Wrangell City and Borough",275,"Other Southeast Region - Northern",8,3,192,0,193,0,6,0,0
"11/21/2021","Y","Y","Wrangell City and Borough",275,"Other Southeast Region - Northern",8,1,193,0,193,0,6,0,0
"11/22/2021","Y","Y","Wrangell City and Borough",275,"Other Southeast Region - Northern",8,0,193,4,197,0,6,0,0
"11/23/2021","Y","Y","Wrangell City and Borough",275,"Other Southeast Region - Northern",8,3,196,2,199,0,6,0,0
"11/24/2021","Y","Y","Wrangell City and Borough",275,"Other Southeast Region - Northern",8,4,200,2,201,0,6,1,1
"11/25/2021","Y","Y","Wrangell City and Borough",275,"Other Southeast Region - Northern",8,0,200,1,202,0,6,0,1
"11/26/2021","Y","Y","Wrangell City and Borough",275,"Other Southeast Region - Northern",8,2,202,1,203,0,6,0,1
"11/27/2021","Y","Y","Wrangell City and Borough",275,"Other Southeast Region - Northern",8,1,203,1,204,0,6,0,1
"11/29/2021","Y","Y","Wrangell City and Borough",275,"Other Southeast Region - Northern",8,1,204,3,207,0,6,0,1
"11/30/2021","Y","Y","Wrangell City and Borough",275,"Other Southeast Region - Northern",8,3,207,0,207,0,6,0,1
"12/09/2021","Y","Y","Wrangell City and Borough",275,"Other Southeast Region - Northern",8,0,207,1,208,0,6,0,1
"12/10/2021","Y","Y","Wrangell City and Borough",275,"Other Southeast Region - Northern",8,1,208,0,208,0,6,0,1
"12/28/2021","Y","Y","Wrangell City and Borough",275,"Other Southeast Region - Northern",8,1,209,1,209,0,6,0,1
"12/30/2021","Y","Y","Wrangell City and Borough",275,"Other Southeast Region - Northern",8,0,209,1,210,0,6,0,1
"01/02/2022","Y","Y","Wrangell City and Borough",275,"Other Southeast Region - Northern",8,1,210,0,210,0,6,0,1
"01/03/2022","Y","Y","Wrangell City and Borough",275,"Other Southeast Region - Northern",8,1,211,10,220,0,6,0,1
"01/04/2022","Y","Y","Wrangell City and Borough",275,"Other Southeast Region - Northern",8,8,219,5,225,0,6,0,1
"01/05/2022","Y","Y","Wrangell City and Borough",275,"Other Southeast Region - Northern",8,6,225,7,232,0,6,0,1
"01/06/2022","Y","Y","Wrangell City and Borough",275,"Other Southeast Region - Northern",8,7,232,5,237,0,6,0,1
"01/07/2022","Y","Y","Wrangell City and Borough",275,"Other Southeast Region - Northern",8,0,232,15,252,0,6,0,1
"01/08/2022","Y","Y","Wrangell City and Borough",275,"Other Southeast Region - Northern",8,0,232,2,254,0,6,0,1
"01/09/2022","Y","Y","Wrangell City and Borough",275,"Other Southeast Region - Northern",8,5,237,2,256,0,6,0,1
"01/10/2022","Y","Y","Wrangell City and Borough",275,"Other Southeast Region - Northern",8,17,254,12,268,0,6,0,1
"01/11/2022","Y","Y","Wrangell City and Borough",275,"Other Southeast Region - Northern",8,9,263,16,284,0,6,0,1
"01/12/2022","Y","Y","Wrangell City and Borough",275,"Other Southeast Region - Northern",8,5,268,12,296,0,6,0,1
"01/13/2022","Y","Y","Wrangell City and Borough",275,"Other Southeast Region - Northern",8,27,295,10,306,0,6,0,1
"01/14/2022","Y","Y","Wrangell City and Borough",275,"Other Southeast Region - Northern",8,0,295,9,315,0,6,0,1
"01/15/2022","Y","Y","Wrangell City and Borough",275,"Other Southeast Region - Northern",8,10,305,2,317,0,6,0,1
"01/17/2022","Y","Y","Wrangell City and Borough",275,"Other Southeast Region - Northern",8,11,316,0,317,0,6,0,1
"01/18/2022","Y","Y","Wrangell City and Borough",275,"Other Southeast Region - Northern",8,2,318,14,331,1,7,0,1
"01/19/2022","Y","Y","Wrangell City and Borough",275,"Other Southeast Region - Northern",8,2,320,3,334,0,7,0,1
"01/20/2022","Y","Y","Wrangell City and Borough",275,"Other Southeast Region - Northern",8,19,339,10,344,0,7,0,1
"01/21/2022","Y","Y","Wrangell City and Borough",275,"Other Southeast Region - Northern",8,9,348,9,353,0,7,0,1
"01/22/2022","Y","Y","Wrangell City and Borough",275,"Other Southeast Region - Northern",8,5,353,6,359,0,7,0,1
"01/23/2022","Y","Y","Wrangell City and Borough",275,"Other Southeast Region - Northern",8,2,355,1,360,0,7,0,1
"01/24/2022","Y","Y","Wrangell City and Borough",275,"Other Southeast Region - Northern",8,2,357,2,362,0,7,0,1
"01/25/2022","Y","Y","Wrangell City and Borough",275,"Other Southeast Region - Northern",8,7,364,9,371,0,7,0,1
"01/26/2022","Y","Y","Wrangell City and Borough",275,"Other Southeast Region - Northern",8,14,378,11,382,0,7,0,1
"01/27/2022","Y","Y","Wrangell City and Borough",275,"Other Southeast Region - Northern",8,6,384,8,390,0,7,0,1
"01/28/2022","Y","Y","Wrangell City and Borough",275,"Other Southeast Region - Northern",8,11,395,10,400,0,7,0,1
"01/29/2022","Y","Y","Wrangell City and Borough",275,"Other Southeast Region - Northern",8,4,399,2,402,0,7,0,1
"01/30/2022","Y","Y","Wrangell City and Borough",275,"Other Southeast Region - Northern",8,2,401,0,402,0,7,0,1
"01/31/2022","Y","Y","Wrangell City and Borough",275,"Other Southeast Region - Northern",8,2,403,1,403,0,7,0,1
"02/01/2022","Y","Y","Wrangell City and Borough",275,"Other Southeast Region - Northern",8,6,409,7,410,0,7,0,1
"02/02/2022","Y","Y","Wrangell City and Borough",275,"Other Southeast Region - Northern",8,1,410,0,410,0,7,0,1
"02/03/2022","Y","Y","Wrangell City and Borough",275,"Other Southeast Region - Northern",8,0,410,3,413,0,7,0,1
"02/04/2022","Y","Y","Wrangell City and Borough",275,"Other Southeast Region - Northern",8,2,412,1,414,0,7,0,1
"02/05/2022","Y","Y","Wrangell City and Borough",275,"Other Southeast Region - Northern",8,2,414,0,414,0,7,0,1
"02/07/2022","Y","Y","Wrangell City and Borough",275,"Other Southeast Region - Northern",8,1,415,2,416,0,7,0,1
"02/08/2022","Y","Y","Wrangell City and Borough",275,"Other Southeast Region - Northern",8,2,417,1,417,0,7,0,1
"02/11/2022","Y","Y","Wrangell City and Borough",275,"Other Southeast Region - Northern",8,7,424,7,424,0,7,0,1
"02/13/2022","Y","Y","Wrangell City and Borough",275,"Other Southeast Region - Northern",8,1,425,1,425,0,7,0,1
"02/23/2022","Y","Y","Wrangell City and Borough",275,"Other Southeast Region - Northern",8,1,426,1,426,0,7,0,1
"02/24/2022","Y","Y","Wrangell City and Borough",275,"Other Southeast Region - Northern",8,1,427,1,427,0,7,0,1
"02/26/2022","Y","Y","Wrangell City and Borough",275,"Other Southeast Region - Northern",8,1,428,1,428,0,7,0,1
"03/01/2022","Y","Y","Wrangell City and Borough",275,"Other Southeast Region - Northern",8,1,429,1,429,0,7,0,1
"03/15/2022","Y","Y","Wrangell City and Borough",275,"Other Southeast Region - Northern",8,3,432,3,432,0,7,0,1
"03/16/2022","Y","Y","Wrangell City and Borough",275,"Other Southeast Region - Northern",8,2,434,2,434,0,7,0,1
"03/17/2022","Y","Y","Wrangell City and Borough",275,"Other Southeast Region - Northern",8,1,435,1,435,0,7,0,1
"03/18/2022","Y","Y","Wrangell City and Borough",275,"Other Southeast Region - Northern",8,3,438,4,439,0,7,0,1
"03/19/2022","Y","Y","Wrangell City and Borough",275,"Other Southeast Region - Northern",8,2,440,1,440,0,7,0,1
"03/20/2022","Y","Y","Wrangell City and Borough",275,"Other Southeast Region - Northern",8,1,441,2,442,0,7,0,1
"03/21/2022","Y","Y","Wrangell City and Borough",275,"Other Southeast Region - Northern",8,1,442,2,444,0,7,0,1
"03/22/2022","Y","Y","Wrangell City and Borough",275,"Other Southeast Region - Northern",8,4,446,5,449,0,7,0,1
"03/23/2022","Y","Y","Wrangell City and Borough",275,"Other Southeast Region - Northern",8,7,453,4,453,0,7,0,1
"03/24/2022","Y","Y","Wrangell City and Borough",275,"Other Southeast Region - Northern",8,8,461,8,461,0,7,0,1
"03/25/2022","Y","Y","Wrangell City and Borough",275,"Other Southeast Region - Northern",8,7,468,7,468,0,7,0,1
"03/26/2022","Y","Y","Wrangell City and Borough",275,"Other Southeast Region - Northern",8,3,471,3,471,0,7,0,1
"03/29/2022","Y","Y","Wrangell City and Borough",275,"Other Southeast Region - Northern",8,9,480,11,482,0,7,0,1
"03/30/2022","Y","Y","Wrangell City and Borough",275,"Other Southeast Region - Northern",8,6,486,4,486,0,7,0,1
"03/31/2022","Y","Y","Wrangell City and Borough",275,"Other Southeast Region - Northern",8,3,489,3,489,0,7,0,1
"04/01/2022","Y","Y","Wrangell City and Borough",275,"Other Southeast Region - Northern",8,1,490,1,490,0,7,0,1
"04/02/2022","Y","Y","Wrangell City and Borough",275,"Other Southeast Region - Northern",8,6,496,6,496,0,7,0,1
"04/04/2022","Y","Y","Wrangell City and Borough",275,"Other Southeast Region - Northern",8,0,496,1,497,0,7,0,1
"04/05/2022","Y","Y","Wrangell City and Borough",275,"Other Southeast Region - Northern",8,2,498,3,500,0,7,0,1
"04/06/2022","Y","Y","Wrangell City and Borough",275,"Other Southeast Region - Northern",8,1,499,1,501,0,7,0,1
"04/07/2022","Y","Y","Wrangell City and Borough",275,"Other Southeast Region - Northern",8,4,503,5,506,0,7,0,1
"04/08/2022","Y","Y","Wrangell City and Borough",275,"Other Southeast Region - Northern",8,0,503,1,507,0,7,0,1
"04/09/2022","Y","Y","Wrangell City and Borough",275,"Other Southeast Region - Northern",8,7,510,3,510,0,7,0,1
"04/12/2022","Y","Y","Wrangell City and Borough",275,"Other Southeast Region - Northern",8,1,511,1,511,0,7,0,1
"04/13/2022","Y","Y","Wrangell City and Borough",275,"Other Southeast Region - Northern",8,1,512,1,512,0,7,0,1
"04/14/2022","Y","Y","Wrangell City and Borough",275,"Other Southeast Region - Northern",8,0,512,2,514,0,7,0,1
"04/15/2022","Y","Y","Wrangell City and Borough",275,"Other Southeast Region - Northern",8,3,515,3,517,0,7,0,1
"04/16/2022","Y","Y","Wrangell City and Borough",275,"Other Southeast Region - Northern",8,5,520,3,520,0,7,0,1
"04/19/2022","Y","Y","Wrangell City and Borough",275,"Other Southeast Region - Northern",8,1,521,7,527,0,7,0,1
"04/20/2022","Y","Y","Wrangell City and Borough",275,"Other Southeast Region - Northern",8,6,527,0,527,0,7,0,1
"04/22/2022","Y","Y","Wrangell City and Borough",275,"Other Southeast Region - Northern",8,8,535,8,535,0,7,0,1
"04/23/2022","Y","Y","Wrangell City and Borough",275,"Other Southeast Region - Northern",8,3,538,3,538,0,7,0,1
"04/26/2022","Y","Y","Wrangell City and Borough",275,"Other Southeast Region - Northern",8,4,542,4,542,0,7,0,1
"07/13/2020","Y","Y","Yakutat plus Hoonah-Angoon",400,"Other Southeast Region - Northern",8,0,0,1,1,0,0,0,0
"07/18/2020","Y","Y","Yakutat plus Hoonah-Angoon",400,"Other Southeast Region - Northern",8,0,0,1,2,0,0,0,0
"07/20/2020","Y","Y","Yakutat plus Hoonah-Angoon",400,"Other Southeast Region - Northern",8,0,0,1,3,0,0,0,0
"07/22/2020","Y","Y","Yakutat plus Hoonah-Angoon",400,"Other Southeast Region - Northern",8,0,0,1,4,0,0,0,0
"07/23/2020","Y","Y","Yakutat plus Hoonah-Angoon",400,"Other Southeast Region - Northern",8,1,1,1,5,0,0,0,0
"07/25/2020","Y","Y","Yakutat plus Hoonah-Angoon",400,"Other Southeast Region - Northern",8,2,3,0,5,0,0,0,0
"07/26/2020","Y","Y","Yakutat plus Hoonah-Angoon",400,"Other Southeast Region - Northern",8,1,4,1,6,0,0,0,0
"07/27/2020","Y","Y","Yakutat plus Hoonah-Angoon",400,"Other Southeast Region - Northern",8,1,5,1,7,0,0,0,0
"07/29/2020","Y","Y","Yakutat plus Hoonah-Angoon",400,"Other Southeast Region - Northern",8,1,6,0,7,0,0,0,0
"07/30/2020","Y","Y","Yakutat plus Hoonah-Angoon",400,"Other Southeast Region - Northern",8,1,7,0,7,0,0,0,0
"08/08/2020","Y","Y","Yakutat plus Hoonah-Angoon",400,"Other Southeast Region - Northern",8,0,7,1,8,0,0,0,0
"08/14/2020","Y","Y","Yakutat plus Hoonah-Angoon",400,"Other Southeast Region - Northern",8,1,8,0,8,0,0,0,0
"08/20/2020","Y","Y","Yakutat plus Hoonah-Angoon",400,"Other Southeast Region - Northern",8,0,8,2,10,0,0,0,0
"08/21/2020","Y","Y","Yakutat plus Hoonah-Angoon",400,"Other Southeast Region - Northern",8,0,8,1,11,0,0,0,0
"08/23/2020","Y","Y","Yakutat plus Hoonah-Angoon",400,"Other Southeast Region - Northern",8,0,8,1,12,0,0,0,0
"08/24/2020","Y","Y","Yakutat plus Hoonah-Angoon",400,"Other Southeast Region - Northern",8,0,8,1,13,0,0,0,0
"08/25/2020","Y","Y","Yakutat plus Hoonah-Angoon",400,"Other Southeast Region - Northern",8,2,10,2,15,0,0,0,0
"08/26/2020","Y","Y","Yakutat plus Hoonah-Angoon",400,"Other Southeast Region - Northern",8,0,10,1,16,0,0,0,0
"08/27/2020","Y","Y","Yakutat plus Hoonah-Angoon",400,"Other Southeast Region - Northern",8,1,11,1,17,0,0,0,0
"08/28/2020","Y","Y","Yakutat plus Hoonah-Angoon",400,"Other Southeast Region - Northern",8,6,17,0,17,0,0,0,0
"08/29/2020","Y","Y","Yakutat plus Hoonah-Angoon",400,"Other Southeast Region - Northern",8,0,17,2,19,0,0,0,0
"08/31/2020","Y","Y","Yakutat plus Hoonah-Angoon",400,"Other Southeast Region - Northern",8,1,18,1,20,0,0,0,0
"09/01/2020","Y","Y","Yakutat plus Hoonah-Angoon",400,"Other Southeast Region - Northern",8,1,19,0,20,0,0,0,0
"09/02/2020","Y","Y","Yakutat plus Hoonah-Angoon",400,"Other Southeast Region - Northern",8,0,19,0,20,1,1,0,0
"09/05/2020","Y","Y","Yakutat plus Hoonah-Angoon",400,"Other Southeast Region - Northern",8,1,20,0,20,0,1,0,0
"09/17/2020","Y","Y","Yakutat plus Hoonah-Angoon",400,"Other Southeast Region - Northern",8,0,20,2,22,0,1,0,0
"09/19/2020","Y","Y","Yakutat plus Hoonah-Angoon",400,"Other Southeast Region - Northern",8,1,21,0,22,0,1,0,0
"09/20/2020","Y","Y","Yakutat plus Hoonah-Angoon",400,"Other Southeast Region - Northern",8,1,22,1,23,0,1,0,0
"09/21/2020","Y","Y","Yakutat plus Hoonah-Angoon",400,"Other Southeast Region - Northern",8,0,22,1,24,0,1,0,0
"09/22/2020","Y","Y","Yakutat plus Hoonah-Angoon",400,"Other Southeast Region - Northern",8,1,23,0,24,0,1,0,0
"09/25/2020","Y","Y","Yakutat plus Hoonah-Angoon",400,"Other Southeast Region - Northern",8,1,24,0,24,0,1,0,0
"10/03/2020","Y","Y","Yakutat plus Hoonah-Angoon",400,"Other Southeast Region - Northern",8,0,24,1,25,0,1,0,0
"10/04/2020","Y","Y","Yakutat plus Hoonah-Angoon",400,"Other Southeast Region - Northern",8,1,25,0,25,0,1,0,0
"10/10/2020","Y","Y","Yakutat plus Hoonah-Angoon",400,"Other Southeast Region - Northern",8,0,25,1,26,0,1,0,0
"10/13/2020","Y","Y","Yakutat plus Hoonah-Angoon",400,"Other Southeast Region - Northern",8,0,25,1,27,0,1,0,0
"10/14/2020","Y","Y","Yakutat plus Hoonah-Angoon",400,"Other Southeast Region - Northern",8,0,25,1,28,0,1,0,0
"10/15/2020","Y","Y","Yakutat plus Hoonah-Angoon",400,"Other Southeast Region - Northern",8,2,27,0,28,0,1,0,0
"10/18/2020","Y","Y","Yakutat plus Hoonah-Angoon",400,"Other Southeast Region - Northern",8,1,28,0,28,0,1,0,0
"10/19/2020","Y","Y","Yakutat plus Hoonah-Angoon",400,"Other Southeast Region - Northern",8,0,28,1,29,0,1,0,0
"10/20/2020","Y","Y","Yakutat plus Hoonah-Angoon",400,"Other Southeast Region - Northern",8,0,28,1,30,0,1,0,0
"10/23/2020","Y","Y","Yakutat plus Hoonah-Angoon",400,"Other Southeast Region - Northern",8,0,28,1,31,0,1,0,0
"10/24/2020","Y","Y","Yakutat plus Hoonah-Angoon",400,"Other Southeast Region - Northern",8,1,29,0,31,0,1,0,0
"10/26/2020","Y","Y","Yakutat plus Hoonah-Angoon",400,"Other Southeast Region - Northern",8,1,30,0,31,0,1,0,0
"10/27/2020","Y","Y","Yakutat plus Hoonah-Angoon",400,"Other Southeast Region - Northern",8,1,31,0,31,0,1,0,0
"11/03/2020","Y","Y","Yakutat plus Hoonah-Angoon",400,"Other Southeast Region - Northern",8,0,31,1,32,0,1,0,0
"11/04/2020","Y","Y","Yakutat plus Hoonah-Angoon",400,"Other Southeast Region - Northern",8,0,31,1,33,0,1,0,0
"11/06/2020","Y","Y","Yakutat plus Hoonah-Angoon",400,"Other Southeast Region - Northern",8,0,31,1,34,0,1,0,0
"11/07/2020","Y","Y","Yakutat plus Hoonah-Angoon",400,"Other Southeast Region - Northern",8,1,32,0,34,0,1,0,0
"11/09/2020","Y","Y","Yakutat plus Hoonah-Angoon",400,"Other Southeast Region - Northern",8,0,32,1,35,0,1,0,0
"11/10/2020","Y","Y","Yakutat plus Hoonah-Angoon",400,"Other Southeast Region - Northern",8,0,32,1,36,0,1,0,0
"11/13/2020","Y","Y","Yakutat plus Hoonah-Angoon",400,"Other Southeast Region - Northern",8,2,34,1,37,0,1,0,0
"11/14/2020","Y","Y","Yakutat plus Hoonah-Angoon",400,"Other Southeast Region - Northern",8,0,34,1,38,0,1,0,0
"11/17/2020","Y","Y","Yakutat plus Hoonah-Angoon",400,"Other Southeast Region - Northern",8,3,37,1,39,0,1,0,0
"11/18/2020","Y","Y","Yakutat plus Hoonah-Angoon",400,"Other Southeast Region - Northern",8,1,38,0,39,0,1,0,0
"11/20/2020","Y","Y","Yakutat plus Hoonah-Angoon",400,"Other Southeast Region - Northern",8,0,38,1,40,0,1,0,0
"11/21/2020","Y","Y","Yakutat plus Hoonah-Angoon",400,"Other Southeast Region - Northern",8,0,38,1,41,0,1,0,0
"11/22/2020","Y","Y","Yakutat plus Hoonah-Angoon",400,"Other Southeast Region - Northern",8,2,40,0,41,0,1,0,0
"11/24/2020","Y","Y","Yakutat plus Hoonah-Angoon",400,"Other Southeast Region - Northern",8,0,40,1,42,0,1,0,0
"11/25/2020","Y","Y","Yakutat plus Hoonah-Angoon",400,"Other Southeast Region - Northern",8,1,41,0,42,0,1,0,0
"11/27/2020","Y","Y","Yakutat plus Hoonah-Angoon",400,"Other Southeast Region - Northern",8,0,41,1,43,0,1,0,0
"11/28/2020","Y","Y","Yakutat plus Hoonah-Angoon",400,"Other Southeast Region - Northern",8,1,42,0,43,0,1,0,0
"12/01/2020","Y","Y","Yakutat plus Hoonah-Angoon",400,"Other Southeast Region - Northern",8,0,42,0,43,1,2,0,0
"12/03/2020","Y","Y","Yakutat plus Hoonah-Angoon",400,"Other Southeast Region - Northern",8,1,43,0,43,0,2,0,0
"12/07/2020","Y","Y","Yakutat plus Hoonah-Angoon",400,"Other Southeast Region - Northern",8,0,43,0,43,0,2,1,1
"12/16/2020","Y","Y","Yakutat plus Hoonah-Angoon",400,"Other Southeast Region - Northern",8,1,44,1,44,0,2,0,1
"12/20/2020","Y","Y","Yakutat plus Hoonah-Angoon",400,"Other Southeast Region - Northern",8,0,44,1,45,0,2,0,1
"12/23/2020","Y","Y","Yakutat plus Hoonah-Angoon",400,"Other Southeast Region - Northern",8,0,44,1,46,0,2,0,1
"12/27/2020","Y","Y","Yakutat plus Hoonah-Angoon",400,"Other Southeast Region - Northern",8,0,44,1,47,0,2,0,1
"12/30/2020","Y","Y","Yakutat plus Hoonah-Angoon",400,"Other Southeast Region - Northern",8,1,45,0,47,0,2,0,1
"12/31/2020","Y","Y","Yakutat plus Hoonah-Angoon",400,"Other Southeast Region - Northern",8,1,46,1,48,0,2,0,1
"01/01/2021","Y","Y","Yakutat plus Hoonah-Angoon",400,"Other Southeast Region - Northern",8,1,47,0,48,0,2,0,1
"01/04/2021","Y","Y","Yakutat plus Hoonah-Angoon",400,"Other Southeast Region - Northern",8,1,48,1,49,0,2,0,1
"01/07/2021","Y","Y","Yakutat plus Hoonah-Angoon",400,"Other Southeast Region - Northern",8,1,49,1,50,0,2,0,1
"01/16/2021","Y","Y","Yakutat plus Hoonah-Angoon",400,"Other Southeast Region - Northern",8,1,50,0,50,0,2,0,1
"01/19/2021","Y","Y","Yakutat plus Hoonah-Angoon",400,"Other Southeast Region - Northern",8,0,50,2,52,1,3,0,1
"01/21/2021","Y","Y","Yakutat plus Hoonah-Angoon",400,"Other Southeast Region - Northern",8,2,52,0,52,0,3,0,1
"02/13/2021","Y","Y","Yakutat plus Hoonah-Angoon",400,"Other Southeast Region - Northern",8,0,52,1,53,0,3,0,1
"02/16/2021","Y","Y","Yakutat plus Hoonah-Angoon",400,"Other Southeast Region - Northern",8,1,53,0,53,0,3,0,1
"02/17/2021","Y","Y","Yakutat plus Hoonah-Angoon",400,"Other Southeast Region - Northern",8,0,53,1,54,0,3,0,1
"02/19/2021","Y","Y","Yakutat plus Hoonah-Angoon",400,"Other Southeast Region - Northern",8,1,54,0,54,0,3,0,1
"02/21/2021","Y","Y","Yakutat plus Hoonah-Angoon",400,"Other Southeast Region - Northern",8,0,54,0,54,0,3,1,2
"02/27/2021","Y","Y","Yakutat plus Hoonah-Angoon",400,"Other Southeast Region - Northern",8,0,54,1,55,0,3,0,2
"03/01/2021","Y","Y","Yakutat plus Hoonah-Angoon",400,"Other Southeast Region - Northern",8,1,55,0,55,0,3,0,2
"04/05/2021","Y","Y","Yakutat plus Hoonah-Angoon",400,"Other Southeast Region - Northern",8,0,55,1,56,0,3,0,2
"04/06/2021","Y","Y","Yakutat plus Hoonah-Angoon",400,"Other Southeast Region - Northern",8,1,56,0,56,0,3,0,2
"04/21/2021","Y","Y","Yakutat plus Hoonah-Angoon",400,"Other Southeast Region - Northern",8,0,56,1,57,0,3,0,2
"04/25/2021","Y","Y","Yakutat plus Hoonah-Angoon",400,"Other Southeast Region - Northern",8,1,57,0,57,0,3,0,2
"04/27/2021","Y","Y","Yakutat plus Hoonah-Angoon",400,"Other Southeast Region - Northern",8,0,57,1,58,1,4,0,2
"04/28/2021","Y","Y","Yakutat plus Hoonah-Angoon",400,"Other Southeast Region - Northern",8,0,57,1,59,0,4,0,2
"04/30/2021","Y","Y","Yakutat plus Hoonah-Angoon",400,"Other Southeast Region - Northern",8,1,58,7,66,0,4,0,2
"05/06/2021","Y","Y","Yakutat plus Hoonah-Angoon",400,"Other Southeast Region - Northern",8,1,59,0,66,0,4,0,2
"05/08/2021","Y","Y","Yakutat plus Hoonah-Angoon",400,"Other Southeast Region - Northern",8,0,59,1,67,0,4,0,2
"05/10/2021","Y","Y","Yakutat plus Hoonah-Angoon",400,"Other Southeast Region - Northern",8,2,61,0,67,1,5,0,2
"05/11/2021","Y","Y","Yakutat plus Hoonah-Angoon",400,"Other Southeast Region - Northern",8,0,61,1,68,0,5,0,2
"05/13/2021","Y","Y","Yakutat plus Hoonah-Angoon",400,"Other Southeast Region - Northern",8,7,68,0,68,0,5,0,2
"05/17/2021","Y","Y","Yakutat plus Hoonah-Angoon",400,"Other Southeast Region - Northern",8,0,68,1,69,0,5,0,2
"05/22/2021","Y","Y","Yakutat plus Hoonah-Angoon",400,"Other Southeast Region - Northern",8,0,68,1,70,0,5,0,2
"05/25/2021","Y","Y","Yakutat plus Hoonah-Angoon",400,"Other Southeast Region - Northern",8,2,70,0,70,0,5,0,2
"07/23/2021","Y","Y","Yakutat plus Hoonah-Angoon",400,"Other Southeast Region - Northern",8,0,70,1,71,0,5,0,2
"07/24/2021","Y","Y","Yakutat plus Hoonah-Angoon",400,"Other Southeast Region - Northern",8,1,71,0,71,0,5,0,2
"07/25/2021","Y","Y","Yakutat plus Hoonah-Angoon",400,"Other Southeast Region - Northern",8,0,71,1,72,0,5,0,2
"07/26/2021","Y","Y","Yakutat plus Hoonah-Angoon",400,"Other Southeast Region - Northern",8,1,72,0,72,0,5,0,2
"08/17/2021","Y","Y","Yakutat plus Hoonah-Angoon",400,"Other Southeast Region - Northern",8,0,72,1,73,0,5,0,2
"08/18/2021","Y","Y","Yakutat plus Hoonah-Angoon",400,"Other Southeast Region - Northern",8,0,72,2,75,0,5,0,2
"08/19/2021","Y","Y","Yakutat plus Hoonah-Angoon",400,"Other Southeast Region - Northern",8,1,73,2,77,0,5,0,2
"08/20/2021","Y","Y","Yakutat plus Hoonah-Angoon",400,"Other Southeast Region - Northern",8,1,74,0,77,0,5,0,2
"08/21/2021","Y","Y","Yakutat plus Hoonah-Angoon",400,"Other Southeast Region - Northern",8,1,75,0,77,0,5,0,2
"08/23/2021","Y","Y","Yakutat plus Hoonah-Angoon",400,"Other Southeast Region - Northern",8,0,75,1,78,0,5,0,2
"08/24/2021","Y","Y","Yakutat plus Hoonah-Angoon",400,"Other Southeast Region - Northern",8,2,77,0,78,0,5,0,2
"08/25/2021","Y","Y","Yakutat plus Hoonah-Angoon",400,"Other Southeast Region - Northern",8,0,77,1,79,0,5,0,2
"08/26/2021","Y","Y","Yakutat plus Hoonah-Angoon",400,"Other Southeast Region - Northern",8,1,78,1,80,0,5,0,2
"08/27/2021","Y","Y","Yakutat plus Hoonah-Angoon",400,"Other Southeast Region - Northern",8,0,78,1,81,0,5,0,2
"08/29/2021","Y","Y","Yakutat plus Hoonah-Angoon",400,"Other Southeast Region - Northern",8,0,78,1,82,0,5,0,2
"09/01/2021","Y","Y","Yakutat plus Hoonah-Angoon",400,"Other Southeast Region - Northern",8,2,80,1,83,0,5,0,2
"09/02/2021","Y","Y","Yakutat plus Hoonah-Angoon",400,"Other Southeast Region - Northern",8,1,81,0,83,0,5,0,2
"09/04/2021","Y","Y","Yakutat plus Hoonah-Angoon",400,"Other Southeast Region - Northern",8,1,82,0,83,0,5,0,2
"09/07/2021","Y","Y","Yakutat plus Hoonah-Angoon",400,"Other Southeast Region - Northern",8,1,83,0,83,0,5,0,2
"09/08/2021","Y","Y","Yakutat plus Hoonah-Angoon",400,"Other Southeast Region - Northern",8,0,83,1,84,0,5,0,2
"09/10/2021","Y","Y","Yakutat plus Hoonah-Angoon",400,"Other Southeast Region - Northern",8,0,83,1,85,0,5,0,2
"09/13/2021","Y","Y","Yakutat plus Hoonah-Angoon",400,"Other Southeast Region - Northern",8,0,83,3,88,0,5,0,2
"09/14/2021","Y","Y","Yakutat plus Hoonah-Angoon",400,"Other Southeast Region - Northern",8,1,84,7,95,0,5,0,2
"09/15/2021","Y","Y","Yakutat plus Hoonah-Angoon",400,"Other Southeast Region - Northern",8,1,85,0,95,0,5,0,2
"09/16/2021","Y","Y","Yakutat plus Hoonah-Angoon",400,"Other Southeast Region - Northern",8,1,86,0,95,0,5,0,2
"09/17/2021","Y","Y","Yakutat plus Hoonah-Angoon",400,"Other Southeast Region - Northern",8,0,86,3,98,0,5,0,2
"09/18/2021","Y","Y","Yakutat plus Hoonah-Angoon",400,"Other Southeast Region - Northern",8,1,87,0,98,0,5,0,2
"09/20/2021","Y","Y","Yakutat plus Hoonah-Angoon",400,"Other Southeast Region - Northern",8,2,89,10,108,0,5,0,2
"09/21/2021","Y","Y","Yakutat plus Hoonah-Angoon",400,"Other Southeast Region - Northern",8,5,94,5,113,0,5,0,2
"09/22/2021","Y","Y","Yakutat plus Hoonah-Angoon",400,"Other Southeast Region - Northern",8,2,96,3,116,0,5,0,2
"09/23/2021","Y","Y","Yakutat plus Hoonah-Angoon",400,"Other Southeast Region - Northern",8,4,100,5,121,0,5,0,2
"09/24/2021","Y","Y","Yakutat plus Hoonah-Angoon",400,"Other Southeast Region - Northern",8,9,109,10,131,0,5,0,2
"09/25/2021","Y","Y","Yakutat plus Hoonah-Angoon",400,"Other Southeast Region - Northern",8,3,112,1,132,0,5,0,2
"09/26/2021","Y","Y","Yakutat plus Hoonah-Angoon",400,"Other Southeast Region - Northern",8,0,112,4,136,0,5,0,2
"09/27/2021","Y","Y","Yakutat plus Hoonah-Angoon",400,"Other Southeast Region - Northern",8,4,116,6,142,0,5,0,2
"09/28/2021","Y","Y","Yakutat plus Hoonah-Angoon",400,"Other Southeast Region - Northern",8,6,122,5,147,0,5,0,2
"09/29/2021","Y","Y","Yakutat plus Hoonah-Angoon",400,"Other Southeast Region - Northern",8,3,125,2,149,0,5,0,2
"09/30/2021","Y","Y","Yakutat plus Hoonah-Angoon",400,"Other Southeast Region - Northern",8,1,126,1,150,0,5,0,2
"10/01/2021","Y","Y","Yakutat plus Hoonah-Angoon",400,"Other Southeast Region - Northern",8,9,135,6,156,0,5,0,2
"10/02/2021","Y","Y","Yakutat plus Hoonah-Angoon",400,"Other Southeast Region - Northern",8,1,136,1,157,0,5,0,2
"10/03/2021","Y","Y","Yakutat plus Hoonah-Angoon",400,"Other Southeast Region - Northern",8,0,136,1,158,0,5,0,2
"10/04/2021","Y","Y","Yakutat plus Hoonah-Angoon",400,"Other Southeast Region - Northern",8,4,140,18,176,0,5,0,2
"10/05/2021","Y","Y","Yakutat plus Hoonah-Angoon",400,"Other Southeast Region - Northern",8,3,143,2,178,0,5,0,2
"10/06/2021","Y","Y","Yakutat plus Hoonah-Angoon",400,"Other Southeast Region - Northern",8,16,159,1,179,0,5,0,2
"10/07/2021","Y","Y","Yakutat plus Hoonah-Angoon",400,"Other Southeast Region - Northern",8,8,167,3,182,0,5,0,2
"10/08/2021","Y","Y","Yakutat plus Hoonah-Angoon",400,"Other Southeast Region - Northern",8,1,168,7,189,0,5,0,2
"10/09/2021","Y","Y","Yakutat plus Hoonah-Angoon",400,"Other Southeast Region - Northern",8,15,183,0,189,0,5,0,2
"10/10/2021","Y","Y","Yakutat plus Hoonah-Angoon",400,"Other Southeast Region - Northern",8,0,183,1,190,1,6,0,2
"10/11/2021","Y","Y","Yakutat plus Hoonah-Angoon",400,"Other Southeast Region - Northern",8,5,188,8,198,0,6,0,2
"10/12/2021","Y","Y","Yakutat plus Hoonah-Angoon",400,"Other Southeast Region - Northern",8,1,189,1,199,0,6,0,2
"10/13/2021","Y","Y","Yakutat plus Hoonah-Angoon",400,"Other Southeast Region - Northern",8,0,189,5,204,0,6,0,2
"10/14/2021","Y","Y","Yakutat plus Hoonah-Angoon",400,"Other Southeast Region - Northern",8,2,191,2,206,0,6,0,2
"10/15/2021","Y","Y","Yakutat plus Hoonah-Angoon",400,"Other Southeast Region - Northern",8,10,201,3,209,0,6,0,2
"10/16/2021","Y","Y","Yakutat plus Hoonah-Angoon",400,"Other Southeast Region - Northern",8,2,203,1,210,0,6,0,2
"10/17/2021","Y","Y","Yakutat plus Hoonah-Angoon",400,"Other Southeast Region - Northern",8,3,206,0,210,0,6,0,2
"10/18/2021","Y","Y","Yakutat plus Hoonah-Angoon",400,"Other Southeast Region - Northern",8,0,206,1,211,0,6,0,2
"10/19/2021","Y","Y","Yakutat plus Hoonah-Angoon",400,"Other Southeast Region - Northern",8,1,207,0,211,0,6,0,2
"10/21/2021","Y","Y","Yakutat plus Hoonah-Angoon",400,"Other Southeast Region - Northern",8,6,213,2,213,0,6,0,2
"10/25/2021","Y","Y","Yakutat plus Hoonah-Angoon",400,"Other Southeast Region - Northern",8,1,214,4,217,0,6,0,2
"10/27/2021","Y","Y","Yakutat plus Hoonah-Angoon",400,"Other Southeast Region - Northern",8,1,215,1,218,0,6,0,2
"10/28/2021","Y","Y","Yakutat plus Hoonah-Angoon",400,"Other Southeast Region - Northern",8,2,217,1,219,0,6,1,3
"10/29/2021","Y","Y","Yakutat plus Hoonah-Angoon",400,"Other Southeast Region - Northern",8,3,220,3,222,0,6,0,3
"10/31/2021","Y","Y","Yakutat plus Hoonah-Angoon",400,"Other Southeast Region - Northern",8,1,221,0,222,0,6,0,3
"11/02/2021","Y","Y","Yakutat plus Hoonah-Angoon",400,"Other Southeast Region - Northern",8,0,221,1,223,0,6,0,3
"11/03/2021","Y","Y","Yakutat plus Hoonah-Angoon",400,"Other Southeast Region - Northern",8,2,223,1,224,0,6,0,3
"11/04/2021","Y","Y","Yakutat plus Hoonah-Angoon",400,"Other Southeast Region - Northern",8,1,224,2,226,0,6,0,3
"11/05/2021","Y","Y","Yakutat plus Hoonah-Angoon",400,"Other Southeast Region - Northern",8,0,224,2,228,1,7,0,3
"11/06/2021","Y","Y","Yakutat plus Hoonah-Angoon",400,"Other Southeast Region - Northern",8,3,227,0,228,0,7,0,3
"11/07/2021","Y","Y","Yakutat plus Hoonah-Angoon",400,"Other Southeast Region - Northern",8,1,228,0,228,0,7,0,3
"11/08/2021","Y","Y","Yakutat plus Hoonah-Angoon",400,"Other Southeast Region - Northern",8,0,228,2,230,0,7,0,3
"11/10/2021","Y","Y","Yakutat plus Hoonah-Angoon",400,"Other Southeast Region - Northern",8,1,229,0,230,0,7,0,3
"11/13/2021","Y","Y","Yakutat plus Hoonah-Angoon",400,"Other Southeast Region - Northern",8,1,230,1,231,0,7,0,3
"11/14/2021","Y","Y","Yakutat plus Hoonah-Angoon",400,"Other Southeast Region - Northern",8,0,230,4,235,0,7,1,4
"11/15/2021","Y","Y","Yakutat plus Hoonah-Angoon",400,"Other Southeast Region - Northern",8,6,236,3,238,0,7,0,4
"11/17/2021","Y","Y","Yakutat plus Hoonah-Angoon",400,"Other Southeast Region - Northern",8,1,237,0,238,0,7,0,4
"11/18/2021","Y","Y","Yakutat plus Hoonah-Angoon",400,"Other Southeast Region - Northern",8,1,238,1,239,0,7,0,4
"11/23/2021","Y","Y","Yakutat plus Hoonah-Angoon",400,"Other Southeast Region - Northern",8,1,239,1,240,0,7,0,4
"11/24/2021","Y","Y","Yakutat plus Hoonah-Angoon",400,"Other Southeast Region - Northern",8,1,240,0,240,0,7,0,4
"11/26/2021","Y","Y","Yakutat plus Hoonah-Angoon",400,"Other Southeast Region - Northern",8,0,240,1,241,0,7,0,4
"11/27/2021","Y","Y","Yakutat plus Hoonah-Angoon",400,"Other Southeast Region - Northern",8,1,241,0,241,0,7,0,4
"12/01/2021","Y","Y","Yakutat plus Hoonah-Angoon",400,"Other Southeast Region - Northern",8,0,241,1,242,0,7,0,4
"12/02/2021","Y","Y","Yakutat plus Hoonah-Angoon",400,"Other Southeast Region - Northern",8,1,242,0,242,0,7,0,4
"12/09/2021","Y","Y","Yakutat plus Hoonah-Angoon",400,"Other Southeast Region - Northern",8,1,243,1,243,0,7,0,4
"12/12/2021","Y","Y","Yakutat plus Hoonah-Angoon",400,"Other Southeast Region - Northern",8,0,243,1,244,0,7,0,4
"12/15/2021","Y","Y","Yakutat plus Hoonah-Angoon",400,"Other Southeast Region - Northern",8,1,244,1,245,0,7,0,4
"12/16/2021","Y","Y","Yakutat plus Hoonah-Angoon",400,"Other Southeast Region - Northern",8,0,244,1,246,0,7,0,4
"12/17/2021","Y","Y","Yakutat plus Hoonah-Angoon",400,"Other Southeast Region - Northern",8,2,246,0,246,0,7,0,4
"12/22/2021","Y","Y","Yakutat plus Hoonah-Angoon",400,"Other Southeast Region - Northern",8,1,247,1,247,0,7,0,4
"12/23/2021","Y","Y","Yakutat plus Hoonah-Angoon",400,"Other Southeast Region - Northern",8,6,253,6,253,0,7,0,4
"12/24/2021","Y","Y","Yakutat plus Hoonah-Angoon",400,"Other Southeast Region - Northern",8,1,254,1,254,1,8,0,4
"12/27/2021","Y","Y","Yakutat plus Hoonah-Angoon",400,"Other Southeast Region - Northern",8,2,256,2,256,0,8,0,4
"12/28/2021","Y","Y","Yakutat plus Hoonah-Angoon",400,"Other Southeast Region - Northern",8,1,257,1,257,0,8,0,4
"12/29/2021","Y","Y","Yakutat plus Hoonah-Angoon",400,"Other Southeast Region - Northern",8,0,257,2,259,0,8,0,4
"01/01/2022","Y","Y","Yakutat plus Hoonah-Angoon",400,"Other Southeast Region - Northern",8,2,259,0,259,0,8,0,4
"01/02/2022","Y","Y","Yakutat plus Hoonah-Angoon",400,"Other Southeast Region - Northern",8,1,260,3,262,0,8,0,4
"01/03/2022","Y","Y","Yakutat plus Hoonah-Angoon",400,"Other Southeast Region - Northern",8,2,262,2,264,0,8,1,5
"01/04/2022","Y","Y","Yakutat plus Hoonah-Angoon",400,"Other Southeast Region - Northern",8,1,263,1,265,0,8,0,5
"01/05/2022","Y","Y","Yakutat plus Hoonah-Angoon",400,"Other Southeast Region - Northern",8,5,268,4,269,0,8,0,5
"01/06/2022","Y","Y","Yakutat plus Hoonah-Angoon",400,"Other Southeast Region - Northern",8,3,271,3,272,0,8,0,5
"01/07/2022","Y","Y","Yakutat plus Hoonah-Angoon",400,"Other Southeast Region - Northern",8,5,276,5,277,0,8,0,5
"01/08/2022","Y","Y","Yakutat plus Hoonah-Angoon",400,"Other Southeast Region - Northern",8,2,278,3,280,0,8,0,5
"01/09/2022","Y","Y","Yakutat plus Hoonah-Angoon",400,"Other Southeast Region - Northern",8,1,279,0,280,0,8,0,5
"01/10/2022","Y","Y","Yakutat plus Hoonah-Angoon",400,"Other Southeast Region - Northern",8,19,298,21,301,0,8,0,5
"01/11/2022","Y","Y","Yakutat plus Hoonah-Angoon",400,"Other Southeast Region - Northern",8,24,322,25,326,0,8,0,5
"01/12/2022","Y","Y","Yakutat plus Hoonah-Angoon",400,"Other Southeast Region - Northern",8,1,323,5,331,0,8,0,5
"01/13/2022","Y","Y","Yakutat plus Hoonah-Angoon",400,"Other Southeast Region - Northern",8,23,346,20,351,0,8,0,5
"01/14/2022","Y","Y","Yakutat plus Hoonah-Angoon",400,"Other Southeast Region - Northern",8,3,349,2,353,0,8,0,5
"01/15/2022","Y","Y","Yakutat plus Hoonah-Angoon",400,"Other Southeast Region - Northern",8,3,352,3,356,0,8,0,5
"01/16/2022","Y","Y","Yakutat plus Hoonah-Angoon",400,"Other Southeast Region - Northern",8,0,352,1,357,0,8,0,5
"01/17/2022","Y","Y","Yakutat plus Hoonah-Angoon",400,"Other Southeast Region - Northern",8,0,352,1,358,0,8,0,5
"01/18/2022","Y","Y","Yakutat plus Hoonah-Angoon",400,"Other Southeast Region - Northern",8,4,356,4,362,0,8,0,5
"01/19/2022","Y","Y","Yakutat plus Hoonah-Angoon",400,"Other Southeast Region - Northern",8,6,362,10,372,0,8,0,5
"01/20/2022","Y","Y","Yakutat plus Hoonah-Angoon",400,"Other Southeast Region - Northern",8,2,364,1,373,0,8,0,5
"01/22/2022","Y","Y","Yakutat plus Hoonah-Angoon",400,"Other Southeast Region - Northern",8,1,365,1,374,0,8,0,5
"01/24/2022","Y","Y","Yakutat plus Hoonah-Angoon",400,"Other Southeast Region - Northern",8,1,366,2,376,0,8,0,5
"01/25/2022","Y","Y","Yakutat plus Hoonah-Angoon",400,"Other Southeast Region - Northern",8,9,375,4,380,1,9,0,5
"01/26/2022","Y","Y","Yakutat plus Hoonah-Angoon",400,"Other Southeast Region - Northern",8,7,382,3,383,0,9,0,5
"01/27/2022","Y","Y","Yakutat plus Hoonah-Angoon",400,"Other Southeast Region - Northern",8,2,384,2,385,0,9,0,5
"01/28/2022","Y","Y","Yakutat plus Hoonah-Angoon",400,"Other Southeast Region - Northern",8,4,388,4,389,0,9,0,5
"01/29/2022","Y","Y","Yakutat plus Hoonah-Angoon",400,"Other Southeast Region - Northern",8,2,390,3,392,0,9,0,5
"01/31/2022","Y","Y","Yakutat plus Hoonah-Angoon",400,"Other Southeast Region - Northern",8,4,394,5,397,0,9,0,5
"02/01/2022","Y","Y","Yakutat plus Hoonah-Angoon",400,"Other Southeast Region - Northern",8,6,400,6,403,0,9,0,5
"02/02/2022","Y","Y","Yakutat plus Hoonah-Angoon",400,"Other Southeast Region - Northern",8,1,401,1,404,0,9,0,5
"02/03/2022","Y","Y","Yakutat plus Hoonah-Angoon",400,"Other Southeast Region - Northern",8,5,406,5,409,0,9,0,5
"02/04/2022","Y","Y","Yakutat plus Hoonah-Angoon",400,"Other Southeast Region - Northern",8,5,411,2,411,0,9,0,5
"02/05/2022","Y","Y","Yakutat plus Hoonah-Angoon",400,"Other Southeast Region - Northern",8,0,411,1,412,0,9,0,5
"02/06/2022","Y","Y","Yakutat plus Hoonah-Angoon",400,"Other Southeast Region - Northern",8,2,413,2,414,0,9,0,5
"02/07/2022","Y","Y","Yakutat plus Hoonah-Angoon",400,"Other Southeast Region - Northern",8,1,414,0,414,0,9,0,5
"02/08/2022","Y","Y","Yakutat plus Hoonah-Angoon",400,"Other Southeast Region - Northern",8,3,417,3,417,0,9,0,5
"02/09/2022","Y","Y","Yakutat plus Hoonah-Angoon",400,"Other Southeast Region - Northern",8,1,418,1,418,0,9,0,5
"02/13/2022","Y","Y","Yakutat plus Hoonah-Angoon",400,"Other Southeast Region - Northern",8,3,421,3,421,0,9,0,5
"02/14/2022","Y","Y","Yakutat plus Hoonah-Angoon",400,"Other Southeast Region - Northern",8,1,422,1,422,0,9,0,5
"02/15/2022","Y","Y","Yakutat plus Hoonah-Angoon",400,"Other Southeast Region - Northern",8,1,423,1,423,0,9,0,5
"02/17/2022","Y","Y","Yakutat plus Hoonah-Angoon",400,"Other Southeast Region - Northern",8,2,425,2,425,0,9,0,5
"02/22/2022","Y","Y","Yakutat plus Hoonah-Angoon",400,"Other Southeast Region - Northern",8,3,428,3,428,0,9,0,5
"02/24/2022","Y","Y","Yakutat plus Hoonah-Angoon",400,"Other Southeast Region - Northern",8,2,430,2,430,0,9,0,5
"02/25/2022","Y","Y","Yakutat plus Hoonah-Angoon",400,"Other Southeast Region - Northern",8,0,430,1,431,0,9,0,5
"02/27/2022","Y","Y","Yakutat plus Hoonah-Angoon",400,"Other Southeast Region - Northern",8,0,430,1,432,0,9,0,5
"02/28/2022","Y","Y","Yakutat plus Hoonah-Angoon",400,"Other Southeast Region - Northern",8,2,432,2,434,0,9,0,5
"03/01/2022","Y","Y","Yakutat plus Hoonah-Angoon",400,"Other Southeast Region - Northern",8,0,432,3,437,0,9,0,5
"03/02/2022","Y","Y","Yakutat plus Hoonah-Angoon",400,"Other Southeast Region - Northern",8,3,435,3,440,0,9,0,5
"03/03/2022","Y","Y","Yakutat plus Hoonah-Angoon",400,"Other Southeast Region - Northern",8,3,438,2,442,0,9,0,5
"03/04/2022","Y","Y","Yakutat plus Hoonah-Angoon",400,"Other Southeast Region - Northern",8,2,440,1,443,0,9,0,5
"03/07/2022","Y","Y","Yakutat plus Hoonah-Angoon",400,"Other Southeast Region - Northern",8,9,449,10,453,0,9,0,5
"03/08/2022","Y","Y","Yakutat plus Hoonah-Angoon",400,"Other Southeast Region - Northern",8,7,456,9,462,0,9,0,5
"03/09/2022","Y","Y","Yakutat plus Hoonah-Angoon",400,"Other Southeast Region - Northern",8,12,468,13,475,0,9,0,5
"03/10/2022","Y","Y","Yakutat plus Hoonah-Angoon",400,"Other Southeast Region - Northern",8,5,473,5,480,0,9,0,5
"03/11/2022","Y","Y","Yakutat plus Hoonah-Angoon",400,"Other Southeast Region - Northern",8,5,478,5,485,0,9,0,5
"03/14/2022","Y","Y","Yakutat plus Hoonah-Angoon",400,"Other Southeast Region - Northern",8,5,483,2,487,0,9,0,5
"03/15/2022","Y","Y","Yakutat plus Hoonah-Angoon",400,"Other Southeast Region - Northern",8,1,484,1,488,0,9,0,5
"03/19/2022","Y","Y","Yakutat plus Hoonah-Angoon",400,"Other Southeast Region - Northern",8,4,488,0,488,0,9,0,5
"03/27/2022","Y","Y","Yakutat plus Hoonah-Angoon",400,"Other Southeast Region - Northern",8,1,489,1,489,0,9,0,5
"03/30/2022","Y","Y","Yakutat plus Hoonah-Angoon",400,"Other Southeast Region - Northern",8,0,489,2,491,0,9,0,5
"03/31/2022","Y","Y","Yakutat plus Hoonah-Angoon",400,"Other Southeast Region - Northern",8,2,491,0,491,0,9,0,5
"04/04/2022","Y","Y","Yakutat plus Hoonah-Angoon",400,"Other Southeast Region - Northern",8,0,491,1,492,0,9,0,5
"04/05/2022","Y","Y","Yakutat plus Hoonah-Angoon",400,"Other Southeast Region - Northern",8,0,491,1,493,0,9,0,5
"04/06/2022","Y","Y","Yakutat plus Hoonah-Angoon",400,"Other Southeast Region - Northern",8,2,493,1,494,0,9,0,5
"04/07/2022","Y","Y","Yakutat plus Hoonah-Angoon",400,"Other Southeast Region - Northern",8,2,495,2,496,0,9,0,5
"04/09/2022","Y","Y","Yakutat plus Hoonah-Angoon",400,"Other Southeast Region - Northern",8,1,496,2,498,0,9,0,5
"04/11/2022","Y","Y","Yakutat plus Hoonah-Angoon",400,"Other Southeast Region - Northern",8,2,498,2,500,0,9,0,5
"04/12/2022","Y","Y","Yakutat plus Hoonah-Angoon",400,"Other Southeast Region - Northern",8,0,498,1,501,0,9,0,5
"04/13/2022","Y","Y","Yakutat plus Hoonah-Angoon",400,"Other Southeast Region - Northern",8,0,498,1,502,0,9,0,5
"04/14/2022","Y","Y","Yakutat plus Hoonah-Angoon",400,"Other Southeast Region - Northern",8,0,498,1,503,0,9,0,5
"04/15/2022","Y","Y","Yakutat plus Hoonah-Angoon",400,"Other Southeast Region - Northern",8,2,500,0,503,0,9,0,5
"04/18/2022","Y","Y","Yakutat plus Hoonah-Angoon",400,"Other Southeast Region - Northern",8,3,503,0,503,0,9,0,5
"04/25/2022","Y","Y","Yakutat plus Hoonah-Angoon",400,"Other Southeast Region - Northern",8,1,504,1,504,0,9,0,5
"04/26/2022","Y","Y","Yakutat plus Hoonah-Angoon",400,"Other Southeast Region - Northern",8,3,507,3,507,0,9,0,5
"03/25/2020","Y","Y","Yukon-Koyukuk Census Area",290,"Other Interior Region",7,0,0,1,1,0,0,0,0
"03/27/2020","Y","Y","Yukon-Koyukuk Census Area",290,"Other Interior Region",7,1,1,0,1,0,0,0,0
"06/17/2020","Y","Y","Yukon-Koyukuk Census Area",290,"Other Interior Region",7,0,1,1,2,0,0,0,0
"06/19/2020","Y","Y","Yukon-Koyukuk Census Area",290,"Other Interior Region",7,1,2,0,2,0,0,0,0
"06/26/2020","Y","Y","Yukon-Koyukuk Census Area",290,"Other Interior Region",7,1,3,0,2,0,0,0,0
"06/28/2020","Y","Y","Yukon-Koyukuk Census Area",290,"Other Interior Region",7,0,3,1,3,0,0,0,0
"06/29/2020","Y","Y","Yukon-Koyukuk Census Area",290,"Other Interior Region",7,0,3,1,4,0,0,0,0
"07/03/2020","Y","Y","Yukon-Koyukuk Census Area",290,"Other Interior Region",7,1,4,2,6,0,0,0,0
"07/06/2020","Y","Y","Yukon-Koyukuk Census Area",290,"Other Interior Region",7,1,5,1,7,0,0,0,0
"07/08/2020","Y","Y","Yukon-Koyukuk Census Area",290,"Other Interior Region",7,0,5,3,10,0,0,0,0
"07/09/2020","Y","Y","Yukon-Koyukuk Census Area",290,"Other Interior Region",7,0,5,1,11,0,0,0,0
"07/10/2020","Y","Y","Yukon-Koyukuk Census Area",290,"Other Interior Region",7,2,7,3,14,0,0,0,0
"07/11/2020","Y","Y","Yukon-Koyukuk Census Area",290,"Other Interior Region",7,6,13,0,14,0,0,0,0
"07/13/2020","Y","Y","Yukon-Koyukuk Census Area",290,"Other Interior Region",7,1,14,1,15,0,0,0,0
"07/14/2020","Y","Y","Yukon-Koyukuk Census Area",290,"Other Interior Region",7,2,16,5,20,0,0,0,0
"07/15/2020","Y","Y","Yukon-Koyukuk Census Area",290,"Other Interior Region",7,2,18,5,25,0,0,0,0
"07/16/2020","Y","Y","Yukon-Koyukuk Census Area",290,"Other Interior Region",7,1,19,2,27,1,1,0,0
"07/17/2020","Y","Y","Yukon-Koyukuk Census Area",290,"Other Interior Region",7,0,19,2,29,0,1,0,0
"07/18/2020","Y","Y","Yukon-Koyukuk Census Area",290,"Other Interior Region",7,10,29,6,35,0,1,0,0
"07/20/2020","Y","Y","Yukon-Koyukuk Census Area",290,"Other Interior Region",7,0,29,1,36,1,2,0,0
"07/21/2020","Y","Y","Yukon-Koyukuk Census Area",290,"Other Interior Region",7,4,33,4,40,0,2,0,0
"07/22/2020","Y","Y","Yukon-Koyukuk Census Area",290,"Other Interior Region",7,4,37,2,42,0,2,0,0
"07/23/2020","Y","Y","Yukon-Koyukuk Census Area",290,"Other Interior Region",7,1,38,3,45,0,2,0,0
"07/24/2020","Y","Y","Yukon-Koyukuk Census Area",290,"Other Interior Region",7,3,41,0,45,0,2,0,0
"07/25/2020","Y","Y","Yukon-Koyukuk Census Area",290,"Other Interior Region",7,1,42,0,45,0,2,0,0
"07/26/2020","Y","Y","Yukon-Koyukuk Census Area",290,"Other Interior Region",7,0,42,0,45,0,2,1,1
"07/27/2020","Y","Y","Yukon-Koyukuk Census Area",290,"Other Interior Region",7,0,42,1,46,0,2,0,1
"07/28/2020","Y","Y","Yukon-Koyukuk Census Area",290,"Other Interior Region",7,0,42,1,47,0,2,0,1
"07/29/2020","Y","Y","Yukon-Koyukuk Census Area",290,"Other Interior Region",7,0,42,1,48,0,2,0,1
"07/30/2020","Y","Y","Yukon-Koyukuk Census Area",290,"Other Interior Region",7,3,45,0,48,0,2,0,1
"07/31/2020","Y","Y","Yukon-Koyukuk Census Area",290,"Other Interior Region",7,1,46,2,50,0,2,0,1
"08/01/2020","Y","Y","Yukon-Koyukuk Census Area",290,"Other Interior Region",7,1,47,0,50,0,2,0,1
"08/03/2020","Y","Y","Yukon-Koyukuk Census Area",290,"Other Interior Region",7,1,48,2,52,0,2,0,1
"08/04/2020","Y","Y","Yukon-Koyukuk Census Area",290,"Other Interior Region",7,1,49,1,53,0,2,0,1
"08/05/2020","Y","Y","Yukon-Koyukuk Census Area",290,"Other Interior Region",7,0,49,1,54,1,3,0,1
"08/06/2020","Y","Y","Yukon-Koyukuk Census Area",290,"Other Interior Region",7,1,50,0,54,0,3,0,1
"08/07/2020","Y","Y","Yukon-Koyukuk Census Area",290,"Other Interior Region",7,2,52,0,54,0,3,0,1
"08/08/2020","Y","Y","Yukon-Koyukuk Census Area",290,"Other Interior Region",7,1,53,1,55,0,3,0,1
"08/09/2020","Y","Y","Yukon-Koyukuk Census Area",290,"Other Interior Region",7,1,54,0,55,0,3,0,1
"08/10/2020","Y","Y","Yukon-Koyukuk Census Area",290,"Other Interior Region",7,0,54,1,56,0,3,0,1
"08/11/2020","Y","Y","Yukon-Koyukuk Census Area",290,"Other Interior Region",7,1,55,0,56,0,3,0,1
"08/12/2020","Y","Y","Yukon-Koyukuk Census Area",290,"Other Interior Region",7,1,56,3,59,1,4,0,1
"08/14/2020","Y","Y","Yukon-Koyukuk Census Area",290,"Other Interior Region",7,2,58,1,60,0,4,0,1
"08/16/2020","Y","Y","Yukon-Koyukuk Census Area",290,"Other Interior Region",7,1,59,0,60,0,4,0,1
"08/17/2020","Y","Y","Yukon-Koyukuk Census Area",290,"Other Interior Region",7,1,60,1,61,0,4,0,1
"08/18/2020","Y","Y","Yukon-Koyukuk Census Area",290,"Other Interior Region",7,0,60,1,62,0,4,0,1
"08/19/2020","Y","Y","Yukon-Koyukuk Census Area",290,"Other Interior Region",7,1,61,4,66,0,4,0,1
"08/20/2020","Y","Y","Yukon-Koyukuk Census Area",290,"Other Interior Region",7,4,65,2,68,0,4,0,1
"08/21/2020","Y","Y","Yukon-Koyukuk Census Area",290,"Other Interior Region",7,2,67,0,68,0,4,0,1
"08/22/2020","Y","Y","Yukon-Koyukuk Census Area",290,"Other Interior Region",7,0,67,0,68,0,4,1,2
"08/24/2020","Y","Y","Yukon-Koyukuk Census Area",290,"Other Interior Region",7,0,67,1,69,0,4,0,2
"08/25/2020","Y","Y","Yukon-Koyukuk Census Area",290,"Other Interior Region",7,0,67,2,71,0,4,0,2
"08/26/2020","Y","Y","Yukon-Koyukuk Census Area",290,"Other Interior Region",7,1,68,1,72,0,4,0,2
"08/27/2020","Y","Y","Yukon-Koyukuk Census Area",290,"Other Interior Region",7,2,70,0,72,0,4,0,2
"08/28/2020","Y","Y","Yukon-Koyukuk Census Area",290,"Other Interior Region",7,2,72,0,72,0,4,0,2
"08/29/2020","Y","Y","Yukon-Koyukuk Census Area",290,"Other Interior Region",7,0,72,0,72,1,5,0,2
"09/03/2020","Y","Y","Yukon-Koyukuk Census Area",290,"Other Interior Region",7,0,72,1,73,0,5,0,2
"09/04/2020","Y","Y","Yukon-Koyukuk Census Area",290,"Other Interior Region",7,1,73,0,73,0,5,0,2
"09/09/2020","Y","Y","Yukon-Koyukuk Census Area",290,"Other Interior Region",7,1,74,2,75,0,5,0,2
"09/10/2020","Y","Y","Yukon-Koyukuk Census Area",290,"Other Interior Region",7,1,75,0,75,0,5,0,2
"09/11/2020","Y","Y","Yukon-Koyukuk Census Area",290,"Other Interior Region",7,0,75,1,76,0,5,0,2
"09/12/2020","Y","Y","Yukon-Koyukuk Census Area",290,"Other Interior Region",7,1,76,1,77,0,5,0,2
"09/13/2020","Y","Y","Yukon-Koyukuk Census Area",290,"Other Interior Region",7,1,77,0,77,0,5,0,2
"09/16/2020","Y","Y","Yukon-Koyukuk Census Area",290,"Other Interior Region",7,0,77,1,78,0,5,0,2
"09/17/2020","Y","Y","Yukon-Koyukuk Census Area",290,"Other Interior Region",7,1,78,1,79,1,6,0,2
"09/18/2020","Y","Y","Yukon-Koyukuk Census Area",290,"Other Interior Region",7,1,79,1,80,0,6,0,2
"09/19/2020","Y","Y","Yukon-Koyukuk Census Area",290,"Other Interior Region",7,1,80,0,80,0,6,0,2
"09/24/2020","Y","Y","Yukon-Koyukuk Census Area",290,"Other Interior Region",7,1,81,1,81,0,6,0,2
"09/25/2020","Y","Y","Yukon-Koyukuk Census Area",290,"Other Interior Region",7,0,81,1,82,0,6,0,2
"09/26/2020","Y","Y","Yukon-Koyukuk Census Area",290,"Other Interior Region",7,1,82,0,82,0,6,0,2
"09/30/2020","Y","Y","Yukon-Koyukuk Census Area",290,"Other Interior Region",7,1,83,1,83,0,6,0,2
"10/01/2020","Y","Y","Yukon-Koyukuk Census Area",290,"Other Interior Region",7,2,85,3,86,0,6,0,2
"10/06/2020","Y","Y","Yukon-Koyukuk Census Area",290,"Other Interior Region",7,1,86,4,90,0,6,0,2
"10/07/2020","Y","Y","Yukon-Koyukuk Census Area",290,"Other Interior Region",7,2,88,0,90,0,6,0,2
"10/08/2020","Y","Y","Yukon-Koyukuk Census Area",290,"Other Interior Region",7,1,89,5,95,0,6,0,2
"10/09/2020","Y","Y","Yukon-Koyukuk Census Area",290,"Other Interior Region",7,1,90,0,95,0,6,0,2
"10/10/2020","Y","Y","Yukon-Koyukuk Census Area",290,"Other Interior Region",7,5,95,0,95,0,6,0,2
"10/11/2020","Y","Y","Yukon-Koyukuk Census Area",290,"Other Interior Region",7,1,96,1,96,0,6,0,2
"10/13/2020","Y","Y","Yukon-Koyukuk Census Area",290,"Other Interior Region",7,0,96,1,97,0,6,0,2
"10/14/2020","Y","Y","Yukon-Koyukuk Census Area",290,"Other Interior Region",7,0,96,3,100,0,6,0,2
"10/15/2020","Y","Y","Yukon-Koyukuk Census Area",290,"Other Interior Region",7,1,97,2,102,0,6,0,2
"10/16/2020","Y","Y","Yukon-Koyukuk Census Area",290,"Other Interior Region",7,2,99,3,105,0,6,0,2
"10/17/2020","Y","Y","Yukon-Koyukuk Census Area",290,"Other Interior Region",7,3,102,0,105,0,6,0,2
"10/18/2020","Y","Y","Yukon-Koyukuk Census Area",290,"Other Interior Region",7,1,103,0,105,0,6,0,2
"10/19/2020","Y","Y","Yukon-Koyukuk Census Area",290,"Other Interior Region",7,2,105,2,107,0,6,0,2
"10/20/2020","Y","Y","Yukon-Koyukuk Census Area",290,"Other Interior Region",7,0,105,2,109,0,6,0,2
"10/21/2020","Y","Y","Yukon-Koyukuk Census Area",290,"Other Interior Region",7,0,105,1,110,0,6,0,2
"10/22/2020","Y","Y","Yukon-Koyukuk Census Area",290,"Other Interior Region",7,1,106,4,114,0,6,0,2
"10/23/2020","Y","Y","Yukon-Koyukuk Census Area",290,"Other Interior Region",7,0,106,2,116,0,6,0,2
"10/24/2020","Y","Y","Yukon-Koyukuk Census Area",290,"Other Interior Region",7,5,111,0,116,0,6,0,2
"10/25/2020","Y","Y","Yukon-Koyukuk Census Area",290,"Other Interior Region",7,0,111,0,116,0,6,1,3
"10/26/2020","Y","Y","Yukon-Koyukuk Census Area",290,"Other Interior Region",7,3,114,1,117,0,6,0,3
"10/27/2020","Y","Y","Yukon-Koyukuk Census Area",290,"Other Interior Region",7,0,114,2,119,0,6,0,3
"10/28/2020","Y","Y","Yukon-Koyukuk Census Area",290,"Other Interior Region",7,4,118,3,122,0,6,0,3
"10/29/2020","Y","Y","Yukon-Koyukuk Census Area",290,"Other Interior Region",7,0,118,1,123,0,6,0,3
"10/30/2020","Y","Y","Yukon-Koyukuk Census Area",290,"Other Interior Region",7,2,120,0,123,0,6,0,3
"11/01/2020","Y","Y","Yukon-Koyukuk Census Area",290,"Other Interior Region",7,2,122,1,124,0,6,0,3
"11/02/2020","Y","Y","Yukon-Koyukuk Census Area",290,"Other Interior Region",7,0,122,2,126,0,6,0,3
"11/03/2020","Y","Y","Yukon-Koyukuk Census Area",290,"Other Interior Region",7,1,123,0,126,0,6,0,3
"11/04/2020","Y","Y","Yukon-Koyukuk Census Area",290,"Other Interior Region",7,1,124,0,126,0,6,0,3
"11/05/2020","Y","Y","Yukon-Koyukuk Census Area",290,"Other Interior Region",7,1,125,0,126,0,6,0,3
"11/06/2020","Y","Y","Yukon-Koyukuk Census Area",290,"Other Interior Region",7,0,125,1,127,0,6,0,3
"11/07/2020","Y","Y","Yukon-Koyukuk Census Area",290,"Other Interior Region",7,0,125,4,131,1,7,0,3
"11/08/2020","Y","Y","Yukon-Koyukuk Census Area",290,"Other Interior Region",7,3,128,1,132,0,7,0,3
"11/09/2020","Y","Y","Yukon-Koyukuk Census Area",290,"Other Interior Region",7,2,130,0,132,0,7,0,3
"11/10/2020","Y","Y","Yukon-Koyukuk Census Area",290,"Other Interior Region",7,1,131,3,135,0,7,0,3
"11/11/2020","Y","Y","Yukon-Koyukuk Census Area",290,"Other Interior Region",7,0,131,1,136,0,7,0,3
"11/13/2020","Y","Y","Yukon-Koyukuk Census Area",290,"Other Interior Region",7,2,133,5,141,1,8,0,3
"11/14/2020","Y","Y","Yukon-Koyukuk Census Area",290,"Other Interior Region",7,4,137,1,142,0,8,0,3
"11/15/2020","Y","Y","Yukon-Koyukuk Census Area",290,"Other Interior Region",7,1,138,1,143,0,8,0,3
"11/16/2020","Y","Y","Yukon-Koyukuk Census Area",290,"Other Interior Region",7,2,140,2,145,0,8,1,4
"11/17/2020","Y","Y","Yukon-Koyukuk Census Area",290,"Other Interior Region",7,6,146,12,157,0,8,0,4
"11/18/2020","Y","Y","Yukon-Koyukuk Census Area",290,"Other Interior Region",7,3,149,1,158,0,8,0,4
"11/19/2020","Y","Y","Yukon-Koyukuk Census Area",290,"Other Interior Region",7,5,154,10,168,0,8,0,4
"11/20/2020","Y","Y","Yukon-Koyukuk Census Area",290,"Other Interior Region",7,0,154,3,171,0,8,0,4
"11/21/2020","Y","Y","Yukon-Koyukuk Census Area",290,"Other Interior Region",7,4,158,1,172,0,8,0,4
"11/22/2020","Y","Y","Yukon-Koyukuk Census Area",290,"Other Interior Region",7,4,162,1,173,0,8,0,4
"11/23/2020","Y","Y","Yukon-Koyukuk Census Area",290,"Other Interior Region",7,4,166,2,175,0,8,0,4
"11/24/2020","Y","Y","Yukon-Koyukuk Census Area",290,"Other Interior Region",7,1,167,1,176,0,8,0,4
"11/25/2020","Y","Y","Yukon-Koyukuk Census Area",290,"Other Interior Region",7,1,168,2,178,0,8,0,4
"11/26/2020","Y","Y","Yukon-Koyukuk Census Area",290,"Other Interior Region",7,3,171,0,178,0,8,0,4
"11/27/2020","Y","Y","Yukon-Koyukuk Census Area",290,"Other Interior Region",7,4,175,2,180,0,8,0,4
"11/28/2020","Y","Y","Yukon-Koyukuk Census Area",290,"Other Interior Region",7,0,175,2,182,0,8,0,4
"11/29/2020","Y","Y","Yukon-Koyukuk Census Area",290,"Other Interior Region",7,0,175,3,185,0,8,0,4
"11/30/2020","Y","Y","Yukon-Koyukuk Census Area",290,"Other Interior Region",7,3,178,3,188,0,8,0,4
"12/01/2020","Y","Y","Yukon-Koyukuk Census Area",290,"Other Interior Region",7,0,178,1,189,0,8,0,4
"12/02/2020","Y","Y","Yukon-Koyukuk Census Area",290,"Other Interior Region",7,1,179,1,190,0,8,0,4
"12/03/2020","Y","Y","Yukon-Koyukuk Census Area",290,"Other Interior Region",7,7,186,0,190,0,8,0,4
"12/04/2020","Y","Y","Yukon-Koyukuk Census Area",290,"Other Interior Region",7,2,188,6,196,1,9,0,4
"12/06/2020","Y","Y","Yukon-Koyukuk Census Area",290,"Other Interior Region",7,1,189,0,196,0,9,0,4
"12/07/2020","Y","Y","Yukon-Koyukuk Census Area",290,"Other Interior Region",7,1,190,3,199,0,9,0,4
"12/08/2020","Y","Y","Yukon-Koyukuk Census Area",290,"Other Interior Region",7,1,191,0,199,0,9,0,4
"12/09/2020","Y","Y","Yukon-Koyukuk Census Area",290,"Other Interior Region",7,3,194,1,200,0,9,0,4
"12/10/2020","Y","Y","Yukon-Koyukuk Census Area",290,"Other Interior Region",7,2,196,3,203,0,9,0,4
"12/11/2020","Y","Y","Yukon-Koyukuk Census Area",290,"Other Interior Region",7,0,196,3,206,0,9,0,4
"12/12/2020","Y","Y","Yukon-Koyukuk Census Area",290,"Other Interior Region",7,1,197,0,206,0,9,0,4
"12/13/2020","Y","Y","Yukon-Koyukuk Census Area",290,"Other Interior Region",7,1,198,0,206,0,9,0,4
"12/14/2020","Y","Y","Yukon-Koyukuk Census Area",290,"Other Interior Region",7,0,198,2,208,0,9,0,4
"12/15/2020","Y","Y","Yukon-Koyukuk Census Area",290,"Other Interior Region",7,5,203,3,211,0,9,0,4
"12/16/2020","Y","Y","Yukon-Koyukuk Census Area",290,"Other Interior Region",7,1,204,1,212,0,9,0,4
"12/17/2020","Y","Y","Yukon-Koyukuk Census Area",290,"Other Interior Region",7,2,206,2,214,0,9,0,4
"12/18/2020","Y","Y","Yukon-Koyukuk Census Area",290,"Other Interior Region",7,5,211,1,215,0,9,0,4
"12/21/2020","Y","Y","Yukon-Koyukuk Census Area",290,"Other Interior Region",7,1,212,0,215,0,9,0,4
"12/22/2020","Y","Y","Yukon-Koyukuk Census Area",290,"Other Interior Region",7,0,212,1,216,0,9,0,4
"12/23/2020","Y","Y","Yukon-Koyukuk Census Area",290,"Other Interior Region",7,1,213,1,217,0,9,0,4
"12/26/2020","Y","Y","Yukon-Koyukuk Census Area",290,"Other Interior Region",7,0,213,2,219,0,9,0,4
"12/27/2020","Y","Y","Yukon-Koyukuk Census Area",290,"Other Interior Region",7,1,214,1,220,0,9,0,4
"12/28/2020","Y","Y","Yukon-Koyukuk Census Area",290,"Other Interior Region",7,0,214,5,225,0,9,0,4
"12/29/2020","Y","Y","Yukon-Koyukuk Census Area",290,"Other Interior Region",7,1,215,2,227,0,9,0,4
"12/30/2020","Y","Y","Yukon-Koyukuk Census Area",290,"Other Interior Region",7,1,216,0,227,0,9,0,4
"01/01/2021","Y","Y","Yukon-Koyukuk Census Area",290,"Other Interior Region",7,0,216,1,228,0,9,0,4
"01/02/2021","Y","Y","Yukon-Koyukuk Census Area",290,"Other Interior Region",7,0,216,0,228,1,10,0,4
"01/03/2021","Y","Y","Yukon-Koyukuk Census Area",290,"Other Interior Region",7,4,220,2,230,0,10,0,4
"01/04/2021","Y","Y","Yukon-Koyukuk Census Area",290,"Other Interior Region",7,2,222,5,235,0,10,0,4
"01/05/2021","Y","Y","Yukon-Koyukuk Census Area",290,"Other Interior Region",7,2,224,1,236,0,10,0,4
"01/06/2021","Y","Y","Yukon-Koyukuk Census Area",290,"Other Interior Region",7,3,227,3,239,0,10,0,4
"01/07/2021","Y","Y","Yukon-Koyukuk Census Area",290,"Other Interior Region",7,9,236,6,245,0,10,0,4
"01/08/2021","Y","Y","Yukon-Koyukuk Census Area",290,"Other Interior Region",7,1,237,7,252,1,11,0,4
"01/09/2021","Y","Y","Yukon-Koyukuk Census Area",290,"Other Interior Region",7,2,239,2,254,0,11,0,4
"01/10/2021","Y","Y","Yukon-Koyukuk Census Area",290,"Other Interior Region",7,1,240,2,256,0,11,0,4
"01/11/2021","Y","Y","Yukon-Koyukuk Census Area",290,"Other Interior Region",7,0,240,9,265,0,11,0,4
"01/12/2021","Y","Y","Yukon-Koyukuk Census Area",290,"Other Interior Region",7,6,246,4,269,0,11,0,4
"01/13/2021","Y","Y","Yukon-Koyukuk Census Area",290,"Other Interior Region",7,3,249,3,272,0,11,0,4
"01/14/2021","Y","Y","Yukon-Koyukuk Census Area",290,"Other Interior Region",7,2,251,7,279,0,11,0,4
"01/15/2021","Y","Y","Yukon-Koyukuk Census Area",290,"Other Interior Region",7,2,253,3,282,0,11,0,4
"01/16/2021","Y","Y","Yukon-Koyukuk Census Area",290,"Other Interior Region",7,3,256,1,283,0,11,0,4
"01/18/2021","Y","Y","Yukon-Koyukuk Census Area",290,"Other Interior Region",7,3,259,1,284,0,11,0,4
"01/19/2021","Y","Y","Yukon-Koyukuk Census Area",290,"Other Interior Region",7,0,259,2,286,0,11,0,4
"01/20/2021","Y","Y","Yukon-Koyukuk Census Area",290,"Other Interior Region",7,1,260,1,287,0,11,0,4
"01/21/2021","Y","Y","Yukon-Koyukuk Census Area",290,"Other Interior Region",7,2,262,0,287,0,11,0,4
"01/22/2021","Y","Y","Yukon-Koyukuk Census Area",290,"Other Interior Region",7,0,262,3,290,0,11,0,4
"01/23/2021","Y","Y","Yukon-Koyukuk Census Area",290,"Other Interior Region",7,2,264,1,291,0,11,0,4
"01/25/2021","Y","Y","Yukon-Koyukuk Census Area",290,"Other Interior Region",7,0,264,1,292,0,11,0,4
"01/26/2021","Y","Y","Yukon-Koyukuk Census Area",290,"Other Interior Region",7,0,264,5,297,0,11,0,4
"01/27/2021","Y","Y","Yukon-Koyukuk Census Area",290,"Other Interior Region",7,4,268,1,298,0,11,0,4
"01/28/2021","Y","Y","Yukon-Koyukuk Census Area",290,"Other Interior Region",7,0,268,3,301,0,11,0,4
"01/29/2021","Y","Y","Yukon-Koyukuk Census Area",290,"Other Interior Region",7,1,269,3,304,0,11,0,4
"01/30/2021","Y","Y","Yukon-Koyukuk Census Area",290,"Other Interior Region",7,2,271,0,304,0,11,0,4
"02/01/2021","Y","Y","Yukon-Koyukuk Census Area",290,"Other Interior Region",7,1,272,5,309,0,11,0,4
"02/02/2021","Y","Y","Yukon-Koyukuk Census Area",290,"Other Interior Region",7,1,273,1,310,0,11,0,4
"02/03/2021","Y","Y","Yukon-Koyukuk Census Area",290,"Other Interior Region",7,0,273,1,311,0,11,0,4
"02/04/2021","Y","Y","Yukon-Koyukuk Census Area",290,"Other Interior Region",7,0,273,2,313,0,11,0,4
"02/05/2021","Y","Y","Yukon-Koyukuk Census Area",290,"Other Interior Region",7,2,275,4,317,0,11,0,4
"02/06/2021","Y","Y","Yukon-Koyukuk Census Area",290,"Other Interior Region",7,39,314,0,317,0,11,0,4
"02/08/2021","Y","Y","Yukon-Koyukuk Census Area",290,"Other Interior Region",7,0,314,1,318,0,11,0,4
"02/09/2021","Y","Y","Yukon-Koyukuk Census Area",290,"Other Interior Region",7,3,317,4,322,1,12,0,4
"02/10/2021","Y","Y","Yukon-Koyukuk Census Area",290,"Other Interior Region",7,1,318,1,323,0,12,0,4
"02/11/2021","Y","Y","Yukon-Koyukuk Census Area",290,"Other Interior Region",7,4,322,0,323,0,12,0,4
"02/12/2021","Y","Y","Yukon-Koyukuk Census Area",290,"Other Interior Region",7,1,323,0,323,0,12,0,4
"02/14/2021","Y","Y","Yukon-Koyukuk Census Area",290,"Other Interior Region",7,0,323,1,324,1,13,0,4
"02/16/2021","Y","Y","Yukon-Koyukuk Census Area",290,"Other Interior Region",7,3,326,3,327,0,13,0,4
"02/17/2021","Y","Y","Yukon-Koyukuk Census Area",290,"Other Interior Region",7,1,327,2,329,0,13,0,4
"02/18/2021","Y","Y","Yukon-Koyukuk Census Area",290,"Other Interior Region",7,2,329,0,329,0,13,0,4
"02/19/2021","Y","Y","Yukon-Koyukuk Census Area",290,"Other Interior Region",7,7,336,7,336,0,13,0,4
"03/05/2021","Y","Y","Yukon-Koyukuk Census Area",290,"Other Interior Region",7,1,337,1,337,0,13,0,4
"03/08/2021","Y","Y","Yukon-Koyukuk Census Area",290,"Other Interior Region",7,0,337,1,338,0,13,0,4
"03/09/2021","Y","Y","Yukon-Koyukuk Census Area",290,"Other Interior Region",7,1,338,1,339,0,13,0,4
"03/11/2021","Y","Y","Yukon-Koyukuk Census Area",290,"Other Interior Region",7,1,339,0,339,0,13,0,4
"03/12/2021","Y","Y","Yukon-Koyukuk Census Area",290,"Other Interior Region",7,0,339,1,340,0,13,0,4
"03/17/2021","Y","Y","Yukon-Koyukuk Census Area",290,"Other Interior Region",7,1,340,0,340,0,13,0,4
"03/19/2021","Y","Y","Yukon-Koyukuk Census Area",290,"Other Interior Region",7,0,340,2,342,0,13,0,4
"03/20/2021","Y","Y","Yukon-Koyukuk Census Area",290,"Other Interior Region",7,2,342,0,342,0,13,0,4
"03/23/2021","Y","Y","Yukon-Koyukuk Census Area",290,"Other Interior Region",7,0,342,1,343,0,13,0,4
"03/24/2021","Y","Y","Yukon-Koyukuk Census Area",290,"Other Interior Region",7,0,342,3,346,0,13,0,4
"03/25/2021","Y","Y","Yukon-Koyukuk Census Area",290,"Other Interior Region",7,3,345,0,346,0,13,0,4
"03/31/2021","Y","Y","Yukon-Koyukuk Census Area",290,"Other Interior Region",7,1,346,0,346,0,13,0,4
"04/06/2021","Y","Y","Yukon-Koyukuk Census Area",290,"Other Interior Region",7,0,346,2,348,0,13,0,4
"04/07/2021","Y","Y","Yukon-Koyukuk Census Area",290,"Other Interior Region",7,0,346,2,350,0,13,0,4
"04/08/2021","Y","Y","Yukon-Koyukuk Census Area",290,"Other Interior Region",7,3,349,0,350,0,13,0,4
"04/09/2021","Y","Y","Yukon-Koyukuk Census Area",290,"Other Interior Region",7,1,350,3,353,0,13,0,4
"04/10/2021","Y","Y","Yukon-Koyukuk Census Area",290,"Other Interior Region",7,1,351,0,353,0,13,0,4
"04/12/2021","Y","Y","Yukon-Koyukuk Census Area",290,"Other Interior Region",7,2,353,0,353,0,13,0,4
"04/16/2021","Y","Y","Yukon-Koyukuk Census Area",290,"Other Interior Region",7,0,353,1,354,0,13,0,4
"04/18/2021","Y","Y","Yukon-Koyukuk Census Area",290,"Other Interior Region",7,1,354,0,354,0,13,0,4
"04/19/2021","Y","Y","Yukon-Koyukuk Census Area",290,"Other Interior Region",7,0,354,0,354,1,14,0,4
"04/20/2021","Y","Y","Yukon-Koyukuk Census Area",290,"Other Interior Region",7,1,355,1,355,0,14,0,4
"04/28/2021","Y","Y","Yukon-Koyukuk Census Area",290,"Other Interior Region",7,0,355,1,356,0,14,0,4
"04/30/2021","Y","Y","Yukon-Koyukuk Census Area",290,"Other Interior Region",7,0,355,1,357,0,14,0,4
"05/02/2021","Y","Y","Yukon-Koyukuk Census Area",290,"Other Interior Region",7,1,356,0,357,0,14,0,4
"05/03/2021","Y","Y","Yukon-Koyukuk Census Area",290,"Other Interior Region",7,1,357,0,357,0,14,0,4
"05/05/2021","Y","Y","Yukon-Koyukuk Census Area",290,"Other Interior Region",7,0,357,2,359,0,14,0,4
"05/06/2021","Y","Y","Yukon-Koyukuk Census Area",290,"Other Interior Region",7,1,358,0,359,0,14,0,4
"05/09/2021","Y","Y","Yukon-Koyukuk Census Area",290,"Other Interior Region",7,0,358,1,360,0,14,0,4
"05/10/2021","Y","Y","Yukon-Koyukuk Census Area",290,"Other Interior Region",7,1,359,0,360,1,15,0,4
"05/11/2021","Y","Y","Yukon-Koyukuk Census Area",290,"Other Interior Region",7,1,360,1,361,0,15,0,4
"05/18/2021","Y","Y","Yukon-Koyukuk Census Area",290,"Other Interior Region",7,0,360,1,362,0,15,0,4
"05/20/2021","Y","Y","Yukon-Koyukuk Census Area",290,"Other Interior Region",7,0,360,1,363,0,15,0,4
"05/24/2021","Y","Y","Yukon-Koyukuk Census Area",290,"Other Interior Region",7,3,363,0,363,0,15,0,4
"06/10/2021","Y","Y","Yukon-Koyukuk Census Area",290,"Other Interior Region",7,0,363,1,364,0,15,0,4
"06/13/2021","Y","Y","Yukon-Koyukuk Census Area",290,"Other Interior Region",7,1,364,0,364,0,15,0,4
"06/30/2021","Y","Y","Yukon-Koyukuk Census Area",290,"Other Interior Region",7,0,364,2,366,0,15,0,4
"07/01/2021","Y","Y","Yukon-Koyukuk Census Area",290,"Other Interior Region",7,2,366,0,366,0,15,0,4
"07/08/2021","Y","Y","Yukon-Koyukuk Census Area",290,"Other Interior Region",7,0,366,1,367,0,15,0,4
"07/09/2021","Y","Y","Yukon-Koyukuk Census Area",290,"Other Interior Region",7,1,367,0,367,0,15,0,4
"07/12/2021","Y","Y","Yukon-Koyukuk Census Area",290,"Other Interior Region",7,0,367,1,368,0,15,0,4
"07/15/2021","Y","Y","Yukon-Koyukuk Census Area",290,"Other Interior Region",7,1,368,0,368,0,15,0,4
"07/20/2021","Y","Y","Yukon-Koyukuk Census Area",290,"Other Interior Region",7,1,369,1,369,0,15,0,4
"07/22/2021","Y","Y","Yukon-Koyukuk Census Area",290,"Other Interior Region",7,0,369,1,370,0,15,0,4
"07/23/2021","Y","Y","Yukon-Koyukuk Census Area",290,"Other Interior Region",7,1,370,1,371,0,15,0,4
"07/26/2021","Y","Y","Yukon-Koyukuk Census Area",290,"Other Interior Region",7,0,370,1,372,0,15,0,4
"07/27/2021","Y","Y","Yukon-Koyukuk Census Area",290,"Other Interior Region",7,3,373,2,374,0,15,0,4
"07/28/2021","Y","Y","Yukon-Koyukuk Census Area",290,"Other Interior Region",7,1,374,0,374,0,15,0,4
"07/31/2021","Y","Y","Yukon-Koyukuk Census Area",290,"Other Interior Region",7,0,374,2,376,0,15,0,4
"08/01/2021","Y","Y","Yukon-Koyukuk Census Area",290,"Other Interior Region",7,2,376,2,378,0,15,0,4
"08/02/2021","Y","Y","Yukon-Koyukuk Census Area",290,"Other Interior Region",7,2,378,3,381,0,15,0,4
"08/03/2021","Y","Y","Yukon-Koyukuk Census Area",290,"Other Interior Region",7,2,380,2,383,0,15,0,4
"08/04/2021","Y","Y","Yukon-Koyukuk Census Area",290,"Other Interior Region",7,3,383,1,384,0,15,0,4
"08/05/2021","Y","Y","Yukon-Koyukuk Census Area",290,"Other Interior Region",7,0,383,1,385,0,15,0,4
"08/06/2021","Y","Y","Yukon-Koyukuk Census Area",290,"Other Interior Region",7,2,385,1,386,0,15,0,4
"08/09/2021","Y","Y","Yukon-Koyukuk Census Area",290,"Other Interior Region",7,1,386,3,389,0,15,0,4
"08/10/2021","Y","Y","Yukon-Koyukuk Census Area",290,"Other Interior Region",7,0,386,2,391,0,15,0,4
"08/11/2021","Y","Y","Yukon-Koyukuk Census Area",290,"Other Interior Region",7,4,390,0,391,0,15,0,4
"08/12/2021","Y","Y","Yukon-Koyukuk Census Area",290,"Other Interior Region",7,0,390,2,393,0,15,0,4
"08/13/2021","Y","Y","Yukon-Koyukuk Census Area",290,"Other Interior Region",7,0,390,1,394,0,15,0,4
"08/14/2021","Y","Y","Yukon-Koyukuk Census Area",290,"Other Interior Region",7,1,391,0,394,0,15,0,4
"08/15/2021","Y","Y","Yukon-Koyukuk Census Area",290,"Other Interior Region",7,0,391,3,397,0,15,0,4
"08/16/2021","Y","Y","Yukon-Koyukuk Census Area",290,"Other Interior Region",7,1,392,2,399,0,15,0,4
"08/17/2021","Y","Y","Yukon-Koyukuk Census Area",290,"Other Interior Region",7,4,396,0,399,0,15,0,4
"08/18/2021","Y","Y","Yukon-Koyukuk Census Area",290,"Other Interior Region",7,1,397,7,406,0,15,0,4
"08/19/2021","Y","Y","Yukon-Koyukuk Census Area",290,"Other Interior Region",7,3,400,9,415,0,15,0,4
"08/20/2021","Y","Y","Yukon-Koyukuk Census Area",290,"Other Interior Region",7,4,404,3,418,0,15,0,4
"08/21/2021","Y","Y","Yukon-Koyukuk Census Area",290,"Other Interior Region",7,0,404,1,419,0,15,0,4
"08/22/2021","Y","Y","Yukon-Koyukuk Census Area",290,"Other Interior Region",7,0,404,1,420,0,15,0,4
"08/23/2021","Y","Y","Yukon-Koyukuk Census Area",290,"Other Interior Region",7,1,405,9,429,0,15,0,4
"08/24/2021","Y","Y","Yukon-Koyukuk Census Area",290,"Other Interior Region",7,3,408,3,432,1,16,0,4
"08/25/2021","Y","Y","Yukon-Koyukuk Census Area",290,"Other Interior Region",7,2,410,0,432,0,16,0,4
"08/26/2021","Y","Y","Yukon-Koyukuk Census Area",290,"Other Interior Region",7,1,411,8,440,0,16,0,4
"08/27/2021","Y","Y","Yukon-Koyukuk Census Area",290,"Other Interior Region",7,6,417,2,442,0,16,0,4
"08/28/2021","Y","Y","Yukon-Koyukuk Census Area",290,"Other Interior Region",7,5,422,2,444,0,16,1,5
"08/29/2021","Y","Y","Yukon-Koyukuk Census Area",290,"Other Interior Region",7,1,423,2,446,2,18,0,5
"08/30/2021","Y","Y","Yukon-Koyukuk Census Area",290,"Other Interior Region",7,0,423,9,455,0,18,0,5
"08/31/2021","Y","Y","Yukon-Koyukuk Census Area",290,"Other Interior Region",7,3,426,8,463,0,18,0,5
"09/01/2021","Y","Y","Yukon-Koyukuk Census Area",290,"Other Interior Region",7,3,429,5,468,0,18,0,5
"09/02/2021","Y","Y","Yukon-Koyukuk Census Area",290,"Other Interior Region",7,2,431,2,470,0,18,0,5
"09/03/2021","Y","Y","Yukon-Koyukuk Census Area",290,"Other Interior Region",7,6,437,4,474,0,18,0,5
"09/04/2021","Y","Y","Yukon-Koyukuk Census Area",290,"Other Interior Region",7,4,441,0,474,0,18,0,5
"09/05/2021","Y","Y","Yukon-Koyukuk Census Area",290,"Other Interior Region",7,1,442,1,475,0,18,0,5
"09/06/2021","Y","Y","Yukon-Koyukuk Census Area",290,"Other Interior Region",7,4,446,1,476,0,18,0,5
"09/07/2021","Y","Y","Yukon-Koyukuk Census Area",290,"Other Interior Region",7,16,462,5,481,1,19,0,5
"09/08/2021","Y","Y","Yukon-Koyukuk Census Area",290,"Other Interior Region",7,4,466,3,484,0,19,0,5
"09/09/2021","Y","Y","Yukon-Koyukuk Census Area",290,"Other Interior Region",7,6,472,4,488,0,19,0,5
"09/10/2021","Y","Y","Yukon-Koyukuk Census Area",290,"Other Interior Region",7,0,472,8,496,0,19,0,5
"09/11/2021","Y","Y","Yukon-Koyukuk Census Area",290,"Other Interior Region",7,0,472,5,501,0,19,0,5
"09/12/2021","Y","Y","Yukon-Koyukuk Census Area",290,"Other Interior Region",7,1,473,3,504,0,19,0,5
"09/13/2021","Y","Y","Yukon-Koyukuk Census Area",290,"Other Interior Region",7,0,473,10,514,1,20,0,5
"09/14/2021","Y","Y","Yukon-Koyukuk Census Area",290,"Other Interior Region",7,6,479,8,522,0,20,1,6
"09/15/2021","Y","Y","Yukon-Koyukuk Census Area",290,"Other Interior Region",7,2,481,7,529,0,20,0,6
"09/16/2021","Y","Y","Yukon-Koyukuk Census Area",290,"Other Interior Region",7,4,485,9,538,2,22,0,6
"09/17/2021","Y","Y","Yukon-Koyukuk Census Area",290,"Other Interior Region",7,8,493,4,542,0,22,0,6
"09/18/2021","Y","Y","Yukon-Koyukuk Census Area",290,"Other Interior Region",7,7,500,0,542,0,22,1,7
"09/19/2021","Y","Y","Yukon-Koyukuk Census Area",290,"Other Interior Region",7,3,503,4,546,0,22,0,7
"09/20/2021","Y","Y","Yukon-Koyukuk Census Area",290,"Other Interior Region",7,5,508,9,555,1,23,0,7
"09/21/2021","Y","Y","Yukon-Koyukuk Census Area",290,"Other Interior Region",7,2,510,9,564,0,23,0,7
"09/22/2021","Y","Y","Yukon-Koyukuk Census Area",290,"Other Interior Region",7,11,521,7,571,1,24,0,7
"09/23/2021","Y","Y","Yukon-Koyukuk Census Area",290,"Other Interior Region",7,5,526,8,579,0,24,0,7
"09/24/2021","Y","Y","Yukon-Koyukuk Census Area",290,"Other Interior Region",7,16,542,3,582,0,24,0,7
"09/25/2021","Y","Y","Yukon-Koyukuk Census Area",290,"Other Interior Region",7,3,545,2,584,0,24,0,7
"09/26/2021","Y","Y","Yukon-Koyukuk Census Area",290,"Other Interior Region",7,5,550,0,584,0,24,1,8
"09/27/2021","Y","Y","Yukon-Koyukuk Census Area",290,"Other Interior Region",7,2,552,6,590,0,24,0,8
"09/28/2021","Y","Y","Yukon-Koyukuk Census Area",290,"Other Interior Region",7,2,554,8,598,0,24,0,8
"09/29/2021","Y","Y","Yukon-Koyukuk Census Area",290,"Other Interior Region",7,18,572,8,606,0,24,0,8
"09/30/2021","Y","Y","Yukon-Koyukuk Census Area",290,"Other Interior Region",7,17,589,12,618,0,24,0,8
"10/01/2021","Y","Y","Yukon-Koyukuk Census Area",290,"Other Interior Region",7,11,600,3,621,0,24,0,8
"10/02/2021","Y","Y","Yukon-Koyukuk Census Area",290,"Other Interior Region",7,4,604,0,621,0,24,0,8
"10/03/2021","Y","Y","Yukon-Koyukuk Census Area",290,"Other Interior Region",7,1,605,3,624,1,25,0,8
"10/04/2021","Y","Y","Yukon-Koyukuk Census Area",290,"Other Interior Region",7,16,621,5,629,0,25,0,8
"10/05/2021","Y","Y","Yukon-Koyukuk Census Area",290,"Other Interior Region",7,0,621,4,633,0,25,0,8
"10/06/2021","Y","Y","Yukon-Koyukuk Census Area",290,"Other Interior Region",7,6,627,13,646,0,25,0,8
"10/07/2021","Y","Y","Yukon-Koyukuk Census Area",290,"Other Interior Region",7,0,627,6,652,0,25,0,8
"10/08/2021","Y","Y","Yukon-Koyukuk Census Area",290,"Other Interior Region",7,7,634,8,660,0,25,0,8
"10/09/2021","Y","Y","Yukon-Koyukuk Census Area",290,"Other Interior Region",7,1,635,1,661,0,25,0,8
"10/10/2021","Y","Y","Yukon-Koyukuk Census Area",290,"Other Interior Region",7,4,639,1,662,0,25,0,8
"10/11/2021","Y","Y","Yukon-Koyukuk Census Area",290,"Other Interior Region",7,2,641,9,671,1,26,0,8
"10/12/2021","Y","Y","Yukon-Koyukuk Census Area",290,"Other Interior Region",7,11,652,7,678,1,27,0,8
"10/13/2021","Y","Y","Yukon-Koyukuk Census Area",290,"Other Interior Region",7,5,657,4,682,0,27,0,8
"10/14/2021","Y","Y","Yukon-Koyukuk Census Area",290,"Other Interior Region",7,2,659,9,691,0,27,0,8
"10/15/2021","Y","Y","Yukon-Koyukuk Census Area",290,"Other Interior Region",7,2,661,2,693,0,27,0,8
"10/16/2021","Y","Y","Yukon-Koyukuk Census Area",290,"Other Interior Region",7,3,664,0,693,1,28,0,8
"10/18/2021","Y","Y","Yukon-Koyukuk Census Area",290,"Other Interior Region",7,10,674,2,695,0,28,0,8
"10/19/2021","Y","Y","Yukon-Koyukuk Census Area",290,"Other Interior Region",7,0,674,7,702,1,29,0,8
"10/20/2021","Y","Y","Yukon-Koyukuk Census Area",290,"Other Interior Region",7,2,676,4,706,0,29,0,8
"10/21/2021","Y","Y","Yukon-Koyukuk Census Area",290,"Other Interior Region",7,0,676,4,710,0,29,0,8
"10/22/2021","Y","Y","Yukon-Koyukuk Census Area",290,"Other Interior Region",7,1,677,2,712,0,29,0,8
"10/23/2021","Y","Y","Yukon-Koyukuk Census Area",290,"Other Interior Region",7,5,682,1,713,0,29,0,8
"10/24/2021","Y","Y","Yukon-Koyukuk Census Area",290,"Other Interior Region",7,0,682,2,715,0,29,0,8
"10/25/2021","Y","Y","Yukon-Koyukuk Census Area",290,"Other Interior Region",7,7,689,3,718,0,29,0,8
"10/26/2021","Y","Y","Yukon-Koyukuk Census Area",290,"Other Interior Region",7,18,707,2,720,0,29,0,8
"10/27/2021","Y","Y","Yukon-Koyukuk Census Area",290,"Other Interior Region",7,1,708,4,724,0,29,0,8
"10/28/2021","Y","Y","Yukon-Koyukuk Census Area",290,"Other Interior Region",7,1,709,4,728,0,29,0,8
"10/29/2021","Y","Y","Yukon-Koyukuk Census Area",290,"Other Interior Region",7,4,713,6,734,0,29,0,8
"10/30/2021","Y","Y","Yukon-Koyukuk Census Area",290,"Other Interior Region",7,6,719,1,735,0,29,0,8
"10/31/2021","Y","Y","Yukon-Koyukuk Census Area",290,"Other Interior Region",7,2,721,0,735,0,29,0,8
"11/01/2021","Y","Y","Yukon-Koyukuk Census Area",290,"Other Interior Region",7,1,722,9,744,0,29,0,8
"11/02/2021","Y","Y","Yukon-Koyukuk Census Area",290,"Other Interior Region",7,8,730,8,752,0,29,0,8
"11/03/2021","Y","Y","Yukon-Koyukuk Census Area",290,"Other Interior Region",7,16,746,4,756,0,29,0,8
"11/04/2021","Y","Y","Yukon-Koyukuk Census Area",290,"Other Interior Region",7,5,751,1,757,0,29,0,8
"11/05/2021","Y","Y","Yukon-Koyukuk Census Area",290,"Other Interior Region",7,4,755,5,762,0,29,0,8
"11/06/2021","Y","Y","Yukon-Koyukuk Census Area",290,"Other Interior Region",7,2,757,1,763,0,29,0,8
"11/07/2021","Y","Y","Yukon-Koyukuk Census Area",290,"Other Interior Region",7,0,757,0,763,1,30,0,8
"11/08/2021","Y","Y","Yukon-Koyukuk Census Area",290,"Other Interior Region",7,3,760,8,771,0,30,0,8
"11/09/2021","Y","Y","Yukon-Koyukuk Census Area",290,"Other Interior Region",7,8,768,1,772,0,30,0,8
"11/10/2021","Y","Y","Yukon-Koyukuk Census Area",290,"Other Interior Region",7,0,768,4,776,0,30,0,8
"11/11/2021","Y","Y","Yukon-Koyukuk Census Area",290,"Other Interior Region",7,3,771,1,777,0,30,0,8
"11/12/2021","Y","Y","Yukon-Koyukuk Census Area",290,"Other Interior Region",7,2,773,3,780,0,30,0,8
"11/13/2021","Y","Y","Yukon-Koyukuk Census Area",290,"Other Interior Region",7,1,774,1,781,0,30,0,8
"11/14/2021","Y","Y","Yukon-Koyukuk Census Area",290,"Other Interior Region",7,1,775,1,782,1,31,0,8
"11/15/2021","Y","Y","Yukon-Koyukuk Census Area",290,"Other Interior Region",7,6,781,3,785,0,31,0,8
"11/16/2021","Y","Y","Yukon-Koyukuk Census Area",290,"Other Interior Region",7,2,783,2,787,0,31,0,8
"11/17/2021","Y","Y","Yukon-Koyukuk Census Area",290,"Other Interior Region",7,1,784,1,788,0,31,0,8
"11/18/2021","Y","Y","Yukon-Koyukuk Census Area",290,"Other Interior Region",7,1,785,2,790,0,31,0,8
"11/19/2021","Y","Y","Yukon-Koyukuk Census Area",290,"Other Interior Region",7,1,786,1,791,0,31,0,8
"11/20/2021","Y","Y","Yukon-Koyukuk Census Area",290,"Other Interior Region",7,1,787,1,792,0,31,0,8
"11/21/2021","Y","Y","Yukon-Koyukuk Census Area",290,"Other Interior Region",7,1,788,0,792,0,31,0,8
"11/22/2021","Y","Y","Yukon-Koyukuk Census Area",290,"Other Interior Region",7,2,790,3,795,1,32,0,8
"11/23/2021","Y","Y","Yukon-Koyukuk Census Area",290,"Other Interior Region",7,3,793,1,796,0,32,0,8
"11/24/2021","Y","Y","Yukon-Koyukuk Census Area",290,"Other Interior Region",7,1,794,2,798,0,32,0,8
"11/26/2021","Y","Y","Yukon-Koyukuk Census Area",290,"Other Interior Region",7,1,795,0,798,0,32,0,8
"11/27/2021","Y","Y","Yukon-Koyukuk Census Area",290,"Other Interior Region",7,1,796,0,798,0,32,1,9
"11/29/2021","Y","Y","Yukon-Koyukuk Census Area",290,"Other Interior Region",7,0,796,2,800,0,32,0,9
"11/30/2021","Y","Y","Yukon-Koyukuk Census Area",290,"Other Interior Region",7,1,797,0,800,0,32,0,9
"12/01/2021","Y","Y","Yukon-Koyukuk Census Area",290,"Other Interior Region",7,0,797,1,801,0,32,0,9
"12/05/2021","Y","Y","Yukon-Koyukuk Census Area",290,"Other Interior Region",7,0,797,1,802,1,33,0,9
"12/06/2021","Y","Y","Yukon-Koyukuk Census Area",290,"Other Interior Region",7,1,798,1,803,0,33,0,9
"12/08/2021","Y","Y","Yukon-Koyukuk Census Area",290,"Other Interior Region",7,1,799,1,804,0,33,0,9
"12/09/2021","Y","Y","Yukon-Koyukuk Census Area",290,"Other Interior Region",7,1,800,1,805,0,33,0,9
"12/11/2021","Y","Y","Yukon-Koyukuk Census Area",290,"Other Interior Region",7,0,800,1,806,0,33,0,9
"12/13/2021","Y","Y","Yukon-Koyukuk Census Area",290,"Other Interior Region",7,0,800,3,809,0,33,0,9
"12/14/2021","Y","Y","Yukon-Koyukuk Census Area",290,"Other Interior Region",7,4,804,3,812,0,33,0,9
"12/15/2021","Y","Y","Yukon-Koyukuk Census Area",290,"Other Interior Region",7,7,811,2,814,0,33,0,9
"12/16/2021","Y","Y","Yukon-Koyukuk Census Area",290,"Other Interior Region",7,2,813,1,815,0,33,0,9
"12/17/2021","Y","Y","Yukon-Koyukuk Census Area",290,"Other Interior Region",7,4,817,3,818,0,33,0,9
"12/19/2021","Y","Y","Yukon-Koyukuk Census Area",290,"Other Interior Region",7,1,818,0,818,0,33,0,9
"12/20/2021","Y","Y","Yukon-Koyukuk Census Area",290,"Other Interior Region",7,0,818,0,818,0,33,1,10
"12/22/2021","Y","Y","Yukon-Koyukuk Census Area",290,"Other Interior Region",7,1,819,1,819,0,33,0,10
"12/27/2021","Y","Y","Yukon-Koyukuk Census Area",290,"Other Interior Region",7,1,820,2,821,0,33,0,10
"12/28/2021","Y","Y","Yukon-Koyukuk Census Area",290,"Other Interior Region",7,1,821,2,823,0,33,0,10
"12/29/2021","Y","Y","Yukon-Koyukuk Census Area",290,"Other Interior Region",7,5,826,4,827,0,33,0,10
"12/30/2021","Y","Y","Yukon-Koyukuk Census Area",290,"Other Interior Region",7,3,829,6,833,0,33,0,10
"12/31/2021","Y","Y","Yukon-Koyukuk Census Area",290,"Other Interior Region",7,1,830,4,837,0,33,0,10
"01/01/2022","Y","Y","Yukon-Koyukuk Census Area",290,"Other Interior Region",7,16,846,26,863,0,33,0,10
"01/02/2022","Y","Y","Yukon-Koyukuk Census Area",290,"Other Interior Region",7,0,846,2,865,1,34,0,10
"01/03/2022","Y","Y","Yukon-Koyukuk Census Area",290,"Other Interior Region",7,1,847,15,880,0,34,0,10
"01/04/2022","Y","Y","Yukon-Koyukuk Census Area",290,"Other Interior Region",7,6,853,20,900,0,34,0,10
"01/05/2022","Y","Y","Yukon-Koyukuk Census Area",290,"Other Interior Region",7,6,859,16,916,0,34,0,10
"01/06/2022","Y","Y","Yukon-Koyukuk Census Area",290,"Other Interior Region",7,5,864,3,919,0,34,0,10
"01/07/2022","Y","Y","Yukon-Koyukuk Census Area",290,"Other Interior Region",7,15,879,13,932,0,34,0,10
"01/08/2022","Y","Y","Yukon-Koyukuk Census Area",290,"Other Interior Region",7,5,884,1,933,0,34,0,10
"01/09/2022","Y","Y","Yukon-Koyukuk Census Area",290,"Other Interior Region",7,40,924,7,940,0,34,0,10
"01/10/2022","Y","Y","Yukon-Koyukuk Census Area",290,"Other Interior Region",7,1,925,14,954,0,34,0,10
"01/11/2022","Y","Y","Yukon-Koyukuk Census Area",290,"Other Interior Region",7,6,931,7,961,1,35,0,10
"01/12/2022","Y","Y","Yukon-Koyukuk Census Area",290,"Other Interior Region",7,1,932,3,964,0,35,0,10
"01/13/2022","Y","Y","Yukon-Koyukuk Census Area",290,"Other Interior Region",7,4,936,9,973,0,35,0,10
"01/14/2022","Y","Y","Yukon-Koyukuk Census Area",290,"Other Interior Region",7,8,944,12,985,0,35,0,10
"01/15/2022","Y","Y","Yukon-Koyukuk Census Area",290,"Other Interior Region",7,11,955,4,989,0,35,0,10
"01/16/2022","Y","Y","Yukon-Koyukuk Census Area",290,"Other Interior Region",7,0,955,5,994,0,35,0,10
"01/17/2022","Y","Y","Yukon-Koyukuk Census Area",290,"Other Interior Region",7,4,959,13,1007,0,35,0,10
"01/18/2022","Y","Y","Yukon-Koyukuk Census Area",290,"Other Interior Region",7,1,960,20,1027,0,35,0,10
"01/19/2022","Y","Y","Yukon-Koyukuk Census Area",290,"Other Interior Region",7,19,979,22,1049,0,35,0,10
"01/20/2022","Y","Y","Yukon-Koyukuk Census Area",290,"Other Interior Region",7,11,990,22,1071,0,35,0,10
"01/21/2022","Y","Y","Yukon-Koyukuk Census Area",290,"Other Interior Region",7,11,1001,20,1091,0,35,0,10
"01/22/2022","Y","Y","Yukon-Koyukuk Census Area",290,"Other Interior Region",7,11,1012,9,1100,0,35,0,10
"01/23/2022","Y","Y","Yukon-Koyukuk Census Area",290,"Other Interior Region",7,8,1020,10,1110,0,35,0,10
"01/24/2022","Y","Y","Yukon-Koyukuk Census Area",290,"Other Interior Region",7,22,1042,26,1136,0,35,0,10
"01/25/2022","Y","Y","Yukon-Koyukuk Census Area",290,"Other Interior Region",7,5,1047,20,1156,0,35,0,10
"01/26/2022","Y","Y","Yukon-Koyukuk Census Area",290,"Other Interior Region",7,18,1065,6,1162,0,35,0,10
"01/27/2022","Y","Y","Yukon-Koyukuk Census Area",290,"Other Interior Region",7,18,1083,7,1169,0,35,0,10
"01/28/2022","Y","Y","Yukon-Koyukuk Census Area",290,"Other Interior Region",7,3,1086,5,1174,0,35,0,10
"01/29/2022","Y","Y","Yukon-Koyukuk Census Area",290,"Other Interior Region",7,21,1107,5,1179,0,35,0,10
"01/30/2022","Y","Y","Yukon-Koyukuk Census Area",290,"Other Interior Region",7,10,1117,4,1183,0,35,0,10
"01/31/2022","Y","Y","Yukon-Koyukuk Census Area",290,"Other Interior Region",7,3,1120,15,1198,0,35,0,10
"02/01/2022","Y","Y","Yukon-Koyukuk Census Area",290,"Other Interior Region",7,32,1152,17,1215,0,35,0,10
"02/02/2022","Y","Y","Yukon-Koyukuk Census Area",290,"Other Interior Region",7,23,1175,12,1227,0,35,0,10
"02/03/2022","Y","Y","Yukon-Koyukuk Census Area",290,"Other Interior Region",7,20,1195,17,1244,0,35,0,10
"02/04/2022","Y","Y","Yukon-Koyukuk Census Area",290,"Other Interior Region",7,31,1226,16,1260,0,35,0,10
"02/05/2022","Y","Y","Yukon-Koyukuk Census Area",290,"Other Interior Region",7,19,1245,1,1261,0,35,0,10
"02/06/2022","Y","Y","Yukon-Koyukuk Census Area",290,"Other Interior Region",7,0,1245,1,1262,1,36,0,10
"02/07/2022","Y","Y","Yukon-Koyukuk Census Area",290,"Other Interior Region",7,4,1249,4,1266,0,36,0,10
"02/08/2022","Y","Y","Yukon-Koyukuk Census Area",290,"Other Interior Region",7,10,1259,18,1284,0,36,0,10
"02/09/2022","Y","Y","Yukon-Koyukuk Census Area",290,"Other Interior Region",7,2,1261,5,1289,0,36,0,10
"02/10/2022","Y","Y","Yukon-Koyukuk Census Area",290,"Other Interior Region",7,0,1261,16,1305,1,37,0,10
"02/11/2022","Y","Y","Yukon-Koyukuk Census Area",290,"Other Interior Region",7,12,1273,9,1314,0,37,0,10
"02/12/2022","Y","Y","Yukon-Koyukuk Census Area",290,"Other Interior Region",7,3,1276,0,1314,0,37,0,10
"02/14/2022","Y","Y","Yukon-Koyukuk Census Area",290,"Other Interior Region",7,2,1278,8,1322,0,37,0,10
"02/15/2022","Y","Y","Yukon-Koyukuk Census Area",290,"Other Interior Region",7,3,1281,8,1330,0,37,0,10
"02/16/2022","Y","Y","Yukon-Koyukuk Census Area",290,"Other Interior Region",7,0,1281,5,1335,0,37,0,10
"02/17/2022","Y","Y","Yukon-Koyukuk Census Area",290,"Other Interior Region",7,2,1283,1,1336,0,37,0,10
"02/18/2022","Y","Y","Yukon-Koyukuk Census Area",290,"Other Interior Region",7,8,1291,1,1337,0,37,0,10
"02/19/2022","Y","Y","Yukon-Koyukuk Census Area",290,"Other Interior Region",7,20,1311,1,1338,0,37,0,10
"02/20/2022","Y","Y","Yukon-Koyukuk Census Area",290,"Other Interior Region",7,3,1314,2,1340,0,37,0,10
"02/21/2022","Y","Y","Yukon-Koyukuk Census Area",290,"Other Interior Region",7,2,1316,3,1343,0,37,0,10
"02/22/2022","Y","Y","Yukon-Koyukuk Census Area",290,"Other Interior Region",7,0,1316,2,1345,0,37,0,10
"02/23/2022","Y","Y","Yukon-Koyukuk Census Area",290,"Other Interior Region",7,2,1318,4,1349,1,38,0,10
"02/24/2022","Y","Y","Yukon-Koyukuk Census Area",290,"Other Interior Region",7,0,1318,1,1350,0,38,0,10
"02/25/2022","Y","Y","Yukon-Koyukuk Census Area",290,"Other Interior Region",7,5,1323,2,1352,0,38,0,10
"02/26/2022","Y","Y","Yukon-Koyukuk Census Area",290,"Other Interior Region",7,2,1325,2,1354,0,38,0,10
"02/28/2022","Y","Y","Yukon-Koyukuk Census Area",290,"Other Interior Region",7,0,1325,1,1355,0,38,0,10
"03/01/2022","Y","Y","Yukon-Koyukuk Census Area",290,"Other Interior Region",7,5,1330,0,1355,0,38,0,10
"03/02/2022","Y","Y","Yukon-Koyukuk Census Area",290,"Other Interior Region",7,0,1330,2,1357,0,38,0,10
"03/03/2022","Y","Y","Yukon-Koyukuk Census Area",290,"Other Interior Region",7,2,1332,1,1358,0,38,0,10
"03/04/2022","Y","Y","Yukon-Koyukuk Census Area",290,"Other Interior Region",7,0,1332,3,1361,0,38,0,10
"03/05/2022","Y","Y","Yukon-Koyukuk Census Area",290,"Other Interior Region",7,1,1333,2,1363,0,38,0,10
"03/07/2022","Y","Y","Yukon-Koyukuk Census Area",290,"Other Interior Region",7,3,1336,8,1371,0,38,0,10
"03/08/2022","Y","Y","Yukon-Koyukuk Census Area",290,"Other Interior Region",7,35,1371,1,1372,0,38,0,10
"03/09/2022","Y","Y","Yukon-Koyukuk Census Area",290,"Other Interior Region",7,6,1377,5,1377,0,38,0,10
"03/10/2022","Y","Y","Yukon-Koyukuk Census Area",290,"Other Interior Region",7,5,1382,5,1382,0,38,0,10
"03/11/2022","Y","Y","Yukon-Koyukuk Census Area",290,"Other Interior Region",7,4,1386,4,1386,0,38,0,10
"03/14/2022","Y","Y","Yukon-Koyukuk Census Area",290,"Other Interior Region",7,1,1387,1,1387,0,38,0,10
"03/15/2022","Y","Y","Yukon-Koyukuk Census Area",290,"Other Interior Region",7,2,1389,3,1390,0,38,0,10
"03/16/2022","Y","Y","Yukon-Koyukuk Census Area",290,"Other Interior Region",7,6,1395,5,1395,0,38,0,10
"03/17/2022","Y","Y","Yukon-Koyukuk Census Area",290,"Other Interior Region",7,2,1397,2,1397,0,38,0,10
"03/18/2022","Y","Y","Yukon-Koyukuk Census Area",290,"Other Interior Region",7,1,1398,1,1398,0,38,0,10
"03/19/2022","Y","Y","Yukon-Koyukuk Census Area",290,"Other Interior Region",7,1,1399,1,1399,0,38,0,10
"03/21/2022","Y","Y","Yukon-Koyukuk Census Area",290,"Other Interior Region",7,0,1399,1,1400,0,38,0,10
"03/23/2022","Y","Y","Yukon-Koyukuk Census Area",290,"Other Interior Region",7,2,1401,3,1403,0,38,0,10
"03/24/2022","Y","Y","Yukon-Koyukuk Census Area",290,"Other Interior Region",7,4,1405,2,1405,0,38,0,10
"03/29/2022","Y","Y","Yukon-Koyukuk Census Area",290,"Other Interior Region",7,0,1405,1,1406,0,38,0,10
"03/31/2022","Y","Y","Yukon-Koyukuk Census Area",290,"Other Interior Region",7,1,1406,1,1407,0,38,0,10
"04/01/2022","Y","Y","Yukon-Koyukuk Census Area",290,"Other Interior Region",7,1,1407,1,1408,0,38,0,10
"04/04/2022","Y","Y","Yukon-Koyukuk Census Area",290,"Other Interior Region",7,0,1407,2,1410,0,38,0,10
"04/05/2022","Y","Y","Yukon-Koyukuk Census Area",290,"Other Interior Region",7,2,1409,0,1410,0,38,0,10
"04/06/2022","Y","Y","Yukon-Koyukuk Census Area",290,"Other Interior Region",7,0,1409,2,1412,0,38,0,10
"04/07/2022","Y","Y","Yukon-Koyukuk Census Area",290,"Other Interior Region",7,1,1410,1,1413,0,38,0,10
"04/08/2022","Y","Y","Yukon-Koyukuk Census Area",290,"Other Interior Region",7,2,1412,0,1413,0,38,0,10
"04/09/2022","Y","Y","Yukon-Koyukuk Census Area",290,"Other Interior Region",7,1,1413,0,1413,0,38,0,10
"04/12/2022","Y","Y","Yukon-Koyukuk Census Area",290,"Other Interior Region",7,0,1413,1,1414,0,38,0,10
"04/13/2022","Y","Y","Yukon-Koyukuk Census Area",290,"Other Interior Region",7,1,1414,1,1415,0,38,0,10
"04/14/2022","Y","Y","Yukon-Koyukuk Census Area",290,"Other Interior Region",7,1,1415,1,1416,0,38,0,10
"04/15/2022","Y","Y","Yukon-Koyukuk Census Area",290,"Other Interior Region",7,1,1416,1,1417,0,38,0,10
"04/20/2022","Y","Y","Yukon-Koyukuk Census Area",290,"Other Interior Region",7,0,1416,1,1418,0,38,0,10
"04/21/2022","Y","Y","Yukon-Koyukuk Census Area",290,"Other Interior Region",7,1,1417,1,1419,0,38,0,10
"04/22/2022","Y","Y","Yukon-Koyukuk Census Area",290,"Other Interior Region",7,1,1418,0,1419,0,38,0,10
"04/26/2022","Y","Y","Yukon-Koyukuk Census Area",290,"Other Interior Region",7,1,1419,0,1419,0,38,0,10
